chr	start	end	V2	length	CG_total	CG_per	CA_total	CA_per
1	5809951	5810400	cttgtgcagtttcatgccaaagagctctccattccatatatttgcccatactagggagagcggcttttacaaccgtttgccagtcggcaggagttagtgccatgccggcaagcctgtctaactgcaccaaggtaaaattagcattggttccatatttacggaccgactcggcaagctctttaatctgtaagtattctaccggagcgtggacacgcccaccctcggctccttcaaagactggaaatgcctgttgtattttcctttgttcctctctgggaatgaatgagtctgcgcactgcctctctgcgcattgtctctctgcgcagggctgacgcactacgcagggcgggggctccgcatagggcggaccttgaagccgactgccctgaggccaatcagcaaactggccttcgccagccgcttttggcttccttaactgattagctagc	449	44	10%	58	13%
1	6432451	6432750	ggaagaaacatgtgtaacatccatttgccagacctgtagaggtcgaataccgcgtgggttaattcccacatgaggaactggcaagaactcacagcagctttgacattgagtaacaatgtcacgggcttcttttcttgtcaaggagaaacgactgcgtaatgtttcagccgtcacatgaaaattgttatgaaaattttttgcagcctctaccggggatgatagggcagcagccaccactttagtggccttatctgccaaatcatttcccagagccatggggccaggtaggcctgaatggg	299	16	5%	54	18%
1	6436051	6436500	ccatttgccagtcagcaggagttagtgccatgccggcgagcctgtctaactgcaccaaggtaaaattagcattggttccgtatttacggaccgactcggcaatttctttaatttgtaagtattctaccggagcgtggacacgcccaccctcggctccttcaaagaccggaaatgcctgttgtattttcctttgttcctctctgggaatgaatgagtctgcgcactgcctctctgcgcactgcctctctgcgcatctctctgcgcattgcctctctgcgcattgctgacgcactacgcagggcggggactccgcatagggcggaccttgaagccgactgccctgaggccaatcagcaaactggccttcgccagccgcttttggcttccttaactgattagctagcactttacctggctggtacccttttttctcataatgagctgcttct	449	48	11%	52	12%
1	6437251	6437550	aagcaagagagagagaaaacgaaaccccgtccctattaaggagaattttccttcgcctaggacgtgtcactccctgattggctgcagcccatcggccgagttgacgtcacgaggaaggcagagcacatggagtgaagaaccaccctcggcacatgcgcagattatttgtttaccacttagaacacagctgtcagcgccatcttgtaacggcgaatgtgggcgcggctcccaacaCTTTGATTTAGGTTTGCCAAGTCCTTGCTCCTCCAAGGCCTGCTGCTGCTTCCTCCGTAAGTATT	299	32	11%	42	14%
1	6691201	6691350	aagtgttcccgtaaagcagactgttgagaaggatctggcgtggattcagaactcttcagctggggaacggtactgatgaagagaaagaagaaagatgaggactgaataaactgctgttagaaggactggtggtcgcgtcgttcttgctg	149	12	8%	6	4%
1	7993951	7995150	gctcctgaagatgtaagcaataaagttttgccgcagaagattttggtctgttgtgttcttcctggccgggcgtgagaacgcgtttaataacaattggtgccgaattccgggacgagaaaaaactcgggactggcgcaaggaagatccctcattccagaaccagaactgcgggtcgcggtaataaaggttcccgtaaagcagactgttaagaaggattcaactgtatgaattcagaacttttcagctggggaacgagagtaccagtgagtacagctttacgaggtaagcctggccttgaactttctaaggaaattcaagacagtctatcagaagtaaagtggaaaatgtttggccttgaattttttctaatgttagaagcccttttgttccttttcacatgttatcaagtggttaaggcagggaggattctagatgaaattcaggacaatctatcagaagtaaagcggggagagagagtaggagcaaagagaaaatatggtacacaaaataagtatacaggcctttccaagggtcttgaacccgaagaaaagtttaggtcaggtaagaatacctggggagagattagaaggaaggaaaagaaaaaagaaaagaaaaaagatcgattagcggaggtctctaggagatactcgtcactagatgagctcaggaagccagctcttagtagctctgaagcagatgaagaattctcctctgaggaaacagactgggaggaagaagcagctcattatgagaaaaaagggtaccagccaggtaaagtgctagctaatcagttaaggaagccaaaagcggctggcgaaggccagtttgctgattggcctcagggcagtcggtttcaaggtccgccctatgcggagcccccgccctgcgtagtgcgtcagcaatgcgcagagaggcaatgcgcagagagatgcgcagagaggcagtgcgcagagaggcagtgcgcagagaggcagtgcgcagactcattcattcccagagaggaacaaaggaaaatacaacaggcatttccagtctttgaaggagccgagggtgggcgtgtccacgctccggtagaatacttacaaattaaagagcttgccgagtcggtccgtaaatacggaaccaatgctaattttaccttggtgcagttagacaggcttgccggcatggcactaactcctgctgactggcaaacggtt	1199	90	8%	144	12%
1	11950351	11950800	aaagctatacttacgggtaccctgttccccagctgaagagttctgaattcacgcagttgaatccttctcaacagtctgttttacgggaacacttcattaccgtgacccgcagttctggttccggaatgaagaatcttccttgcgccggtgatggttaactcccgtcccgagttttcttgtcccgggttttttcgtcccgggttctttcttcccggatttcggcaccaaCtcttacacgcgttcgcgaccggccaggaaagacgcagcaaaccagaatcttctgcggcaaaactttattgcttacatcttcaggagcaagagtgcaagcccccaaaagcaaaagcgaaaccccgtccctcttaaggagagttatccttcgcctaggacgtatcactccctgattggctgcagcccatggccgagttgtcgtcacggggaaggcagagcac	449	58	13%	56	12%
1	13550551	13550850	aattttccactacatgtactctgcctttactcggccatgggctgcagccaatcagggagtgatgcgtcctaggcaaagaataattctccttaaaaggggacggggtttccgccattctctctcttgctctgcgccctggcgctctggcgcgctggcgctctggctcctaaagatgtaagcggggggctttcgtttttgggcttgggggcttgcgctcctgctcctgaagatgtaagcaataaagttttgccgcagaagattctggtttgttgtgttcttcctggccggtcgtgagaacg	299	32	11%	20	7%
1	14364601	14365050	acaacgtacacacaccaggtacacacaccaggtcagcacaacgtacacaccccaggtacacacaccaggtcagcacaacgtacacaccccaggtacacacaccaggtcagcacaacgtacacaccccaggtacacacaccaggtcagcacaacgtacacaccccaggtacacacaccaggtcagcacaacgtacacacaccaggtacacacaccaggtcagcacaacgtacacaccccaggtacacacaccaggtcagcacaacgtacacaccccaggtacacacaccaggtcagcacaacgtacacacaccaggtacacacaccaggtcagccagcataacgtacacacaccaggtacacacaccaggtacacacaccaggtacacacaccagatacacacaccaggtacacacaccaggtacacacaccaggtacacacaccaggtc	449	20	4%	252	56%
1	16713301	16713600	aagtttcactcaccgtgaacttaccctgcctgcaaccactgactgctgaaagttctgaactcggtgggggagtcggttccccgtacgggccaccaattgtcgcgtccactctcgaccagcaagaacgacacgaccaccagtccttctaacagcagtttattcagtcttcatctttcttctttctcttcatcagtaccgttccccagctgaagagttctgaatccacgccggatccttctcaacagtctgttttacaggaacttttattaaccactccttccccgtgatgcagttctgaa	299	28	9%	50	17%
1	16738351	16739700	gcatgtgccgagggtggttcttcactccatgtgctctgccttcctcgtgacgtcaactcggccgatgggctgcagccaatcagggagtgacacgtcctaggcgaaggaaaattctccttaatagggacggggtttcgttttctctctctcttgcttcttgcactctggctcctgaagatgtaagcaataaagctttgccgcagaagattctggtctgttgcgtctttcctggccggtcgtgagaacgcgtctaataacaattggtgccgaattccgggacgagaaaaaaactcgggactggcgcaaggaagatccctcattccagaaccagaactgcgggtcgcggtaataaaggttcccgtaaagcagactgttaagaaggattcaactgtatgaattcagaacttttcagctggggaacgagagtaccagtgagtacagctttacgaggtaagtctgatcttgaactttctaaggaaattcaagacagtctatcagaagtaaagtggaatatgtttggccttgaattttttctggtgttaggagcccttttgttccttttcacatgttatcaagtggttaagatagggaggattctagatgaaattcaggacaagctatcagaagtaaagcggggagagagagtaggagcaaagagaaaatatggtacacaaaataagtatacaggcctttccaagggtcttgaacccgaggaaaagtttaggtcaggtaagaatacctggggagagattagaaggaaggaaaagaaaaaagaaaagaaaaaagatcgattagcggaggtctctaggagatactcgtcactagatgagctcaggaagccagctcttagtagttctgaagcagatgaagaattctcctctgaggaaacagactgggaggaagaagcagcccattaccagccaggtaaagtgctagctaatcagttaaggaagccaaaagcggctggcgaaggccagtttgctgattggcctcagggcagtcggcttcaaggtccgccctatgcggagtccccgccctgcgtagtgcgtcagccctgcgcagagaggcagtgcgcagagaggcagtgcgcagactcattcattcccagagaggaacaaaggaaaatacaacaggcatttccggtctttgaaggagccgagggtgggcgtgtccacgctccggtagaatacttacaaattaaagaaattgccgagtcggtccgtaaatacggaaccaatgctaattttaccttggtgcagttagacaggctcgccggcatggcactaactcctgctgactggcaaacggttgtaaaagccgctctccctagtatgggcaaatatatggaa	1349	110	8%	148	11%
1	17958001	17958300	gcgcagagagacagtgcgcagagaggcagtgcgcagactcattcattcccagagaggaacaaaggaaaatacaacaggcatttccagtctttgaaggagccgagggtgggcgtgtccacgctccggtagaatacgtgcagattaaagaactcgccgagtcggtccgtaaatacggaaccaatgctaattttaccttggtgcagttagacaggcttgccggcatggcactaacccctgccgactggcaaacgattgtaaaagccgctctccctagtatgggcaaatatatggaatggaga	299	34	11%	44	15%
1	22247551	22248000	gaggTAATCTCCAATATGTTAAGGATTGTTAAATCTATTTTTAGCAAGGGTTTATCTTTTAGtgtaggaagccgccctcacatttgccattacaagatggcgctgacagctgtgttctaagtggtaaacataatctgcacacgtgcaggggcagttttcccgccatgtgttctgcctttcccgtgatgacaactgggccgatgggctgcagccaatcagggagtaatacgtcctaggcggaggataattctccttaaaagggacagggtttcgccattctttttctctttcttgctttcttgttcttgttctttttctctctcttgcgctctggctcctgaagatgtaagcaataaagctttgccgcagaagattccggtttgttgctttcttcctggccagtcgcgagaacgcgtgtaagaTTTTAGTAACCAGAGCAAGATAAAGTA	449	32	7%	48	11%
1	23782201	23782800	ctggctcttatggtcttttccccttctcttccctagtgcttcctaaaccttacattttagagtattctctacatgaatccactgggatgtgctccacaaatctgcattttgattgCGTCTGtattgcgtcccgctcgaccggcaagaaagacgcaacaaaccagaatcttccgcggcaaaagctttattgcttgcttctcaggaagattccgaaccgggaaaatggcgctgcttttataacccgcagcgtgacgtttcagcacctgatatggcgtgacagctcctggttcgttgcttgcccatcaccccactattacaccccgagaatgggagtgactaggagtgaattcactcttgcacctgcgtacaggacttgtttactagttaggcacagcggaggcccgcgccatcttataatggcgattgctcgcggcacacacggctctcctcagagattactggcagcacgcatgcaattgctcgcagcacgtaacggctctccacaTAtccccctttttattttattaaaatttgaggctggtctaggcctgtgtaattatgcccatccgctgtggctcctgtcttaggtcgttcctcca	599	62	10%	80	13%
1	23785951	23786550	gcaaacaatcaaaagggcttctaactctggagaaatttcaagattgtacgtaccttgtagagccttttgtcccacggttctgattctgccccgcgaacgagggatcttccttgcgccggtgtgatgacagttcccgggttcttcggcgccacttattgcgtcccgctcgaccggcaagaaagacgcaacaaaccagaatcttccgcggcaaaagctttattgcttgcttctcaggaagattccgaaccgggaaaatggcgctgcttttataacccgcagcgtgacgtttcagcacctgatatggcgtgacagctcctggttcgttgcttgcccatcaccccactattacaccctgagaatgggagtgactaggagtgaattcactcttgcacctgcgtacaaggcttgtttactagttaggcacagcggaggcccgcgccatcttataatggcgattgctcgcggcacacacggctctcctcagagattactggcagcacgcatgcaattgctcgcagcacgtaacggctctccacaCGTCTGTATTCCCAAAGTGGTCTCCATCTATTGcaaaacaaccccaaaaaacaaacaaacaa	599	76	13%	94	16%
1	24721351	24721650	tggcctgagaggtttgtggcacaggcgccggcgggagccttcttggctccgggactccgcggagggcaggctgcacgggtgaccgtgtggaatacagagtgtcagccgtttctgggacgggcgagagtcgcagagcttctgggcggcgccatcttcagctccagacagccggccaccttcctggtgagagcacgggggtctgccaggcctgagaggtttgtggcacaggcgccggcgggagccttcttggctccgggactccgcggagggcaggctgcacgggtgaccgtgtggaatac	299	48	16%	36	12%
1	35788501	35788950	TCCtgttgggagccgcgcccacattcgccgttacaagatggcgctgacagctgtgttctaagtggtaaacaaataatctgcgcatatgccgagggtggttctctactccatgtactctgccttccccgtgacgtcaactcggccgatgggctgcagccaatcagggagtgacacgtcctaggcgaaggagaattctctttaatagggacggggtttcgttttctctcgctcttgcttcttgctctcttgcttcttgcactctggctcctgaagatgtaagcaataaagttttgccgcagaagattctggtctgtggtgttcttcctggccggtcgtgagaacgcgtctaataacaattggtgccgaattccgggacgagaaaaaactcgggactggcgcaaggaagatccctcattccagaaccagaactgcgggtcgcggtaataaag	449	58	13%	40	9%
1	35789551	35789700	tggcgaaggccagtttgctgattggcctcagggcagtcggcttcaaggtccgccctatgcggagtccccgccctgcgtagtgcgtcagcaatgcgcagagaggcagtgcgcagagaggcagtgcgcagactcattcattcccagagagg	149	20	13%	28	19%
1	35795251	35795550	cgccgttacaagatggcgctgacagctgtgttctaagtggtaaacaaataatctgcgcatatgccgagggtggttctctactccatgtactctgccttccccgtgacgtcaactcggccgatgggctgcagccaatcagggagtgacacgtcctaggcgaaggagaattctctttaatagggacggggtttcgttttctctcgctcttgcttcttgctctcttgcttcttgcactctggctcctgaagatgtaagcaataaagttttgccgcagaagattctggtctgtggtgttcttc	299	30	10%	26	9%
1	37283101	37283700	ttcacgcagttgaatccttctcaacagtctgttttacgagaacacttcattaccgtgacccgcagttctggttccggaatgagggatcttccttgcgccggtgatggtaaccgtcccaggttttcttgtcctaggattttctcgtcccgtcccgggtctcagcaccaactcttacacgcgttctcacgaccggccaggaaagaacacaacaaaccagaatcttctgcggcaaaactttattgcttacatcttcaggagcaggagcgcaaaaccccaagccccaaaaacgaaagcccccttctaaacgaaagcgaaaccccccgtccctatttaggagagttaaccttcgcttaggacgcatcactccctgattggctgcagcccatggccgagctgacgtcacgggaaaggcagagtacaagtagtggtaaaatacccttggcacatgcgcagattatttgtttaccacttagaacacaggatgtcagcaccatcttgtgacagcgaatgtgggggcggctcccaacaCCTTCTCAGTCTCTtgcctttccttcttgaaacaactttaactctctatccttgatatcttcaaattcacc	599	58	10%	96	16%
1	37774051	37774350	acacgtcctaggcgaaggataattctccttaatagggacggggtttcgtttgctcgctctcttgcttcttacactcttgctcctgaagatgtaagcaataaagttttgccgcagaagattctggtttgctgtgttcttcctggccgggcgtgagaacgcgttaataagaattggtgctgaaatccgggacgagaaaaaatccgggacgaaaaaatacaagaaaactcgggaccggcacaaggaagatccctcattccagaaccagaactgcgggtcgcggtaataaaggttcccgtaaa	299	40	13%	20	7%
1	38705851	38706150	acagactgggaggaagaagcagcccattaccagccagctaattggtcaagaaaaaagccaaaagcggctggcgaaggccagtttgctgattggcctcagggcaatcggctaccaggtgcactcccgccctatgcggagtccccgccctgcgtagtgcgtcagcccgtagtgcgtcagcaatgcgcagagaggcagtgcgcagagaggcagtgcgcagactcattcattcccagagaggaacaaaggaaaatacaacaggcatttccggtctttgaaggagccgagggtgggcgtgtcca	299	32	11%	56	19%
1	44360551	44361000	ccttttctctctcttgctctcttgctctcttgctctctggctcctgaaaatgtaagcaataaagctttgccgcagaagattccggtttgttgcgtctttcctggccggtcgcgaatgcgtgtaagaGTtggtgctgagacccgggacgagaagacctgggacgagaagccctgggacgagaaatcccgggacaagaagacctgggacgagaaatcctgggacgagaaaacctgggacggttaccatcaccggcgcaaggaagatccctcattccggaaccagaactgcgggtcatggtaatgaagtgttcccgcaacacagactgttgagaaggattcaactgcgtgaattcagaactcttcagctggggaacggtggtaatgaagtgttcccgtaaaacagactgttgagaaggattcaactgcgtgaattcagaactcttcagctgg	449	48	11%	38	8%
1	47629351	47629800	cgccatcttcagctccagacagccggccaccttcctggtgagagcacgggggtctgcctggcctgagaggtttgtggcacaggcgccggcgggagccttcttggctccgggactccgcggagggcaggctgcacgggtgaccgtgtggaatacagagtgccagccgtttctgggacgggcgagagagtcgcagagcttctgggcggcgccatcttcagctccagacagccggccaccttcctggtgagagcacgggggtctgcctggcctgagaggtttgtggcacaggcgccggcgggagccttcttggctccgggactccgcggagggcaggctgcacgggtgaccgtgtggaatacagagtgccagccgtttctgggacgggcgagagagtcgcagagcttctgggcggcgccatctttagctccagacagccggccaccttcctg	449	68	15%	60	13%
1	47957701	47958150	ttacttctgatagactgtcttgaatttcgttagaaagttcaaggccagacttaccttgtaaagctatacttacgggtaccctgttccccagctgaagagttctgaattcacgcagttgaatccttctcaacagtctgttttacgggaacacttcattaccaccgttccccagctgaagagttctgaattcacgcagttgaatccttctcaacagtctgttttacgggaacacttcattaccatgacccgcagttctggttccggaatgagggatcttccttgcgccggtgatggtaaccgtcctgggttttctcatcccaggatttctcgtcccaggtcttctcgtcccggatctcagcaccaaCtcttacacgcgttctcgcaaccggccaggaagaacgcagcaaactggaatcttctgcggcaaagctttattgcttacatcttca	449	42	9%	66	15%
1	48093901	48094350	ggcctatttgctcttattaatagaaaagggggaACtgtgggaagccgcccccacattcgccgttacaagatggcgctgacatcctgtgttctaagtggtaaacaaataatctgcgcatgtgccaagggtatcttatgactacttgtgctctgccttccccgtgacgtcaactcggccgatgggctgcagccaatcagggagtgacacgtccgaggcgaaggagaatgctccttaagagggacggggttttcgtttctctctctctcttgcttcttgctctcttgcttcttgcactctgttcctgaagatgtaagaataaagctttgccgcagaagattctggtctgtggtgttcttcctggccggtcgtgagaacgcgtctaataacaAAAAGTTATTTAAGCAACATTTTATATTCCTTTAGAGATTCATACAACTCCAAGCTACCAC	449	38	8%	42	9%
1	53133301	53133750	cagcttcgtgccaaagcgctctccattccatatatttgcccatactagggagagcggcttttacaaccgtttgccagtcggcaggagttagtgccatgccagcgagcctgtctaactgcaccaaggtaaaattagcattggttccgtatttacgaaccgactcggcaatttccttaatttgtaagtattctaccggagcgtggacacgcccaccctcggcttcttcaaagaccggaaatgcctgttgtattttcctttgttcctctctgggaatgaatgagtctgcgcactgcctctctgcgcactgcctctctgcgcattgctgacgcactacgcagggcggggactccgcatagggcggaccttgaagccgactgccctgaggccaatcagcaaactggccttcgccagccgcttttggcttttttcttgaccaattagctggctgg	449	52	12%	56	12%
1	53235751	53236200	ggggttttgccattctttttctctctcttgttcttgctttttctctctcttgttcttgctttttctctctcttgttcttgctttttctctctcttgctttcttgttctttctcttgctttcttgttcttgttctttttcttgctctcttgctctcttgctctcttgcactcttgctcctgaagatgtaagcaataaagcttttgccgcagaagattccggtttgctgagttcttcctggccggtcgcgtgaacgcgtgcaagaGttggtgccgaaacccgggaagaaagaacccgggacgaagaaagatcccgggacaagaaaaactcgggacgggagttaaccatcaccggcgcaaggaagatccctcattccggaaccagaactgcgggtcatggtaatgaagtgttcccgtaaaacagactgttgagaaggattcaactgcgtgaa	449	40	9%	28	6%
1	56773201	56773650	cctctgaggaaacagactgggaggaagaagcagcccattaccagccagctaattggtcaagaaaaaagccaaaagcggctggcgaaggccagtttgctgattggcctcagggcagtcggcttcaaggtccgccctatgcggagtccccgccctgcgtagtgcgtcagcaatgcgcagagaggcagtgcgcagagaggcagtgcgcagactcattcattcccagagaggaacaaaggaaaatacaacaggcatttccggtctttgaaggagccgagggtgggcgtgtccacgctccggtagaatacttacaaattaaggaaattgccgagtcggttcgtaaatacggaaccaatgctaattttaccttggtgcagttagacaggctcgctggcatggcactaactcctgccgactggcaaacggttgtaaaagccgctctccctagtatg	449	48	11%	66	15%
1	58817401	58818900	gcaccaaggtaaaattagcattggttccgtatttacggaccgactcggcaagttctttaatttgtaagtattctaccggagcgtggacacgcccaccctcggctccttcaaagactggaaatgcctgttgtattttcctttgttcctctctgggaatgaatgagtctgcgcactgcctctctgcgcactgcctctctgcgcactgcctctctgcgcatctctctgcgcattgcctctctgcgcatctctctgtgcattgcctctctgcgcatctctctgcgcattgcctctctgcgcatctctgacgcactacgcagggcggggactccgcatagggcggaccttgaaaccgactgccctgaggccaatcagcaaactggccttcgccagccgcttttggcttccttaactgattagctagcactttacctggctggtacccttttttctcataatgagctgcttcttcctcccagtctgtttcttcagaggagaattcatcatctgattcagagctaccaagagctggctccccgagcccatccagcgatgagcacaggctccttttcctagagacctccgctaattgatctttcttcttttccctttttcctctttttcttctaatctctctccaggtattcctacctaaccttaacttttcctcgggttcaagacccttggaaaggcctgtatacttattttgtgtaccatatttcctctttgttcctactctctctccccactttacttctgatagcttgtcctgaatttcctctagaattttcagccctatcttaatcacttgataacatgtgaaaaggaacaaaagggctcctaacaccagaaaaaattcaaggccaaacattttccactttacttctgatagactgtcttgaatttccttagaaagttcaaggccaggcttacctcgtaaagctatactcactggtactctcgttccccagctgaaaagttctgaattcatgcagttgaatccttcttaacagtctgctttacgggaacctttattaccgcgacccgcagttctggttctggaatgagggatcttccttgcgccagtcccgagttttttctcgtcccggaattcggcaccaattgttattagaagcgttctcacgcccggccaggaagaacaccacagaccagaatcttctgcggcaaaactttattgcttacatcttcaggagcaagagtgtaagaagcaagagagagagaaaacgaaaccccgtccctattaaggagaattatccttcgcctaggacgtgtcactccctgattggctgcagcccatcggccgagttgacgtcacggggaaggcagagcacatggagtggagaaccaccctcggcacatgcgcagattatttgtttaccacttagaacacagctgtcagcgccatcttgtaaaggcgaatgtgggcgcggctcccaacatgtgtgtgtgtgtgtttcccttctctgggttttgctagtgtg	1499	116	8%	180	12%
1	64183801	64184250	tcatgccaaagagctctccattccatatatttgcccatactagggagagcggcttttacaaccgtttgccagtcggcaggagttagtgccatgccggcaagcctgtctaactgcaccaaggtaaaattagcattggttccgtatttacggaccgactcggcaagctctttaatttgtaagtattctaccggagcgtggacacgcccaccctcggctccttcaaagaccggaaatgcctgttgtattttcctttgttcctctctgggaatgaatgagtctgcgcactgcctctctgcgcattgcctctctgcgcagggctgacgcactacgcagggcggggactccgcatagggcggaccttgaagccgactgccctgaggccaatcagcaaactggccttcgccagccgcttttggcttccttaactgattagctagcactttacctgg	449	48	11%	56	12%
1	64315801	64315950	gaccaccagtccttctaacagcagtttattcagtcttcatctctcttctttctcttcatcagtaccgttccccagctgaatagttctgaatccacgccagatccttctcaacagtctgtttcacgggaacctttattaaccactccttc	149	6	4%	30	20%
1	64960351	64960650	cacagaccagaatcttctgcggcaaggctttattgcttacatcttcaggagccagagtgcaagaagcaagagcgagcgagaagcaagagagagagaaaacgaaaccccgtccctattaaagagaattctccttcgcctaggacgtgtcactccctgattggctgcagcccatcggccgagttgacgtcacggggaaggcagagcacatggagtgaagaaccaccctcggcacatgcgcagattatttgtttaccacttagaacacagctgtcagcgccatcttgtaacggcgaatgtgg	299	32	11%	52	17%
1	64966051	64967250	accaaggtaaaattagcattggttccgtatttacggaccgactcggcaatttctttaatttgtaagtattctaccggagcgtggacacgcccaccctcggctccttcaaagactggaaatgcctgttgtattttcctttgttcctctctgggaatgaatgagtctgcgcactgcctctctgcgcagggctgacgcactacgcagggcggggactccgcatagggcggaccttgaagccgactgccctgaggccaatcagcaaactggccttcgccagccgcttttggcttttttcttgaccaattagctggctggtaatgggctgcttcttcctcccagtctgtttcctcagaggagaattcttcatctgcttcagagctactaagagctggctccccgagcccatccagcgatgagcacaggctccttttcctagagacctccgctaattgatctgtcttcttttccctttttcctctttttcttctaatctctctccaggtattcctacctaaccttaacttttcctcgggttcaagacccttggaaaggcctgtatacttattttgtgtaccatattttctctttgctcctactctctctccccgctttacttctgatagcttgtcctgaatttcctctagaattttcagccctatcttaatcacttgataacatgtgaaaaggaacaaaagggctcctaacaccagaaaaaattcaaggccaaacatattccactttacttctgatagactgtcttgaatttccttagaaagttcaagatcagacttacctcgtaaagctgtactcactggtactctcgttccccagctgaaaagttctgaattcatacagttgaatccttcttaacagtctgctttacgggaacctttattaccgcgacccgcagttctggttctggaatgagggatcttccttgcgccagtcccgagttttttctcgtcccggaattcggcaccaattgttattagacgcgttctcacgaccggccaggaagaacaccacagaccagaatcttctgcggcaaggctttattgcttacatcttcaggagccagagtgcaagaagcaagagcgagcgagaagcaagagagagagaaaacgaaaccccgtccctattaaagagaattctccttcgcctaggacgtgtcactccctgattggctgcagcccatcggc	1199	92	8%	128	11%
1	64994551	64994700	AGGACTTCCCGCACCGCCTCGTACAGGGTGTCGCGTGAGACTTTGCTGCTCATGGCTGCGGCTGCCGCGGAAACCGGAAAAAGCAAAAGGTGATTTCTTGTTGGAGAAAATTTAATCATTTCTACCATTTTTCTTATACAAATTGCCAG	149	18	12%	16	11%
1	74191501	74191650	acacacacacatataccacacatacatatatacacacacacatatacactacacatacactgacacacaccacacacacatataccacgcatacatacatatacacacacaaaacacacacacacaccatatatacatacatacataca	149	2	1%	90	60%
1	76776451	76777800	cgccattccacatatttggccatactagggagagcggcttttgcaatcatttgccagtcggcaggagtcagtgccacgccggcaagcctgtccaactgcaccaaggcaaaattagcattgattccatatttaatctgcacatattctaccggagcgtggacacgcccaccctcggctccttcaaagactggaaatgcctgttgtattttcctttgttcctctcggggaatgaatgagtctgcgcactgcctctctgcgcattgctgacgcactacgggctgacgcactacgcagggcggggactccgcatagggcgggagtgcacctggtagccgattgccctgaggccaattagcaaactggccttcgccagccgcttttggctttttccttaaatgactagttagcactttacttggcggctggtatccttttctttcataatgagccgcttttttctcccagtctgtttcctcagaggaggattcttcacttgcttcagagttactaagagctggcttcctgagctcatctagtgacgagtatctcctagagacctccgctaattgatcttttttcttttcttttttctttttcttccttctaatctctccccaggtattcctacctgaccttaacttttcctcgggttcaagacccttggaaaggcctgtatacttaccgtttctccttgttcctactctctctctccgctttacttctgatagactgtcctgaatttcctctagaatttttagccctatcttaagcactatataacatgtgaaaaggaacaaaagggctcctaacactagaaaaagttcaaggccaaacatacctggtaaagccatttctcacttccgttccccagctgatgagttctgaattcggcagttgaatccttctcaacagtctgttttacgggaacctttatcaccgtcgttccccagctgatgagttctgaattcggcagttgaatccttctcaacagtctgctttacgggaacctttatcaccgtcgttccccagctgatgagttctgaattcggcagttgaatccttctcaacagtctgtgttacgggaaccttataaccttgattcgcagttctggttctggaatgaggtatccctcctgcgccagtccggagttttttctcgtcccggattttctcgtcccggaattcggcaccaattgttattcgacgcgttctcacgaccggccaggaagaacaccacagaccagaatcttctgcggcaaagctttattcttacatcttcaggaaaagagagcaagaagcaagagagagaagcaagagagcgaaaaagcaagagagagagaaaacgaaaa	1349	112	8%	162	12%
1	79937251	79937400	cctaggcgaaggagaattctctttaatagggacggggtttcgttttctctctctcttgcttctcgctcgctcttgcttcttgcactcctgctcctgaaaatgtaagcaataaagctttgccgcagaagattctggtctgtggtgttctt	149	12	8%	6	4%
1	79938151	79938450	caacctcagggcagtcggcttcaaggtccgccctatgcggagtccccgccctgcgtagtgcgtcagcaatgcgcagagaggcagtgcgcagagaggcagtgcgcagactcattcattcccagagaggaacaaaggaaaatacaacaggcatttccggtctttgaaggagccgagggtgggcgtgtccacgctccggtagaatacttacaaattaaagaaattgccgagtcggtccgtaaatacggaaccaatgctaattttaccttggtgcagttagacaggctcgccggcatggcact	299	40	13%	50	17%
1	81692551	81693150	agctgaagagttctgaatccatgctggatccttctcagcagtctgttttgcaggaacacttcattaccaccattccccagctgaagagttctgaatccacgctggatccttctcagcagtctgttttacgggaaccttcattaccaccgttccccagctgaagagttctgaatccacgctggatccttctcagcagtttgttttacgggaacctttattaccaccgttccccagctgaagagttctgaatccacgctggatccttctcagcagtctgttttacgggaacctttattaccatcgttccccagctgaagagttctgaatccacgctggatccttctcagcagtctgttttacgggaaccttcattaccaccgttccccagctgaagagttctgaatccacgcagtcggatccttctcagcagtctgttttgcaggaacacttcattaccaccgttccccagctgaagagttctgaatccatgctggatccttctcagcagtctgttttacgggaaccttcattaaccgctccttccccgtgatgcagttctgaatcctccctgtagcagggggtcttcgcttgtgcctgaa	599	38	6%	92	15%
1	81982951	81983250	gagaacgcgggtaagaGttggtgccgaaacccgggacgagaagacctgggacgagaaatcctgggacaagaagacctgggacggttaccatcactggcgcaaggaagatccctcattccggaaccagaactgcgggtcatggtaatgaagtgttcccgtaaaacagactgttgagaaggattcaactgcgtgaattcagaactcttcagctggggaatggtggtaatgaagtgttcccacaacacagactgttgagaaggattcaactgcgtgaattcagaactcttcagctggggaac	299	26	9%	36	12%
1	83988301	83988600	aagtcctcccataccatgatgtacggttgttggtctggatgcgaccctggtccttcctgaaaaacaatggccttcacagcccttatggtgggtaagtaaaaagttccttctgctggccaacctactccaaaaacaggccattctgaggaacagaaagtcatccatggctttttcttcacttttactgacaaattttgtcctctagccctaacgtccgtccaatggtccttagtcaaagataaaggagtagacacggtctgtcccatagtgaagaataagagtaaacacaacacaatgac	299	10	3%	44	15%
1	85112551	85112700	GGATGTCGTACACGACTCTCTCCAGTGGGACCAGGTTCTTACATGTTTCTTGATATTCCTTAAAATAGGGAATGCAGAATTGTGTCATGATGGATTTATGGGTTATATGAGGCTTACATTGGTTCAAACACCATTTCTCTTTTTTTGTA	149	4	3%	20	13%
1	85144501	85145100	gagcggacacgagactaagacaaaaaagaaaccagaaacggcggcgactctgcgtcgaccacaagcaactcaaagaatcagatggcctttctaaggccggccgattgagaccctctgcgcgaggtgggactcgaacccacgatcccgtgaccaaacgcgaggtgggactcgaacccacggtctcgcaacaaggcgcgaggtgggactcaaacccacgatctcgcaacaaaacgggaggtgggactccaacccacgatctcgcaactggtcacgaggtgggactcaaacccacgatctcgcaaccccaaatggtctcttggccttcaaaggggtccaccaggcgtccctggtcctcccctgttcctcctgggacgtctcccagggtgaacggacggtggacacctggacacgtctatccttatccaccccgcgttccctctcggagcgcggtctcactgagcgtccgcaaaaccaaaactgcgatcgcaccaaacttagaaacagaacacaaacatcagaccaaaacagaacaaagaatcttacctctaagtgggtctaggacctctgggtggtcgcgctgattcccggccaatgcacca	599	92	15%	96	16%
1	85147651	85147950	cgggcctgacccggaacaaaagccccttccgctccactcgtgacagggcttcttggccagcggagttgcctgacacccgcaagggcccacacaggactccccacgggatcctaagacctctggtgagtggaacacagcgcctgccccaatccaatcgcgcggaacctgagactgcggtacatagggaagcagactgcccggggcctgacccgggacaaaagccccttccgctccactcgagcccagggcttcctggccagcggagttgcctgacacccgcaagggcccacacaggattc	299	36	12%	50	17%
1	85180351	85181100	ATTTAGAAGCTAGAGATGTAAGGGTCAAAATGTCCCAAGTGTTAAAGGAATGGCCCCAAGAGGGAGAAGGAGGAATTGAGCAATTGAAAAGTGACACACAAGAAGAAATCCTCTTTTCAGGTCTAAGAAGACGCAGAAAAGAAAATGCCAATTTTAGTGCTGAGTTGCTTCCCGTGACGTGTGGTAACTTGAAGGGAGTGTTACACAAGGATAAATTCAAACAAGGTGGGCTTCATGGTTTTTGTTTTGCAAATGCTAAATTTTGAAATCACATGTAATAATGCAACTATTACTTAAGGAACTGTGGGGTAAGCATGGCTTGACATCAGGAAGGGATTCTGATGTGCTATTTTCACACTTGAAGAAACAATACATAATAGATGCTCACAACAACGTGAATATAGCCACGAGATGACCAGAGAACCAGAAAGAAGGCCATGAACTTCCGTCCATAGATGGAAACTATTGTATAGTTTCATTCTGGTCAGACACAAATGGGAAGAGGCTATAAACATTTGTCTTCACATCCCTGTGTCATTAGCACCAGCATGACAGTCATGGGAAGGCCATCACAGGACTGAGAATCAGAGAACCCAATTTCCAGCCTCAGATTGGCCAAACAAGATGTTCTCATTCTATAGAGAGGGGGGCTTTCTGAGCCTGAATTTTTCCATTTTGAAATAGAGGACAATAATTTAAAGCCTGATCGATGGGGATTAATGTATATCATTGGTATAGCATATTCTTCA	749	14	2%	124	17%
1	85289701	85290150	TAAGAGTTAGTAATTATGTTGGAATGGCCTGTTTGCCTTGGCCAGGGTCATTAAGGAAAGCAGAGCTATCTGACAGATGACTACCAGTGAAACCACTGCTTGTGGATTTGTTATTATTCAATAAAATGTTTTAGAAAGACATAAATACGTTTACCTCTGTTTGTGACACAGCACGCTCACGACaccctgctacgcattgcttggctccagtggcctcctggaaccgtgttgcaagctttcatgactccctcactctggcattttgaaccttgcaacatcagtaccatgcagatggtacccagctgctgtcagctcaagatgcggcctgtcccccttgaacaactaccacagcctttctgtgacttcataactgaactaaaaagacacttacttagttaagcagccatttttcaacagggctcccttgaggctctgtcattgttagacgc	449	14	3%	72	16%
1	85339801	85340100	taggatcccatgtggaatcctgtgtgggcccttgcgggtgtcaggcgactctgctggcaaggtagcccggggctcgagtggagcagaaaaggtttgtgccccagatcaagcccgggtagcctgcttccctatgtaccgcagtctcaggttcagcgtgattggattggggcaggcgctgtgttccactcaccagaggtcttaggatcccgtggggagtcctgtgtgggcccttgcaggtgttgggcgagactctgctggcaaggtagcccggggctcgagtggagcggaaggggctagtg	299	26	9%	30	10%
1	85651351	85651650	aaacttgctatgtaaacctgcctggacttggacttacaatagagatccatctgcctctgcctcccaagtacagggattaaaggtgtacaataccatacctggGTCTTTCTTATTGTCTACAAAATATTTATTGGGTCTCGCGCGTGCGTGCATGCgtgcgtgcgtgtgtgtgtgtgtgtgtgtgtgtgtgtgtgtgtgtgtgtAAGAGAGAGAGAGAAAAGAgtgtgtacactattagggaatgtgcctttggaggacagaagaggatgtcaggtcccctgtagttggagttatagatg	299	12	4%	22	7%
1	87139351	87140700	ttagtgccatgccggcgagcctgtctaactgcaccaaggtaaaattagcattggttccgtatttacggaccgactcggcaatttctttaatttgtaagtattctaccggagcgtggacacgcccaccctcggctccttcaaagactggaaatgcctgttgtattttcctttgttcctctctgggaatgaatgagtctgcgcactgcctctctgcgcactgcctctctgcgcatctctctgcgcactgcctctctgcgcatctctctgcgcactgcctctctgcgcatctctctgcgcattgcctctctgcgcatctctctgcgcattgcctctctgcgcattgctgacgcactacgcagggcgggggctccgcatagggcggaccttgaaaccgactgccgggaggttgaacagtacgctggctttcgccagccgcttttggcttttttcttgaccaattagctggctggtaatgggctgcttcttcctcccagtctgtttcctcagaggagaattcttcatctgcttcagaactactaagagctggcttcctgagctcatctagtgacgagtatctcctagagacctccgctaatcgatcttttttcttttcttttttcttttccttccttctaatctctccccaggtattcttacctgacctaaacttttcctcgggttcaagacccttggaaaggcctgtatacttattttgtgtaccatattttctctttgctcctactctctctccccgctttacttctgatagattgccctgaatttcatccagaattttcagccctatcttaatcacctgataacatgtgaaaaggaacaaaagggctcctaacattagaaaaaattcaaggccaaacattttccactttacttctgatagactgtcttgaatttccttagaaagttcaagatcagacttacctcgtaaagctgtactcactggtactctcgttccccagctgaaaagttctgaattcatacagttgaatccttcttaacagtctgctttacgggaacctttattaccgcgacccgcagttctggttctggaatgagggatcttccttgcgccagtcccgagttttttttctcgtcccggaattcggcaccaattgttattagacgcgttctcacgaccggccaggaaagacacaacaaaccagaatcttctgcggcaaaactttattgcttacatctttgggagccaggagggcaagcgcccagcgcccagccccaaaaacgaaagccccttcaataatgaaaccgaaaccccttccctctttaggagagttaaatttcgcctaggacgcatcactccctgattggctgca	1349	116	9%	144	11%
1	88286401	88286850	atcaggagttcaaggccatcctctgctacacagcaagttcacaggctagcccagaatacgagaggcttcgacttaagaaagagaCACACATGTGCAAAAGCTAGTTCACTATTCAACCCCAAAGTGTCACAGAGCAAATCCCATGCTGGGAAGCACGCGATGAGAGAGAAGCATGCGCTGCCAGGCATGCTAGGCGTGTGAGAAGATCTACGCATCACCTGGATGGGCACGTGATGGCTGGTAGTGCCAGTGATGCCCTGCAGACTACGGGGTGCTCTCATTCTTTACACCAGGAAAGCTGGCTAGCACCACGGGAGGAGAAAACAGAAGAAGATGAAGAGAGAGATGCATGGTGGGAAAATTTCCTGGGTCTCCTAAAGTGGGAAGGTTTCTCAAAAGAACGACACGCAGCTAGAGAGAATCCGGTGCAACTCTTGGCTGAGCCCTCA	449	26	6%	82	18%
1	91476901	91477350	aaccgtttgccagtcggcaggagttagtgccatgccggcaagcctgtctaactgcaccaaggtaaaattagcattggttccgtatttacggaccgactcggcaatttctttaatttgtaagtattctaccggagcgtggacacgcccaccctcggctccttcaaagaccggaaatgcctgttgtattttcctttgttcctctctgggaatgaatgagtctgcgcactgcctctctgcgcactgcctctctgcgcagggctgacgcactacgcagggcggggactccgcatagggcggaccttgaagccgactgccctgaggccaatcagcaaactggccttcgccagccgcttttggcttccttaactgattagctagcactttacctggctggtacccttttttctcataatgagctgcttcttcctcccagtctgtttcttcagagg	449	46	10%	50	11%
1	92418301	92418450	ttccactcaccggaggtcttagggtcccgtggggagtcccgtgtgggcccttgcgggtgttgggcaagactctgctggcaaggaagcccggggctcgagtcgagcggaagggacttgtgccccagatcaggcccgggtagcctgcttcc	149	18	12%	12	8%
1	92527051	92527650	gttgagtgcgcgcaaGAGTTGGTGCTGaaacccgggaaaagaaacatcttcaggcaagagcgaagagcccctgctacagggaggattcagaactgcataacggggaagaaggggttaataaaggttcccttaaaacagactgttgagaaggatccagcatggattcagaactcttcagctggggaacggtactgatgaagagaaagaagaaagatgaagactgaataaactgctgttagaaggactggtggtcacgtcgttcttgctggtcgagagcgggcgcgacaattggtggcccgtacggggaaccgactcccccaccgagttcagaactttcagcagtcagtggttgccggcagggtaagttcaaggtgagtgaaacttgtgaccccaggagtttgggaaggacctcggataaaatagaggtgagcataaagttgccaggaagtaggcacaaagtaacccaggagtttgggaaggacctcggataaaatagaggggaatataaagttgccaggaagcaggcacaaagtaacgaaaggttcacggttttgggataagttaaggttcctggctttgggacaagttaaggttcctgg	599	42	7%	66	11%
1	95696101	95696550	ggtagctctgaatcagatgatgaattctcctctgaagaaacagactgggaggaagaagcagctcattatgagaaaaaagggtaccagccaggtaaagtgctagctaatcagttaaggaagccaaaagcggctggcgaaggccagtttgctgattggcctcagggcagtcggcttcaaggtccgccctatgcggagtccccgccctgcgtagtgcgtcagccctgcgcagagaggcaatgcgcagagaggcagtgcgcagactcattcattcccagagaggaacaaaggaaaatacaacaggcatttccggtctttgaaggagccgagggtgggcgtgtccacgctccggtagaatacttacaaattaaagagcttgccgagtcggtccgtaaatacggaaccaatgctaattttaccttggtgcagttagacaggctcgccggcatggc	449	44	10%	62	14%
1	97172851	97173300	gcagccaatcagggagtgacacgtcctaggcgaaggataattctccttaataggaacggggtttcgttttctagctctcttgcttcttacactcttgctcctgaagatgtaagcaataaagttttgccgcagaagattctggtctgtggtgttcttcctggccgggcgtgagaacgcgtctaataacaattggtgccgaattccgggacgagaaaaaactcgggacgagagtttaccatcaccggtgcaaggaagatccctcattccagaaccagaactgcgggtcgcggtaataaaggttcccgtaaagcagactgttaagaaggattcaactgtatgaattcagaacttttcagctggggaacgagagtaccagtgagtacagctttacgaggtaagtctggtcttgaactttctaaggaaattcaagacagtctatcagaagtaaa	449	42	9%	46	10%
1	98602201	98602350	tctttaatctgcacatattctaccggagcgtggacacgcccaccctcggctccttcaaagaccggaaatgcctgttgtattttcctttgttcctcctttggaatgaacgagtctgtgcattgcctctctgtccattgcctctctgcgca	149	14	9%	16	11%
1	100224751	100224900	gagaatgcagaggacatccaggaagaaagtcctttgattccatcgatcaatgatgggtccacgcgcgtagaattaatcgtcatcactgctgtacgtaacgcctcaagcttttcgtcaaatccttcagaccagtttcctgtaagaaacaa	149	16	11%	26	17%
1	103178551	103179000	gggcgcgcTCAAGAGTTGGTGCCaaaacccgggacaagaaacatcttcaggcatgagcgaagaccccctgctacaggaaggattcagaactgcatcacggggaaggagtggttaataaaggttcccgtaaaacagactgttgagaaggatccagcgtggattcagaactcttcagctggggaagggcaatgatgaagagaaagaagaaagatgaagaatgaataaactgctgttagaaggactggtggtcgcgtcgttcttgctgattgagagcgggcgcgacaattggtggcccgtacggggaaccgactcccccaccgagttcagaactttcagcagtcagtggttgctggcagggtaagttcacggtgagtgaaatttgcgaccccaggagtttgggaaggacctcagataaaatagaggtgagcataaagttgccaggaagtagg	449	38	8%	52	12%
1	103210951	103211400	ggaccgactcggcaatttctttaatttgtaagtattctaccggagcgtggacacgcccaccctcggctccttcaaagaccggaaatgcctgttgtattttcctttgttcctctctgggaatgaatgagtctgcgcactgcctctctgcgcactgcctctctgcgcattgctgacgcactacgcagggcggggactccgcatagggcggaccttgaagccgactgccctgaggccaatcagcaaactggccttcgccagccgcttttggcttttttcttgaccaattagctggctggtacccttttttctcataatgagctgcttcttcctcccagtctgtttcctcagaggaggattcttcacctgcttcagaactactaagagctggcttcctgagctcatctagtgacgagtatctcctagagacctccgctaattgatctttcttc	449	40	9%	42	9%
1	106731001	106731450	agggagatataaaaacaagggagagatataaacaagggagagatataaacaagggagatataaacaagggaaatatagagaaagaagaaacaggactgaataaacgtgtgcagaaggatcctgtagcagcgtcgttcttcctggccagttgagcgcgcgcaacaAGttggtgccgaaacccgggacaagaaacatcttcaggcatgagtgaagaccccctgctacagggaggattcagaactgcatcacggggaaggagtggttaataaaagttcccgtaaaacagactgttgagaaggatccggcgtggattcagaactcttcagctggggaacggtactgatgaagagaaagaagaaagatgaggacggaataaactgctgttagaaggactggtggtcgtgtcgttcttgctggttgagagtgggcgcgacaattggtggcccgta	449	38	8%	44	10%
1	110613001	110613300	agccgcccccacattcgccgtcacaagatggcgctgacatcctgtgttctaagtggtaaacaaataatctgcgcatgtgccaagggtattttacgactacttgtactctgcctttcccgtgaacgtcagctcggccatgggctgcagccaatcagggagtgatgcgtcctaagcgaaggataactcctccttaaaggggacggggtttccgccattctctctctggctctggcgcctgctcgcttgctcctaaagatgtaaacaatagagcgcgctctgcgctttggcgcgccggagct	299	42	14%	30	10%
1	112440001	112440600	taacactacaaaccccctatttcctaggccttggtaaatacttgcatgagcataacttggctgttctttaaagtatctgtggagaatctccatttgtcagaagaattcaccaacttgcttctaatatgcaatgttattgcgtcccgctcgaccggcaagaaagacgcaacaaaccagaatcttccgcggcaaaagctttattgcttgcttctcaggaagatcctgaaccgggaaaatggcgctgcttttataacccgcagcgtgacgtttcagcacctgatatggcgtgacagctcccgattcgttgcttgcccatcaccccactattacaccccgagaatgggagtgactaggagtgaattcactcttgcacctgcgtgcaaggcttgtttactagttaggcacagcggaggcccgcgccatcttataatggtgattgctcgcggcacacacggctctcctcagagattactggcggcacacatgtgattgctcgcagcacgtaccggctctccacatctcccccttttaattttattaaaatttaaggctggtctaggcctgtgtaattatgcccatccgctgtggctcctgtctta	599	56	9%	82	14%
1	112929301	112930800	aaggttgtaatcctgaaaagttactgatagacattgaaatttaggtatagaatttagcattacaatacatagcaatagtccacacttcaacaATtgttgggagccgcgcccacattcgctgttacaagatggcgctgacagctgtgttctaagtggtaaacaaataatctgcgcatgtgccgagggtggttctccactccatgtgctctgccttccccgtgacgtcaactcggccgatgggctgcagccaatcagggagtgacacgtcctaggcgaaggataattctccttaatagggacggggtttcgttttctctctctcttgcttcttacactcttgctcctgaagatgtaagcaataaagttttgccgcagaagattttggtttgctgtgttcttcctggccgggcgtgagaacgcgtttaataacaattggtgccgaattccgggacgagaaaaaactcgggactggcgcaaggaagatccctcattccagaaccagaactgcgggtcgcggtaataaaggttcccgtaaagcagactgttaagaaggattcaactgtatgaattcagaacttttcagctggggaacgagagtaccagtgagtacagctttacgaggtaagcctggccttgaactttctaaggaaattcaagacagtctatcagaagtaaagtggaaaatggctttacaagttatgtttggccttgaattttttctagtgttagaagcccttttgttccttttcacatgttatcaagtggttaaggcagggcggattctagatgaaattcagggcaatctatcagaagtaaagcggggagagagagtaggagcaaagagaaaatatggtacacaaaataagtatacaggcctttccaagggtcttgaacccgaggaaaagttaaggttaggtaggaatacctggagagagattagaagaaaaagaggaaaaagggaaaagaagaaagatcaattagcggaggtctctaggaaaaggagcctgtgctcatcgctggatgggctcggggagccagctcttagtagctctgaagcagatgaagaattctcctctgaggaaacagactgggaggaagaagcagctcattatgagaaaaaagggtaccagccaggtaaagtgctagctaatcagttaaggaagccaaaagcggctggcgaaggccagtttgctgattggcctcagggcagtcggcttcaaggtccgccctatgcggagtccccgccctgcgtagtgcgtcagcaatgcgcagagaggcaatgcgcagagagatgcgcagagaggcaatgcgcagagagatgcgcagagaggcagtgcgcagagaggcagtgcgcagagaggcagtgcgcagagaggcagtgcgcagactcattcattcccagagaggaacaaaggaaaatacaacaggcatttccagtctttgaaggagccgagggtgggcgtgtccacgctccggtagaatacttacaaattaaagaa	1499	114	8%	188	13%
1	113016301	113017500	cttgcttcttgctctcttgcttcttgctctcttgcttcttgcactctggctcctgaagatgtaagcaataaagctttgccgcagaagattctggtttgttgcgtctttcctggccggtcgtgagaacgcgtctaataacaattggtgccgaattccgggacgagaaaaaactcgggactggcgcaaggaagatccctcattccagaaccagaactgcgggtcgcggtaataaaggttcccgtaaagcagactgttaagaaggattcaactgtatgaattcagaacttttcagctggggaacgagagtaccagtgagtacagctttacgaggtaagtctgatcttgaactttctaaggaaattcaagacagtctatcagaagtaaagtggaatatgtttggccttgaattttttctggtgttaggagcccttttgttccttttcacatgttatcaagtgattaagatagggctgaaaattctagaggaaattcaggacaagctatcagaagtaaagcggggagagagagtaggaacaaagaggaaatatggtacacaaaataagtatacaggcctttccaagggtcttgaacccgaggaaaagttaaggttaggtaggaatacctggagagagattagaagaaaaagaggaaaaagggaaaagaagaaagatcaattagcggaggtctctaggaaaaggagcctgtgctcatcgctggatgggctcggggagccagctcttagtagctctgaagcaggtgaagaattctcctctgaagaaacagactgggaggaagaagcagctcattatgagaaaaaagggtaccagccaggtaaagtgctagctaatcagttaaggaagccaaaagcggctggcgaaggccagtttgctgattggcctcagggcagtcggcttcaaggtccgccctatgcggagtccccgccctgcgtagtgcgtcagccttgcgcagagaggcagtgcgcagactcattcattcccagagaggaacaaaggaaaatacaacaggcatttccggtctttgaaggagccgagggtgggcgtgtccacgctccggtagaatacttacaaattaaagaaattgccgagtcggtccgtaaatacggaaccaatgctaattttaccttggtgcagttagacaggctcgccggcatggcactaactcctgctgactggcaaacg	1199	88	7%	124	10%
1	114215101	114215550	cttaaattttaataaaataaaaagggggagatgtggagagccggtacgtgctgcaagcaatcgcatgtgtgccgccagtaatctctgaggagagccgtgtgtgcagcgagcaatcgccattataagatggcgcgggcctccgctgtgcctaactagtaaacaagccttgtacgcaggtgcgagagtgaattcactcctagtcactcccattctcggggtgtaatagtggggtgatgggcaagcaacgaatcgggagctgtcacgccatatcaggtgctgaaacgtcacgctgcgggttataaaagcagcgccattttcccggtttgggatcttcctgagaagcaagcaataaagcttttgccgcggaagattctggtttgttgcgtctttcttgccggtcgagcgggacgcaataCAAGGGATGTGGGTGTGATGGCACACATATCCTT	449	56	12%	54	12%
1	116654101	116654250	acacgcccaccctcggctccttcaaagaccggaaatgcctgttgtattttcctttgttcctctctgggaatgaatgagtctgcgcactgcctctctgcgcactgcctctctgcgcattgctgacgcactacgcagggcggggactccgc	149	20	13%	16	11%
1	120574651	120576000	gtcggcaggagttagtgccatgctggcaagcctgtctaactgcaccaaggtaaaattagcattgattccatatttaatctgcacatattctaccggagcgtggacacgcccaccctcggctccttcaaagactggaaatgcctgttgtattttcctttgttcctctcggggaatgaatgagtctgcgcactgcctttctgcgcactgcctctctgcgcattgctgacgcactacgggctgacgcactacgcagggcggggactccgcatagggcgggagtgcacctggtagccgattgccctgaggccaattagcaaactggccttcgccagccgcttttggcttttttcttgaatgactagttagcactttacttggcggctggtatccttttctttcataatgagccgcttttttctcccagtctgtttcttcagagcacaggctccttctcctagagacctccgctaattgatcttttttcttctccctttttcctctttttcttctaatctctctccaggtattcctacctaaccttaacttttcctcgggttcaagacccttggaaaggcctgtatacttaccgtttctccttgttcctactctctctctccgctttacttctgatagactgtcctgaatttcctctagaatttttagccctgccttaagcactatataacatgtgaaaaggaacaaaagggctcctaacactagaaaaagttcaaggccaaacatacctggtaaagccatttctcacttccgttccccagctgatgagttctgaattcggcagttgaatccttctcaacagtctgctttacgggaacctttatcaccgtcgttccccagctgatgagttctgaattcggcagttgaatccttctcaacagtctgtgttacgggaaccttataaccttgattcgcagttctggttctggaatgaagtatccctcctgcgccagtccggagttttttctcgtcccggattttctcgtcccggaattcggcaccaattgttattcgacgcgttctcacgaccggccaggaagaacaccacagaccagaatcttctgcggcaaagctttattcttacatcttcaggaaaagagagcaagaagcaagagagagagaaaacgaaaaccccgtccctcttaaggagcattctccttcgcctcggacgtgtcactccttgattggctgcagcccatcggccgagttgacgtcacggggaaggcagagcacaagtagtcataagatacccttggcacatgcgcagattatttgtttaccacttagaacacaggatgtcagcgccatcttgtaacggcgaatgtgggggcggc	1349	120	9%	162	12%
1	125362051	125362200	ttccactcaccagaggtcttaggatcccgtggggagtcccgtgtgggcccttgcgggtgttgggcaagactctgctggcaaggtagcccggggctcgagtctcgagtcgagcggaagggacttgtgccccagatcaggcccgggtagcc	149	18	12%	14	9%
1	126424351	126424500	gcagaagattctggtctgtggtgttcttcctggccggtcgtgagaacgcgtctaataacaattggtgccgaattccgggacgagaaaaaaactcgggactggcgcaaggaagatccctcattccagaaccagaactgcgggtcgcggta	149	24	16%	12	8%
1	126940051	126940650	aaagttaaggttaggtaggaatacctggagagagattagaagaaaaagaggaaaaagggagaagaaaaaagatcgattagcggaggtctctaggagaaggagcctgtgctctgaagaaacagactgggaggaagaagcagcccattaccagccagctaattggtcaagaaaaaagccaaaagcggctggcgaaggccagtttgctaattggcctcagggcaatcggctaccaggtgcactcccgccctatgcggagtccccgccctgcgtagtgcgtcagcccgtagtgcgtcagcaatgcgcagaggggcagtgcgcagagaggcagtgcgcagactcattcattccccgagaggaacaaaggaaaatacagcaggcatttccagtctttgaaggagccgagggtgggcgtgtccacgctccggtagaatacgtacagattaaggaaattgccgagtcggttcgtaaatacggaaccaatgctaatttcaccttggtgcagttagacaggctcgctggtatggcactaacgcctgccgactggcaaatgattgcaaaagtcgctctccctagtatggccaaatatgtggaatggcgag	599	60	10%	74	12%
1	128888101	128888850	ttgcaagatggcgctgacatcctgtgttctaagtggtaaacaaataatctgcgcatgtgccaagggtagttttccaccccatgtgctctgccttccccgtgacgacaactcggccgatgggctgcagccaatcaaggagtaatacgtcctaggcggagaataattctccttaaaagggacggggtttcgccattctctctcttgcactcttgctcctgaagatgtaagcaataaagttttgccgcagaagattctggtttgctgcgtctttcctggccggtcgcgaacgcgtgtaagaGttggtgctgaaacccgggacaagaagacctgggacgagaaaacccgggacaagaaaacccgggacggttaccatcaccggcgcaaggaagatccctcattccggaaccagaactgcgggtcatggtaatgaagtgttcccgtaaaacagactgttgagaaggatccagcctggattcagaactcctcagctggggaacggtggtaatgaagtgttcccgtaaaacagactgttgagaaggattcaactgcgtgaattcagaactcttcagctggggaacagggtacccgtaagtatagctttacaaggtaagtctggtcttgaactttctaacgaaattcaagacagtctatcagaagtaaagtgggaaatagctttacaaggtatgtttggccttgaactttctctagtgttaggagcctttttgttccttttcacatgttatcaagtg	749	64	9%	80	11%
1	132072451	132072600	catacacacacatatacacatacagacacacacagacacacacacagacacatactcacatacacacatatacacatacagacacacactcacatacacacatatacacacacaagtacacactcacagatacactcacgcacattcac	149	2	1%	96	64%
1	137277751	137278050	tgtactcactggtactctcgttccccagctgaaaagttctgaattcatacagttgaatccttcttaacagtctgctttacgggaacctttattaccgcgacccgcagttctggttctggaatgagggatcttccttgcgccagtcccgagttttttctcgtcccggaattcggcaccaattgttattagacgcgttctcacgaccggccaggaaagacgcaacaaaccagaatcttctgcggcaaagctttattgcttacatcttcaggagccagagtgcaagaagcaagagagagaga	299	32	11%	40	13%
1	139724851	139726350	tgccaagggtatcttatgactacttgtgctctgccttccccgtgacgtcaactcggccgatgggctgcagccaatcagggagtgacacgtccgaggcgaaggagaatgctccttaatagggacggggtttcgttctctctctctcttgcttcttgcgctctcttgcttttcgctctctcttgcttttctctctctcttgcttcttgctctctcgcttcttgcactctgttcctgaagatgtaagaataaagctttgccgcagaagattctggtctgtggtgttcttcctggccggtcgtgagaacgcgtctaataacaattggtgccgaattccgggacgagaaaaaaaaactcgggactggcgcaaggaggatccctcattccggaaccagaactgcggatcacgtttataaaggttcccgtaacacagactgttgagaaggattcaactgccgaattcagaactcatcagctggggaacgacggtgataaaggttcccgtaaagcagactgttaagaaggattcaactgtatgaattcagaacttttcagctggggaacggcggtaacccgtaagtatagctttacaagataagtctgatcttgaactttctaacgaaattcaagacagtctatcagaagtaaagtggaaaatgtttggccttgaattttttctggtgttaggagcccttttgttccttttcacatgttatcaagtggttaagatagggcggattctagatgaaattcaggacaagctatcagaagtaaagtggggagagaaagtaggaacaaagaggaaatatggtacacaaaataagtatacaggcctttccaagggtcttgaacccgaggaaaagtttaggtcaggtaagaatacctggagagagattagaagaaaaagaggaaaaagggaaaagaagaaagatcaattagcggaggtctctaggagaaggagcctgtgctctgaagaaacagactgggagaaaaaagcggctcattatgaaagaaaaggataccagccgccaagtaaagtgctaactagtcatttaaggaaaaagccaaaagcggctggcgaaggccagtttgctaattggcctcagggcaatcggctaccaggtgcactcccgccctatgcggagtccccgccctgcgtagtgcgtcagcccgtagtgcgtcagcaatgcgcagagaggcagtgcgcagagaggcagtgcgcagactcattcattccccgagaggaacaaaggaaaatacaacaggcatttccagtctttgaaggagccgagggtgggcgtgtccacgctccggtagaatatgtgcagattaaagaaattgctgagtcggtccgtaaatatggaattaatgctaattttaccttggtgcagttagacaggcttgccggcatggcactaactcctgccgactggcaaatgattgcaaaagccgctctccctagtatgggcaaatatgtgaaatggagatctctgtggcgagag	1499	126	8%	150	10%
1	140047951	140048250	ATTGTGGCCATCTTTTTCCACCCCCTCGGAGGAGTCGATGTTGCGGACATTCTTCACAATCACACTGACGCCGACGTCTGAGGATGATGGGGTGTGAGAGTCGTCATCCACGTGAGCGTTCTGCTTAATGTGGCTCTCATGGTCATCGTGTCCGGACTCAATCGCTGCTTTGGGATCGACCATATCTGGTATGTCAAATGCTGCCAAGAGGTCATCAAAGTCTGGGGTCTTCATATCCCCCATGGTCATGAATTTGATCAGTTCTTGTGAACCTTGACCTTTTGAAAAGACTTTGGCCC	299	26	9%	42	14%
1	140816701	140818200	ACTATAACGGAGGATTAAATAAACACATATGATAAGAAAGAAAAAGGTTAGATATTTAAtgttgggagccgcgcccacattcgccgttacaagatggcgctgacagctgtgttctaagtggtaaacaaataatctgcgcatgtgccaagggtatcttatgactacttgtgctctgccttccccgtgacgtcaactcggccgatgggctgcagccaatcagggagtgacacgtccgaggcgaaggagaatgctccttaagagggacggggtttcgttttctctctctcttgcttttctctcttctcttgctttttcgctctcttgcttctcgctctctcttgcttcttgctctcttgcttcttgcactctgttcctgaagatgtaagaataaagctttgccgcagaagattctggtctgtggtgttcttcctggccggtcgtgagaacgcgtctaataacaattggtgccgaaacccgggacgagaaaaaaactcgggactggcgcaaggaggatccctcattccggaaccagaactgcggatcacgtttataaaggttcccgtaaagcagactgttgagaaggattcaactgccgaattcagaactcatcagctggggaacgacggtgataaaggttcccgtaaagcagactgttaagaaggattcaactgtatgaattcagaacttttcagctggggaacgaggtaagcctggccttgaactttctaacgaaattcaagacagtctatcagaagtaaagtggaatatgtttggccttgaattttttctaatgttaggagcccttttgttccttttcacatgttatcaagtgattaagatagggctgaaaattctagaggaaattcaggacaagctatcagaagtaaagcggggagagagagtaggaacaaagaggaaatatggtacacaaaataagtatacaggcctttccaagggtcttgaacccgaggaaaagttaaggttaggtaggaatacctggggagagattagaaggaaggaaaagaaaaaagaaaagaaaaaagatcgattagcggaggtctctaggagatactcgtcactagatgagctcaggaagccagctcttagtagttctgaagcagaaacagactgggaggaagaagcagcccattaccagccagctaattggtcaagaaaaaagccaaaagcggctggcgaaggccagtttgctgattggcctcagggcagtcggcttcaaggtccgccctatgcggagtccccgccctgcgtagtgcgtcagcaatgcgcagagaggcagtgcgcagagaggcagtgcgcagactcattcattcccagagaggaacaaaggaaaatacaacaggcatttccggtctttgaaggagccgagggtgggcgtgtccacgctccggtagaatacttacaaattaaagaaattgctgagtcggttcgtaaatacggaaccaatgctaattttaccttggtgcagttagacaggctcg	1499	126	8%	156	10%
1	141036301	141036900	agcagatgaagaattctcctctgaagaaacagactgggaggaagaagcagctcattatgagaaaaaagggtaccagccaggtaaagtgctagctaatcagttaaggaagccaaaagcggctggcgaaggccagtttgctgattggcctcagggcagtcggtttcaaggtccgccctatgcggagcccccgccctgcgtagtgcgtcagcaatgcgcagagaggcaatgcgcagagagatgcgcagagaggcaatgcgcagagagatgcgcagagaggcagtgcgcagagagacaatgcgcagagaggcagtgcgcagactcattcattcccagagaggaacaaaggaaaatacaacaggcatttccagtctttgaaggagccgagggtgggcgtgtccacgctccggtagaatacttacaaattaaagagcttgccgagtcggtccgtaaatacggaaccaatgctaattttaccttggtgcagttagacaggcttgccggcatggcactaactcctgccgactggcaaacggttgtaaaagccgctctccctagtatgggcaaatatatggaatggagagcgctttggcatgaaactg	599	58	10%	90	15%
1	141372751	141373800	gtaagtattctaccggagcgtggacacgcccaccctcggctccttcaaagactggaaatgcctgttgtattttcctttgttcctctctgggaatgaatgagtctgcgcactgcctctctgcgcattgtctctctgcgcagggctgacgcactacgcagggcggggactccgcatagggcggaccttgaagccgactgccctgaggccaatcagcaaactggccttcgccagccgcttttggcttccttaactgattagctagcactttacctggctggtacccttttttctcataatgagctgcttcttcctcccagtctgtttcttcagaggagaattcatcatctgattcagagctaccaagagctggcttcctgagctcatctagtgacgagtatctcctagagacctccgctaatcgatcttttttcttttcttttttcttttccttccttctaatctctccccaggtattcttacctgacctaaacttttcctcgggttcaagacccttggaaaggcctgtatacttattttgtgtaccatattttctctttgctcctactctctctccccgctttacttctgatagattgtcctgaatttcatctagaatccgccctgccttaaccacttgataacatgtgaaaaggaacaaaagggcttctaacattagaaaaaattcaaggccaaacatattccactttacttctgatagactgtcttgaatttccttagaaagttcaagaccagacttacctcgtaaagctgtactcactggtactctcgttccccagctgaaaagttctgaattcatacagttgaatccttcttaacagtctgctttacgggaacctttattaccgcgacccgcagttctggttctggaatgagggatcttccttgcgccagtcccgagttttttctcgtcccggaattcggcaccaattgttattaaacgcgttctcacgcccggccaggaagaacacagcaaaccagaatcttctgcggcaaaactttattgcttacatcttcaggagcaagagtgt	1049	74	7%	110	10%
1	141372751	141373800	gtaagtattctaccggagcgtggacacgcccaccctcggctccttcaaagactggaaatgcctgttgtattttcctttgttcctctctgggaatgaatgagtctgcgcactgcctctctgcgcattgtctctctgcgcagggctgacgcactacgcagggcggggactccgcatagggcggaccttgaagccgactgccctgaggccaatcagcaaactggccttcgccagccgcttttggcttccttaactgattagctagcactttacctggctggtacccttttttctcataatgagctgcttcttcctcccagtctgtttcttcagaggagaattcatcatctgattcagagctaccaagagctggcttcctgagctcatctagtgacgagtatctcctagagacctccgctaatcgatcttttttcttttcttttttcttttccttccttctaatctctccccaggtattcttacctgacctaaacttttcctcgggttcaagacccttggaaaggcctgtatacttattttgtgtaccatattttctctttgctcctactctctctccccgctttacttctgatagattgtcctgaatttcatctagaatccgccctgccttaaccacttgataacatgtgaaaaggaacaaaagggcttctaacattagaaaaaattcaaggccaaacatattccactttacttctgatagactgtcttgaatttccttagaaagttcaagaccagacttacctcgtaaagctgtactcactggtactctcgttccccagctgaaaagttctgaattcatacagttgaatccttcttaacagtctgctttacgggaacctttattaccgcgacccgcagttctggttctggaatgagggatcttccttgcgccagtcccgagttttttctcgtcccggaattcggcaccaattgttattaaacgcgttctcacgcccggccaggaagaacacagcaaaccagaatcttctgcggcaaaactttattgcttacatcttcaggagcaagagtgt	1049	74	7%	110	10%
1	144384151	144385500	ctacatgtactctgcctttactcggccatgggctgcagccaatcagggagtgatgcgtcctaggcgaaggataattctccttaaaaggggacggggtttccgccattctctctcttacttgcgctctcttgcttgcgcttttgcgctctgcgctctggcgctctggcgctctggcgcgctggcgctctggctcctaaagatgtaagcggggggttttcgtttttggggcttggggtttgcgctcctggctcctgaagatgtaagcaataaagttttgccgcagaagattctggtttgttgtgttcttcctggccggtcgtgagaacacgtttaagaGTTGGTGCTGaaatccgggacgagaaaatacaagaaaactcgggaccggcgcaaggaagatccctcattccggaaccagaactgcgggtcacggtaataaaggttcccgtaaaacagactgttgagaaggattcaactgcatgaattcagaacttttcagctggggaacaggagtaccagtgagtacagctttacaaggtaagtctggtcttgaactttctaacgaaattcaagacagtctatcagaagtaaagtggaaaatagctttacaaggtatgtttggccttgaactttttctagtgttaggagcccttttgttctttttcacatgttatcaagtgattaagatagggctgaaaattctagatgaaattcaggacaatctatcagaagtaaagcggggagagagagtaggagcaaagaggaaatatggtgcacagaataagtatacaggcctttccaagggtcttgaacccaaggaaaagtttaggtcaggtaagaatacctggggagagattagaaggaaggaaaagaaaaaagaaaagaaaaaagatcaattagcggaggtctctaggagatactcgtcactagatgagctcaggaagccagctcttagtagctctgaagcagatgaagaattctcctctgaagaaacagactgggaggaagaagcagctcattaccagccagataaagtgctagctagtcggtcaagaaaaaagccaaaagcggctggcgaaagccagcatgctgttcagcctccgggcagtcggcttcaaggtccgccctatgcggagcccccgccctgcgtagtgcgtcagccctgcgcagagagacaatgcgcagagagacaatgcgcagagagacaatgcgcagagaggcaatgcacagactcattcattcccagagaggaacaaaggaaaatacaacaggcatttccggtctttgaaggagccgagggtgggcgtgtccacgctccggtagaatacgtgcagattaaagaacttgccgag	1349	110	8%	154	11%
1	146122051	146122350	gtcggcttcaaggtccgccctatgcggagtccccgccctgcgtagtgcgtcagcaatgcgcagagaggcagtgcgcagagaggcagtgcgcagactcattcattcccagagaggaacaaaggaaaatacaacaggcatttccggtctttgaaggagccgagggtgggcgtgtccacgctccggtagaatacttacaaattaaagaaattgccgagtcggtccgtaaatacggaaccaatgctaattttaccttggtgcagttagacaggctcgccggcatggcactaactcctgctgac	299	40	13%	44	15%
1	148462501	148462650	ccatatttacggaccgactcggcaagttctttaatttgtaagtattctaccggagcgtggacacgcccaccctcggctccttcaaagactggaaatgcctgttgtattttcctttgttcctctctgggaatgaatgagtctgcgcactg	149	16	11%	12	8%
1	149582551	149583000	aaaaagggtaccagccaggtaaagtgctagctaatcagttaaggaagccaaaagcggctggcgaaggccagtttgcggattggcctcagggcagtcggtttcaaggtccgccctatgcggagcccccgccctgcgtagtgcgtcagcaatgcgcagagaggcaatgcgcagagagatgcgcagagaggcagtgcgcagagaggcagtgcgcagactcattcattcccagagaggaacaaaggaaaatacaacaggcatttccggtctttgaaggagccgagggtgggcgtgtccacgctccggtagaatacttacaaattaaagaaattgccgagtcggtccgtaaatacggaaccaatgctaattttaccttggtgcagttagacaggcttgccggcatggcactaactcctgctgactggcaaacggttgtaaaagccgctctccct	449	52	12%	66	15%
1	154904551	154906050	cgtttgctcgggcctgcgcttgtgcagcttcatgccaaagcgctctccattccatatatttgcccatactagggagagcggcttttacaaccgtttgccagtcggcaggagttagtgccatgccggcgagcctgtctaactgcaccaaggtaaaattagcattggttccgtatttacggaccgactcggcaatttctttaatttgtaagtattctaccggagcgtggacacgcccaccctcggctccttcaaagaccggaaatgcctgttgtattttcctttgttcctctctgggaatgaatgagtctgcgcactgcctctctgcgcactgcctctctgcgcagggctgacgcactacgcagggcggggactccgcatagggcggaccttgaagccgactgccctgaggccaatcagcaaactggccttcgccagccgcttttggcttccttaactgattagctagcactttacctggctggtacccttttttctcataatgagctgcttcttcctcccagtctgtttcctcagaggaggattcttcacctgcttcagagctactaagagctggctccccgagcccatccagcgatgagcacaggctccttttcctagagacctccgctaattgatctttcttcttttccctttttcctctttttcttctaatctctctccaggtattcctacctaaccttaacttttcctcgggttcaagacccttggaaaggcctgtatacttattttgtgtaccatatttcctctttgttcctactctctctccccgctttacttctgatagcttgtcctgaatttcatccagaatccgccctgccttaaccacttgataacatgtgaaaaggaacaaaagggctcctaacaccagaaaaaattcaaggccaaatataccttgcaaagccattttccactttacttctgatagactgtcttgaatttccttagaaagttcaagatcagacttacctcgtaaagctgtactcactggtactctcgttccccagctgaaaagttctgaattcatacagttgaatccttcttaacagtctgctttacgggaacctttattaccgcgacccgcagttctggttctggaatgagggatcttccttgcgccagtcccgagttttttctcgtcccggaattcggcaccaattgttattcgcgttctcacgcccggccaggaaagacgcaacaaaccagaatcttctgcggcaaagctttattgcttacatcttcaggagccagagtgcaagaagcaagagagagagaaaacgaaacccgtccctattaaggagaattatccttcgcctcggacgtgtcactccctgattggctgcagcccatcggccgagttgacgtcacggggaaggcagagtacaagtagtcacaaaatacccttggcacatgcgcagattatttgtttaccacttagaacacagctgtcagcgccatcttgtaacggcgaatgtgggcgc	1499	132	9%	180	12%
1	166357201	166357650	aaagaaacatcttcaggcatgagcgaagaccccctgctacagggaggattcagaactgcatcactgggaaggagcggttaataaaggttcccgtaaaacagactgttgagaaggatctggcgtggattcagaactcttcagctggggaacggtactgatgaagagaaagaagaaagatgaagactgaataaactgctgttagaaggactggtggtcgcatcgttcttgctggtcgagagcaggcgcgacaattggtggcccgtacggggaaccgactcccccaccgagttcagaactttcagcagtcagtggttgccggcagggtaagttcacggtgagtgaaacttgcgaccccaggagtttgggaaggacctcggataaaatagaggcaagcataaagttgccaggaagcaggcacaaggtaacaaaaggttcctggttttgggata	449	36	8%	56	12%
1	166768351	166769850	ccatgccggcgagcctgtctaactgcaccaaggtaaaattagcattggttccgtatttacggaccgactcggcaagctctttaatttgtaagtattctaccggagcgtggacacgcccaccctcggctccttcaaagaccggaaatgcctgttgtattttcctttgttcctctctgggaatgaatgagtctgcgcactgcctctctgcgcactgcctctctgcgcactgcctttctgcgcactgcctctctgcgcactgcctctctgcgcattgcctctctgcgcattgcctctctgcgcattgcctctctgcgcattgtctctctgcgcattgctgacgcactacgcagggcgggggctccgcatagggcggaccttgaaaccgactgcccggaggttgaacagtacgctggctttcgccagccgcttttggcttttttcttgaccaattagctggctggtaatgggctgctttttcctcccagtctgtttcctcagaggagaattcttcatctgcttcagagctactaagagctggcttcctgagctcatctagtgacgagtatctcctagagacctccgctaatcgatcttttttcttttcttttttcttttcctttcttctaatctctccccaggtattcttacctgacctaaacttttcctcgggttcaagacccttggaaaggcctgtatacttattttgtgtaccatattttctctttgctcctactctctctccccgctttacttctgatagattgccctgaatttcatctagaatccgccctgccttaaccacttgataacatgtgaaaaggaacaaaagggcttctaacactagaaaaaattcaaggccaaacattttccactttacttctgatagactgtcttgaatttccttagaaagttcaaggccaggcgtacctcgtaaagctgtactcactggtactctcgttccccagctgaaaagttctgaattcatgcagttgaatccttcttaacagtctgctttacgggaacctttattaccgcgacccgcagttctggttctggaatgagggatcttccttgcgccggtgaaactcccgtcccgagtttcctcccgggttttttcttcccggattttttctcgtcccggaatttctcgtcccggatttcagcaccaattcttaatAgcgttctcacgcccggccaggaagaacacaacagaccagaatcttctgcggcaaaactttattgtttacatcttcaggagctaggagcgcaaacccccagccccaaaagcgaaagccacccctctaatgaaaccgaaacccctttcctatttaggagagttatatttcgcctaggacgcatcactccctgattggctgcagcccatggccgagctgacgttcacgggaaaggcagagtacaagtagtcgtaaaatacccttggcacatgcgcagattatttgtttaccacttagaacacaggatgtcagcgccatcttgtg	1499	138	9%	160	11%
1	170116651	170117100	aaaagaagaaagatcaattagcggaggtctctaggaaaaggagcctgtgctcatcgctggatgggctcggggagccagctcttggtagctctgaatcagatgatgaattctcctctgaagaaacagactgggaggaagaagcagctcattatgagaaaaaagggtaccagccaggtaaagtgctagctaatcagttaaggaagccaaaagcggctggcgaaggccagtttgctgattggcctcagggcagtcggcttcaaggtccgccctatgcggagtccccgccctgcgtagtgcgtcagccctgcgcagagagacaatgcgcagagaggcaatgcgcagactcattcattcccagagaggaacaaaggaaaatacaacaggcatttccagtctttgaaggagccgagggtgggcgtgtccacgctccggtagaatacgtacagatt	449	38	8%	62	14%
1	172267051	172267200	gtagcgtatatacagattaaagagcttgccgagtcggtccgtaactatggagtcagtgctaatttcactatagcacaagtggaaaggcttgcgaatcacgctatgactcctggtgattggcagacggtagtaaaagctgtagcccccag	149	14	9%	16	11%
1	175041901	175042200	ACAGATTGTTGATACACTTTTTCATGAATCCATGCTATATTCCTAAATTAAGGCCAGCTATAATACCCAAGGGAGTCAGGCAGGGACAAGAAAGACCAAGtgttattagacgcgttctcacgaccggccaggaaagacgcaacaaaccagaatcttctgcggcaaagctttattgcttacatcttcaggagccagagtgcaagaagcaagagagagagaaaacgaaaccccgtccctattaaggagaattatccttcgcctcggacgtgtcactccctgattggctgcagcccatcggc	299	24	8%	48	16%
1	178126801	178126950	ttaaccttcttacacgcgttctcgcgaccggccaggaagaacacaacaaaccggaatcttctgcggcaaaactttattgcttacatcttcaggagcaagagtgcaagagagcaagagctctattgcttacatctttaggagccagagcg	149	16	11%	26	17%
1	179894101	179895450	ctcttacttgcgctctcttgctctgcgctctggcgctctggcgcgctggcgctctggctcctaaagatgtaagcggggggctttcgtttttggggcttggggcttgcgctcctgctcctgaagatgtaagcaataaagttttgccgcagaagattctggtttgttgtgttcttcctggccggtcgtgagaacgcgtttaagaGTTGGTGCTGaaacccgggacgagaaaatacaagaaaactcgggacaggagttaaccatcaccggcgcaaggaagatccctcattccggaaccagaactgcgggtcacggtaataaaggttcccgtaaaacagactgttgagaaggattcaactgcatgaattcagaactcttcagctggggaacaggagtaccagtgagtacagctttacaaggtaagtctggtcttgaactttctaaggaaagtcaagacagtctatcagaagtaaagtggaaaatagctttacaaggtatgtttggccttgaactttttctagtgttaggagcccttttgttctttttcacatgttatcaagtgattaagatagggctgaaaattctagatgaaattcaggacaatctatcagaagtaaagcggagagagagagtaggagcaaagaggaaatatggtgcacagaataagtatacaggcctttccaagggtcttgaacccaaggaaaagtttaggtcaggtaagaatacctggggagagattagaaggaaggaaaagaaaaaagaaaagaaaaaagatcaattagcggaggtctctaggagatactcgtcactagatgagctcaggaagccagctcttagtagctctgaagcagatgaagaattctcctctgaagaaacagactgggaggaagaagcagctcattaccagccagataaagtgctagctagtcggtcaagaaaaaagccaaaagcggctggcgaaagccagcatgctgttcagcctccgggcagtcggcttcaaggtccgccctatgcggagcccccgccctgcgtagtgcgtcagccctgcgcagagagacaatgcgcagagagacaatgcgcagagagacaatgcgcagagaggcaatgcgcagactcattcattcccagagaggaacaaaggaaaatacaacaggcatttccggtctttgaaggagccgagggtgggcgtgtccacgctccggtagaatacttgcagattaaagaacttgccgagtcggtccgtaaatacggaaccaatgctaattttaccttggtgcagttagacaggcttgccggcatggcactaactcctgccgactggcaaacgattgtaaaagccgctctccctagta	1349	108	8%	156	12%
1	180120901	180121650	GCTTTGAGAGTTTCGGTCTATTTCCTTACAGGTTGGCTATCTTCTCCTCCTCACCTTTAGCCCCGTCTCTTGTCtgcccgtgttatgttactgaggtgcctgtgctatgatgtcactgaggtgctcgtgttatgatgtcattgaggtacctgtgttatgatgccactgaggtgcccgtgttgtgatgtcactgaggtgcccgtgttgatgccactgaggtacccgtgttatgatgccactgaggtgcccgtgttgtgatgtcactgaggtgcccgtgttgtgatgtcactgaggtgcccgtgttgtgatgtcactgaggtgcccgtgttgtgatgccactgaggtgcccgtgttgtgatgtcactgaggtgcccgtgttgtaatgtcactgaggtgcccgtgttgatgccactgaggtgcccgtgttgtgatgccactgaggtgcccgtgttgtgatgtcactgaggtgcccatgttgtgatgtcactgaggtgcccatgttgatgccactgaggtgcccgtgttgtgatgtcactgaggtgcccgtgttgtgatgtcactgaggtgcccgtgttgtaatgtcactgaggtgcccgtgttgatgccactgaggtgcccgtgttgtgatgtcactgaggtgcccgtgttgtgatgccactgaggtgcccgtgttgtgatgtcactgaggtgcTGCTGCCCTTGCTCCTTCCTTCTTGCCTTCTGCTCGCTAGCAGTGTGAACCACAGCAC	749	48	6%	64	9%
1	181269301	181269600	ccgactcggcaatttctttaatttgtaagtattctaccggagcgtggacacgcccaccctcggctccttcaaagaccggaaatgcctgttgtattttcctttgttcctctctgggaatgaatgagtctgcgcactgcctctctgcgcactgcctctctgcgcattgctgacgcactacgcagggcggggactccgcatagggcggaccttgaagccgactgccctgaggccaatcagcaaactggccttcgccagccgcttttggcttttttcttgaccaattagctggctggtaatgg	299	36	12%	30	10%
1	181492951	181494300	gacagctgtgttctaagtggtaaacaaataatctgcgcatgtgccgagggtggttctccactccatgtgctctgccttccccgtgacgtcaactcggccgatgggctgcagccaatcagggagtgacacgtcctaggcgaaggataattctccttaatagggacggggtttcgttttctctctctcttgcttcttacgctcttgctcctgaagatgtaagcaataaagttttgccgcagaagattctggtttgctgtgttcttcctggccgggcgtgagaacgcgttaataacaattggtgccgaattccgggacgagaaaaaactcgggactggcgcaaggaagatccctcattccagaaccagaactgcgggtcgcggtaataaaggttcccgtaaagcagactgttaagaaggattcaactgtatgaattcagaacttttcagctggggaacgagagtaccagtgagtacagctttacgaggtaagtctggtcttgaactttctaaggaaattcaagacagtctatcagaagtaaagtggaatatgtttggccttgaattttttctggtgttaggagcccttttgttccttttcacatgttatcaagtgattaagatagggctgaaaattctagaggaaattcaggacaagctatcagaagtaaagtggggagagagagtaggaacaaagaggaaatatggtacacaaaataagtatacaggcctttccaagggtcttgaacccgaggaaaagttaaggttaggtaggaatacctggagagagattagaagaaaaagaggaaaaagggaaaagaagaaagatcaattagcggaggtctctaggaaaaggagcctgtgctcatcgctggatgggctcggggagccagctcttggtagctctgaatcagatgatgaattctcctctgaagaaacagactgggaggaagaagcagctcattatgagaaaaaagggtaccagccaggtaaagtgctagctaatcagttaaggaagccaaaagcggctggcgaaggccagtttgctgattggcctcagggcagtcggcttcaaggtccgctctatgcggagtccccgccctgcgtagtgcgtcagccctgcgcagagagacaatgcgcagagaggcagtgcgcagactcattcattcccagagaggaacaaaggaaaatacaacaggcatttccggtctttgaaggagccgagggtgggcgtgtccacgctccggtagaatacttacaaattaaagaactcgccgagtcggtccgtaaatacggaaccaatgctaattttaccttggtgcagttagacaggcttgccggcatggcactaac	1349	106	8%	144	11%
1	181751401	181752150	TTAACCACAGCAGTGAAACTTGTCCTGGGAGGAATGACCAACCCCAtaatgtacatctcatgtgacccgttctccctaacatacatgtcatgtgacacattctccctaacgtgcatctcatgtgacacgttctccctaacatacatgtcatgtgacacgttctccctaatgtacatctcatgtgacacgttctccctaacgtacatgtcatgtgacacattctccctaacgtgcatctcatgtgacacgttctccctaacatacatgtcatgtgacgcgttctccctaacatacatctcatgtgacgtgttctccctaacatacatgtcatgtgacacattctccctaacgtgcatctcatgtgacatgttctccctaacatacatgtcatgtgacacgttctccctaatgtacatctcatgtgacacgttctccctaacatacatgtcatgtgacgcgttctccctaacatacatctcatgtgacgtgttctccctaacatacatgtcatgtgacacattctccctaacgtgcatctcatgtgacatgttctccctaacatacatgtcatgtgacgcattctccctaacatacctgtcatgtgacacgttctccctaGGTGTTCTTGAGGCTCAAGAAGATTTTAAATCTGCCTGACTTCAACCCCAACAAGATTGCGATGGTTTCTGTGGCTTGTTGCTCCATGTGCCAGTGGGTGATTGCCTTGAATAACTACCATGAAGTACAGA	749	42	6%	158	21%
1	185319301	185319750	tgtacacagctataacgtgctctgtgactcagcatcagcgcagctgtgtgtgtacacagctataacgtgttctgtgactcagcatcagcgcagctgtgtgtgtacacagctataacgtgttctgtgactcagcatcagcgcagctgtgtgtgtacacagctataacgtgctctgtgactcagcatcagcgcacctgtgtgtgtacacagctataacgtgttctgtgactcagcatcagcgcagctgtgtgtgtacacagctataacgtgttctgtgactcagcatcagcgcagctgtgtgtgtacacagctataacgtgctctgtgactcagcatcagcgcagctgtgtgtgtacacagctataacgtgttctgtgactcagcatcagcgcagctgtgtgtgtacacagctataacgtgttctgtgactcagcatcagcgcagctgtgt	449	36	8%	108	24%
1	187354801	187355700	gaatgcgtgtgggtggcccgtggtgcactgacattccacactggtggcactagtgcattacagaatccgtgtgggtgacccgtggtgcactgacattccacactggtggcactagtgcattacagaatgcgtgtgggtggcccgtggtacactgacattccacactggtggcactagtgcattacagaaagcgtgtgggtggcccgtggtgcactgacattccacactggtggctctagtgcattacagaatgcgtgtgggtgacccgtggtacactgacattccacactggtggctctagtgcattacagaatgcgtgtgggtggcccgtggtgcactgacattccacactggtggcactagtgcattacagaatgtgtgtgggtggcccatggtgcactgacattccacaccggtggctctagtgcattacagaatgcgtgtgggtggcccatggtgcactgacattccacactggtggctctagtgcattacagaatgcgtgtgggtggcccgtggtgcactgacattccacactggtggcactagtgcattacagaatgcgtgtgggtggcccatggtgcactgacattccacaccggtggctctagtgcattacagaatgagtgtgggtggcccgtggtgcactgacattccacactggtggctctagtgcattacagaatccgtgtgggtggcccgtggtgcactgacattccacactggtggcactagtgcattacagaatgcgtgtgggtggcccgtggtgcactgacattccacactggtggcactagtgcattacagaatgcgtgtgggtggcccgtggtgcactgacattccacaccggtggctctagtgcattacagaatgagtgtgggtggcccgtggtgcactga	899	54	6%	190	21%
1	188793301	188794350	AAAACACACACATAATTTTAAACTGGGTTTAATCTTTTTATGCgtgtatgtgtgtgtctgtgtgtgtctgtgtgtgtctgtgtgtctgtgtgtgtgtgtatgtgtatgtgtgtgtgtctgtgtgtctgtatgtgcctgtgtgtgtctgtatgtgtctgtgtgtgtgtctgtatgtgtctgtgcgtgtgtgtctgtgtgtctgtgtatgtgtgtctgtgtgtctgtatgtgtctgtgtgtgtctgaatgtgtctgtgtgtgtgtctgcatgtgtctgtgcgtgtgtgtctgtgtgtctgtgtgtgtgtctgtgtgtctgtgtgtatctgtgtgtgtctgtgtgtctgtgtgtgtgtgtctgtatgtgtctgtgtgtgtctgtgagtgtctgtgtgtctgtgtgtctgtgtgtgtctgtgtgtctgtgtgtgtctgtatgtgtctgtgtgtgtgtctgtgtgtctgtatgtgcctgtgtgtgtctgtatgtgtctgtgtgtgtgtctgtatgtgtctgtgcgtgtgtgtctgtgtgtctgtgtgtgtgtgtctgtgtgtctgtatgtgtctgtgtgtgtctgtatgtgtctgtgtgtgtgtctgtatgtgtctgtgcgtgtgtgtctgtgtgtctgtgtgtgtgtctgtgtgtctgtgtgtgtctgtgtgtgtctgtgtgtctgtgtgtctgtgtgtgtgtgtctgtatgtgtctgtgtgtgtctgtgagtgtctgtgtgtctgtgtgtgtgtgtctgtatgtgtctgtgtgtgtctgtgtgtctgtgtgtgtctgtgtgtgtctgtgtgtctgtgtgtgtctgtatgtgtctgtgtgtgtgtctgtgtgtctgtatgtgcctgtgtgtgtctgtatgtgtctgtgtgtgtgtctgtatgtgtctgtgcgtgtgtgtctgtgtgtctgtatgtgtctgtgtgtgtctgtatgtgtctgtgtgtgtgtctgtatgtgtctgtgcgtgtgtgtctgtgtgtctgtgtgtgtgtctgtgtgtctgtgtgtgtctgtgtgtgtctgtgtgtctgt	1049	12	1%	10	1%
1	190984801	190985100	tgggggagtcggttccccgtacgggccaccaattgtcgcgcccgctctcgaccagcaagaacgacgtgaccaccagtccttctaacagcagtttattcagtcctcatctttcttctttctcttcatcagtacctttccccagctgaagagttctgaatccacgccggatccttctcaacagtctgtttcacgggaacactttattaaccccttcttccccgttatgcagttctgaatcctccctgtagcagggggtcttcgctcttgcctgaagatgtttcttgtcccgggtttCGGCA	299	32	11%	42	14%
1	192743551	192743700	acacacactctcacacaatactctcacattttcacatacacacacactctctcacacactctcacaatgtctttcttacacacacacacacatacatacacacgctctcacaatgtctttcacacacactcacacacatactctcacaa	149	2	1%	82	55%
1	195321451	195321750	gtcagcaatgcgcagagaggcagtgcgcagagaggcaatgcgcagagaggcagtgcgcagagaggcagtgcgcagagagacagtgcgcagagaggcagtgcgcagactcattcattcccagagaggaacaaaggaaaatacaacaggcatttccagtctttgaaggagccgagggtgggcgtgtccacgctccggtagaatacgtgcagattaaagaactcgccgagtcggtccgtaaatacggaaccaatgctaattttaccttggtgcagttagacaggctcgccggcatggcacta	299	38	13%	60	20%
1	195357601	195358200	cccatttctagaaaaacagtagtcacaacaagagcggacacgagactaagacaaaaaagaaaccagaaacggcggcgactccgcgtcgaccacaagcaactcaaagaatcagatggcctctttaaggccggccgattgagaccctctgcacgaggtgggactcgaacccacgatcccgtgaccaaacgcgaggtgggactcgaacccacggtctcgcaacaaggcgcgaggtgggactcaaacccacgatctcgcaacaaaacgcgaggtgggactcgaacccacgatctcgcaactgggcacgaggtgggactcaaacccacgatctcgcaaccccaaatggtctcttggcctccaaaggggtccaccaggcgtccctggtcctcccctgttcctcctgggacgtctcccagggtgaacggacggtggacacctggacacgtctatccttatccaccccgcgttccctctcggagcgcggtcttactgagcgtccgcaaaaccgaaactgcgatcgcaccaaacttagaaacagaacacagacatcagaccaaaacagaacaaagaatcttacctctaagtgagtctaggacctctgg	599	92	15%	96	16%
2	3439501	3439950	TAGGCCAGTGCAGCAATtggacatgactttgtgtgtttgctggcctcacataacatagagcgtggacatgactttgtgtgtttgctggcctcacataacatagaatgtggacatgactttgtgtgtttgctggcctcacataacatagaatgtggacatgactttgtgtgtttgctggcctcacataacatagaatgtggacatgactttgtgtgtttgctggcctcacataacatagaatgtggacatgactttgtgtgtttgctggcctcacataacatagaatgtggacatgactttgtgtgtttgctggcctcacataacatagaatgtggacatgactttgtgtgtttgctggcctcacataacatagagcgtggacatgactttgtgtgtttgctggcctcacataacatagaatgCTACTATTTTAATTTTGTTTCATGATC	449	4	1%	80	18%
2	11105101	11105700	tctctcttgcactcttgctctcttgctctcttgctctggctcctaaagatgtaagcaatagagctcttgctctcttgcactcttgctcctgaagatgtaagcaataaagttttgccgcagaagattccggtttgctgcgtctttcctggccgttcgtgaatgcgggtaagaGttggtgccgaaacccgggaagaaagaacccgggacgagaagacctaggacgagaagacctgggacgagaaaacctgggacggttaccaccaccggcgcaaggaagatccctcattccggaaccagaactgcgggtcatggtaatgaagtgttcccgtaaaacagactgttgagaaggattcaactgcgtgaattcagaactcttcagctggggaatggtggtaatgaagtgttcccgtaaaacagactgttgagaaggattcaactgcgtgaattcagaactcttcagctggggaatggtggtaatgaagtgttcccgtaaaacagactgttgagaaggattcaactgcgtgaattcagaactcttcagctggggaacagggtacccgtaagtatagctttacaaggtaagtctggtcttgaacttt	599	48	8%	50	8%
2	11744251	11745150	CTTCAATCCCCAGCACCAACGTCCAAACCGACCCAGTgtattcctgtctccacagcgtattcctgtctccactgcgtgttcctgtctccactgcgtgttcctgtctccactgcgtattcctgtctccactgcgtattcctgtgtccactgcgtattcctgtctccactgcgtattcctgtctccactgcatattcctgtctccactgcgtgttcctgtctccactgcatattccagtctccactgcgtattcctgtgtccactgcgtattcctgtgtccactgcgtattcctgtctccactgcatattcctgtctccactgcgtattcctgtgtccactgcgtattcctgtgtccactgcgtattcctgtgtccactgcgtattcctgtctccactgcatattcctgtgtccactgcgtattcctgtgtccactgcgtattcctgtctccactgcgtattcctgtgtccactgcgtattcctgtgtccactgcgtattcttgtctctactgcgtattcctgtctccactgcgtgttcctgtctccactgcatattccagtctccactgcgtattcctgtgtccactgcgtattcctgtgtccactgcgtattcctgtctccactgcatattcctgtctccactgcatattcctgtgtccactgcgtattcctgtgtccactgcgtattcctgtctccactgcgtattcctgtgtccactgcgtattcttgtctccactgcgtattcctgtctccactgcgtattcctgtgtccactgcgtattcttgtctctactgcgtaCAGCAGAGAAGGTTCCTGCAGTTTTCTATCTGTACATTGTCTCCATAAAGAGGAAACACCACAGCACAGGGAGGGGTAGAGCCTGGCACACAGCAAGCA	899	70	8%	138	15%
2	12043201	12043500	cttattagcgttctcacgcccggccaggaagaacacaacagaccagaatcttctgcggcaaaactttattgcttacatcttcaggagctaggagcgcaaacccccagccccaaaagcgaaagccaccccttctaacatctttaggagccagagctccggcgcgccaaagcgcagagcgcgctctattgtttacatcttttggagcaagcgagcaggcgccagagccagagagagaaaagagagagaatggcggaaaccccgtcccctttaaggaggagttatccttcgcttaggacgca	299	36	12%	46	15%
2	14376601	14377350	cccagaagctctgcgactctcgcccgtcccagaaacggctggcactctgtattccacacggtcacccgtgcagcctgccctccgcggagtcccggagccaagaaggctcccgccggcgcctgtgccacaaacctctcaggccgggcagacccccgtgctctcaccaggaaggtggccggctgtctggagctgaagatggcgccgcccagaagctctgcgactctcgcccgtcccagaaacggctggcactctgtattccacacggtcacccgtgcagcctgccctccgcggagtcccggagccaagaaggctcccgccggcgcctgtgccacaaacctctcaggccgggcagacccccgtgctctcaccaggaaggtggccggctgtctggagctgaagatggcgccgcccagaagctctgcgactctcgcccgtcccagaaacggctggcactctgtattccacatggtcacccgtgcagcctgccctccgcggagtcccggagccaagaaggctcccgccggcgcctgtgccacgaacctctcaggccggacagaaccccgtgctctcCAATTTATGTTTTTTAACCTATTCAATTGGTTATGgtttgtttgtttttgtatttttgttgttgtttttcttttACAAATTTTAATTTGTAACCATGCCTAATTTCTACGTTGGAGAGTCTTACATAAAATTCATAGCTTTTTTCCTTTTATAATTTACTGTCAGCTTCCAAAGGAAAG	749	98	13%	94	13%
2	14383201	14383650	caatcagggagtgatacgtcctaggcgaaggataactctccttaatagggacggggtttcgctttcgtttttgggggcttacactcttgctccaaaagatgtaagcaatagagctcttgctctgcgctctggcgctctggcgctctggcgctctggcgctctggctcctaaagatgtaagcaataaagctcttgcttcttgctcctgaagatgtaagcaataaagttttgccgcagaagattctggtttgctgcgtctttcctggccggtcgtgaacacgtgtaagaGttggtgccgaaaacccgggaagaaagaacccgggacgaaaaaacccgggacaagaaaactcgggacgggagttaaccatcaccggcgcaaggaagattcttcattccggaaccagaactgcgggtcacggtaatgaagtgttcccgtaaaacagactgttg	449	56	12%	34	8%
2	16581001	16581600	tctgcctgcctctgcctccaagcggtgggattaaaggcgtgcgccaccacgcccggctCATTATCCATTTCTTAAGAATCtcttaatagcgttctcacgcccggccaggaagaacacaacagaccagaatcttctgcggcaaaactttattgcttacatcttcaggagctaggagcgcaaacccccagccccaaaagcgaaagccccttctataatctttaggagccagagctccggcgcgccaaagcgcagagcgcgctctattgtttacatctttaggcagcgagagagcgcagggcgcgcagagccagagagatgccagcgagagagaatggcggaaaaccccgtccccttttttaggagcgttatatttcacctaggacgcatcactccctgattggctgcagcccatggccgagctgacgttcacgggaaaggcagagtacaagtagtcgtaaaatacccttggcacatgcgcagattatttgtttaccacttagaacacaggatgtcagcgccatcttgtgacggcgaatgtgggggcggctcccaacatctcccccttttcttttaataagagcaaataggccacccatatt	599	70	12%	94	16%
2	16585351	16585950	ccttagaaagttcaagaccagacttacctcgtaaagctgtactcactggtactctcgttccccagctgaaaagttctgaattcatgcagttgaatccttctcaacagtctgttttacgggaacctttattaccgcgacccgcagttctggttctggaatgagggatcttccttgcgccggtgaaactcccgtcccgagtttccttgtattttttcgtcccggatttCAGCACCAATtcttaatagcgttctcacgcccggccaggaagaacacaacagaccagaatcttctgcggcaaaactttattgcttacatcttcaggagctaggagcgcaaacccccagccccaaaagcgaaagccccttctataatctttaggagccagagctccggcgcgccaaagcgcagagcgcgctctattgtttacatctttaggcagcgagagagcgcagggcgcgcagagccagagagatgccagcgagagagaatggcggaaaaccccgtccccttttttaggagcgttatatttcgcctaggacgcatcactccctgattggctgcagcccatggccgagctgacgttcacgggaaaggcagag	599	74	12%	78	13%
2	17612701	17614050	agggagtgacacgtccgaggcgaaggagaatgctccttaagagggacggggttttcgtttttctctctctcttgcttcgctctctcttgcttcttgctctcttgcttcttgcactctgttcctgaagatgtaagaataaagctttgccgcagaagattctggtctgtggtgttcttcctggccggtcgtgagaacgcgtctaataacaattggtgccgaattccgggacgagaaaaaaaaactcgggactggcgcaaggaggatccctcattccggaaccagaactgcggatcacgtttataaaggttcccgtaacacagactgttgagaaggattcaactgccgaattcagaactcatcagctggggaacgacggtaataaaggttcccgtaaagcagactgttgagaaggattcaactacatgaattcagaacttttcagctggggaacggtggataccagtaagtatagctttacgaggtacgcctggccttgaactttctaacgaaattcaagacagtctatcagaagtaaagtggggaatagctttacaaggtacgcctggccttgaactttctaacgaaattcaggacagtctatcagaagtaaagtgggaaatggctttacaaggtatatttggccttgaattttttctggtgttaggagcccttttgttccttttcacatgttatcaagtggttaagatagggcggattctagatgaaattcaggacaagctatcagaagtaaagcggggagagagagtaggaacaaagagaaaatatggtacacaaaataagtatacaggcctttccaagggtcttgaacccgaggaaaagttaaggttaggtaggaatacctggagagagattagaagaaaaagaggaaaaagggaaaagaagaaagatcaattagcggaggtctctaggagatactcgtcactagatgagctcagggagccagctcttagtagctctgaagcaggtgaagaatcctcctctgaggaaacagactgggaggaagaagcagcccattaccagccagctaattggtcaagaaaaaagccaaaagcggctggcgaaggccagtttgctgattggcctcagggcagtcggcttcaaggtccgccctatgcggagtccccaccctgcgtagtgcgtcagcaatgcgcagagaggcagtgcgcagagaggcagtgcgcagactcattcattcccagagaggaacaaaggaaaatacaacaggcatttccggtctttgaaggagccgagggtgggcgtgtccacgctccggtagaatacttacaaattaaggaaattgccgagtcggttcgtaaatacggaaccaa	1349	108	8%	146	11%
2	17751301	17751450	atttacgaaccgactcagcaatttctttaatttgtaagtattctaccggagcgtggacacgcccaccctcggctccttcaaagaccggaaatgcctgttgtattttcctttgttcctctcggggaatgaatgagtctgcgcactgcctc	149	18	12%	12	8%
2	18328951	18329400	gaacgcaacaaaccggaatcttctgcagcaaagctttattgcttacatcttcaggagccagagagcaagagagcaagagctctattgcttacatctttaggagccagagcgcaagagcgctagagtgcaagagcaaaagcaaaagcaagagctctattgcttacatctttaggagccagagcgcaagagcgctagagtgcaagagccagagcaagagagagaatggtgaaaccccgtcccttttaaggagaatcatcctctgcctaggacgtgtcactccgattggctgcagcccatcggccgagttgtcgtcacggggaaggcagagcacatggggtggagaactacccttggcacatgcgcagattatttgtttaccacttagaacacaggatgtcagcgccatcttgtaacggcgaatgtgagggcggctccccacagaaactgta	449	36	8%	80	18%
2	18459301	18459600	aaccgcgccaattcctcccccagccccaccccttttctataaaagtccctagcttccaagcctcggggtcgaaaccactgtctcctgcgtgagatacgtttcgaaccggagctccgccattatggctccaccatgtggtcgacacctctgtctcctgcgggagatatgtgtcggcccggagctccgtcattaaactacctcatgcttttacatcaaggtggtcgtctgttcgtgattcttgggtgcgcgccgaacagaaattgagtgggggtttccccactaggttctttcataattag	299	38	13%	32	11%
2	20388151	20388600	agatcttggggggtttcgtcactggtgtgctgcgatcatcatctctcccgagcggtggtttcggtttctctttctcaccattttctcggatggctagaatcttggtgccagggcggagaggcgggaggaatgggcgaacccacgggggtgggtagcgtgccaagtcctcccataccatgatgtacggttgttggtctggatgcgaccctggcccttcctgaaaaacaatgaccttcacagcccttatggtgggtaagtaaaaagttccttctgctggccaacctactccaaaaacaggccattctgaggaacagaaagtcatccatggctttttcttcacttttactgacaaattttgtcctctagccctaacgtccgtccaatggtccttagtcaaagataaaggagtagacacggtctgtcccatagtgaagaataagagtaaacac	449	32	7%	54	12%
2	23013901	23014200	aatcagatggcctctccaaggccggccgattgagaccctctgcacgaggtgggactcgaacccacgatcccgtgaccagacgcgaggtgggactcgaacccacggtctcgcaacaaggtgcgaggtgggactcaaacccacgatctcgcaacaaaacgcgaggtgggactcgaacccacgatctcgcaactgggcacgaggtgggactctaacccacgatctcgcaaccccaaatggtctcttggccttcaaaggggtccaccaggcgtccctgatcctcccctgttcctcctgggacg	299	48	16%	42	14%
2	23294101	23294400	acccctccgggtgactagcctgggaggaggttttgtgtaaggcccctatgcttgcacactggggatttgacctctatcttcactctcagtactgggtggtctgttgcttctaaaataaaagaaaagggggagatgtgaggagccgccctcacagtcgcagttacaagatggcgctgacatccgttgctcgtagtaaaatgtgcgcatgcatcagggtatcgttccattacctgagccctgcctctctcgtggcattaactgactgatagtgggcagccaatcctggtggtgcacgtctc	299	20	7%	34	11%
2	23920801	23921100	ggaagtccagtcaggtgggtcacgtccatctgacggcagaactgctggaatttttgagatgtataagctggtccattatcagtcttaaggagtttgggtttcccccaagcactctatgcctcaaggcaatgttgaatcacgtgtgaggctttttctccggttaacggagaagcaaacatgatgccagaacatgtgtcaatggacacatggagatattgaagttttccaaaggaagaaacatgtgtaacatccatttgccagacctgtagaggtcgaataccgcgtgggttaattcccac	299	16	5%	50	17%
2	23925751	23926200	cacgctggatccttctcaacagtctgttttacgggaacctttatgaccgtgacccgcagttctggttccggaatgagggatcttccttgcgccggtgatggttaactcccgtcccgagttttcttgtcccgggttttttcttcccggattttctcgtcccggatttcggcaccaaCtcttacacgcattcacgcgaccggccaggaaagacgcagcaaaccagaatcttctgcggcaaaactttattgcttacatcttcaggagcaagagtgcaaaccccccattgcttacatctttaggagccagagcgccagagcgccagagcgccagagcgccagagcgccagagcgccagagcgcagagccagagctctattgtttacatctttaggagcaagagagcaagcccaaacccaaaaaacgaaagtgaaaccccttccctcttaagga	449	56	12%	68	15%
2	24165001	24165150	acatgccccactcttacacgcgttctcgcgaccggccaggaagaacgcaacaaaccagaatcttctgcggcaaaagctttattgcttacatcttcaggagcaagagagcaagagcaagagcaagagagagaatggcgaaaccccgtccc	149	18	12%	28	19%
2	24194401	24194700	tccgccctatgcggagtccccgccctgcgtagtgcgtcagccctgcgcagagaggcagtgcgcagagaggcagtgcgcagactcattcattcccagagaggaacaaaggaaaatacaacaggcatttccagtctttgaaggagccgagggtgggcgtgtccacgctccggtagaatacttacaaattaaagaacttgccgagtcggtccgtaaatacggaaccaatgctaattttaccttggtgcagttagacaggctcgccggcatggcactaactcctgctgactggcaaacggttg	299	38	13%	44	15%
2	26532301	26532450	CTGTGAATATGTAACTATATGTCCGTTCATGTCTATGTGCCTGTGCATGactgtgtgtgtaactgtgtgtgtgactgtgtgtgtaactgtgtgtgtatctgtgtgtgtaactgtgtgtgtaactatgtgtgtaactgtgtgtgtaactg	149	2	1%	4	3%
2	27477301	27477600	aactatgtacatgtgtgtaactatgtgtttgtaacagtgtgtgtaactgtgtgtgtgactgtgcatgtgtgcgtaactgtgtatgtgtgtaactatgtgtgtgtaactgtgtatgtgtatataactgtgtgtgtaacagtgtatgtgtgtgtaactgtaactgtgtataactgtgtacatgtgcgtaactatgtgtgtgtaactgtgtgtaattaggtgtgtgtataactgtgtatgtgtatgtaactgtgtgtgtaactgtgtattgtgtaactgtgtgtgtaacagtgtatgtgtgt	299	4	1%	12	4%
2	30218551	30219000	taaacaaataatctgcgcatgtgccgagggtggttctccactccatgtgctctgccttccccgtgacgtcaactcggccgatgggctgcagccaatcagggagtgacacgtcctaggcgaaggataattctccttaatagggacggggtttcgttttctcgctctcttgcttcttacactcttgctcctgaagatgtaagcaataaagttttgccgcagaagattctggtttgctgtgttcttcctggccgggcgtgagaacgcgttaataacaattggtgccgaattccgggacgagaaaaaactcgggacgagagtttaccatcaccggtgcaaggaagatccctcattccagaaccagaactgcgggtcgcggtaataaaggttcccgtaaagcagactgttaagaaggattcaactgtatgaattcagaacttttcagctgggga	449	52	12%	46	10%
2	30219601	30219900	ctgattggcctcagggcagtcggcttcaaggtccgccctatgcggagtccctgccctgcgtagtgcgtcagccctgcgcagagagacaatgcgcagagaggcagtgcgcagactcattcattcccagagaggaacaaaggaaaatacaacaggcatttccagtctttgaaggagccgagggtgggcgtgtccacgctccggtagaatacttacaaattaaagaactcgccgagtcggtccgtaaatatggaaccaatgctaattttaccttggtgcagttagacaggcttgccggcatg	299	34	11%	46	15%
2	30493351	30493500	tatctactgtaagtatgtaatgttttagtgtgtgttctatctgctgtaagtgtgtaatgtgttaacgtgtgtgttctatctgctgtaagtgtgtaatgtgttaacgtgtgtgtgctctatctgctgtaagtgtgtaatgtgttaatgtg	149	4	3%	0	0%
2	30689551	30689700	cctccacacacaaactatacacacaccacacacactacaatacacccttcacacacaccacatacattccacactacgcacacactacacaccacacacatatacactatactcacacatatcacacacacacacacacaactacctac	149	2	1%	88	59%
2	32473351	32473950	tgtgtgtgtgttgggagccgcccccacattcgctgtcacaagatggcgctaacatcctgtgttctaagtggtaaacaaataatctgcgcatgtgccaagggtattttacgactacttgtactctgcctttcctgtgaacgtcagctcggccatgggctgcagccaatcagggagtgatgcgtcctaagcgaaggataactcctccttaaaggggacggggttttccgccattctctctcttacttgcgctcttcgctctggctctggcgcctgctcgcttgctcctaaagatgtaaacaatagagcgcgctctgcgctttggcgcgccggagctctggctcctaaagatgtaagataggggtggctttcgcttttggggctgggggtttgcgctcctagctcctgaagatgtaagcaataaagttttgccgcagaagattctggtctgttgtgttcttcctggccgggcgtgagaacgctattaagaattggtgccgaaacccgggacgagaaaaaatccgggacaaaaaaatacaagaaaactcgggaccggcgcaaggaagatccctcattccagaaccagaactgcgggtcgcggt	599	74	12%	46	8%
2	32477401	32477850	gtaaacaaataatctgcgcatgtgccaagggtattttacgactacttgtactctgcctttcccgtgaacgtcagctcggccatgggctgcagccaatcagggagtgatgcgtcctaagcgaaggataactcctccttaaaggggacggggttttccgccattctctctcttacttgcgctcttcgctctggctctggcgcctgctcgcttgctcctaaagatgtaaacaatagagcgcgctctgcgctttggcgcgccggagctctggctcctaaagatgtaagataggggtggctttcgcttttggggctgggggtttgcgctcctagctcctgaagatgtaagcaataaagttttgccgcagaagattctggtctgttgtgttcttcctggccgggcgtgagaacgctattaagatgtgtgtgtgtgtatgtgtgtgAGTATGCCTG	449	50	11%	24	5%
2	33934051	33934350	gcgtggattgggggtgcgtggattgggggtgtgtggattggggtgtgtgtattggggtgtgtgtattggggtgtgtgtgtattggggtgtgcgtggattggggtgtgtgtgtattggagtgtgtgtggattggggggtgtggattggggtgtgtgtattggggtttgtttgttggcgtgtgtgtattggggtgtgtgtgtattggggtgtgtgtggattggggcgtgtgtgtattggggtgtgtgtgattggtgtgtttgtggattggggtgtttgtggattggtgtgtgtgtgtattg	299	10	3%	0	0%
2	36299701	36300300	cacccgtgcagcctgccctctgcggagtcccggagccaagaaggctcccgccggcgcctgtgccacaaacctctcaggccgggcagacccccgtgctctcaccaggaaggtggccggctgtctggagctgaagatggcgccgcccagaagctctgcgactctcgcccgtcccagaaacggctggcactctgtattccacacggtcacccgtgcagcctgccctccgcggagtcccggagccaagacggctcccgccggcgcctgtgccacaaacctctcaggcctggcagacccccgtgctctcaccaggaaggtggccggctatctggagctgaagatggcgccgcccagaagctctgcgactctcgcccgtcccagaaacggctggcactctgtattccacacggtcacccgtgcagcctgccctccgcggagtcccggagccaagacggctcccgccggcgcctgtgccacaaacctctcaggccaggcagacccccgtgctctcaccaggaaggtggctggctgtctCGCCATTTGGATTATTAAGAGGGAATGTTTATGTGATATGCCTGTGAGTGAAAGGGGCTCCAATCGTC	599	88	15%	80	13%
2	36356101	36356400	aattcacgcagttgaatccttctcaacagtctgttttacgggaaccttcattaccataacccgcagttctggttccggaatgaggaatcttccttgcgccggtgatggttaactcccgtcccgagtttttcatcccgggtttccggcaccaactcttgcacgcgttctcacgaccggccaggaagaacacagcaaaccagaatcttctgcggcaaaactttattgcttacatcttcaggagcaagagtgcaagcctcaaaccccctgcttacatctttaggagccagagcgccagagcg	299	34	11%	52	17%
2	37339801	37341150	ggtaaacaaataatctgcgcatgtgccaagggtatcttatgactacttgtgctctgccttccccgtgacgtcaactcggccgatgggctgcagccaatcagggagtgacacgtccgaggcgaaggagaatgctccttaagagggacggggtttctttttctctctctcttgcttcttgctctcttgcttcttgcactctggctcctgaagatgtaagcaataaagctttgccgcagaagattctggtctgtggtgttcttcctggccggtcgtgagaacgcgtctaataacaattggtgccgaattccgggacgagaaaaaactcgggactggcgcaaggaagatccctcattccagaaccagaactgcgggtcgcggtaataaaggttcccgtaaagcagactgttaagaaggattcaactgtatgaattcagaacttttcagctggggaacgagagtaccagtgagtacagctttacgaggtaagtctgatcttgaactttctaaggaaattcaagacagtctatcagaagtaaagtggaaaatggctttgcaaggtatatttggccttgaattttttctagtgttagaagcccttttgttccttttcacatgttatcaagtggttaagatagggcggattctagatgaaattcaggacaagctatcagaagtaaagtggggagagagagtaggagcaaagaggaaatatggtacacaaaataagtatacaggcctttccaagggtcttgaacccgaggaaaagttaaggttaggtaggaatacctggagagagattagaagaaaaagaggaaaaagggaaaagaagaaagatcaattagcggaggtctctaggaaaaggagcctgtgctcatcgctggatgggctcggggagccagctcttagtagttctgaagcagatgaagaattctcctctgaggaaacagactgggaggaagaagcagcccattaccagccagctaattggtcaagaaaaaagccaaaagcggctggcgaaggccagtttgctgattggcctcagggcagtcggcttcaaggtccgccctatgcggagtccccgccctgcgtagtgcgtcagcaatgcgcagagaggcagtgcgcagagaggcagtgcgcagactcattcattcccagagaggaacaaaggaaaatacaacaggcatttccggtctttgaaggagccgagggtgggcgtgtccacgctccggtagaatacttacaaattaaagaaattgccgagtcggtccgtaaatacggaaccaatgctaattttaccttggtgcagttagacaggctcgccggcatggcactaactcctgctgactggc	1349	104	8%	146	11%
2	39360751	39361200	aaataatctgcgcatgtgccaagggtgttttatgactacttgtgctctgccttccccgtgacgtcaactcggccgatgggctgcagccaatcagggagtgacacgtccgaggcgaaggagaattctccttaagagggacggggtttcgttttctctctctcttgcttcttgctctcttgcttcttgcactctggctcctgaagatgtaagcaataaagctttgccgcagaagattctggtttgttgcgtctttcctggccggtcgtgagaacgcgtctaataacaattggtgccgaattccgggacgagaaaaaactcgggactggcgcaaggaagatccctcattccagaaccagaactgcgggtcgcggtaataaaggttcccgtaaagcagactgttaagaaggattcaactgtatgaattcagaacttttcagctggggaacgag	449	52	12%	38	8%
2	39361801	39362100	cggcttcaaggtccgccctatgcggagtccccgccctgcgtagtgcgtcagccctgcgcagagaggcagtgcgcagactcattcattcccagagaggaacaaaggaaaatacaacaggcatttccggtctttgaaggagccgagggtgggcgtgtccacgctccggtagaatacttacaaattaaagaaattgccgagtcggttcgtaaatacggaaccaatgctaattttaccttggtgcagttagacaggctcgccggcatggcactaactcctgctgactggcaaacggttgtaaa	299	40	13%	40	13%
2	39784201	39784650	atatttgcccatactagggagagcggcttttacaaccgtttgccagtcagcaggagttagtgccatgccggcgagcctgtctaactgcaccaaggtaaaattagcattggttccgtatttacggaccgactcggcaagctctttaatttgtaagtattctaccggagcgtggacacgcccaccctcggctccttcaaagaccggaaatgcctgttgtattttcctttgttcctctctgggaatgaatgagtctgcgcactgcctctctgcgcattgcctctctgcgcagggctgacgcactacgcagggcggggactccgcatagggcggaccttgaagccgactgccctgaggccaatcagcaaactggccttcgccagccgcttttggcttccttaactgattagctagcactttacctggctggtacccttttttctcataatgag	449	48	11%	50	11%
2	40235701	40237050	ctactccatgtgctctgccttccccgtgacgtcaactcggccgatgggctgcagccaatcagggagtgacacgtcctaggcgaaggagaattctccttaatagggacggggtttcgttttctcgctctctcttgcttcttacactctggctcctgaagatgtaagcaataaagctttgccgcagaagattctggtttgttgcgtctttcctggccggtcgtgagaacgcgtctaataacaattggtgccgaattccgggacgagaaaaaactcgggactagcgcaaggaagatccctcattccagaaccagaactgcgggtcgcggtaataaaggttcccgtaaagcagactgttaagaaggattcaactgtatgaattcagaacttttcagctggggaacgagagtaccagtgagtacagctttacgaggtaagtctgatcttgaactttctaaggaaattcaagacagtctatcagaagtaaagtggaatatgtttggccttgaattttttctagtgttagaagcccttttgttccttttcacatgttatcaagtggttaaggcagggcggattctagatgaaattcaggacaagctatcagaagtaaagtggggagagagagtaggaacaaagagaaaatatggtacacaaaataagtatacaggcctttccacgggtcttgaacccgaggaaaagtttaggtcaggtaagaatacctggggagagattagaaggaaggaaaagaaaaaagaaaagaaaaaagatcgattagcggaggtctctaggagatactcgtcactagatgagctcaggaagccagctcttagtagctctgaagcagatgatgaattctcctctgaagaaacagactgggaggaagaagcagctcattatgagaaaaaagggtaccagccaggtaaagtgctagctaatcagttaaggaagccaaaagcggctggcgaaggccagtttgctgattggcctcagggcagtcggcttcaaggtccgccctatgcggagtccccgccctgcgtagtgcgtcagccctgcgcagagaggcagtgcgcagactcattcattcccagagaggaacaaaggaaaatacaacaggcatttccggtctttgaaggagccgagggtgggcgtgtccacgctccggtagaatacttacaaattaaagaaattgccgagtcggtccgtaaatacggaaccaatgctaattttaccttggtgcagttagacaggctcgccggcatggcactaactcctgctgactggcaaacggttgtaaaagccgctctccctagtatgggcaaatatatggaatggagagctctttggcatga	1349	110	8%	144	11%
2	41212951	41213550	cgcggctgtcccgaggcttgagtgagggtctcccttcgggggtctttcatttgggggctcgtccgggatcagcgcgaccacccagagaccctagacccactttaaggtaagattctttgacctgtcttggtctggtgtctgtgttctgtttctaagtttggtgcgatcgcagtttcggttttgcggacgctcagtgagaccgcgctccgagagggaacgcggggtggataaggatagacgtgtccaggtgtccaccgtccgttcgccctgggagacgtcccaggaggaacaggggaggaccagggatgcctggtggacccctttggaggccaagagaccatctggggttgcgagatcgtgggtttgagtcccacctcgtgccctgttgcgagatcgtgagttcgagtcccacctcgtgttttgttgcgagatcgtgggttcgagtcccaccttgcgccttgttgcgagaccgtgggttcgagtcccacctcgtgtttggttacgggatcgtgggttcgagtcccacctcgtgcagagggtctcaatcggccggccttagaaaggccatctgattctttgagttgcttgtggtcgacgcg	599	94	16%	44	7%
2	43261501	43261650	gagctttattgcttacatctttaggagcaagaagcaagagccagagcaagagagcaaaagggcgaaaccccgtcccctttaaggagaattattctccgcctaggacgtattactccctgattggctgcagcccatcggcccagttatca	149	10	7%	20	13%
2	44935951	44936400	gggctggtgatgattgctttcttatacccattttgccctcagcttcctgataaaagttattagaaattactgatgagACAGGCGCcggcgggagccttcttggctccgggactccgcggagggcaggctgcacgggagaccatgtggaatacacaggccagctgtttctgggacgggcgagagtcgcagagcttctggggcggcgccatcttcgtctccagacaaccggccaccttcctggcgagagccacagagcttctgaggcggcaccatcttcagctccagacagccggccaccttcctggtgagagcacgggtctctgcccggcctgagaggtttgtgtcacaggcgccggcgggagccttcttggctccgggacaccgcggagggcaggctgcacggatgaccgtgtggaatacagaggccagccgtttctggtacgggcgag	449	60	13%	60	13%
2	46387201	46387650	caaaagtccaatctctctgctctggagtcaaagcagctgcgtttgttcgggcctgtgcttgtgcagcctcatgccaaagcgctctccattccatatatttgcccatactagggagagcggcttttacaatcgtttgccagtcggcaggagttagtgccatgccggcaagcctgtctaactgcaccaaggtaaaattagcattggttccgtatttacggaccgactcggcaagttctttaatctgcacgtattctaccggagcgtggacacgcccaccctcggctccttcaaagaccggaaatgcctgttgtattttcctttgttcctctctgggaatgaatgagtctgcgcattgcctctctgcgcattgtctctctgcgcattgtctctctgcgcattgtctctctgcgcagggctgacacactacgcagggcgggggctccgcatag	449	50	11%	64	14%
2	50680801	50681100	agagaggcagtgcgcagactcattcattcccagagaggaacaaaggaaaatacaacaggcatttccggtctttgaaggagccgagggtgggcgtgtccacgctccggtagaatacttacaaattaaagaaattgccgagtcggtccgtaaatacggaaccaatgctaattttaccttggtgcagttagacaggcttgccggcatggcactaactcctgccgactggcaaacggttgtaaaagccgctctccctagtatgggcaaatatatggaatggagagcgctttggcacgaagctg	299	32	11%	38	13%
2	58674751	58675050	cagaactgcgggtcacggtcataagtgttcccgtaaaacagactgttgagaaagattcaactgcgtgaattcagaactcttcagctggaaaatggtggtaataaagtgttcccacaaaacagactgttgagaaagattcaactgcgtaaattcaaaactcttcagctggggaacagggtacccgtaaatatagctttacaaggtaagtctggtcttgaactttctaacgaaattcaagacagtctatcagaagtaaagtggggaatagctttacaaggtacgcctggtcttgaactttc	299	16	5%	38	13%
2	63301351	63302700	ggagttagtgccatgccagcgagcctgtctaactgcaccaaggtaaaattagcattggttccgtatttacggaccgactcggcaagctctttaatttgtaagtattctaccggagcgtggacacgcccaccctcggctccttcaaagaccggaaatgcctgttgtattttcctttgttcctctctgggaatgaatgagtctgcgcactgcctctctgcgcagggctgacgcactacgcagggcggggactccgcatagggcggaccttgaagccgactgccctgaggccaatcagcaaactggccttcgccagccgcttttggcttccttaactgattagctagcactttacctggctggtacccttttttctcataatgagctgcttcttcctcccagtctgtttcttcagaggagaattcttcatctgcttcagagctactaagagctggctccccgagcccatccagcgatgagcacaggctccttttcctagagaactccgctaattgatctttcttcttttccctttttcctctttttcttctaatctctctccaggtattcccacctaaccttaacttttcctcgggttcaagacccttggaaaggcctgtatacttattttgtgtaccatatttcctctttgttcctactttctctccccgctttacttctgatagcttgtcctgaatttcctctagaattttcagccctatcttaatcacttgataacatgtgaaaaggaacaaaagggctcctaacaccagaaaaaattcaaggccaaacatattccactttacttctgatagactgtcttgaatttccttagaaagttcaagatcagacttacctcgtaaagctgtactcactggtactctcgttccccagctgaaaagttctgaattcatacagttgaatccttcttaacagtctgctttacgggaacctttattaccgcgacccgcagttctggttctggaatgagggatcttccttgcgccagtcccgagttttttctcgtcccggaattcggcaccaattgttattagacgcgttctcacgaccggccaggaaagacgcaacagaccagaatcttctgcggcaaagctttattgcttacatcttcaggagcaagagtgtaagaagcaagagagcaagaagcaagagagagagaaaacgaaaccccgtccctttttaaggagaattctccttcgcctcggacgtgtcactccttgattggctgcagcccatcggccgagttgacgtcacggggaaagcagagtacaagtagtcataagatacccttggcacatgcgcagattatttgtttaccacttagaacacag	1349	104	8%	156	12%
2	66846151	66846450	aagccaaaagcggctggcgaaagccagcgtactgttcaacctccgggcagtcggtttcaaggtccgccctatgcggagcccccgccctgcgtagtgcgtcagcaatgcgcagagagacaatgcgcagagaggcaatgcgcagagaggcagtgcgcagagaggcaatgcgcagagaggcagtgcgcagagaggcagtgcgcagagaggcagtgcgcagactcattcattcccagagaggaacaaaggaaaatacaacaggcatttccagtctttgaaggagccgagggtgggcgtgtcca	299	40	13%	62	21%
2	70884001	70884450	tcctgaatttcctctagaatccgccctgccttaaccacttgataacatgtgaaaaggaacaaaagggcttttaacactagaaaaagttcaaggccaaacataccttataaagctattttccactttacttctgatagactgtcttgaatttccttagaaagttcaagatcagacttacctcgtaaagctgtactcactggtactctcgttccccagctgaaaagttctgaattcatacagttgaatccttcttaacagtctgctttacgggaacctttattaccgcgacccgcagttctggttctggaatgagggatcttccttgcgccagtcccgagttttttctcgtattttttcgtcccggattttttctcgtcccgtcccgggtttcggcaccaattgttattagacgcgttctcacgcccggccaggaagaacacagcaaacca	449	40	9%	50	11%
2	71947801	71947950	tcgtttgccagtcggcaggagttagtgccatgccggcaagcctgtctaactgcaccaaggtaaaattagcattggttccgtatttacggaccgactcggcaagttctttaatctgcacgtattctaccggagcgtggacacgcccaccc	149	22	15%	22	15%
2	73747951	73748250	gggagtgatacgtcctaggcgaaggataactctcctaaatagggacggggtttcgctttcgttttttgggtttgagttttgcactcttgctcctgaagatgtaagcaataaagttttgccgcagaagattctggtttgttgtgtctttcctggccggtcgtgagaacacgtgtaaGAGttggtgccgagaacccgggacgagaaaatccgggacgagaaaatccgggaagaaaaaacccgggacaagaaaactcgggacgggagttaaccatcaccggcgcaaggaagattcctcattc	299	40	13%	18	6%
2	73748851	73749150	tgcgagctaattggtcaagaaaaaagccaaaagcggctggcgaaagccagtttactgcttggcctccgggcagtcggcttcaaggtgcacttccgccctatgcggagcccccaccctgcgtagtgcgtcagccctgcgcagagagacaatgcgcagagagacaatgcgcagagaggcaatgcgcagactcattcattcccagagaggaacaaaggaaaatacaacaggcatttccggtctttgaaggagccgagggtgggcgtgtccacgctccggtagaatatgtgcagattaaagag	299	36	12%	48	16%
2	80732251	80732850	ctcctgatacttggctaggtttccagtactaggaataatgttcctcttgttaaatgagtcttaaatctgattagagagatattggttactactgttgggagccgcccccacattcgccgtcacaagatggcgctgacatcctgtgttctaagtggtaaacaaataatctgcgcatgtgccaagggtattttaccactacttgtactctgcctttcccgtgacgtcagctcggccatgggctgcagccaatcagggagtgatgcgtcctaagcgaaggataactcctccttaaaggggacggggtttccgccattctctctctggctctggcgcctgctcgcttgctcctaaagatgtaaacaatagagcgcgctctgcgctttggcgcgccggagctctggctcctaaagatgtaagaagggggtggctttcgcttttggggctgggggtttgcgctcctggctcctgaagatgtaagcaataaagttttgccacagaagattttggtttgttgtgttcttcctggccgggcgcgagaacgcgtataagatactaccaagctatgggtaccactattgcacccttagggatatcatggc	599	54	9%	48	8%
2	80814901	80815350	gcaaggtagcccggggctcgagtctcgagtcgagcggaagggacttgtgccccagatcaggcccgggtagcctgcttccctatgtaccgcagtctcaagttctgcgcgattggattggggcaggcactgtggtccactcaccagaggtcttagggtcccgtggggagtcccgtgtggacccttgcgggtgttgggcaagactctgctggcaaggtagcccggggctcgagtctcgagtcgagcggaagggacttgtgccccagatcaggcccgggtagcctgcttccctatgtaccgcagtctcaagttctgcgcgattggattggggcaggcactgtggtccactcaccagaggtcttagggtcccgtggggagtcccgtgtggacccttgcgggtgttgggcaagactctgctggcaaggtagcccggggctcgagtctcgagtcga	449	56	12%	46	10%
2	81460351	81462150	tgacatcctgtgttctaagtggtaaacaaataatctgcgcatgtgccaagggtattttacgactacttgtactctgcctttcccgtgaacgtcagctcggccatgggctgcagccaatcagggagtgatgcgtcctaagcgaaggataactcctccttaaaggggacggggttttccgccattctctctcttacttgcgctcttcgctctggctctggcgcctgctcgcttgctcctaaagatgtaaacaatagagcgcgctctgcgctttggcgcgccggagctctggctcctaaagatgtaagataggggtggctttcgcttttggggctgggggtttgcgctcctagctcctgaagatgtaagaaataaagttttgccgcagaagattctggtctgttgtgttcttcctggccgggcgtgagaacgctattaagaattggtgctgaaatccgggacgagaaaaaatccgggacgaaaaaatacaagaaaactcgggaccggcgcaaggaagatccctcattccagaaccagaactgcgggtcgcggtaataaaggttcccgtaaagcagactgttaagaaggattcaactgcatgaattcagaacttttcagctggggaacgagagtaccagtgagtacagctttacgaggtacgcctggccttgaactttctaaggaaattcaagacagtctatcagaagtaaagtggaaaatgtttggccttgaattttttctagtgttagaagcccttttgttccttttcacatgttatcaagtggttaaggcagggcggattctagatgaaattcaggacaatctatcagaagtaaagcggggagagagagtaggagcaaagagaaaatatggtacacaaaataagtatacaggcctttccaagggtcttgaacccgaggaaaagtttaggtcaggtaagaatacctggagagagattagaaggaaggaaaagaaaaaagaaaagaaaaaagatcgattagcggaggtctctaggagatactcgtcactagatgagctcaggaagccagctcttagtagctctgaagcagatgaagaattctcctctgaggaaacagactgggaggaagaagcagcccattaccagccagctaattggtcaagaaaaaagccaaaagcggctggcgaaagccagcgtactgttcaacctccgggcagtcggtttcaaggtccgccctatgcggagcccccgccctgcgtagtgcgtcagcaatgcgcagagaggcaatgcgcagagaggcagtgcgcagagaggcagtgcgcagagaggcagtgcgcagagaggcagtgcgcagagaggcagtgcgcagagaggcagtgcgcagactcattcattcccagagaggaacaaaggaaaatacaacaggcatttccggtctttgaaggagccgagggtgggcgtgtccacgctccggtagaatacgtacagattaaagaactcgccgagtcggtccgtaaatacggaaccaatgctaattttaccttggtgcagttagacaggctcgccggcatggcactaactcctgctgactggcaaacgattgtaaaagccgctctccctagtatgggcaaatatatggaatggagagcgctttggcacgaagctgcacaagcgcaggcccgagcaaacgcagctgctttgactccagagcagagagattggacttttgacttgttaacgggtcagggagcttattctgctgatcagacaaactaccattggggagcttatgcccaaatttcctccacggctattagggcct	1799	170	9%	204	11%
2	81460351	81462150	tgacatcctgtgttctaagtggtaaacaaataatctgcgcatgtgccaagggtattttacgactacttgtactctgcctttcccgtgaacgtcagctcggccatgggctgcagccaatcagggagtgatgcgtcctaagcgaaggataactcctccttaaaggggacggggttttccgccattctctctcttacttgcgctcttcgctctggctctggcgcctgctcgcttgctcctaaagatgtaaacaatagagcgcgctctgcgctttggcgcgccggagctctggctcctaaagatgtaagataggggtggctttcgcttttggggctgggggtttgcgctcctagctcctgaagatgtaagaaataaagttttgccgcagaagattctggtctgttgtgttcttcctggccgggcgtgagaacgctattaagaattggtgctgaaatccgggacgagaaaaaatccgggacgaaaaaatacaagaaaactcgggaccggcgcaaggaagatccctcattccagaaccagaactgcgggtcgcggtaataaaggttcccgtaaagcagactgttaagaaggattcaactgcatgaattcagaacttttcagctggggaacgagagtaccagtgagtacagctttacgaggtacgcctggccttgaactttctaaggaaattcaagacagtctatcagaagtaaagtggaaaatgtttggccttgaattttttctagtgttagaagcccttttgttccttttcacatgttatcaagtggttaaggcagggcggattctagatgaaattcaggacaatctatcagaagtaaagcggggagagagagtaggagcaaagagaaaatatggtacacaaaataagtatacaggcctttccaagggtcttgaacccgaggaaaagtttaggtcaggtaagaatacctggagagagattagaaggaaggaaaagaaaaaagaaaagaaaaaagatcgattagcggaggtctctaggagatactcgtcactagatgagctcaggaagccagctcttagtagctctgaagcagatgaagaattctcctctgaggaaacagactgggaggaagaagcagcccattaccagccagctaattggtcaagaaaaaagccaaaagcggctggcgaaagccagcgtactgttcaacctccgggcagtcggtttcaaggtccgccctatgcggagcccccgccctgcgtagtgcgtcagcaatgcgcagagaggcaatgcgcagagaggcagtgcgcagagaggcagtgcgcagagaggcagtgcgcagagaggcagtgcgcagagaggcagtgcgcagagaggcagtgcgcagactcattcattcccagagaggaacaaaggaaaatacaacaggcatttccggtctttgaaggagccgagggtgggcgtgtccacgctccggtagaatacgtacagattaaagaactcgccgagtcggtccgtaaatacggaaccaatgctaattttaccttggtgcagttagacaggctcgccggcatggcactaactcctgctgactggcaaacgattgtaaaagccgctctccctagtatgggcaaatatatggaatggagagcgctttggcacgaagctgcacaagcgcaggcccgagcaaacgcagctgctttgactccagagcagagagattggacttttgacttgttaacgggtcagggagcttattctgctgatcagacaaactaccattggggagcttatgcccaaatttcctccacggctattagggcct	1799	170	9%	204	11%
2	81794401	81794550	ttcgcaagcctttccacttgtgctatagtgaaattagcactgactccatagttacggaccgactcggcaagctctttaatctgtatatacgctaccggagcgtggacacgcccaccctcggctccttcaaagaccggaaatgcctgttg	149	20	13%	16	11%
2	83972251	83972550	GCTGTAGGATATAGACATGAAAATAAAACACAGATAAATTAATTGACACGTACGTTTGAAGAATGAATGACAGACTTCCGGTATGATGGCGGCGCGGTGGAGCTTTAGGTAATTACGGAACTCTGAAGACTTGGGATAGACTAGGAGCCAGAGTGGGGGCGGCGGGTTGCTAGGTCGCGTGGAGAGGGCAGGGACTTGCGAGGGGCGCTTGCCCGGTGGGTCTTGCTTTTCTCACGTGGCTGCGCCGTCTCCACCGACGGCCTGCGAGGTGTGGTGTGAGCCGGCTGGGCCTAGCGCCA	299	44	15%	20	7%
2	84565951	84566400	agctcttagtagctctgaagcagatgaagaattctcctctgaagaaacagactgggaggaagaagcagctcattatgagaaaaaagggtaccagccaggtaaagtgctagctaatcagttaaggaagccaaaagcggctggcgaaggccagtttgctgattggcctcagggcagtcggcttcaaggtccgccctatgcggagcccccgccctgcgtagtgcgtcagcaatgcgcagagagatgcgcagagaggcagtgcgcagactcattcattcccagagaggaacaaaggaaaatacaacaggcatttccggtctttgaaggagccgagggtgggcgtgtccacgctccggtagaatacttacaaattaaagaaattgccgagtcggtccgtaaatacggaaccaatgctaattttaccttggtgcagttagacaggctcgccggca	449	44	10%	62	14%
2	84898951	84899850	ccccagagctctggtctgtgttctatgtgctttcttgctgttgtactattaaatcttgccttctacattttgagtatggtctcagtgtcttcttgggtacgcggctgtcccgaggcctgagtgagggtctcccttcgggggtctttcaTTTTGGTGCATTGGCCGGGAACAagcgtgaccacccagaggtcctagacccacttagaggtaagattctttgttctgttttggtctgatgtttgtgttctgtttctaagtttggtgcgatcgcagtttcggttttgcggacgctcagtgagaccgcgctccgagagggaacgcggggtggataaggatagacgtgtccaggtgtccaccgtccgttcgccctgggagacgtcccaggaggaacaggggagaaccagggacgcctggtggacccctttggaggccaagagaccatttggggttgcgagatcgtgggtttgagtcccacctcgtgcccggttgcgagatcgtgggttcgagtcccacctcgcgttttgttgcgagatcgtgggtttgagtcccacctcgcgccttgttgcgagaccgtgggttcgagtcccacctcgcgtttggtcacgggatcgtgggttcgagtcccacctcgtgcagagggtctcaatcggccggccttagagaggccatctgattctttgagttgcttgtggtcgacgcagagtcgccgccgtttctggtttcttttttgtcttagtctcgtgtctgctcttgttatgactactgtttttctagaaatgggacaatctgtgtccactcccctttctctgactctggagcattggaaggaggtgcgggtcagagcccacaaccagtcggtggaggtcagaaagggtccgtggcagaccttttgcgcctcc	899	112	12%	74	8%
2	87595801	87596400	aaagttcaaggccaaacataccttgtaaagctatttcccactttacttctgatagactgtcttgaatttcattagaaagttcaagaccagacttaccttgtaaagctatacttacgggtaccctgttccccagctgaagagttctgaattcacgcagttgaatccttctcaacagtctgttttacgggaacacttcattaccaccgttccccagctgaagagttctgaattcacgcagttgaatccttctcaacagtctgttttacgggaacacttcattaccaccattccccagctgaggagttctgaatccacaccggatccttctcaacagtctgttttacgggaacctttatgaccgtgacccgcagttctggttccggaatgaggaatcttccttgcgccggtgatggttaactcccgtcccgagttttcttgtcccgggtttccggcaccaaCtcttacacgcgttcgctaccggccaggaagaacgcaacaaaccggaatcttctgcggcaaaactttattgcttacatcttcaggagcaagagagcaagagagcaagagcaagaaaaagaacaagaacaagaaaagcaaga	599	48	8%	92	15%
2	87934351	87935550	tcggccgatgggctgcagccaatcagggagtgacacgtcctaggcgaaggagaattctccttaatagggacggggtttcgttttctctctctcttgcttcttacactcttgctcctgaagatgtaagcaataaagttttgccgcagaagattctggtctgtggtgttcttcctggccgggcgtgagaacgcgtctaataacaattggtgccgaattccgggacgagaaaaaactcgggactggcgcaaggaagatccctcattccagaaccagaactgcgggtcgcggtaataaaggttcccgtaaagcagactgttaagaaggattcaactgcatgaattcagaacttttcagctggggaacgagagtaccagtgagtatagctttacgaggtaagcctggccttgaactttctaaggaaattcaagacagtctatcagaagtaaagtggaatatgtttggccttgaattttttctggtgttaggagcccttttgttccttttcacatgttatcaagtgattaagatagggctgaaaattctagaggaaattcaggacaagctatcagaagtaaagtggggagagagagtaggaacaaagaggaaatatggtacacaaaataagtatacaggcctttccaagggtcttgaacccgaggaaaagttaaggttaggtaggaatacctggagagagattagaagaaaaagaggaaaaagggaaaagaagaaagatcaattagcggaggtctctaggaaaaggagcctgtgctcatcgctggatgggctcggggagccagctcttggtagctctgaatcagatgatgaattctcctctgaagaaacagactgggaggaagaagcagctcattatgagaaaaaagggtaccagccaggtaaagtgctagctaatcagttaaggaagccaaaagcggctggcgaaggccagtttgctgattggcctcagggcagtcggcttcaaggtccgccctatgcggagtccctgccctgcgtagtgcgtcagccctgcgcagagaggcaatgcgcagagaggcagtgcgcagactcattcattcccagagaggaacaaaggaaaatacaacaggcatttccggtctttgaaggagccgagggtgggcgtgtccacgctccggtagaatacttacaaattaaagagcttgccgagtcggtccgtaaatacg	1199	90	8%	124	10%
2	89264551	89265150	cctcatccaatacaagatcaggtctctactgttgggagccgcccccacattcgccgtcacaagatggcgctgacatcctgtgttctaagtggtaaacaaataatctgcgcatgtgccaagggtattttatgactacttgtactctacctttcccgtaaacgtcagctcggccatgggctgcagccaatcagggagtgatgcgtcctaggcgaaatataactctcctaaaaaaggggacggggtttccgccattctctctcgctggcatctctctggctctgcgcgccctgcgctcgctcgctgcctaaagatgtaaacaatagagcgcgctctgcgccccggcgcgccggagctctggctcctaaagatgtagatagaaggggctttcgtttttggggctgggcgctgggcgcttgccctcctggctcccaaagatgtaagcaataaagttttgccgcagaagattctggtctgttgcgtctttcctggccgggcgtgagaacgctattaagaattggtgccgaaacccgggacgagaaattccgggacgagaaaaaatccgggaagaaaaaacccgggaggaaactcgggacgggagt	599	84	14%	46	8%
2	89268601	89269050	gtcaaagctgctgtgagttcttgccagttcctcatgtgggaattaacccacgcggtattcgacctctacaggtctggcaaatggatgttacacatgtttcttcctttggaaaacttcaatatctccatgtgtccattgacacatgttctggcatcatgtttgcttctccgttaaccggagaaaaagcctcacatgtgattcaacattgtcttgaggcatggagtgcttgggggaaacccaaactccttaagactgataatggaccagcttatacgtctcaaaaattccagcagttctgccgtcagatggacgtaacccacctgactggacttccatacaaccctcaaggacagggtattgttgagcgtgcgcatcgcaccctcaaagcctatcttataaaacagaagaggggaacttttgaagagattttaccccgagcaccaagagtg	449	24	5%	74	16%
2	91664401	91664700	ccatacatacagacacatagagacacacaccacatttatacacaccatctcagacacatacacatacaccacaaagacacacaggcatataccacacatatacagacacacacacacacacacttacactcacacaaagacacataccgtatacatcacacacacagacacacatcatacacacatagatacacgtctcatacacacaccatcctattccctacctccctactactactactactacacacacacacatactgatacacacttaccacacacatcacacacagacatac	299	4	1%	158	53%
2	92938801	92938950	cacggggaaggcagagcacatggggtggaaaactacccttggcacatgcgcagattatttgtttaccacttagaacacaggatgtcagcgccatcttgtaacggcgaatgtgagggcggctccccacaATATTAATATCAGAGAAACAG	149	12	8%	32	21%
2	93831301	93831600	agatcagacttacctcgtaaagctgtactcactggtactctcgttccccagctgaaaagttctgaattcatacagttgaatccttcttaacagtctgctttacgggaacctttattaccgcgacccgcagttctggttctggaatgagggatcttccttgtgccagtcccgagttttttctcgtcccggaattcggcaccaattgttattagacgcgttctcacgaccggccaggaagaacaccacagaccagaatcttctgcggcaaagctttatttcttacatcttcaggagcaagc	299	30	10%	40	13%
2	94606201	94607550	tttacaaccgtttgccagtcagcaggagttagtgccatgccagcgagcctgtctaactgcaccaaggtaaaattagcattggttccgtatttacgaaccgactcggcaatttctttaatttgtaagtattctaccggagcgtggacacgcccaccctcggctccttcaaagaccggaaatgcctgttgtattttcctttgttcctctctgggaatgaatgagtctgcgcactgcctctctgcgcactgcctctctgcgcatctctctgcgcattgctgacgcactacgcagggcggggactccgcatagggcggaccttgaagccgactgccctgaggccaatcagcaaactggccttcgccagccgcttttggcttttttcttgaccaattagctggctggtacccttttttctcataatgagctgcttcttcctcccagtctgtttcctcagaggaggattcttcacctgcttcagagctactaagagctggctccccgagcccatccagcgatgagcacaggctccttttcctagagacctccgctaattgatctttcttcttttccctttttcctctttttcttctaatctctctccaggtattcctacctaaccttaacttttcctcgggttcaagacccttggaaaggcctgtatacttattttgtgtaccatatttcctctttgttcctactctctctccccgctttacttctgatagcttgtcctgaatttcctctagaattttcagccctatcttaatcacttgataacatgtgaaaaggaacaaaagggctcctaacaccagaaaaaattcaaggccaaatataccttgtaaagccatttcccactttacttctgatagactgtcttgaatttcgttagaaagttcaagatcagacttacctcgtaaagctgtactcactggtactctcgttccccagctgaaaagttctgaattcatacagttgaatccttcttaacagtctgctttacgggaacctttattaccgcgacccgcagttctggttctggaatgagggatcttccttgcgccagtcccgagttttttctcgtcccggaattcggcaccaattgttattagacgcgttctcacgaccggccaggaagaacaccacagaccagaatcttctgcggcaaagctttatttcttacatcttcaggagcaagcgtgtaagaagcaagagagcaagaagcaagagagcaagaagcaagagagcaagaagcaagagagagagagaacgaaaccccgtccctattttaggagagttatccctcgcctaggacgtgtcactccctgattggctgcagcccatcggccgag	1349	104	8%	156	12%
2	94801801	94802100	gagtgcccggggtacggaacagtcaggaggacctggctgttgcctggcagagtgaagaagagtgagtgctcttcctgccagaggagtggagcggaatcccactccatcagaggtagcgtttggctggttgtgtaagtccagacgcagacgagtgtgcttggatgtcttagtgttttccgtctctgtcattgtgttgtgtttactcttattcttcactatgggacagaccgtgtctactcctttatctttgactaaggaccattggacggacgttagggctagaggacaaaatttgtcag	299	20	7%	30	10%
2	94802851	94803150	aaccgaggagagagagaggattctcctcgaggctcggaaaaatgtccgagacgaggctgggcgccctgtccaaactccagctgagatagatgaaggatttccgctaacccggccccgatgggattataatacggcatcaggtagggaacgactgtccaattatcgccgggtcctagtggcgggtctcagaggtgctgcccggcagcccacgaatctggccaaggtaagagaggttatgcagggagcgactgagcccccctcagtcttccttgaaaggctcatggaggcttataggagat	299	34	11%	24	8%
2	96191401	96191700	CTGGAACTGGTATTTCTGAGTCTATAATTAAATGTGGCACTTATCTTAATGAGCACGTGCAGTTCTTCTCTCTGTGCACAGCATCTCCAGGAAACTGCAATAGCCTCCCtgttattagacgcgttctcacgcccggccaggaagaacacagcaaaccaaaatcttctgcggcaaaactttattgcttacatcttcaggagcaagagtgtaagaagcaagagagcgagaaaacgaaaccccgtccctattaaggagaattatccttcgcctaggacgtgtcactccctgattggctgcag	299	22	7%	42	14%
2	96197101	96197400	gagcctgtctaactgcaccaaggtaaaattagcattggttccatatttacggaccgactcggcgagttctttaatttgtaagtattctaccggagcgtggacacgcccaccctcggctccttcaaagactggaaatgcctgttgtattttcctttgttcctctctgggaatgaatgagtctgcgcactgcctctctgcgcattgtctctctgcgcagggctgacgcactacgcagggcagggactccgcatagggcggaccttgaagccgactgccctgaggccaatcagcaaactggc	299	32	11%	34	11%
2	96198001	96198600	gaaaagttctgaattcatacagttgaatccttcttaacagtctgctttacgggaacctttattaccgcgacccgcagttctggttctggaatgagggatcttccttgcgccagtcccgagttttttctcgtcccggaattcggcaccaattgttattagacgcgttctcacgcccggccaggaagaacacagcaaaccaaaatcttctgcggcaaaactttattgcttacatcttcaggagcaagagtgtaagaagcaagagagcgagaaaacgaaaccccgtccctattaaggagaattatccttcgcctaggacgtgtcactccctgattggctgcagcccatcggccgagttgacgtcacggggaaggcagagcacatggagtggagaaccaccctcggcacatgcgcagattatttgtttaccacttagaacacagctgtcagcgccatcttgtaacggcgaatgtgggcgcggctcccaacaCCTCCCTATTGCAAAGAGCCCACTGCAGAATCCCCTGCATCCTGCCTTACAATTAGTTTTTTCTAACAATGTGGGTTTTTAAAAAGTGTGTGTTTATCTTCATGATGCAGGG	599	60	10%	88	15%
2	98662051	98664150	GAGTATGTGTAACTTAGAAATAACATCGCTTGCTAATTGAACTTATATGTCTCACACAGACCTTTATATGTGCTGTTATTTTCATTCCTCACAAATCCTGGTTATTTTGGTTCATTCTGTAGATGAGAGCATCCGAATTGGCTTTCCTGGTGTCATTTCTACATAGGGAAAGATAAGCTGCATgtccttcagtgtgcatttctcatttttcacgttttttagtgatttcgtcatttttcaagtcgtcaagtagatgtttctcattttccatgattttcagttttcttgccatattccacgtcctgcactggacatttctaaattttccacctttttcagttttccttgccatatttcacgtcctaaagtgtgtatttctcattttccgtgattttcagttttctcgccatattccaggttcttcagtgtgcatttcacatttttcacgtatcattttccatgtttttcattgtaactcattgatatacactgttctacaaatcccgtttccaacgaatgtgtttttcagtgtaactcactcatctaatacgttctgcagtgtggtttttatcattttcgatgtttttcattgtaactcattgatatacactgttctacaaatcccgtttccaacgaatgtgtttttcattgtaactcactcatctaatatgttctacagtgtggtttttatcattttccatgttttcattgtaagtcattgatatacactattctacaatgccggtttccaacgtatgtgtttttcagtgtaactcggaaaatttagaaatgtccactgtaggacgtggaatatggcaagaaaattgaaaatcatggaaaatgagaaacatcgacttgacgacttgaaaaatgacgaaatcactaaaatacgtgaaaaatgagaaatgcacactgaaggacctgtaatttaactagaaaactGACACATTTTTATTATTTgggatgttaaaaagttatcgtatgtgtgtgtgtgtgtgtgtgtgtgtgtgtgtgtgtgtgtgtgtgtgtatgtgtgtgtgcttccttatgaagctgttttgtttccagtttctgtgaagaattgtgttgaatgtcatggggtttgaattaaatctatagattgcatttgactggatggccatttccacaaaaatctctcatcttctgatatgcttttcaatttctttcttcaatgctttacaggtttattatacaagtctttcactgtcttggttagagttatcccaaaatgtccttttttttgaggttCTGTATATCCTCCCTTCAGAAGGCAGGAGTTACTTGAGAATGCTGAGCTGGGAATGCCAAGATGCAGGAAACTAGCTATAAAGCTTCCAGCAAATTTCCAGAAGGGCATTCTGAGCTGGACCTGGCTTGTACAAAGCCCTGGGGTTCAATCCCCAAGACCACTAACAAATAAAAACAGTACTGAAATATGCAGAGCTACTGAGCGAAAGTCCTATATCCTCTATCAGTTCAAACCTCTCCTCATTTATAATGAAACCACTTTGCCCATCTGTGTAGAAAGCTGTTGCTCTGGGCTTGGGATGTGGCTCAATGGCAGAGTGCcatttctaaattttccacctttttcagttttcctcggcacatttgatttcctaaagtgtgtatttctcattttccgtgattttcagttttctccccatattccaggtcttacagtgtgcacttctatttttcacgtttttgagtgatttcatcattttttcaagtcaagtggatgtttctcattttccatgattttcagttttcttgacatattccatgtcctacagtggacatttctaaatttcccacctttttcagttttcctcgtcatatttcacttcctaaagtgtgtatttctcattttccgtgattttcagttttctcgccatattccaggtcttacagtgtgcatttatcatttttcaggtttttcattgatttcatcatttttctagtcgtcaagtggatatttctcattttccatgattttcagttttcttaccatattccTCAAGGTTTCCGGGGCTAGAGAAAGTTTGCTGGTGGTAGACGAAGCCGACTGCATGGTA	2099	72	3%	314	15%
2	98666101	98667450	cagcttcacaaatgaccctcgggcccctTTTGAACATGTGTCTGGCTATGTCCCAGTTCTTCAAATTTCCCTATATTCATAGAAGCCTTTCCCCAATCTTTCTgtttctcccctttcccagtttctttcttttattttgatatacactgttctacaatgccggtttccaacgaatgtgtttttcagtgtaactcacacatctaatatgttctacagtgtggtttttatcattttccatgtttctcattgtaactcattgatatacactgttctaaaaaatcccgtttccaacgaatgtgtttttcagtgtaactcactcatctaatatgttctacagtgttgtttttatcattttccatgtttctcattgtaactcattgatatacactgttctacaatgccggtttccaacgtatgtgttttttttGTGTGTGTACCTACTTtggaaagaaaactgaaaatcatggaaaatgagaaacatccacttgacgacttgaaaaatgacgaaatcactaaaatacgtgaaaaatgagaaatgcacactgaaggacctggaatatggagagaaaactgaaaatcacggaaaatgagaaatacacactttaggacgtgaaatatggcgaggaaaactgaaaaaggtggaatatttagaaatgtccactgtaggacgtggaatattgcaagaaaactgaaaatcatggaaaatgagaaacatctacttgacgacttgaaaaatgacgaaatcactaaaaaacgtgaaaaatgtgaaatgcacactgaaggacctggaatatggcgagaaacctgaaaatcacggaaaatgagaaatacacactttaggacgtgaaatatggcgaggaaaactgaaaaaggtggaaaatttagaaatgtccactgtaggacgtggagtatggcaagaaaactgaaaatcaaagaaaactgaaaatcatggaaaatgagaaacatccacttgactacttgaaaaatgacgaaatcactaaaaaacgtgaaaaatgagaaatgcacactgaaggacctggaatatggcgagaaaactgaaaatcacggaaaatgagaaatacacactttaggacgtgaaatatggcgaggaaaactgaaaaaggtggaatatttagaaatgtccactgtaggacgtgaaatatggcaagaaaactgaaaatcatggaaaatgagaaacatccacttgacgacttgaaaaatgacgaaatcaTCTGTTTCCAAAGTAGGTACACACACaaaaaaaaTTGTATATAACTTAGTTACATGTTCCTGCACATGTTTGCTGCCATGTATCTTGTGCAccctgccaccaaaattccccttccaat	1349	62	5%	166	12%
2	110497951	110498100	tctggctctggctcttgctcgcttgctcctaaagatgtaaacaatagagctcttgctctgcgctctggcgttctggcgctctggcgctctggctcctaaagatgtaagcggggggcttttcgtttttggggcttggggcttgcgctcct	149	16	11%	2	1%
2	114313351	114313650	ggatattagtcccctatcagatttaggattggtaaagatcctttcctgtggagagccggtacgtgctgcgagcaattgcatgtgtgccgccagtaatctctgaggagagccgtgtgtgccgcgagcaatcgccattataagatggcgcgggcctccgctgtgcctaactagtaaacaagccttgtacgcaggtgcaagagtgaattcactcctagtcactcccattctcggggtgtaatagtggggtgatgggcaagcaacgaatcgggagctgtcacgccatatcaggtgctgaaacg	299	34	11%	34	11%
2	116490001	116490300	cggctggcgaaggccagtttgctgattggcctcagggcagtcggcttcaaggtccgccctatgcggagcccccgccctgcgtagtgcgtcagcaatgcgcagagaggcaatgcgcagagagatgcgcagagaggcagtgcgcagagaggcagtgcgcagagaggcagtgcgcagactcattcattcccagagaggaacaaaggaaaatacaacaggcatttccagtctttgaaggagccgagggtgggcgtgtccacgctccggtagaatacttacaaattaaagaacttgccgagtcg	299	40	13%	52	17%
2	117506701	117507000	agaaagacgcaacaaaccggaatcttccgtggcaaaagctttattgcttacttcttcaggaagaccctgaaccgggaaaatggcgccgcttttataacccgcagcgtgacgtttcagcacctgatatggcgtgacagctcctgattcgttgctcgcccatcaccccactattacaccccgagaatgggagtgactaggagtgagttcactcttgcacctgcgtacaaggcttgtttactagttaggcacagcggaggccagcgccatcttataatggcgattgctcgcggcacggctct	299	40	13%	40	13%
2	125630851	125631300	cgccgtcacaagatggcgctgacatcctgtgttctaagtggtaaacaaataatctgcgcatgtgccaagggtattttccactacatgtactctgcctttactcggccatgggctgcagccaatcagggagtgatgcgtcctaggcgaaggataattctccttaaaaggggacggggtttccgccattctctctcttacttgcgctcttgcgctctctgcgctctggcgctctggcgcgctggcgcgctggcgctctagctcctaaagatgtaagcggggggctttcgtttttggggctgggggcttgcgctcctgctcctgaagatgtaagcaataaagttttgccgcagaagattctggtttgttgtgttcttcctggccggtcgtgagaacgcgtttaagaGttggtgccggaaacccgggaagaaaaactcgggacgggagttaac	449	60	13%	30	7%
2	129521251	129521400	tgtcttgagactgtgtctcctagTtcttacatgcgttcacgcgaccggccaggaaagacgcagcaaaccagaatcttctgcggcaaaactttattgcttacatcttcaggagcaagagtgtaaacccccctttgcttacatctttagga	149	12	8%	22	15%
2	129774601	129774900	caccaattgtcacgcctgctctcgaccagcaagaacgacacgaccaccagtccttctaacagcagtttactcagtcttcatctttcttctttctcttcatcagtaccgttccccagctgaatagttctgaatccacgccagatccttctcaacagtctgttttacgggaacttttattaaccccttcttccccgttatgcagttctgaatcctccctgtagcagggggtcttcactcatgcctgaagatgtttcttttcccgggttttctcgtcctgtcccgggtttcagccccacttg	299	22	7%	50	17%
2	131645551	131645700	gctttattgcttacatcttcaggagccagagagcaagaacaagaacaagaaagcaagagcaagagagagaaaaagaacaagagcaagaaagcaagagcaagagagagaaaaagaatggcaaaaccccgtcccttttaaggagaattatc	149	2	1%	26	17%
2	131647501	131648250	aaagctatacttacgggtaccctgttccccagctgaagagttctgaattcacgcagttgaatccttctcaacagtctgtgttgcgggaacacttcattaccaccgttccccagctgaagagttctgaattcacgcagttgaatccttctcaacagtctgttttacgggaacacttcattaccaccattccccagctgaagagttctgaatccaggatggatccttctcaacagtctgttttacgggaacacttcattaccatgacccgcagttctggttccggaatgagggatcttccttgcgccggtggtggtaaccgtcccaggtcttctcgtcccaggatttctcgtcccaggtcttctcgtcccgggtcttctcgtcccgggtctcagcaccaaCtcttacacacgttcacgcgaccggccaggaaagacgcaacaaaccggaatcttctgcggcaaaagctttattgcttacatcttcaggagccagagagcaagaacaagaacaagaaagcaagagcaagagagagaaaaagaacaagagcaagaaaacaagagcaagagagagaaaaagaatggcaaaaccccgtcccttttaaggagaattatcctccgcctaggacgtattactccctgattggctgcagcccatcggctcagttgtcattacgggaaaggcagaacacatggtgggaaaactgcccctgcacgtgtgcagattatgtttaccacttagaacacagctgt	749	62	8%	126	17%
2	138035551	138035700	caaggttataaggttcccgtaacacagactgttgagaaggattcaactgccgaattcagaactcatcagctggggaacgacggtgataaaggttcccgtaaagcagactgttaagaaggattcaactgtatgaattcagaacttttcag	149	10	7%	22	15%
2	138517201	138517500	gtgaaaccgcgccaattcctcccccagccccactccttttctataaaaacccctagcttccaagcctcgtggtcgaatccactgtctcctgttgtgtgagatacgtttcgacccggagctccgccattaaaaaacctcttgttgttacatcaaggtgttgtgttctattcgcgattcttgggtgcacgccgaatcgggagctgagtgggggtttccccactgagttctttcatttggaggttccaccgagatctgcgtgacacccaggaaccccgaaggaccccttggaggtgcgtttg	299	34	11%	28	9%
2	142202851	142204050	gttagtgccatgccagcgagcctgtctaactgcaccaaggtaaaattagcattggttccgtatttacgaaccgactcggcaatttccttaatttgtaagtattctaccggagcgtggacacgcccaccctcggctccttcaaagaccggaaatgcctgttgtattttcctttgttcctctctgggaatgaatgagtctgcgcactgcctctctgcgcactgcctctctgcgcattgctgacgcactacgcagggcggggactccgcatagggcggaccttgaagccgactgccctgaggccaatcagcaaactggccttcgccagccgcttttggcttttttcttgaccaattagctggctggtaatgggctgcttcttcctcccagtctgtttcctcagaggaggattcttcacctgcttcagagctactaagagctggctccccgagcccatccagcgatgagcacaggctccttttcctagagacctccgctaattgatctttcttcttttccctttttcctctttttcttctaatctctctccaggtattcctacctaaccttaacttttcctcgggttcaagacccttggaaaggcctgtatacttattttgtgcaccatattttctctttgctcctactctctctccccgctttacttctgatagcttgtcctgaatttcatctagaatcctccctatcttaaccacttgataacatgtgaaaaggaacaaaagggcttctaacactagaaaaaattcaaggccaaacattttccactttacttctgatagactgtcttgaatttcgttagaaagttcaagatcagacttacctcgtaaagctgtactcactggtactctcgttccccagctgaaaagttctgaattcatacagttgaatccttcttaacagtctgctttacgggaacctttattactgcgacccgcagttctggttctggaatgagggatcttccttgcgccagtcccgagttttttctcgtcccggaattcggcaccaattgttattagacgcgttctcacgaccggccaggaagaacaccacagaccagaatcttctgcggcaaagctttatttcttacatcttcaggagccagggtgcaggaagcaagagagcaagaagcaagagagcaagaagcaagagagcaagaagcaagagaaggagaaaacgaa	1199	86	7%	140	12%
2	146136001	146136150	ggggcttgcactcttgctcctgaagatgtaagcaataaagttttgccgcagaagattctggtttgttgtgttcttcctggccggtcgtgagaacgcgtgtaaGAGttggtgctgaaacccgggacgagaaaacccgggacgagaaatcc	149	18	12%	6	4%
2	146140051	146140350	cccatgtactctgccttccccgtggcaacaactcggccatgggctgcagccaatcagggagtgatacgtcctaggcgaaggataactctcctaaatagggacggggtttcgctttcgtttttgggcttggggcttgcactcttgctcctgaagatgtaagcaataaagttttgccgcagaagattctggtttgttgtgttcttcctggccggtcgtgagaacgcgtgtaagactttctctttgtcattgatgttcggaagtttgatgcagttgatggtttatgtttattatgttttaag	299	26	9%	24	8%
2	148410601	148411200	actattgttgggagccgcccccacattcgccgttacaagatggcgctgacatcctgtgttctaagtggtaaacaaataatctgcgcatgtgccaagggtatcttatgactacttgtgctctgccttccccgtgacgtcaactcggccgatgggctgcagccaatcagggagtgacacgtccgaggcgaaggagaatgctccttaagagggacggggttttcgttttctctctctcttgcttcttgctctcttttcctgaagatgtaagaataaagctttgccgcagaagattctggtctgtggtgttcttcctggccggtcgtgagaacgcgtcgaataacaattggtgccgaattccgggacgagaaaatccgggacgagaaaaaactccggactggcgcaggagggatacttcatttcagaaccagaactgcggatcacgtttataaaggttcccgtaacacagactgttgagaaggattcaactgccgaattcagaactcatcagctggggaacgacggtgataaaggttcccgtaacacagactgttgagaaggattcaactgccgaattcagaactcatcagctggggaacgac	599	72	12%	62	10%
2	150197701	150198150	acagtctgtgttgcgggaacacttcattaccaccgttccccagctgaggagttctgaatccaggccggatccttctcaacagtctgttttatgggaacctttatgaccgtgacccgcagttctggttccggaatgaggaatcttccttgcgctggtgatggttaactcccgtcccgggttCCAGCACCAACtcttaccgcgcgttcgcgaccggctaggaaagacgcagcaaaccggaatcttctgcggcaaaactttattgcttacatcttcaggagcaagagtgcaagagagcaagagcgctacatcttcaggagccagagcgcaagagcaagagctctattgcttacatctttaggagccagagctcaagagagcaagagagagcaagcgaaaccccgtccctattaaggagaattatccttcgcctaggacgtgtcactccctga	449	48	11%	62	14%
2	150556651	150556950	cagccagtgaggcatctacacatgctttaatattcccttttgattttgactgccccatgataaaaacttactcgtttcttaactgatttacgatcagcccgcctgcagcacggtcaacgaggtcctatctttgcctgagaaaataaagaatagaaagaaaaaaaaagaaagaaaagaaaagactaatctactctggtgtccctgttcgaaggcgccatctgccgcaggccctctggtcccttgtgcctgcgtaggaaagggtctctagagtagatgggcaagataagatgtagtgacag	299	18	6%	28	9%
2	150706051	150706800	AGACACACTCGACCCTTTCTTGTCCTCCACAAGCAGGCAAAAGAATTAGACGATGTTGGAGGGGGAAGCTTCCGCTTCAACAGAACTCGGTCCCTCTGACCGATCCGGAGACGGCCAGGCATCCCTGGCTCTCCTTACCTCCCAGGGCGTCCCCCAGGGCCACAGCCTGTGGTCCTCCTAGCACGTCTGCCGACCACAGTCCTCCGGTCCTTACGGCCCAAAAGGACAGCTGCAAATACAGACGCGCGCATTTCAGAAAACCCCATCACCCCATCGTCTACAAACACCGTCGTCCACTTCTACTTAGACGACCAAAACCAGAGaagcacacttgttcctcactctgccaggtgtaaaaccaaggcacaaggtgggactcgaacccacgatttcgtaaccctgaaaccaaagcacgaggtgggactggaacccacgatctcgcaaccctgaaaccaagacacaaattcaataaactcagatggatccaaactcagactttgccgtgcttcagaaacataggacaagacacaaacaacccaacataACAAGCACATGTTCCAATGTTCGTTTcagaaacagacactcaaaacagatacaccggccggcacacacacaagaggggatccccatacctccaagtcggttctcgggtgtgaggggtggtcgcgtttcccggccaacgcaccaaatgaaagacccacaacgtgaggactcccccacgttctgactcaggagaggcgacaccccaa	749	76	10%	168	22%
2	151179451	151179600	ttgcttcttgctctcttgcttcttacacgcttgctcctgaagatgtaagaaataaagctttgccgcagaagattctggtctgtggtgttcttcctggccggtcgtgagaacgcgtctaataacaattggtgccgaattccgggacgaga	149	18	12%	6	4%
2	152206501	152206950	catgtactctgcctttactcggccatgggctgcagccaatcagggagtgatgcgtcctaggcgaaggataattctccttaaaaggggacggggtttccgccattctctctcttacttgcgcttttgcgctctggcactggcgctctggcgcgctggcgctctggctcctaaagatgtaagcgggggggctttcgtttttggggctgggggcttgcgctcctgctcctgaagatgtaagcaataaagttttgccgcagaagattctggtttgttgtgtctttcctggccggtcgtgaaaacgcgtttaagaGttggtgctgagacccgggacgggacgagaaaatcctgggacaagaaaacctgggacggttaccatcaccggcgcaaggaagatccctcattccggaaccagaactgcgggtcacggtaataaaggttcccgtaaaaca	449	58	13%	34	8%
2	155028451	155028900	cctctctaaggccggccgattgagaccctctgcacgaggtgggactcgaacccacgatcccgtgaccagacgcgaggtgggactcgaacccacggtctcgcaacaaggtgcgaggtgggactcaaacccacgatctcgcaacaaaacgcgaggtgggactcgaacccacgatctcgcaactgggcacgaggtgggactctaacccacgatctcgcaaccccaaatggtctcttggcctttaaaggggtccaccaggcgtccctgatcctcccctgttcctcctgggacgtctcccagggtgaacggacggtggacacctggacacgtctatccttatccaccccgcactccctctcggagcacggtctcactgagcgtccgcaaaactgaaactgcgatcgcaccaaacttagaaacagaacacagacatcagaacacagacatcagac	449	68	15%	74	16%
2	158050651	158051250	tatacatactcgtacattatatatacactcacacatatatggcatatttatatacatactcatacattatatatacactcacacatatacggcatatttatatgcatactcatacattatatatatactcacacatatacggcatatttatatacatactcatacattatacatatactcacacatatacggcatatttatatacatactcatacattatatatatactcacacatatacggcatatttatatacatactcatacattatatatatactcacacatatacggcatatttatatacatactcatacattatatatatactcacacatatacggcatatttatatgcatactcatacattatatatatactcacacatatacggcatatttatatacatactcatacattatacatatatactcacacatatacggcatatttatatacatactcatacattatatatatactcacacatatacggcatatttatatacatactcatacattatatatatactcacacatatacggcatatttatatacatactcatacattatatatacactcacacatatacggcatat	599	24	4%	176	29%
2	158233651	158234250	AATGGACCAGCCTGTGCCAAGAGACAGGGGGATGTGAGCTTTTCCTGCAAGGCATGAAGAGTCAGAAGGGAACGAAAGGGAGCCTCCCGTGAGATCCCCCAAACTGCTGGGTGGTGGTAtgtaggaagccgccctcacattcgccgttgcaagatggcgctgacatcctgtgttctaagtggtaaacaaataatctgcgcatgtgccaagggtagttctccaccccatgtgctctgccttccccgtgacgacaactcggccgatgggctgcagccaatcagggagtaatacgtcctaggcggagaataattctccttaaaaagggacggggtttcgccatttgctctcttgcactcttgctctggctcttgcttcttgctcctaaagatgtaagcaatagagctcttgctcttgctctcttgctctcttgcgctcttgcgctctggctcctaaagatgtaagcaatagagctcttgctctcttgcttcttgctcctgaagatgtaagcaataaagttttgccgcagaagattccggtttgctgcgttcttcctggccggtcgcgagaatgcgtgtaagaGTGGTAGTGTTAGGGAGCAG	599	48	8%	54	9%
2	160636801	160637250	ccaatggtagtttgtctgatcagcagaataagctccctgacccgttaacaaatcaaaagtccaatctctctgctctggagtcaaagcagctgcgtttgctcgggcctgcgcttgtgcagcttcgtgccaaagcgctctctatttcatatatttgcccatactagggagagcggcttttacaaccgtttgccagtcggcaggagttagtgccatgccggcaagcctgtctaactgcaccaaggtaaaattagcattggttccgtatttacggaccgactcggcaatttctttaatttgtaagtattctaccggagcgtggacacgcccaccctcggctccttcaaagactggaaatgcctgttgtattttcctttgttcctctctgggaatgaatgagtctgcgcactgcctctctgcgcactgcctctctgcgcactgcctctctgcgc	449	44	10%	54	12%
2	160637851	160638300	tcactttacttctgatagactgtcttgaatttccttagaaagtttaagatcagacttacctcgtaaagctgtactcactggtactctcgttccccagctgaaaagttctgaattcatacagttgaatccttcttaacagtctgctttacgggaacctttattaccgcgacccgcagttctggttctggaatgagggatcttccttgcgccagtcccgagttttttctcgtcccgggtttcggcaccaattgttattaaacgcgttctcacgaccggccaggaagaacaccacagaccagaatcttctgcggcaaaactttattgcttacatcttcaggagcaagagtgtaagaagcaagagagagagaaaacgaaaccccgtcccttttttaggagagttatatttcgcctaggacgtgtcactccctgattggctgcagcccatcggc	449	42	9%	50	11%
2	164040451	164040900	actcacacatatacacatcacacacacaccacataaatatatacacatcacgtacatacaacacacacatacacatatcatacacatacacacactcacacatacacacatcacacacatatcacatacatatacacacatcacacacacacacatcccacatatgcacactctcacacatgcacacatcacacacatacatacacatgcagcacatatcacacacatcacacacacatgtacacatcacacacatacacacacactcacacatacatcacacacatacacacacacacaccacacacatatacatcacaaatacacacacagagcacacagcacacacacacacatctcacacacacaATGACATCTAgtgtgatgagtttatgtgtgatgtgcgtgtatgtatgtgtagtatgtgtgtgtgatgtgtatatgtgtga	449	4	1%	264	59%
2	165203251	165203400	gttatgtgtgtgtggcatgtgtgtgtatgtgtgtgttatgtgtgtatatgtgtatgtgttatgtgtatacatgtgtgtatgtgtaatgtgGTCTGTACCCACGAAGGGGCTCTCTGAGAGCCAACATCTCTGATGCTCGGCTCCCTGAA	149	4	3%	10	7%
2	165292951	165293100	atgaccagcttacactcatgtgctcacagagtcacaggtgaccggcttacactcatgtgctcacagagtcacacgtgagtgacttacacccatgttctcagagtcacacgtgaccaacttacactcatgtgctcacagagtcacacatg	149	6	4%	52	35%
2	166208101	166208250	acactcatgcacatacacacatactcatcacacacacatgcacacacacatacacacacatgcaaacacacacagtcatgcaatacacacatacttatcacacacacatacatactcacatacgtactcacacacgcaagaaaatatac	149	4	3%	88	59%
2	166534801	166535100	aacgctcctaaaaaaggggacgggtttccgccattctctctcgctggcatctctctggctctgcgcgccctgcgctcgctcgctgcctaaagatgtaaacaatagagcacgctctgcgctttggcgcgccggagctctggctcctaaagatattatagaaggggttttcgcttttggggttggggtttttgcactcctgctcctgaagatgtaagcaataaagttttgccgcagaagattttggtttgttgcgtctttcctggccggtcgcgtgagaacgcgattaagaTGTACCCACT	299	44	15%	16	5%
2	166816051	166816500	agcattgattccatatttaatctgcacatattctaccggagcgtggacacgcccaccctcggctccttcaaagactggaaatgcctgttgtattttcctttgttcctctcggggaatgaatgagtctgcgcactgcctctctgcgcattgctgacgcactacgggctgacgcactacgcagggcggggactccgcatagggcgggagtgcacctggtagccgattgccctgaggccaattagcaaactggccttcgccagccgcttttggctttttccttaaatgactagttagcactttacttggcggctggtatccttttctttcataatgagccgcttttttctcccagtctgtttcctcagaggaggattcttcacttgcttcagagttactaagagctggcttcctgagctcatctagtgacgagtatctcctagagacctccg	449	42	9%	48	11%
2	167106151	167106600	TAAAGAACTTCCATTTCTTGGGCGAGGACAGGAACCTCAGCAAGTACTCCATGGTGAACCACGCGATGCACACAGCCTCCACGTGTGCCAGCTGCGGGTTGTCCGTGCTCTGGCCGAATTCGTCCAGGCTCTGTAGCTCAGGCAGTGTGTTGAGTGACAGGGCAATGGTGGAGAGGACAATGAACATGATGGAGATGATGGCCAGGATCTGCGGGGAGAAGAGAGAGCTCGGTCAGCACCCAGCACATCACAGCATGGCTCTCACACAAAGAGGGCTCGGTCAGCACCCAGCAGGGCGTGGCCCTCACACACGGTCATCGCAGCTTTCACACACGTTCTCACCAGAGACTTCACGGCTGACCGAGTTACAGAGGGAACGTGTTTAAGCCTGTTTATGACTTAGATGTGAAAACCCGAAGCTAGAAAATGAAAACAATCTCAAGCTTGTC	449	38	8%	96	21%
2	167282851	167283300	gtgctctgccttccccgtgacgtcaactcggccgatgggctacagccaatcagggagtgacacgtcctaggcaaaggataattctccttaatagggacggggtttcgttttctctctctcttgcttcttacactcttgctcctgaagatgtaagcaataaagttttgccgcagaagattctggtttgctgtgttcttcctggccgggcgtgagaacgcgttaataacaattggtgccgaaacccgggacgagagtttaccatcaccggtgcaagaaagatccctcattccagaaccagaactgcgggtcgcggtaataaaggttcccgtaaagcagactgttaagaaggattcaactgtatgaattcagaacttttcagctggggaacgagagtaccagtgagtacagctttacgaggtaagtctggtcttaaactttctaaggaaatt	449	44	10%	44	10%
2	167990551	167990850	cacccatgaacacacagcacacacttgcatacatatacacacagtgcacacatatacacagcacacacagacacacacagcacacaccacatacacaccacacacagcacacacgcatacacacacagcacacacacatacacacacagcacacatatacacacacagcacacacatacacatatacacagcacagacacacatagcacacaccacatacacaccacacacacatacgcatatacacagcacacacagacacacatagcacacaccacacacacatacacacacagcac	299	4	1%	218	73%
2	168619051	168619650	GTGTTCAAAGCCAATCAggcgggtcagacggctccacaggtaaaggagctgcttaagccagggttcagttccttccagaagccactaaaggtgggaagagagagccgactccacaaagtcctcttctgacctacacacacgtgccacagcccacactcccatattacacacgcgtgccacagcccacactcccatattacacacgcgtgccacagcccacactcccatattacacacgcgtgccacagcccacactcccatattacacacgcgtgccacagcccacactcccatattacacacgcgtgccacagcccacactcccatattacacacgcgtgccacagcccacactcccatattacacacgcgtgccacagcccacactcccatattacacacgcgtgccacagcccacactcccatattacacacgcgtgccacagcccacactcccatattacacacgcgtgccacagcccacactcccatattacacacACAAGAATAACAATAACAACAATAATACATTTTTAAACTTTTCAAAGCCAggggctagagagctagctcagtcttctcgcagaggaccaggtttccgt	599	52	9%	204	34%
2	168670951	168671250	gtgtgtgtgtatgcgtatgtattgtgtgtgtgtgtaggtatatgtgtatatatgtgtgtgtatatatgtattgtgtatgtataggtatatgtgtatatgtgtgtgtatgtattatgtgtgtgtataggtacatatgtatatatgtgtgtgtgtatgtattatgtgtgtgtataggtatatgtgtgtgtatgtattatgtgtatatgtgtgtgtgtatgtattatgtgtgtgtataggtatatgtgtatatgtgtgtgtgtatgtattatgtgtgtgtatgggtatacgtgtatatatat	299	4	1%	2	1%
2	170504401	170505000	CACACAGCATGGTGGAAAAGTCCAGAGCTCAGGATGAGGCTCCTctctcactgtctcacacggggatcctctcactgtctcacacggggatcctctctcactgtctcacacggggatcctccactgtctcacacggggatcctccactgtctcacatggagatcctctctcactgtctcacacggggatcctctcactgtctcacacggggatcctccactgtctcacacggggatcctctcactgtctcacacggggatcctctctcactgtctcacacggggatcctccactgtctcacacggggatcctctctcactgtctcacacggggatcctctcactgtctcacacggggatcctctctcactgtctcacacggggatcctccactgtctcacatggagatcctctctcactgtctcacacggggatcctctcactgtctcacacggggatcctccactgtctcacacggggatcctctcactgtctcacacggggatcctctctcacagtctcacacggggatcctccactgtctcacacggggatcctctctcactgtctcacacggggatcctctcactgtctcacacg	599	42	7%	152	25%
2	170650351	170650800	tgcacatacatgtgttcatgtccatcatatacaaaacacacacacaccacacgcagacacatacagacacatgcacgagtgtgttcatacgcaccatatacacagacacacatagagatatgcagacCCCCACACAGGCATATACATAGACACACATGGATACACAgacacatgtgcaaacacacgcatagatacacaccacacatacacacacatatgcactcatacatacacatacataagcacacacagatacacataccacatgcacacacacacacaaaacacatacacaagcacaTGTGCAAATAGAGACATGCACAAGCGcacacacactcacatagatacaccacacgtacacacagacacatatacacacacaGCCTAACCACTGTGCCATAGCCTGACCCCAACCTCAATTTGTTAATCCTTGCCCTTTCTGAAAAAGA	449	12	3%	216	48%
2	172214851	172215150	cacacaagtatacatatatacacgcatatgcatatgcatacacacatgtacatatgcatacacacatacacacacatatacacacacgcatacacacatacacacatatgcatacacacatatgcgtacacatacacacatatacatacacacatatgcatacacatatgcatacacacatgcatacacatacacacatatacatacacatatgcatacacacatacacacacatatacacacacgcatacacacatacacacatatgcatacacacatgcatacacacatatacatac	299	8	3%	172	58%
2	173493151	173493450	aatggtcagccctgagatcatatgcgagtaacatacaaactgagtggttgtgtttatatatttaggagtgtatgcatgcaagtgtgtgtgtacatgcgtgagtgtgtgcatgtgtgtacatgtttgcatatgtatgtgcatgtgtgtgcacgtatgaatatatacatgtgtgagtgtgtacatgtgtgcatgtatgagtatgtgtgagtgtatgtacatgtgtgcatatgtgtgtgcatgtgtgtgtacatgtgtgtacatgtgtacatgtttgagtatgtgagagtgtgtgcatgtgt	299	6	2%	44	15%
2	174731251	174731400	tgtgtctgcacgcatgtggactgtgtgtgtgcacatggatgtacatgcttgtgtctacatgcgtgtggactgtgtgtgcacatggatgtacatgcttatgtctacatgcatgtggactgtgtgtgtgcacatggatgtacatgcttgtg	149	4	3%	28	19%
2	175043251	175043700	aatcgtttgccagtcagcaggagttagtgccatgccggcgagcctgtctaactgcaccaaggtaaaattagcattggttccgtatttacggaccgactcggcaagttctttaatttgtaagtattctaccggagcgtggacacgcccaccctcggctccttcaaagactggaaatgcctgttgtattttcctttgttcctctctgggaatgaatgagtctgcgcactgcctctctgcgcactgcctctctgcgcactgcctctctgcgcatctctctgcgcattgcctctctgcgcatctctctgcgcattgcctctctgcgcatctctctgcgcattgcctctctgcgcatctctctgcgcattgctgacgcactacgcagggcgggggctccgcatagggcggaccttgaaaccgactgccgggaggttgaacagtacgctggcttt	449	60	13%	52	12%
2	175044301	175044750	acagtctgctttacgggaacctttattaccgcgacccgcagttctggttctggaatgagggatctcccttgcgccggtcccgagttttcttgtattttctcgtcccggattttttctcgtcccggaatttctcgtcccggatttcagcaccaattcttaatAgcgttcgcgcgcccgacgaggaagaacacaacaaaccaaaatcttctgcggcaaaactttattgcttacatcttttggagccaggagggcaagcgcccagcgcccagccccaaaaacgaaagccccctcaataacgaaaccgaaaccccttccctatttaggagagttatatttcgcctaggacgcatcactccctgattggctgcagcccatggccgagctgacgttcacgggaaaggcagagtacaagtagtcgtaaaatacccttggcacatgcgcagattatt	449	64	14%	54	12%
2	177251401	177252150	gttgctgctttatttcgaccccagagctctggtctgtgtgctttcatgtcgctgctttattaaatcttgccttctacattttatgtatggtctcagtgtcttcttgggtacgcggctgtcccgggacttgagtgtctgagtgagggtctcccctcgagggtctttcatttggtgcattggccgggaaAcagcgcgaccacccagaggtcctagacccacttagaggtaagattctttgttctgctttggtctgatgtctgtgttctgtttctaagtctggtgcgatcgcagtttcagttttgcggacgctcagtgagaccgcgctccgagagggagtgcggggtggataaggatagacgtgtccaggtgtccaccgtccgttcaccctgggagacgtcccaggaggaacaggggaggatcagggacgcctggtggacccctttgaaggccaagagaccatttggggttgggagatcgtgggttagagtcccacctcgtgcccagttgcgagatcgtgggttcgagtcccacctcgcattttgttgcgagatcgtgggtttgagtcccacctcgcaccttgttgcgagaccgtgggttcgagtcccacctcgcgtctggtcacgggatcgtgggttcgagtcccacctcgtgcagagggtctcaatcggccggccttagagaggccatctgattcttctggtttcttttttgtcttagtctcgtgtccgctcttgttgtgactactgttt	749	88	12%	66	9%
2	177609301	177609600	cttctcaacagtctgtgttacgggaaccttataaccttgattcgcagttctggttctggaatgaagtatccctcctgcgccagtccggagttttttctcgtcccggattttctcgtcccggaattcggCACCAATtgttattcgacgcgttctcacgaccggccaggaagaacaccacagaccagaatcttctgcggcaaagctttattcttacatcttcaggaaaagagagcaagaagcaagagagcgaagcaagagagagaaagaacgaaaacccgtccctcttaaggagcattctc	299	36	12%	38	13%
2	179893051	179893350	tgcacacacagttatgcccatgtgtgcacatatgcacagccgtgcccgtgtgtgcacacacagttatgcccatgtgtgcacatatgcacagccgtgcccgtgtgtgcgcacTCTGCTCACAGCAGCTTATCCCCTCATAGTCATGGTTCTGCTGTTCGTTGTGTGGATGAAGCGGAGAGAAAAGGAGAGGCACACAAAGCAGCTGCTCATCGACCCTGAGGATGACGTGAGGGACAACATCCTGAAGTACGATGAAGAGGGCGGTGGCGAGGAGGACCAAGTGAGCGAGTGTCCCACGG	299	28	9%	66	22%
3	3865351	3865800	acctttcccgtgaacgtcagctcggccatgggctgcagccaatcagggagtgatgcgtcctaggcgaaatttaacgctcctaaaaaaggggacgggtttccgccattctctctcgctggcatctctctggctctgcgcgccctgcgctcgctcgctgcctaaagatgtaaacaatagagcacgctctgcgctttggcgcgccggagctctggctcctaaaaatatagaaggggctttcgtttttggggctgggcgctgggcgcttgccctcctggctcccaaagatgtaagcaataaagttttgccgcagaagattctggtctgttgcgtctttcctggccggtcgtgagaacgcgtctaataagaattggtgctgaaatccgggacgagaaaaaatccgggacgaaaaaatacaagaaaactcgggaccggcacaaggaagatccctc	449	68	15%	30	7%
3	3869251	3869700	gtgccgagggtggttcttcactccatgtgctctacctttcccgtgaacgtcagctcggccatgggctgcagccaatcagggagtgatgcgtcctaggcgaaatttaacgctcctaaaaaaggggacgggtttccgccattctctctcgctggcatctctctggctctgcgcgccctgcgctcgctcgctgcctaaagatgtaaacaatagagcacgctctgcgctttggcgcgccggagctctggctcctaaaaatatagaaggggctttcgtttttggggctgggcgctgggcgcttgccctcctggctcccaaagatgtaagcaataaagttttgccgcagaagattctggtctgttgcgtctttcctggccgggcttgagaacgcgattaagatccaccttacgccagtaagaatggttaaggtaaagaactcaggtgacagtaga	449	58	13%	36	8%
3	4723951	4725450	agcgctctccattccatatatttgcccatactagggagagcggcttttacaaccgtttgccagtcagcaggagttagtgccatgccggcgagcctgtctaactgcaccaaggtaaaattagcattggttccgtatttacggaccgactcggcaatttctttaatttgtaagtattctaccggagcgtggacacgcccaccctcggctccttcaaagactggaaatgcctgttgtattttcctttgttcctctctgggaatgaatgagtctgcgcactgcctctctgcgcactgcctctctgcgcactgcctctctgcgcatctctctgcgcactgcctctctgcgcatctctctgcgcactgcctctctgcgcatctctctgcgcattgcctctctgcgcattgctgacgcactacgcagggcgggggctccgcatagggcggaccttgaaaccgactgccgggaggttgaacagtacgctggctttcgccagccgcttttggcttttttcttgaccaattagctggctggtaatgggctgcttcttcctcccagtctgtttcctcagaggagaattcttcatctgcttcagaactactaagagctggcttcctgagctcatctagtgacgagtatctcctagagacctccgctaatcgatcttttttcttttcttttttcttttccttccttctaatctctccccaggtattcttacctgacctaaacttttcctcgggttcaagacccttggaaaggcctgtatacttattttgtgtaccatattttctctttgctcctactctctctccccgctttacttctgatagattgccctgaatttcatccagaattttcagccctatcttaatcacctgataacatgtgaaaaggaacaaaagggctcctaacattagaaaaaattcaaggccaaacattttccactttacttctgatagactgtcttgaatttccttagaaagttcaagatcagacttacctcgtaaagctgtactcactggtactctcgttccccagctgaaaagttctgaattcatacagttgaatccttcttaacagtctgctttacgggaacctttattaccgcgacccgcagttctggttctggaatgagggatcttccttgcgccagtcccgagtttttttctcgtcccggaattcggcaccaattgttattagacgcgttctcacgaccggccaggaaagacgcaacaaaccagaatcttctgcggcaaaactttattgcttacatctttgggagccaggagggcaagcgcccagcgcccagccccaaaaacgaaagccccttcaataatgaaaccgaaaccccttccctctttaggagagttaaatttcgcctaggacgcatcactccctgattggctgcagcccatggccgagctgacgttcacgggaaaggtagagtacaagtagtcataaaatacccttggctcatgcgcagattatttgtttaccac	1499	130	9%	168	11%
3	5517751	5519250	tgttgggagccgcccccacattcgccgtcacaagatggcgctgacatcctgtgttctaagtggtaaacaaataatctgcgcatgagccaagggtattttatgactacttgtactctacctttcccgtgaacgtcagctcggccatgggctgcagccaatcagggagtgatgcgtcctaggaaatataactctcctaaagagggaaggggtttcggtttcattattgagggggctttcgtttttggggctgggcgctgggcgcttgccctcctggctcccaaagatgtaagcaataaagttttgccgcagaagattttggtttgttgcgtctttcctggccgggcgtgagaacgcgtctaataacaattggtgccgaattccgggacgagaaaaaaactcgggactggcgcaaggaagatccctcattccagaaccagaactgcgggtcgcggtaataaaggttcccgtaaagcagactgttaagaaggattcaactgtatgaattcagaacttttcagctggggaacgagagtaccagtgagtacagctttacgaggtaagtctgatcttgaactttctaaggaaattcaagacagtctatcagaagtaaagtggaaaatgtttggccttgaattttttctaatgttaggagcccttttgttccttttcacatgttatcaggtgattaagatagggctgaaaattctggatgaaattcagggcaatctatcagaagtaaagcggggagagagagtaggagcaaagagaaaatatggtacacaaaataagtatacaggcctttccaagggtcttgaacccgaggaaaagtttaggtcaggtaagaatacctggggagagattagaaggaaggaaaagaaaaaagaaaagaaaaaagatcgattagcggaggtctctaggagatactcgtcactagatgagctcaggaagccagctcttagtagttctgaagcagatgaagaattctcctctgaggaaacagactgggaggaagaagcagcccattaccagccagctaattggtcaagaaaaaagccaaaagcggctggcgaaagccagcgtactgttcaacctcccggcagtcggtttcaaggtccgccctatgcggagcccccgccctgcgtagtgcgtcagcaatgcgcagagagatgcgcagagaggcaatgcgcagagagatgcgcagagaggcagtgcgcagagagatgcgcagagaggcagtgcgcagagaggcagtgcgcagagaggcagtgcgcagactcattcattcccagagaggaacaaaggaaaatacaacaggcatttccagtctttgaaggagccgagggtgggcgtgtccacgctccggtagaatacttacaaattaaagaaattgccgagtcggtccgtaaatacggaaccaatgctaattttaccttggtgcagttagacaggctcgccggcatggcactaactcctgctgactggcaaacggttgtaaaagc	1499	130	9%	180	12%
3	5517751	5519250	tgttgggagccgcccccacattcgccgtcacaagatggcgctgacatcctgtgttctaagtggtaaacaaataatctgcgcatgagccaagggtattttatgactacttgtactctacctttcccgtgaacgtcagctcggccatgggctgcagccaatcagggagtgatgcgtcctaggaaatataactctcctaaagagggaaggggtttcggtttcattattgagggggctttcgtttttggggctgggcgctgggcgcttgccctcctggctcccaaagatgtaagcaataaagttttgccgcagaagattttggtttgttgcgtctttcctggccgggcgtgagaacgcgtctaataacaattggtgccgaattccgggacgagaaaaaaactcgggactggcgcaaggaagatccctcattccagaaccagaactgcgggtcgcggtaataaaggttcccgtaaagcagactgttaagaaggattcaactgtatgaattcagaacttttcagctggggaacgagagtaccagtgagtacagctttacgaggtaagtctgatcttgaactttctaaggaaattcaagacagtctatcagaagtaaagtggaaaatgtttggccttgaattttttctaatgttaggagcccttttgttccttttcacatgttatcaggtgattaagatagggctgaaaattctggatgaaattcagggcaatctatcagaagtaaagcggggagagagagtaggagcaaagagaaaatatggtacacaaaataagtatacaggcctttccaagggtcttgaacccgaggaaaagtttaggtcaggtaagaatacctggggagagattagaaggaaggaaaagaaaaaagaaaagaaaaaagatcgattagcggaggtctctaggagatactcgtcactagatgagctcaggaagccagctcttagtagttctgaagcagatgaagaattctcctctgaggaaacagactgggaggaagaagcagcccattaccagccagctaattggtcaagaaaaaagccaaaagcggctggcgaaagccagcgtactgttcaacctcccggcagtcggtttcaaggtccgccctatgcggagcccccgccctgcgtagtgcgtcagcaatgcgcagagagatgcgcagagaggcaatgcgcagagagatgcgcagagaggcagtgcgcagagagatgcgcagagaggcagtgcgcagagaggcagtgcgcagagaggcagtgcgcagactcattcattcccagagaggaacaaaggaaaatacaacaggcatttccagtctttgaaggagccgagggtgggcgtgtccacgctccggtagaatacttacaaattaaagaaattgccgagtcggtccgtaaatacggaaccaatgctaattttaccttggtgcagttagacaggctcgccggcatggcactaactcctgctgactggcaaacggttgtaaaagc	1499	130	9%	180	12%
3	9091501	9093000	gctgtgttctaagtggtaaacaaataatctgcgcatgtgccaagggtatcttatgactacttgtgctctgccttccccgtgacgtcaactcggccgatgggctgcagccaatcaaggagtgacacgtccgaggcgaaggagaattctccttaaagagggacggggtttcgttttctctctctcttgcttcttgctctcttgcttcttgctctcttgcttcttgcactctgttcctgaagatgtaagaataaagctttgccgcagaagattctggtctgtggtgttcttcctggccggtcgtgagaacgcgtctaataacaattggtgccgaaacccgggaagaaaaacccgggagggagttaaccatcaccggcgcaggagggatacttcatttcagaaccagaactgcggatcacgtttataaaggttcccgtaacacagactgttgagaaggattcaactgccgaattcagaactcatcagctggggaacgacggtgataaaggttcccgtaaagcagactgttaagaaggattcaactgtatgaattcagaacttttcagctggggaacgagagtaccagtgagtacagctttacgaggtaagcctggccttgaactttctaacgaaattcaagacagtctatcagaagtaaagtggaatatgtttggccttgaattttttctggtgttaggagcccttttgttccttttcacatgttatcaagtggttaagatagggaggattctagatgaaattcagggtaatctatcagaagtaaagtggggagagagagtaggaacaaagaggaaatatggtacacaaaataagtatacaggcctttccaagggtcttgaacccgaggaaaagttaaggttaggtaggaatacctggagagagattagaagaaaaagaggaaaaagggaaaagaagaaagatcaattagcggaggtctctaggaaaaggagcctgtgctcatcgctggatgggctcggggagccagctcttagtagctctgaagcaggtgaagaattctcctctgaggaaacagactgggaggaagaagcagcccattaccagccagctaattggtcaagaaaaaagccaaaagcggctggcgaaggccagtttgctgattggcctcagggcagtcggcttcaaggtccgccctatgcggagtccccgccctgcgtagtgcgtcagcaatgcgcagagaggcagtgcgcagagaggcagtgcgcagactcattcattcccagagaggaacaaaggaaaatacaacaggcatttccggtctttgaaggagccgagggtgggcgtgtccacgctccggtagaatacttacaaattaaagaaattgccgagtcggtccgtaaatatggaaccaatgctaattttaccttggtgcagttagacaggcttgccggcatggcactaactcctgccgactggcaaatgattacaaaagccgctctccctaatatgggcaaatatttgga	1499	112	7%	164	11%
3	9501901	9502650	gggacactgtagcacgggtctttccatacctgcccataccttacagacgggacactgtagcacgggcctttccatacctgcccataccttacagacgggacactgtagcacgggcctttccataactgcccataccttacagacaggacactgtagcacgggtctttccatacctgcccataccttacagacgggacactgtagcacgggtctttccataactgcccataccttacagacgggacactgtagcacgggtctttccatacctgcccataccttacagacgggacactgtagcacgggcctttccatacctgcccataccttacagacgggacactgtagcacgggcctttccataactgcccataccttacagacaggacactgtagcacgggtctttccatacctgcccataccttacagacgggacactgtagcacgggcctttccatacctgcccataccttacagacgggacactgtagcacgggcctttccataactgcccataccttacagacaggacactgtagcacgggtctttccatacctgcccataccttacagacgggacactgtagcacgggcctttccatacctgcccataccttacagacgggacactgtagcacgggtctttccatacctgcccatatcttacagacgggacactgtagcgcgggcctttccatacctgcccataccttacagacgggacactAGCACAAAGCCAGTCTCCCTT	749	56	7%	162	22%
3	9731251	9732600	gccaagggtatttttccactacatgtactctgcctttcccatgacgtcaactcggccatgggctgcagccaatcagggagtgatgcgtcctaggcgaaggataactctcctaaatagggacggggtttcgctttcgtttttgggggcctttcgtttttggggcttggggcttgcgctcctgctcctgaagatgtaagcaataaagttttgccgcagaagattctggtttgttgtgttcttcctggccggtcgtgagaacgcgtttaaGAGTTGGTGCTGaaacccgggacgagaaaatacaagaaaactcgggacgggagttaaccatcaccggcgcaaggaagatccctcattccggaaccagaactgcgggtcatggtaacgaaggttcccgtaaaacagactgttgagaaggattcaactgcgtgaattcagaactcttcagctggggaacaggagtaccagtgagtacagctttacaaggtaagtctggtcttgaactttctaaggaaagtcaagacagtctatcagaagtaaagtgggaaatagctttacaaggtatgtttggccttgaactttttctagtgttaggagcccttttgttctttttcacatgttatcaagtgattaagatagggctgaaaattctggatgaaattcaggacaatctatcagaagtaaagcggggagagagagtaggagcaaagagaaaatatggtacacaaactaagtatacaggcctttccaagggtcttgaacccaaggaaaagtttaggtcaggtaagaatacctggggagagattagaaggaaggaaaagaaaaaagaaaagaaaaaagatcaattagcggaggtctctaagagatactcgtcactagatgagctcaggaagccagctcttagtagctctgaagcagatgaagaattctcctctgaagaaacagactgggaggaagaagcagctcattaccagccagataaagtgctagctaatcggtcaagaaaaaagccaaaagcggctggcgaaggccagcatgctgttcagcctccgggcagtcggcttcaaggtccgccctatgcggagcccccgccctgcgtagtgcgtcagccctgcgcagagagacaatgcgcagagagacaatgcgcagagagacaatgcgcagagaggcaatgcgcagactcattcattcccagagaggaacaaaggaaaatacaacaggcatttccggtctttgaaggagccgagggtgggcgtgtccacgctccggtagaatatgtgcagattaaagaacttgccgagtcggtccgtaaatacggaaccaatgctaattttaccttggtgcagttagac	1349	104	8%	162	12%
3	9731251	9732600	gccaagggtatttttccactacatgtactctgcctttcccatgacgtcaactcggccatgggctgcagccaatcagggagtgatgcgtcctaggcgaaggataactctcctaaatagggacggggtttcgctttcgtttttgggggcctttcgtttttggggcttggggcttgcgctcctgctcctgaagatgtaagcaataaagttttgccgcagaagattctggtttgttgtgttcttcctggccggtcgtgagaacgcgtttaaGAGTTGGTGCTGaaacccgggacgagaaaatacaagaaaactcgggacgggagttaaccatcaccggcgcaaggaagatccctcattccggaaccagaactgcgggtcatggtaacgaaggttcccgtaaaacagactgttgagaaggattcaactgcgtgaattcagaactcttcagctggggaacaggagtaccagtgagtacagctttacaaggtaagtctggtcttgaactttctaaggaaagtcaagacagtctatcagaagtaaagtgggaaatagctttacaaggtatgtttggccttgaactttttctagtgttaggagcccttttgttctttttcacatgttatcaagtgattaagatagggctgaaaattctggatgaaattcaggacaatctatcagaagtaaagcggggagagagagtaggagcaaagagaaaatatggtacacaaactaagtatacaggcctttccaagggtcttgaacccaaggaaaagtttaggtcaggtaagaatacctggggagagattagaaggaaggaaaagaaaaaagaaaagaaaaaagatcaattagcggaggtctctaagagatactcgtcactagatgagctcaggaagccagctcttagtagctctgaagcagatgaagaattctcctctgaagaaacagactgggaggaagaagcagctcattaccagccagataaagtgctagctaatcggtcaagaaaaaagccaaaagcggctggcgaaggccagcatgctgttcagcctccgggcagtcggcttcaaggtccgccctatgcggagcccccgccctgcgtagtgcgtcagccctgcgcagagagacaatgcgcagagagacaatgcgcagagagacaatgcgcagagaggcaatgcgcagactcattcattcccagagaggaacaaaggaaaatacaacaggcatttccggtctttgaaggagccgagggtgggcgtgtccacgctccggtagaatatgtgcagattaaagaacttgccgagtcggtccgtaaatacggaaccaatgctaattttaccttggtgcagttagac	1349	104	8%	162	12%
3	10875751	10876200	tcatttgggggctcgtccgggatcagcgcgaccacccagaggtcctagacccacttaaaggtaagattctttgttctgtcttggtctgatgtctgtgttctgtttctaagtttggtgcgatcacagtttcggttttgcggacgctcagtgagaccgcgctccgagagggaacgcggggtggataaggatagacgtgtccaggtgtccaccgtccgtttgccctgggagacgtcccaggaggaacaggggaggaccagggacgcctggtggacccctttggaggccaagagaccatctggggttgcgagatcgtgggttcgagtcccacctcgtgcctggttgcgagatcgtgggttcgagtcccacctcgtgttttgttacgagatcgtgggttcgagtcccacctcgtgcagagggtctcaatcggtcggccttagaaaggccatctg	449	64	14%	42	9%
3	13146001	13146450	tatatacctgtcctcctgttgggagccgccctcacatttgccattataagatggcgctgacagctgtgttctaagtggtaaacataatttgcacacgtgcaggggcagttttcccgccatgtgttctgcctttctcgtgatgacaactgagccgatgggctgcagccaatcagggagtaatacgtcctaggcggaggataattctccttaaaagggacggggttttgccattctttctcttgttttctcattcttgctctctcttgctttcttgttcttgttctttctcttgctttcttgttcttgttctttttcttgctctcttgctctcttgcgctcttgcactcttgctcctgaagatgtaagcaataaagttttgccgcagaagattccggtttgttgcgtctttcctggccggtcgcgtgaacgtgtgtaagatcctccctttc	449	34	8%	38	8%
3	14235001	14235300	tgtttacatctttaggagcaagcgagcaggcgccagagccagagagagaatggcggaaaccccgtcccctttaaggaggagttatccttcgcttaggacgcatcactccctgattggctgcagcccatggccgagctgacgttcacgggaaaggcagagtacaagtagtcgtaaaatacccttggcacatgcgcagattatttgtttaccacttagaacacaggatgtcagcgccatcttgtgacggcgaatgtgggggcggctcccaacatctcccccttttcttttaataagagcaa	299	30	10%	46	15%
3	14240551	14241000	attccatatatttgcccatactagggagagcggcttttacaatcgtttgccagtcagcaggagttagtgccatgccggcgagcctgtctaactgcaccaaggtaaaattagcattggttccgtatttacggaccgactcggcgagttctttaatctgcacgtattctaccggagcgtggacacgcccaccctcggctccttcaaagactggaaatgcctgttgtattttcctttgttcctctctgggaatgaatgagtctgcgcactgcctctctgcgcactgtctctctgcgcactgcctctctgcgcactgcctctctgcgcattgcctctctgcgcattgcctctctgcgcattgctgacgcactacgcagggcgggggctccgcatagggcggaccttgaaaccgactgcccggaggttgaacagtacgctggctttcgccagcc	449	60	13%	52	12%
3	14707201	14707500	aaaagccaaaagcggctggcgaaggccagcatgctgctcagcctccgggcagtcggcttcaaggtcatagtgcacttccgccctatgcggagcccccgccctgcgtagtgcgtcagccctgcgcagagaggcaatgcgcagactcgttcattccaaaggaggaacaaaggaaaatacaacaggcatttccggtctttgaaggagccgagggtgggtgtgtccacactccggtagaatatgtgcagattaaagagcttgccgagtcggtccgtaaatatggaaccaatgctaattttacc	299	36	12%	44	15%
3	14712901	14713200	cgttacaagatggcgctgacatcctgtgttctaagtggtaaacaaataatctgcgcatgtgccaagggtagttttccaccccatgtgctctgccttccccgtgacgacaactcggccgatgggctgcagccaatcagggagtgacacgttctaggcggaggataattctccttaaaagggacggggtttcgccattctctctcttgcactcttgctcctgaagatgtaagcaataaagttttgccgcaaaagattctggtttgctgcgtctttcctggccggtcgcgaacgcgtgtaag	299	36	12%	32	11%
3	16011601	16011750	aacttgtcccaaagccgggaaccttttgttaccttgtgcctgcttcctggcaactttatgcttgcctctattttatccgaggtccttcccaaactcctggggtcccaagtttcactcaccatgaacttaccctgcgggcaaccactgac	149	6	4%	18	12%
3	19917901	19918050	aggagaattctccttcgcctaggacgtgtcactccctgattggctgcagcccatcggccgagttgacgtcacggggaaggcagagcacatggagtggagaaccaccctcggcacatgcgcagattatttgtttaccacttagaacacag	149	16	11%	28	19%
3	21324151	21324600	tgctggcaaggtagcccggggctcgagtcacgagtcgagcggaagggacttgtgccccagatcaggcccgggtagcctgcttccctatgtactgcagtctcaagttccgcgcgattggattggggcaggcactgtgatccactcaccagaggtcttagggtcccgtggggagtcccgtgtggacccttgcgggtgttgggcaagactctgctggcaaggtagcccggggctcgagtctcgagtcgagaggaagggacttgtgccccagatcaggcccgggtagcctgcttccctatgtaccgcagtctcaagttccgtgcgattggattggggcaggcactgtgatccactcaccagaggtcttagggtcccgtggggagtcctgtgtggacccttgcgggtgttgggcaagactctgctggcaaggtagcccggggctcgagtcacga	449	50	11%	50	11%
3	27022951	27023400	aggggagtggacacagattgtcccatttctagaaaaacagtagtcacaacaagagcggacacgagactaagacaaaaaagaaaccagaaacggcggcgactccgcgtcgaccacaagcaactcaaagaatcagatggcctctctaaggccggccgattgagaccctctgcacgaggtgggactcgaacccacgatcccgtgaccaaacgcgaggtgggactcgaacccacggtctcgcaacaaggtgcgaggtgggactcaaacccacgatctcgcaacaaaacgcgaggcgggactcgaacccacgatctcgcaactgggcacgaggtgggactcaaacccacgatctcgcaaccccaaatggtctcttggcctccaaaggggtccaccaggcgtccctggtcctcccctgttccccctgggacgtctcccagggtgaacagacggtg	449	68	15%	74	16%
3	31182901	31183050	ccctgcggcagagagacaatgcgcagagaggcagtgcgcagactcattcattcccagagaggaacaaaggaaaatacaacaggcatttccagtctttgaaggagccgagggtgggcgtgtccacgctccggtagaatacttacaaatta	149	14	9%	30	20%
3	31192051	31192350	AACAATTAGGGTTTGACGCATTGGATGTGTTTTCAAGATACTTTTacacacacacacacacacacacttctgtgtcttacacacacacacatacacacacacacacacacacacacacttccatgtcttacacacacacttccgtgtcttacacacacacttccatgtcttacacaacacttctatgtcttacacacatacacacacacatctgtgtcttacacacatacttccgtgtcttacacacacacttctgggtcttacacacacacacacacacacacttccaagttttacac	299	6	2%	142	47%
3	31350601	31351050	TTGGTTATTACTGTTAAACAAAACAATGATAGAAATTATGAtcaggcgccggcgggagccttcttggctccgggactccgcggaggacaggctgcacgggtgaccgtgtggaatacagagtgccagccgtttctgggacgggcgagagtcgcagagcttctgggcggcgccatcttcagctccagatagccggccaccttcctggtgagagcacgggggtctgccaggcctgagaggtttgtggcacaggcgccggcgggagccttcttggctccgggactccgcggagggcaggctgcacgggtgaccgtgtggaatacagagtgccagccgtttctgggatgggcgagagtcgcagagcttctgggcggcgccatcttcagctccagacaaccagccaccttcccggcaagagccacagagcttctgaggcagcgccatcctcagct	449	62	14%	66	15%
3	34852051	34853400	gcttcgtgccaaagcgctctccattccatatatttgcccatactagggagagcggcttttacaaccgtttgccagtcggcaggagttagtgccatgccagcgagcctgtctaactgcaccaaggtaaaattagcattggttccgtatttacgaaccgactcggcaatttctttaatttgtaagtattctaccggagcgtggacacgcccaccctcggctccttcaaagaccggaaatgcctgttgtattttcctttgttcctctctgggaatgaatgagtctgcgcactgcctctctgcgcactgcctctctgcgcatctctctgcgcattgctgacgcactacgcagggcggggactccgcatagggcggaccttgaagccgactgccctgaggccaatcagcaaactggccttcgccagccgcttttggcttttttcttgaccaattagctggctggtaatgggctgcttcttcctcccagtctgtttcctcagaggaggattcttcacctgcttcagagctactaagagctggctccccgagcccatccagcgatgagcacaggctccttttcctagagacctccgctaattgatctttcttcttttccctttttcctctttttcttctaatctctctccaggtattcctacctaaccttaacttttcctcgggttcaagacccttggaaaggcctgtatacttattttgtgtaccatatttcctctttgctcctactctctctccccgctttacttctgatagcttgtcctgaatttcctctagaattttcagccctatcttaatcacttgataacatgtgaaaaggaacaaaagggctcctaacaccagaaaaaattcaaggccaaacatattccactttacttctgatagactgtcttgaatttcgttagaaagttcaagatcagacttacctcgtaaagctgtactcactggtactctcgttccccagctgaaaagttctgaattcatacagttgaatccttcttaacagtctgctttacgggaacctttattaccgcgacccgcagttctggttctggaatgagggatcttccttgcgccagtcccgagttttttctcgtcccggaattcggcaccaattgttattagacgcgttctcacgaccggccaggaagaacaccacagaccagaatcttctgcggcaaagctttatttcttacatcttcaggagcaagcgtgtaagaagcaagagagcaagaagcaagagagagagaaaacgaaaccccgtccctcttaaggagcattctccttcgcctcggacgtgtcactccctgattggctgcagcccatcggccgagttga	1349	114	8%	154	11%
3	37216651	37216800	cctgctggcaaccactgactgctgaaagttctgaactcggtgggggagtcggttccccgtacgggccaccaattgtcgcgtctgctctcgaccagcaagaacaatgcgaccaccagtccttctaacagcagtttattcagtcttcatct	149	16	11%	26	17%
3	41769751	41770350	gtgtttggacctcctcctggccgaagatgaaggcccaaagcaggatttttcccagaagctgtgttgctttggcctgcagactgcccgctgcggagtcccagaatcaaggtggcccccgcggaacgtgaggcagaagcctcacgggctgtgcggacacctgtgctctgaccaggaaggtggcaggttgtctggagccgaaaatggcgccgcctcagaggctctgtggctctcgcccggtccagaagctgctggcctctgtgttccacactctcacccgcagaccgcccgctgcagagtcccggaaccaaggtggcccccacggaacgtgaggcagaagcctctcgggccgggtggacccctgtgctctcaccaggaaggtggccggttgtctggagccggaaatggcgccgcctcagaggctctgtggctcttgcccgttccagaaggtgctggcctctgtgttccacactctcacccgcagaccgccggccgcggggtctcggaaccaaggtgactctcgcggaatgtgaggcagaagcctcccgggctgtgcggacacctgtgctctgaccaggaaggtggcaggttgtctgtagccg	599	74	12%	68	11%
3	43860001	43860150	acaaccgtttgccagtcagcaggagttagtgcctgtctaactgcaccaaggtaaaattagcattggttccgtatttacggaccgactcggcaatttctttaatttgtaagtattctaccggagcgtggacacgcccaccctcggctcct	149	18	12%	20	13%
3	43860901	43861350	tcgttccccagctgaaaagttctgaattcatacagttgaatccttcttaacagtctgctttacgggaacctttattaccgcgacccgcagttctggttctggaatgagggatcttccttgcaccggtcccgagtttttttctcgtcccggaattcggcaccaattgttattagacgcgttctcacgaccggccaggaagaacaccacagaccagaatcttctgcggcaaagctttattgcttacatcttcaggagccagagtgcaagaagcaagagagcaagaagcaagagagagagaaaacgaaaccccgtccctattaaggagaattctccttcgcctaggacgtgtcactccctgattggctgcagcccatcggccgagttgacgtcacggggaaggcagagcacatggagtggagaaccaccctcggcatatgcgcagtttattt	449	50	11%	64	14%
3	51100951	51101550	TGGAGATAGAATCTATGCCCCCAGGTGACTGAATTCTTTTGGTCTAGGTCAATGCTAGCTCTGTTCCTGTAGCAACAGTGTTCTCTTCTTTCTATCTTCTCCtgtggaaagccggtacgtgctgcgagcaatcgcatgtgtgccgccagtaatctctgaggagagccgtgtgtgccgcgagcaatcgccattataagatggcgcgggcctccgctgtgcctaactagtaaacaagtcctgtacgcaggtgcaagagtgaattcactcctagtcactcccattctcggggtgtaatagtggggtgatgggcaagcaacgaatcgggagctgtcacgccatatcaggtgctgaaacgtcacgctgcgggttataaaagcagcgccattttcccggtttgggatcttcctgagaagcaagcaataaagcttttgccgcggaagattctggtttgttgcgtctttcttgccggtcgagcgggacgcaataagtggcgccgaagaacccgggaactgtcatcacaccggcgcaaggaagatccctcgttcgcggggcagaatcagaaccgtgggacaaaaggctctacaaggtacgtacaatct	599	78	13%	70	12%
3	51104701	51105300	tggcgatagggttaccctatgacaggaaaggctgtgacattggaggaacgacctaagacaggagccacagcggatgggcataattacacaggcctagaccagccttaaattttaataaaatcaaaagggggagatgtggaaagccggtacgtgctgcgagcaatcgcatgtgtgccgccagtaatctctgaggagagccgtgtgtgccgcgagcaatcgccattataagatggcgcgggcctccgctgtgcctaactagtaaacaagtcctgtacgcaggtgcaagagtgaattcactcctagtcactcccattctcggggtgtaatagtggggtgatgggcaagcaacgaatcgggagctgtcacgccatatcaggtgctgaaacgtcacgctgcgggttataaaagcagcgccattttcccggtttgggatcttcctgagaagcaagcaataaagcttttgccgcggaagattctggtttgttgcgtctttcttgccggtcgagcgggacgcaataTTCTCCcccacccccactccccgtgtgtgtgtgtgtgtgtgtgtgtgtgtgtgtgtgtgtgtgtgtgtgagagagagagag	599	66	11%	68	11%
3	51617701	51617850	agaaattgctgagtcggttcgtaaatacggaaccaatgctaattttaccttggtgcagttagacaggctcgctggcatggcactaactcctgctgactggcaaacggttgtaaaagccgctctccctagtatgggcaaatacatggaat	149	12	8%	16	11%
3	52230301	52230900	tttgccgcagaagattccggtttgctgcgttcttcctggccggtcgcgagaacgcgtgtaagaGttggtgccgaaacccgggacgagaagacccaggacgagaagacctgggatgagaaaacccgggacgagaaatcctgggatgagaaaacctgggacggttaccatcaccggcgcaaggaagatccctcattccggaaccagaactgcgggtcatggtaatgaagtgttcccgtaaaacagactgttgagaaggattcaactgcgtgaattcagaactcttcagctggggaatggtggtaatgaagtgttcccgtaaaacagactgttgagaaggattcaactgcgtgaattcagaactcttcagctggggaatggtggtaatgaagtgttcccgtaaaacagactgttgagaaggattcaactgcgtgaattcagaactcttcagctggggaacagggtacccgtaagtatagctttacaaggtaagtctggccttgaactttctaacgaaattcaagacagtctatcagaagtaaagtggggaatagctttacaaggtaagtctggccttgaactttctaacgaaattcaagaca	599	56	9%	56	9%
3	54826201	54826500	tcgcgcccactctcgaccagcaagaacgacgcgaccaccagtccttctaacagcagtttattcagtcttcatctttcttctttctcttcatcagtaccgttccccagctgaagagttctgaatccacgccggatccttctcaacagtctgttttacgggaacctttattaaccccttcttccccgttatgcagttctgaatcctccctgtagcagggggtcttcacttgtgcctgaagatgtttcttgtcccttgtcctgggtcccgggtcccgggtttcggcaccaACTCttacgcgc	299	32	11%	40	13%
3	54849301	54850650	cccgtgaacgtcagctcggccatgggctgcagccaatcagggagtgatgcgtcctaggcaattgttgttctctttaaagaggaaaggggtttcgttttctctctctcttgcttcgctctctcttgcttcttacactctggccccataagatgtaagcaataaagctttgccgtagaagattctggttgttgtgttcttcctggccggtcgtgagaacgcgtcgaataacaattggtgccgaattccgggacgagaaaaaaactcgggactggcgcagggaagatccctcattccggaaccagaactgcggatcacgtttataaaggttcccgtaacacagactgttgagaaggattcaactgccgaattcagaactcatcagctggggaacgacggtgataaaggttcccgtaaagcagactgttaagaaggattcaactgtatgaattcagaacttttcagctggggaacgagagtaccagtgagtatgtttggccttgaattttttctggtgttaggagcccttttgttctttttcacatgttatcaagtgattaagatagggctgaaaattctagaggaaattcaggacaagctatcagaagtaaagcgggaagagagagtaggaacaaagaggaagtatggtacacaaaataagtatacaggcctttccaagggtcttgaacccgaggaaaagttaaggttaggtaggaatacctggagagagattagaagaaaaagaggaaaaagggagaagaaaaaagatcgattagcggaggtctctaggagatactcgtcactagatgagctcaggaagccagctcttagtagctctgaagcaagtgaagaatcctcctctgaggaaacagactgggaggaagaagcagcccattaccagccagctaattggtcaagaaaaaagccaaaagcggctggcgaaagtcagcgtactgttcaacctcccggcagtcggtttcaaggtccgccctatgcggagcccccgccctgcgtagtgcgtcagcaatgcgcagagaggcagtgcgcagagagatgcgcagagaggcagtgcgcagagagatgcgcagagaggcagtgcgcagagaggcagtgcgcagagaggcagtgcgcagactcattcattccccgagaggaacaaaagaaaatacaacaggcatttccggtctttgaaggagccgagggtgggcgtgtccacgctccggtagaatacgtacagattaaggaaattgccgagtcggttcgtaaatacggaaccaatgctaattttaccttggcgcagttagacaggctcgctggcatggcactaacgcctgctgattggcagacggttg	1349	128	9%	160	12%
3	55585201	55585500	ggttgttggtctggatgcgaccctggtccttcctgaaaaacaatggccttcacagcccttatggtgggtaagtaaaaagttccttctgctggccaacctactccaaaaacaggccattctgaggaacagaaagtcatccatggctttttctttacttttactgacaaattttgtcctctagccctaacgtccgtccaatggtccttagtcaaagataaaggagtagacacggtctgtcccatagtgaagaataagagtaaacacaacacaatgacagagacggaaaacactaagacatc	299	10	3%	44	15%
3	55585201	55585500	ggttgttggtctggatgcgaccctggtccttcctgaaaaacaatggccttcacagcccttatggtgggtaagtaaaaagttccttctgctggccaacctactccaaaaacaggccattctgaggaacagaaagtcatccatggctttttctttacttttactgacaaattttgtcctctagccctaacgtccgtccaatggtccttagtcaaagataaaggagtagacacggtctgtcccatagtgaagaataagagtaaacacaacacaatgacagagacggaaaacactaagacatc	299	10	3%	44	15%
3	57238201	57238650	tgctcgggcctgcgcttgtgcagcctcttgccatagagctctccattccatatatttgcccatactagggagagcggcttttgcaatcatttgccagtcggcaggagttagtgccatgccggcaagcctgtctaagtgcaccaaggtaaaattagcattggttccatatttacggaccgactcggcaagctctttaatctgcacatattctaccggagcgtggacacgcccaccctcggctccttcaaagaccggaaatgcctgttgtattttcctttgttcctcctttggaatgaacgagtctgcgcattgcctctctgtccattgcctctctgcgcagggctgacgccttacgcagggcgggggctccgcatagggtggaagtgcactatgaccttgaagccgactgcccggaggctgagcagcatgctggccttcgccagccgctt	449	48	11%	60	13%
3	59371951	59372100	cgccctgcgtagtgcgtcagccctgcgcagagagacaatgcgcagagaggcagtgcgcagactcattcattcccagagaggaacaaaggaaaatacaacaggcatttccagtctttgaaggagccgagggtgggcgtgtccacgctccg	149	20	13%	30	20%
3	68114551	68115600	tcttatgactacttgtgctctgccttccccgtgacgtcaactcggccgatgggctgcagccaatcaaggagtgacacgtccgaggcgaaggagaatgctccttaagagggacggggttttcgttttctctctctcttgcttcttgctctcttttcctgaagatgtaagaataaagctttgccgcagaagattctggtctgtggtgttcttcctggccggtcgtgagaacgcgtcgaataacaattggtgccgaattccgggacgagaaaatccgggacgagaaaaaactccggactggcgcaggagggatacttcattccagaaccagaactgcgaatcaaggttataaggttcccgtaacacagactgttgagaaggattcaactgccgaattcagaactcatcagctggggaacgacggtgataaaggttcccgtaacacagactgttgagaaggattcaactgccgaattcagaactcatcagctggggaacggaagtgagaaatggctttaccaggtatgtttggccttgaactttttctagtgttaggagcccttttgttccttttcacatgttatatagtgcttaaggcagggctaaaaattctagaggaaattcaggacagtctatcagaagtaaagcggagagagagagtaggaacaaggagaaacggtaagtatacaggcctttccaagggtcttgaacccgaggaaaagttaaggtcaggtaggaatacctggggagagattagaaggaagaaaaagaaaaaagaaaagaaaaaagatcaattagcggaggtctctaggagaaggagcctgtgctctgaagaaacagactgggagaaaaaagcagttcattatgagaaaaaagagtaccaaccaagtaaagtgctaactagtcattcaagaaaaaagccaaaagcggctggcgaaggccagtttgctaattggcctcagggcaatcggctaccaggtgcactcccgccctatgcggagtccccgccctgcgtagtgcgtcagcccgtagtgcgtcagcaatgcgcagag	1049	90	9%	106	10%
3	69209851	69210000	cacatgtgcatgcctacacacagatacaacactcacgtgtgcatgcttacacacagatacaatactcatgtgtacatgcctacacacagatacaacactcacgtgtgcatgcttacacacagatacaatactcatgtgtacatgcctac	149	4	3%	58	39%
3	70571701	70572300	GAATAATAACTTTGtgtggaaagccggtacgtgctgcgagcaatcgcatgtgtgccgccagtaatctctgaggagagccgtgtgccgagagcaatcgccattataagatggcgcgggcctccgctgtgcctaactagtaaacaagccttgtacgcaggtgcaagagtgaattcactcctggtcactcccattctcggggtgtaatagtggggtgatgggcaagcaacgaatcgggagctgtcacgccatatcaggtgctgaaacgtcacgctgcgggttataaaagcagcgccattttcccggttcgggatcttcctgagaagcaagcaataaagcttttgccgcggaagattctggtttgttgcgtctttcttgccggtcgagcgggacgcaataagtggcgccgaagaacccgggaactgtcatcacaccggcgcaaggaagatccctcgttcgcggggcagaatcagaaccgtgggacaaaaggctctacaaggtacgtacaatcttgaaatttcttcagagttagaagcccttttgattgtttgcacggcgattatgaggattgtcagcaaatggtagaagcggggcagaaagtt	599	84	14%	72	12%
3	71974651	71975100	taacactagagaaagtttaaggccaaacataccttgtaaagctatttcccactttacttctgatagactgtcttgaatttcgttagaaagttcaaggccagacttaccttgtaaagctatttcccactttacttctgatagactgtcttgaatttcgttagaaagttcaaggccagacttaccttgtaaagctatacttacgggtatcctgttccccagctgaagagttctgaattcacgcagttgaatccttctcaacagtctgttttacgggaacctttatgaccgtgacccgcagttctggttccggaatgaagaatcttccttgcgccggtgatggttaactcccgtcccgagttttcttgttccgggttttttcttcccggattttctcgtcccggatttcggcaccaaCtcttacacgcattcacgaccggccaggaagaacg	449	42	9%	42	9%
3	73379551	73380000	attttatgactacttgtactctgcctttcccgtgaacgtcagctcggccatgggctgcagccaatcagggagtgatgcgtcctaagcgaaggataactcctccttaaaggggacggggttttccgccattctctctcttacttgcgctcttcgctctggctctggcgcctgctcgcttgctcctaaagatgtaaacaatagagcgcgctctgcgctttggcgcgccggagctctggctcctaaagatgtaagatagaaggggctttcgcttttggggctgggggttttgcgctcctagctcctgaagatgtaagcaataaagttttgccgcagaagattctggtctgttgtgttcttcctggccgggcgtgagaacgcgtataagaggatgggatagggagtttgtagagggggaagcaggaaaggggttaacataaacaaacaaacaa	449	48	11%	28	6%
3	73734451	73734600	agaggaacaaaggaaaatacaacaggcatttccagtctttgaaggagccgagggtgggcgtgtccacgctccggtagaatacgtacagattaaggaaattgccgagtcggttcgtaaatacggaaccaatgctaattttaccttggcgc	149	20	13%	16	11%
3	82972501	82974000	CACACTAGGCACCAAGCTTCCAACtgttgggagccgcgcccacattcgccgttacaagatggcgctgacagctgtgttctaagtggtaaacaaataatctgcgcatatgccgagggtggttctctactccatgtgctctgccttccccgtgacgtcaactcggccgatgggctgcagccaatcagggagtgacacgtcctaggcgaaggagaattctccttaatagggacggggtttcgttttctctctctcttgcttcttgcactcctgctcctgaagatgtaagcaataaagttttgccgcagaagattctggtctgtggtgttcttcctggccggtcgtgagaacgcgtctaataacaattggtgccgaattccgggacgagaaaaaactcgggactggcgcaaggaagatccctcattccagaaccagaactgcgggtcgcggtaataaaggttcccgtaaagcagactgttaagaaggattcaactgtatgaattcagaacttttcagctggggaacgagagtaccagtgagtacagctttacgaggtaagtctgatcttgaactttctaaggaaattcaagacagtctatcagaagtaaagtggaatatgtttggccttgaattttttctggtgttaggagcccttttgttccttttcacatgttatcaagtgattaagatagggctgaagattctagatgaaattcaggacaagctatcagaagtaaagtggggagagagagtaggaacaaagaggaaatatggtacacaaaataagtatacaggcctttccaagggtcttgaacccgaggaaaagttaaggttaggtaggaatacctggagagagattagaagaaaaagaggaaaaagggaaaagaagaaagatcaattagcggaggtctctaggaaaaggagcctgtgctcatcgctggatgggcccggggagccagctcttagtagctctgaagcagatgaagaattctcctctgaagaaacagactgggaggaagaagcagctcattatgagaaaaaagggtaccagccaggtaaagtgctagctaatcagttaaggaagccaaaagcggctggcgaaggccagtttgctgattggcctcagggcagtcggtttcaaggtccgccctatgcggagcccccgccctgcgtagtgcgtcagcaatgcgcagagaggcaatgcgcagagagatgcgcagagaggcaatgcgcagagagatgcgcagagaggcagtgcgcagagaggcagtgcgcagagaggcagtgcgcagactcattcattcccagagaggaacaaaggaaaatacaacaggcatttccggtctttgaaggagccgagggtgggcgtgtccacgctccggtagaatacttacaaattaaagaaattgccgagtcggtccgtaaatacggaaccaatgctaattttaccttggtgcagttagacaggctcgccggcatggcactaactcctgctgactggc	1499	124	8%	178	12%
3	82979251	82979700	tttacctacacactggggatttgacctctatctccactctcattaatatgggtggcctatttgctcttattaaaaggaaagggggagatgttgggagccgcgcccacattcgccgttacaagatggcgctgacagctgtgttctaagtggtaaacaaataatctgcgcatatgccgagggtggttctctactccatgtgctctgccttccccgtgacgtcaactcggccgatgggctgcagccaatcagggagtgacacgtcctaggcgaaggagaattctccttaatagggacggggtttcgttttctctctctcttgcttcttgcactcctgctcctgaagatgtaagcaataaagttttgccgcagaagattctggtctgtggtgttcttcctggccggtcgtgagaacgcgtctaataacaTCCAACACAGGAAACTTTGGCAAA	449	40	9%	48	11%
3	84148051	84148650	ctgcgcttgtgcagcttcgtgccaaagcgctctccattccatatatttgcccatactagggagagcggcttttacaaccgtttgccagtcggcaggagttagtgccatgccagcgagcctgtctaactgcaccaaggtaaaattagcattggttccgtatttacgaaccgactcggcaatttccttaatttgtaagtattctaccggagcgtggacacgcccaccctcggctccttcaaagaccggaaatgcctgttgtattttcctttgttcctctctgggaatgaatgagtctgcgcactgcctctctgcgcactgcctctctgcgcatctctctgcgcattgctgacgcactacgcagggcggggactccgcatagggcggaccttgaagccgactgccctgaggccaatcagcaaactggccttcgccagccgcttttggcttttttcttgaccaattagctggctggtaatgggctgcttcttcctcccagtctgtttcctcagaggaggattcttcacctgcttcagagctactaagagctggctccccgagcccatccagcgatgagcacaggctccttttcctagagacct	599	60	10%	74	12%
3	84411001	84411450	cacatacacacactcacacgtactcacatgtttacacacttacacacactcacacacacacttatacacatgcacacactcacacacactcacatacacacacacttatacacatgtacacactcactcacatacacaaacttatacacatgcacacactcacacacactcacacacacttatacacatgcacacactcacacacacatacacacacttatacacatgcacacactcacacacactcacatgcacacacttatacacatgcgcacacacacacacttatacacatgcacacactcacacacacattcacacataaacacacacacacacacacacGCTACTGCTTCAGGTTTTCCATGAAAACCTTTACACCacaaactcactttgctagacataaagaatccattgggctcacagtgagggtctactgtcttagtcat	449	4	1%	246	55%
3	86825101	86825400	CGAGCATCTTCATCTTGGTGTTTACTAATGGGAGTCACAGAGAAATGCCTACGGCTCTTTCAAATCAATTAGACTGTAATCCAACtacacaagtacaagtatgtgtgtctgccttccgtacattacacaagtacacatgtgtgtgcctgccttccgtacactacacaagtacacatgtgtgtgcctgccttccgtacattacacaagtacacacgtgtgtgcctgccttccgtacattacacaagtacacacgtgtgtgcctgccttccgtacattCTACTTTTGGTGCTAAGAACTGT	299	18	6%	62	21%
3	87834751	87835200	atcccaagcaaccacatggtggctcacgaccatctataatgtgatctgatgcccttctcagccatgcaggcatacatgcagatagagcacgcatatacataaaataaattcttacacgcgttcgcgaccggccaggaaagacgcaacaaaccggaatcttctgcggcaaaagctttattgcttacatcttcaggagccagagagcaagagagcaagagctctattgcttacatctttaggagccagagcgcaagagcgcaagagctctattgcttacatctttaggagcaagagagcaagagcgcaagagtgcaagagagagaatggcgaaaccccgtccctttttaaggagaattatcctccacctaggacgtgtcactccttgattggctgcagcccatcggccaagttgtcgtcacggggaaggcagagcacatggggtggaaaac	449	38	8%	86	19%
3	88666501	88667850	gtggttctccactccatgtgctctgccttccccgtgacgtcaactcggccgatgggctgcagccaatcagggagtgacacgtcctaggcgaaggataattctccttaatagggacggggtttcgttttctcgctctcttgcttcttacactcttgctcctgaagatgtaagcaataaagttttgccgcagaagattctggtttgccgtgttcttcctggccgggcgtgagaacgcgtctaataacaATTGGTGCCGaaaacccgggacgagaaaaaactcgggactggcgcaaggaagatccctcattccagaaccagaactgcgggtcgcggtaataaaggttcccgtaaagcagactgttaagaaggattcaactgtatgaattcagaacttttcagctggggaacgagagtaccagtgagtacagctttacgaggtaagtctggtcttgaactttctaaggaaattcaagacagtctatcagaagtaaagtggaatatgtttggccttgaattttttctggtgttaggagcccttttgttccttttcacatgttatcaagtgattaagatagggctgaaaattctagaggaaattcaggacaagctatcagaagtaaagtggggagagagagtaggaacaaagaggaaatatggtacacaaaataagtatacaggcctttccaagggtcttgaacccgaggaaaagttaaggttaggtaggaatacctggagagagattagaagaaaaagaggaaaaagggaaaagaagaaagatcaattagcggaggtctctaggaaaaggagcctgtgctcatcgctggatgggctcggggagccagctcttggtagctctgaatcagatgatgaattctcctctgaagaaacagactgggaggaagaagcagctcattatgagaaaaaagggtaccagccaggtaaagtgctagctaatcagttaaggaagccaaaagcggctggcgaaggccagtttgctgattggcctcagggcagtcggcttcaaggtccgccctatgcggagtccccgccctgcgtagtgcgtcagccctgcgcagagagacagtgcgcagagaggcagtgcgcagactcattcattcccagagaggaacaaaggaaaatacaacaggcatttccagtctttgaaggagccgagggtgggcgtgtccacgctccggtagaatacttacagattaaagagcttgccgagtcggtccgtaaatatggaaccaatgctaattttaccttggtgcagttagacaggcttgccggcatggcactaactcctgccgactggcaaacggttgtaaaagccgctctccctagtatgg	1349	104	8%	144	11%
3	88671151	88671300	ctctgggaaatgatttggcagataaggccactaaagtggtggctgctgccctatcatccccggtagaggctgcaagaaattttcataacaattttcatgtgacggctgaaacattacgcagtcgtttctccttgacaagaaaagaagcc	149	8	5%	20	13%
3	88734001	88734300	cacgcccggccaggaagaacacagcaaaccagaatcttctgcggcaaaactttattgcttacatcttcaggagcaagagtgtaagaagcaagagagcgagagaacgaaaccccgtccctattaaggagaattatccttcgcctaggacgtgtcactccctgattggctgcagcccatcggccgagttgacgtcacggggaaggcagagcacatggagtggagaaccaccctcggcacatgcgcagattatttgtttaccacttagaacacagctgtcagcgccatcttgtaacggcgaa	299	34	11%	54	18%
3	93285601	93286500	CAAGGCCAGGCATCTGCCCAGGGTCGCGCAGGGTCACAAGGCCAAGCACAGGGCCGCGTCGGCTCGTCAGCTGACAGGCAAGGGCGTCGAGGGGTCAGCGAGAGTCAGGCCAGTGACAGCGAGGGCCACTCCGACTTCTCAGAAGGCCAGGCAGTAGGAGCTCACAGGCAGTCTGGAGCCGGCCAGAGGCACGAGCAGCGGTCCTCCCGAGGCCAGCACGGCTCCGGATTCTACCCAGTATACTACTACTATGAACAAGAACACAGCGAGGAGGAGTCCGATTCCCagcatcagcacggccaccagcacgaacagcaacgcgggcaccagcaccagcaccagcaccagcatgagcacgaACAGCCCGAGTCCGGCCACAGGCAGCAGCAGTCCAGTGGGAGAGGACACCAGGGAGCCCACCAGGAACAGGGAAGGGACAGCGCCAGGTCCCGGGGCTCTAACCAAGGGCACAGCTCCTCTCGCCACCAGGCCGACTCTCCCAGGGTCAGCGCAAGATCAGGCTCAGGAGGAAGAGGACAGTCCCCCGACGCCTCTGGCCGCAGCTCAAACAGGAGGGACAGACCCCGGCAGCCCAGCCCCAGCCAGTCCAGTGACAGCCAAGTCCATTCTGGAGTCCAGGTCGAAGGCCGGCGCGGGCAGTCCTCATCTGCCAACAGGAGGGCCGGATCCAGCTCCGGCTCAGGGGTCCAGGGGGCCTCTGCAGGTGGACTGGCAGCTGACGCCTCCAGGCGCTCTGGGGCGCGTCAAGGCCAGGCATCTGCCCAGGGTCGCGCAGGGTCACAAGGCCAAGCACAGGGCCGCGTCGGCTCGTCAGCTGACAGGCAAGGGCGTCGAGGGGTCAGCGAGAGTCAGGCCAGCGACAGCGAGGGCCACTCTGA	899	112	12%	234	26%
3	93287701	93288450	CGGCAGCCCAGCCCCAGCCAGTCCAGTGACAGCCAAGTCCATTCTGGAGTCCAGGTCGAAGGCCGGCGCGGGCAGTCCTCATCTGCCAACAGGAGGGCCGGATCCAGCTCCGGCTCAGGGGTCCAGGGGGCCTCTGCAGGTGGACTGGCAGCTGACGCCTCCAGGCGCTCTGGGGCGCGTCAAGGCCAGGCATCTGCCCAGGGTCGCGCAGGGTCACAAGGCCAAGCACAGGGCCGCGTCGGCTCGTCAGCTGACAGGCAAGGGCGTCGAGGGGTCAGCGAGAGTCAGGCCAGCGACAGCGAGGGCCACTCTGACTTCTCAGAAGGCCAGGCAGTAGGAGCTCACAGGCAGTCTGGAGCCGGCCAGAGGCACGAGCAGCGGTCCTCCCGAAGCCAGCACGGCTCCGGATACTACTATGAGCAAGAACACAGCGAGGAGGAGTCCGATTCccagcaccagcacagccaccagcacgaacagcaacgcgggcaccagcaccagcaccagcaccagcaTGAGCACGAACAGCCCGAGTCCGGCCACAGGCAGCAGCAGTCCAGTGGGAGAGGAAACCAGGGAGCCCACCAGGAACAGGGAAGGGACAGCGCCAGGTCCCGGGGTTCTAACCAAGGGCACAGCTCCTCTCGCCACCAGGCCGACTCTCCCAGGGTCAGCGCAAGATCAGGCTCAGGAGGAAGAGGACAGTCCCCCGACGCCTCTGGCCGCAGCTCAAACAGGAGGGACAGACC	749	88	12%	198	26%
3	93290101	93290700	GGGGCCTCTGCAGGTGGACTGGCAGCTGACGCCTCCAGGCGCTCTGGGGCGCTTCAAGGCCAGGCATCTGCCCAGGGTCGCGCAGGGTCACAAGGCCAAGCACAGGGCCGCGTCGGCTCGTCAGCTGACAGGCAAGGGCGTCGAGGGGTCAGCGAGAGTCAGGCCAGCGACAGCGAGGGCCACTCTGACTTCTCAGAAGGCCAGGCAGTAGGAGCTCACAGGCAGTCTGGAGCCGGCCAGAGGCACGAGCAGCGGTCCTCCCGAGGCCAGCACGGCTCCGGATACTACTATGAGCAAGAACACAGCGAGGAGGAGTCCGATTCccagcaccagcacggccaccagcacgaacagcaacgcgggcaccagcaccagcaccagcaccagcatgagcacgaACAGCCCGAGTCCGGCCACAGGCAGCAGCAGTCCAGTGGGAGAGGACACCAGGGAGCCCACCAGGAACAGGGAAGGGACAGCGCCAGGTCCCGGGGTTCTAACCAAGGGCACAGCTCCTCTCGCCACCAGGCCGACTCTCCCAGGGTCAGCGCAAGATCAGGCTCAGGAGGAAGAGGACAGTCCCCCGACGCCTCTGGCCG	599	74	12%	158	26%
3	93754201	93754350	cgcacgattggattggggcagacgctgtgttccactcaccagaggtcttaggatctcgtggggaatcctctgtgggcccttgcgggtgtcgggcgactccgctggcagggtaccccagtgctcgagtggagcggaagggCCATTCAGTT	149	20	13%	18	12%
3	94108951	94109400	ccttttgcttgtattgccctacccctcccactgataagtatctgtacttccccctttgcttgtgcatttaaaccttggacctttctcaatacattggggtcttgatacaacttcagaacggtttccgtgtcgttattcgtacaagaccctcgtctctctctaccccccatttggttattaggaggaggtcccctcgagatcctcgaataactggacctgctggacgggtcaagtggcgcccgacgtggagcacgaggtacgactgccctccggacaacggattaaggattaaagaggtaccgcgcagacagagaaacagtgggacagtccaccgacacttcactcgagtgtcgagtacggacgtcgggaggtaagcctaggcattcagttgttgtcccattaaccatggggcatttagtgaagagataaagggttctcttaaggagaga	449	46	10%	46	10%
3	94141951	94142400	tttagaagaagtatacgcaggacccttatctgtctttagcactaagggcttgccccatgcagcccaagcctccaagcagtgagatatgacatgaactgcttattcccctgtcaatggagaggcatgtaggacaccagaactggtatcgatggacacatgtacatattgtaatttcccaaaagctgggatatgcgtgacgtccatttgccaaacatctaggggtcgcaatccgcgaggattaacgcccacggaaggtgcattaataaattctacacatctaccacactgtaggacaatatctcgagcttctgttcgtgtgagcttaaactttttcgtaatgtagaagcagggacatgataaagttgatgaaaattcttagcactgtctatagagctttgtgataggaaaaccatatctctggtggctgaatcagcaattgcatttccctt	449	24	5%	68	15%
3	96842401	96843000	ggggcgtgatgtgtgtgtctgtgcacatgtatgtgggtgtgcttgtagggatggggcgtgatgtgtgtgtctgtgcacatgtatgtgggtgtgcttgtagggatggggcgtgatgtgtgtgtctgtgcacatgtatgtgggtgtgcttgtagggatggggcgtgatgtgtgtgtctgtgcacatgtatgtgggtgtgcttgtagggatggggtgtgatgtgtgtgtctgtgcacatgtatgtgggtgtgcttgtagggatggggtgtgatgtgtgtgtctgtgcacatgtatgtgggtgtgcttgtagggatggggcgtgatgtgtgtgtctgtgcacatgtatgtgggtgtgcttgtagggatggggcgtgatgtgtgtgtctgtgcacatgtatgtgggtgtgcttgtagggatggggcgtgatgtgtgtgtctgtgcacatgtatgtgggtgtgcttgtagggatggggcgtgatgtgtgtgtctgtgcacatgtatgtgggtgtgcttgtagggatggggtgtgatgtgtgtgtctgtgcacatgtatgtgggtgtgcttgtagggatggggtgtgatgtgtgtgtctgtgcaca	599	16	3%	48	8%
3	99412051	99412350	ccagaagctgtgttgctttggcctgcagactgcccgctgtggagtcccagaatcaaggtggcccccgcggaatgtgaggcagaagcctcccgggctgtgcggacacctgtgctctgaccaggaaggtggcaggtggtctgtagctgaaaatggcgccgcctcagaggctctgtgactctcgcccgttccagaagctgctggcctctgtgttccacactctcacccgcagaccgcccgccgcggagtcccggaaccaaggtggcccccacggaacgtgaggcagaagcctctcgggccgg	299	38	13%	34	11%
3	103955401	103956150	AGCTTAAAACTCACAGGAGAATGCTACTTAAGCTAACATAGCCTCAGGTACTTAAGACATCCATGAAAACCCTCACTTAAAAACTATATGGGATTTGAGGATGTGACTCAATCGATAGAATACTTGCTCAGCATGTAttttcttttcttttttctctttATATGtgtgttgtactagtatggtatttgtacgtgtacttgtggatgtatgcacatgtgttgtacgagtatggtatttgtacgtgtacttgtggatgtatgcacatgtgttgtacgagtatggtatttgtacgtgtacttgtggatgtatgcacatgtgttgtacgagtatggtatttgtacgtgtacttgtggatgtatgtacatgtgttgtacgagtatggtatttgtacgtgtacttgtgggtgtatgcacatgtgttgtaagagtatggtatttgtaagtgtacttgtggatgtatgcacatgtgttgtacgagtatggtatttgtacgtgtacttgtggatgtatgcacatgtgttgtacgagtatggtatttgtacgtgtacttgtgggtgtatgcacatgtgttgtacgagtatggtatttttacgtgtacttgtggatgtatgcacatgtgttatacgagtatggtatttgtacgtgtacttgtgggtgtatgcacatgtgttgtacaagtatggtatttgtacgtgtacttgtggatgtatgcacatgtgttgtacgagtatggtatttgtacgtgtactt	749	42	6%	64	9%
3	104594851	104595300	ttgaatccttctcaacagtctgtgttacgggaaccttataaccttgattcgcagttctggttctggaatgaagtatccctcctgcgccagtccggagttttttctcgtcccggattttctcgtcccggaattcggcaccaattgttattagacgcgttctcacgaccggccaggaagaacaccacagaccagaatcttctgcggcaaagctttattcttacatcttcaggaaaagagagcaagaagcaagagagagagaaaagcaagagagcgagaaaagcaagagagagagaaaagcaagagagcgaaaaagcaagagagagagaaaacgaaaaccccgtccctcttaaggagcattctccttcgcctcggacgtgtcactccttgattggctgcagcccatcggccgagttgacgtcacggggaaggcagagcacaagtagtcataa	449	50	11%	60	13%
3	107396851	107397000	gccacctataggcggaccttctgtccggagatttggcgtattgactccccagatgaacacacaggtgattgaggttatggtctcatcaccacgaggtattgtgtccatccccccggggatcgagtagatcaggtgttgacgtgggcgag	149	16	11%	20	13%
3	108412801	108414750	ATGCCCTTGTCCACCGCATAGGCCCGCAGGACGTACTGGGCCACGTTCTCACGATCCAGCCTCCGCAGTGTGCGCACAATGCCCGATGTCGACTCTACAATAAAGTCACCGTCCCCATCATCTCCTCCTTGGAAGGTGTAGAAAACCCTGCCATTCAGACCGGAGTCTCGATCCGTGGCTGAGATCTGCAGGACGCTGGTGAAGGGCGGCACGTCCTCGTAGACGCTGCCCTGGTAGGAATCTCTGAGGAACTGGGGGGCGTTGTCGTTCACGTCATTCACCAGGATCTCCAAATAGGTGGTGTCAGACTTCTGGGGAATGCCATTGTCCCGAGCAGTGATGGCCAGGGTATAAGACACCTGGTCCTCGTAGTCCAGCTCAGCCTGGGTGGTGACAGCCCCAGTGTCCGCGTCGATTCGGAACTGGGGGATGCTATCCTCCATAAAGTAGGTGATTCGGGCATTCTCCCCCGTGTCCTCATCCGTGGCGCTGATCAGCACCACTGTGGTGCCTGCTGGCCGGTCTTCATTAACGTTGACTGTGTAGTGGGAGCTCTGGAAGACGGGACGGTGGGTGTTGGCATCGGTGACATTCACTACTATCTGAGCTGTGTCCTGCCTTGTGCCATCTGAGGCAGTCACTGCCAGCACATACTGCCGCTCGAGTTTGTAGTCTAGCGGTAAGGCAAGGGAGACCAGTCCACCACCACTTTGGCTGGTGATAGAGAAGCGGTTGCGGGTGTTGCCGCTGGTGATCTGGTAGGTAATGACACTGTGAGCGTCTCGATCCACGGCTGACACGGTCACCACACTGGTGCCCACGGCGGCGTCCTCGTTGAGCCGAACGGTGTACTCTGGCTGCGTGAAGGTTGGGTTGTTGTCATTGACGTCCAGGATGGTTACACTGACACTGGCTGAGGCCGTGAGCGCTGGGGTGCCATGGTCCCGGGCCTCTACACCAAAGCTGTAGAAATCAACCTCTTCCCGATCCAACTCTGCGGCCACAGAGATCCAGCCTGTGCCATTGTTAATGGTGAAGGGAAAGTCGTGCCCAACCCCTGCCAGGCTATACTCGAGGCGGGCGTTATCACCAGCGTCAGCATCAATTGCCTGGACGTGCAGAACAAGGTAGCCTAAAGGGACACTCTCTAGGACGGTGGCCTGGAAAGGGGTGCTGACAAAGATGGGGGCGTTATCGTTGATGTCTAGGACTTGCACTGTTACTAGGCCAGAGACATTGGAGAGTGGAGGACGGCCACCGTCCTGAGCCCGGATCCGAAGCGTATACTCTTTGGTTGTCTCATAGTCGAGTGGGCTTACCACATCCAGGGCTCCAGTCTGAGCATCCAGATAGAACTGGCCCCGAGCATTGCCACTCATGATGCTGTAGTGCACTAGGGCATTGCTGCCCTTGTCTCTATCGGAGGCGGTGACTCGGAGAACTGGGGCTCCTGGGGTCACATCCTCCCGCACCTGGACCACATAACGCTTCTCGCTAAACTGGGGGGCGTTGTCATTATCATCCTCCACCGACAGGAAAACAATGGCTGTGGAACTCCGCGGGCCTGGGTCCCGGCCCTGGTCACTCGCCTCCACTGTTAACTTGTAGGATTCCACTTCCTCCCGGTCTACAGGGCCGCGGGTTCGGATCACCCCCGAGCGAGGATCGATCTCAAAGGCGTCTGAGGGGCTGCCTCCGGCCCCCTCCAGCAGGCGGTACAGAATGTTGGCATTGGGAGGGGCGTCGCCGTCGGTGGCCCTGACTGTAAGCACCTCATAGCCAACCTCCAGGTTCTCCCTGAGGCTCTCCTTGTACTCTTGCTGCTCAAAAACAGGGTCGTGATCGTTGGTGTCGGTCACCAAGATGGTAAGCGTGGCCAAGGCACTCCGTCGGGGCATACCGTGATCCTGTGCAGTGACCCTGAAGACGTGGGTGCTCTTGGTCTCCCG	1949	220	11%	262	13%
3	114864001	114864600	tcttgttctttttctctctcttgctctctctcttgctttcttgttcttgttctttttcttgctttctttctctctcttgccctgacacttgctctcttgctctctggctcctgaagatgtaagcaataaagctttgccgcagaagattccggtttgctgtgttcttcctggccggtcgcgagaacgcgtgcaagaGTtggtgccgaaacccgggacgggacgagaagacccgggacgagaagacccgggaagggaaatcctgggacgagaagacctgggacgagaagacctgggacgagaagacctgggacgagaagacctgggacgagaagacctgggacgagaagacctgggacgagaaaacctgggacggaaactaccatcaccagcgcaaggaagatccctcattccggaaccagaactgcgggtcatggtaatgaagtgttcccgtaaaacagactgttgagaaggattcaactgcgtgaattcagaactcttcagctggggaatggtggtaatgaagtgttcccgtaaaacagactgttgagaaggattcaactgcgtgaattcagaactcttcagctggggaacggtggtaa	599	60	10%	38	6%
3	115371601	115371900	aagttctgaattcatacagttgaatccttcttaacagtctgctttacgggaacctttattaccgcgacccgcagttctggttctggaatgagggatcttccttgcgccagtcccgagttttttttctcgtcccgggtttcggcaccaattgttattagacgcgttctcacgaccggccaggaaagacgcaacaaaccagaatcttctgcggcaaagctttattgcttacatcttcaggagccagagtgcaagagagcaagcaagcaaatggcgaaaccccatccctttttaaggagaat	299	32	11%	42	14%
3	116287951	116288250	atacacaaaacacacatacataccacacacaatacacaccacacacacacacaccccaaccacacacacatacaacgcatacacatataacgcatacacatacacaacacatatacatacaacacactacacacaccacacacacacaccactcatacacaatacacacacaacacacacatacaacacatacacacccacaacacatacacggcacactacacacacatcactcgtacacaatacacacaccacacacatacaacacatacacatataccacacacaccataccacac	299	8	3%	198	66%
3	116497651	116497800	GTACAGATCCCGGATCTCCTTCCGGATGCACCGCACAGCCGCCGCCGCCATATCTTTTGCTACCTATTTTGGCAAACCAGAAAAGGAGAACAAATTCGTCACTGGTTATTTGGACCACCGTTTTTATTCCTTCAAAAGTATTTAACGTA	149	18	12%	22	15%
3	116843401	116843850	cacactcacagacacgaatacataactatcacactcacagatatggatacataactatcacactcacagacatagatacgtaactatcacactcacagacatggatacataactatcacactcacagacatggatacataacgatcacactctcagacatggatacataactatcacactcacagacatggatacataatgatcacactcacagacacggatacataactatcacactcacagacacggatacataacgatcacactcacagacacggatacataactatcacactcacagacatggatacataactatcacactcacagacacggatacataactatcacactcacagacatggatacataactatcacactcacagacacggatacataactatcacactcacagacatggatacataactatcacactcacagaca	449	18	4%	184	41%
3	128939551	128940300	GCCAGACTAGCGCCTACGAACACCTAAGGTTAGTCTGTCTTTGCCTCTCATTccactacaatgtatgctgggaatacgtacgattgttaccactacaatgtatgctgggaatacgtacgattgttaccactacaatgtatgctgggaatacgtacgattgttaccactacaatgtatgctgggaatacgtacgattgttaccactacaatgtatgctgggaatacgtacgtttgttaccactacaatgtatgctgggaatacgtacgtttgttaccactacaatgtatgctgggaatacgtacgtttgttaccactacaatgtatgctgggaatacgtacgattgttaccactacaatgtatgctgggaatacgtacgattgttaccactacaatgtatgctgggaatacgtacgtttgttaccactacaatgtatgctgggaatacgtacgattgttaccactacaatgtatgctgggaatacgtacgattgttaccactacaatgtatgctgggaatacgtacgtttgttaccactacaatgtatgctgggaatacgtacgtttgttaccactacaatgtatgctgggaatacgtacgattgttaccactacaatgtatgctgggaatacgtacgattgttaccactacaatgtatgctgggaatacgtacgtttgttaccactacaatgtatgctgggaatacgtacgtttgttaccacatccagttgtatgagagttctgggtct	749	76	10%	84	11%
3	137281801	137281950	ggtttcgccatttgctggcttgctctcttgcactctggctcctgaagatgtaagcaataaagctttgccgcagaagattctggtttgttgcgtctttcctggccggtcgtgagaacgcgtctaataacaattggtgccgaaacccggga	149	18	12%	10	7%
3	138036301	138036600	aatctgcacacgtgcaggggcagttttcccgccatgtgttctgcctttcccgtgatgacaactgagccgatgggctgcagccaatcagggagtaatacgtcctaggcggaggataattctccttaaaagggacggggttttgccattctttttctctctcttgctttcttgttcttgttctttttcttgctttcttgctcttgctcttgctctctggctcctgaagatgtaagcaataaagcttttgccgcagaagattccggtttgttgcgttcttcctggccggtcgcgtgaacgcg	299	30	10%	24	8%
3	144619351	144619650	aagaaaaaacccggaacaaaaaaactcgggacgggaattaaccatcactggcgcaaggaagatccctcattccggaaccagaactgcgggtcacggtcataaaggttcccgtaaaacagactgttgagaaggattcaactgcgtgaattcagaactcttcagctggggaacagggtacccgtaagtatagctttacaaggtaagtctggtcttgaactttctaacgaaattcaagacagtctatcagaagtaaagtgggaaatagctttacaaggtaagtctggtcttgaactttctaa	299	22	7%	36	12%
3	144936451	144936600	gagcgaagaccccctgctacagggaggattcagaactgcataacagggaagaaggggttaataaagtgttcccgtaaaacagactgttgagaaggatccggcgtggattcagaactattcagctggggaacggtactgatgaagagaaa	149	10	7%	14	9%
3	145109101	145110450	gcatgtgccaagggtatcttatgactacttgtgctctgccttccccgtgacgtcaactcggccgatgggctgcagccaatcagggagtgacacgtccgaggcgaaggagaatgctccttaagagggacggggtttcgttttctctctctcttgcttcttgctctcttgcttcttgctctcttgcttcttgcactctggctcctgaagatgtaagcaataaagttttgccgcagaagattctggtctgtggtgttcttcctggccggtcgtgagaacgcgtctaataacaattggtgccgaattccgggacgagaaaaaactcgggactggcgcaaggaagatccctcattccagaaccagaactgcgggtcgcggtaataaaggttcccgtaaagcagactgttaagaaggattcaactgtatgaattcagaacttttcagctggggaacgagagtaccagtgagtacagctttacgaggtaagtctgatcttgaactttctaacgaaattcaagacagtctatcagaagtaaagtggaatatgtttggccttgaattttttctggtgttaggagcccttttgttccttttcacatgttatcaagtgattaagatagggcggattctagaggaaattcaggacaagctatcagaagtaaagcggggagagagagtaggaacaaagaggaaatatggtacacaaaataagcatacaggcctttccaagggtcttgaacccgaggaaaagttaaggttaggtaggaatacctggagagagattagaagaaaaagaggaaaaagggaaaagaagaaagatcaattagcggaggtctctaggaaaaggagcctgtgctcatcgctggatgggctcggggagccagctcttagtagctctgaagcaggtgaagaatcctcctctgaggaaacagactgggaggaagaagcagcccattaccagccagctaattggtcaagaaaaaagccaaaagcggctggcgaaggccagtttgctgattggcctcagggcagtcggcttcaaggtccgccctatgcggagtccccgccctgcgtagtgcgtcagcaatgcgcagagaggcagtgcgcagagaggcagtgcgcagactcattcattcccagagaggaacaaaggaaaatacaacaggcatttccggtctttgaaggagccgagggtgggcgtgtccacgctccggtagaatacttacaaattaaagaaattgccgagtcggtccgtaaatacggaaccaatgctaattttaccttggtacagttagacaggctcgccggcatggcactaactcctgctgactggcaaacggttgtaaaagccg	1349	112	8%	146	11%
3	146084701	146085300	aacctcccggcagtcggtttcaaggtccgccctatgcggagcccccgccctgcgtagtgcgtcagcaatgcgcagagaggcaatgcgcagagaggcaatgcgcagagagatgcgcagagaggcaatgcgcagagagatgcgcagagaggcaatgcgcagagagatgcgcagagaggcaatgcgcagagagatgcgcagagaggcaatgcgcagagagatgcgcagagaggcaatgcgcagagagatgcgcagagaggcagtgcgcagagaggcagtgcgcagagaggcagtgcgcagactcattcattcccagagaggaacaaaggaaaatacaacaggcatttccagtctttgaaggagccgagggtgggcgtgtccacgctccggtagaatacgtacagattaaagaactcgccgagtcggtccgtaaatacggaaccaatgctaattttaccttggtgcagttagacaggctcgccggcatggcactaactcctgctgactggcaaacgattgtaaaagccgctctccctagtatgggcaaatatatggaatggagagcgctttggcacgaagctgcacaagcgcaggcccgaaca	599	84	14%	106	18%
3	148751401	148751550	ttgaaggagccgagggtgggcgtgtccacgctccggtagaatacttacaaattaaggaaattgccgagtcggttcgtaaatacggaaccaatgctaattttaccttggtgcagttagacaggctcgctggcatggcactaactcctgcc	149	18	12%	14	9%
3	152654251	152655000	catgcacagtcatctgtgtacacatatgtgcttccatacacagcacacatacacacacacataccacacaaacacacacacacacacacacacacacagataccacatgaacacacatgcacactcatctgtgtacacacacgtgcttccatacacagcacacatacacagataccacactaacacaacacacagagtcatctgtgtacacacacacacttccatacacagcacacactcacagataccacacaaacacacacacacacacacacagagtcatctgtgtacacacacacacttccatacacagcacacacacacacagataccacatgaacacacacgcacaatcacctatgtacacacacgtgcttccatacacagcacacactcacacataccacacaaacacacacacacacagataccacatgaacacacatgcacactcatctgtgtacacacacgtgcttccatacacagcacacatacacagataccacactaacacaacacacagagtcatctgtgtacacacacacacttccatacacagtacacactcacagataccacacaaacacacacacacacagagtcatctgtgtacacacacacacacttccatacacagcacacactcacagataccacacacacacacagataccacatgaacacacacgcacaatcacctatgtacacacacgtgcttccatacacagcacacactcacacataccaca	749	12	2%	450	60%
3	152807251	152807850	agggagagcggcttttacaaccgtttgccagtcggcaggagttagtgccatgccggcaagcctgtctaactgcaccaaggtaaaattagcattggttctgtatttacggaccgactcggcaatttctttaatttgtaagtattctaccggagcgtggacacgcccaccctcggctccttcaaagaccggaaatgcctgttgtattttcctttgttcctctctgggaatgaatgagtctgcgcactgcctctctgcgcactgcctctctgcgcactgcctctctgcgcatctctctgcgcactgcctctctgcgcatctctctgcgcattgcctctctgcgcatctctctgcgcattgcctctctgcgcattgctgacgcactacgcagggcgggggctccgcatagggcggaccttgaaaccgactgccgggaggttgaacagtacgctggctttcgccagccgcttttggcttttttcttgaccaattagctggctggtaatgggctgcttcttcctcccagtctgtttcctcagaggagaattcttcatctgcttcagaactactaagagctggcttcctgagctcatctagtgacg	599	66	11%	66	11%
3	158879551	158880750	gcgtggacacgcccaccctcggctccttcaaagaccggaaatgcctgttgtattttcctttgttcctctctgggaatgaatgagtctgcgcactgcctctctgcgcactgcctctctgcgcagggctgacgcactacgcagggcggggactccgcatagggcggaccttgaagccgactgccctgaggccaatcagcaaactggccttcgccagccgcttttggcttccttaactgattagctagcactttacctggctggtacccttttttctcataatgagctgcttcttcctcccagtctgtttcctcagaggagaattcttcatctgcttcagagctactaagagctggcttcctgagctcatccagcgatgagcacaggctccttttcctagagacctccgctaattgatctttcttcttttccctttttcctctttttcttctaatctctctccaggtattcctacctaaccttaacttttcctcgggttcaagacccttggaaaggcctgtatacttattttgtgtaccatatttcctctttgttcctactctctctccccgctttacttctgatagattgccctgaatttcatccagaatcctccctgccttaaccacttgataacatgtgaaaagggacaaaagggcttctaacactagaaaaaattcaaggccaaacattttccactttacttctgatagactgtcttgaatttccttagaaagttcaaggccaggcttacctcgtaaagctatactcactggtactctcgttccccagctgaaaagttctgaattcatacagttgaatccttcttaacagtctgctttacgggaacctttattaccgcgacccgcagttctggttctggaatgagggatcttccttgcgccagtcccgagttttttctcgtcccggaattcggcaccaattgttattagacgcgttctcacgaccggccaggaaagacgcaacaaaccagaatcttctgcggcaaagctttattgcttacatcttcaggagccagagtgtaagaagcaagagagagagaaaacgaaaccccgtcccttttttaggagagttatatttcgcctaggacgtgtcactccctgattggctgcagcccatcggccgagttgacgtcacggggaaggcagagcacatggagtgaagaaccaccctcggcacat	1199	90	8%	134	11%
3	159228001	159228300	agacctgtagaggtcgaataccgcgtgggttaattcccacatgaggaactggcaagaactcacagcagctttgacattgagtaacaatgtcacgggcttcttttcttgtcaaggagaaacgactgcgtaatgtttcagccgtcacatgaaaattgttatgaaaatttcttgcagcctctatcggggatgatagggcagcagccaccactttagtggccttatctgccaaatcatttcccagagccatggggccaggtaggcctgaatgggctctaacatgagtaatataaacaggagat	299	16	5%	50	17%
4	3199801	3200250	ttttaaaacagagtgtagagctgtagttacagaatgtgaatttcccatactgctcccttatctacgagaggcttaaatatgagacgagcactgcggcttatatacgtccgtctgactgtgcttcacagcattcaacactttttctttcagcgccacttctggtgagtgcaggatcaaaccaggagaaatagggttaacacagccagcatgagaacaaaaggctttcagtgccgccttccagttaaggggagggattaagaaggatcagagttacttacaaggattcagcatgctctcggaattccaaatccaccgtggttctgaaatctgctccggttggtcggagggtctcctctaggtgccggcgttgttaaggcgttttttcccgggtttcagcaccaagtatcccgagcttatccccgtcccgcgggaaataaacacaggacaca	449	38	8%	68	15%
4	3199801	3200250	ttttaaaacagagtgtagagctgtagttacagaatgtgaatttcccatactgctcccttatctacgagaggcttaaatatgagacgagcactgcggcttatatacgtccgtctgactgtgcttcacagcattcaacactttttctttcagcgccacttctggtgagtgcaggatcaaaccaggagaaatagggttaacacagccagcatgagaacaaaaggctttcagtgccgccttccagttaaggggagggattaagaaggatcagagttacttacaaggattcagcatgctctcggaattccaaatccaccgtggttctgaaatctgctccggttggtcggagggtctcctctaggtgccggcgttgttaaggcgttttttcccgggtttcagcaccaagtatcccgagcttatccccgtcccgcgggaaataaacacaggacaca	449	38	8%	68	15%
4	3252601	3252900	TTTAGTCTTGGAGATGTCAgcagtcatcatcattgtgggacgcctgacttgccagcaagaaagacgccacagcaggatccttctgcaacacgtttattgggagagcattgactgcgtaggcaaaagaccccgagccccagaactggtgctgtttatataggcctaggagtgacgtgtccacacctgattggttgtgccctcagcacctcattcacgtgccttggaccaggcagtgactcagcaaaaaactctatggtacatgcacacattggttgtttacccatattcatgggcgtcgg	299	18	6%	62	21%
4	3973351	3973500	ACCAGGTGCAAGGTGGACTCTTTCTGGATGTTGTAGTCGGACAGGGTGCGGCCATCCTCCAGCTGTTTGCCCGCGAATATCAGCCTCTGCTGGTCAGGTGGGATGCCTTCCTTGTCTTGGATCTTGGCCTTGACATTCTCGATGGTGTC	149	10	7%	16	11%
4	4652101	4652700	ATACATATGAAAGAAACGtgttgggagccgcgcccacattcgccgttacaagatggcgctgacagctgtgttctaagtggtaaacaaataatctgcgcatgtgccaagggtatcttatgactacttgtgctctgccttccccgtgacgtcaactcggccgatgggctgcagccaatcagggagtgacacgtccgaggcgaaggagaattctccttaaaaagggacggggtttcgttttctctctctcttgcttcttgctctcttgcttcttgctctcttgcttcttgcactctggctcctgaagatgtaagcaataaagctttgccgcagaagattctggtttgttgcgtctttcctggccggtcgtgagaacgcgtctaataacaattggtgccgaattccgggacgagaaaaaactcgggactggcgcaaggaagatccctcattccagaaccagaactgcgggtcgcggtaataaaggttcccgtaaagcagactgttaagaaggattcaactgtatgaattcagaacttttcagctggggaacgagagtaccagtgagtacagctttacgaggtaagtctgatcttgaactttct	599	66	11%	54	9%
4	4653301	4653450	gtcagcaatgcgcagagagatgcgcagagaggcagtgcgcagagaggcagtgcgcagactcattcattcccagagaggaacaaaggaaaatacaacaggcatttccggtctttgaaggagccgagggtgggcgtgtccacgctccggta	149	18	12%	32	21%
4	4659001	4659450	tatcttatgactacttgtgctctgccttccccgtgacgtcaactcggccgatgggctgcagccaatcagggagtgacacgtccgaggcgaaggagaattctccttaaaaagggacggggtttcgttttctctctctcttgcttcttgctctcttgcttcttgctctcttgcttcttgcactctggctcctgaagatgtaagcaataaagctttgccgcagaagattctggtttgttgcgtctttcctggccggtcgtgagaacgcgtctaataacaAAACGTTGTTAAGCTACAATATAAGAACGAAGAGAATATTGTAAGATAGGGAGTTAAGAGAGATAGAACAATGGGGCACTCTAAAGGGAAGtgaaatgttgcacctttagaaagatcattaaattcagaaaataaacatcacaaaggcttcaggaagtccctgaaactgatca	449	34	8%	40	9%
4	4889101	4890750	aaagcagctgcgtttgctcgggcctgcgcctgtgcagcttcgtgccaaagcgctttccattccatatatttgcccatactagggagagcggcttttacaaccgtctgccaatcagcaggcgttagtgccatgccagcgagcctgtctaactgcgccaaggtaaaattagcattggttccgtatttacgaaccgactcggcaatttccttaatctgtacgtattctaccggagcgtggacacgcccaccctcggctccttcaaagactggaaatgcctgttgtattttcttttgttcctctcggggaatgaatgagtctgcgcactgcctctctgcgcactgcctctctgcgcactgcctctctgcgcatctctctgcgcactgcctctctgcgcatctctctgcgcattgcctctctgcgcattgctgacgcactacgcagggcgggggctccgcatagggcggaccttgaaaccgactgccgggaggttgaacagtacgctgactttcgccagccgcttttggcttttttcttgaccaattagctggctggtaatgggctgcttcttcctcccagtctgtttcctcagaggaggattcttcacttgcttcagagctactaagagctggcttcctgagctcatctagtgacgagtatctcctagagacctccgctaatcgatcttttttcttctccctttttcctctttttcttctaatctctctccaggtattcctacctaaccttaacttttcctcgggttcaagacccttggaaaggcctgtatacttattttgtgaaccatattttctctttgttcctactctttcttcccgctttacttctgatagcttgtcctgaatttcctctagaattttcagccctatcttaatcacttgataacatgtgaaaaagaacaaaagggctcctaacaccagaaaaaattcaaggccaaacatactcactggtactctcgttccccagctgaaaagttctgaattcatacagttgaatccttcttaacagtctgctttacgggaacctttatcaccgtcgttccccagctgatgagttctgaattcggcagttgaatccttctcaacagtctgtgttacgggaacctttataaacgtgatccgcagttctggttctgaaatgaagtatccctcctgcgccagtccggagttttttctcgtcccggattttctcgtcccggaattcggcaccaattgttattcgacgcgttctcacgaccggccaggaagaacacaacaaccagaatcttctacggcaaagctttattgcttacatcttatggggccagagtgtaagaagcaagagagagcgaaaagcaagagagagagaaaacgaaaaccctttcctctttaaagagaacaacaattgcctaggacgcatcactccctgattggctgcagcccatggccgagctgacgttcacgggaaaaacagagtacaagtagtcgtaaatacccttggctcatgcgcagattatttgtttaccaacttagaacacaggatgtcagcgccatcttgtgacggcgaatgtgggggcggcttcccacaagaatctctggtgcagaagataccatagaaaacattgacacaacaatcaaagaaaagttgaaatg	1649	152	9%	198	12%
4	5464801	5465400	caaaatgaaaccgaaaggaaaagtgtaatcgccgtgcaaacaatcaaaagggcttctaactctgaagaaatttcaagattgtacgtaccttgtagagccttttgtcccacggttctgattctgccccgcgaacgagggatcttccttgcgccggtgtgatgacagttcccgggttcttcggcgccacttattgcgtcccgctcgaccggcaagaaagacgcaacaaaccagaatcttccgcggcaaaagctttattgcttgcttctcaggaagatcccgaactgggaaaaatggcgctgcttttatatcccgcagcgtgacgtttcagcacctgatatggcgtgacagctcccgattcgttgcttgcccatcaccccactattacaccccgagaatgggagtgactaggagtgaattcactctcgcacctgcgtgcaaggcttgtttactagttaggcacagcggaggcccgcgccatcttataatggcgattgctctcggcacacacggctctcctcagagattactggcggcacacatgcgattgctcgcagcacgtaccggctttccacaCCCCACCTTGTGAAATCTTATACcaa	599	84	14%	82	14%
4	7302151	7302750	tgctttacgggaacctttattaccgtgacccgcagttctggttctggaatgagggatcttccttgcgccggtgatggtaaactctcgtcccgagtttttcttccagggtttcctcttcccggattttctcgtcccggaatttctcgtcccggattttctcgtcccggatttcggcaccaattcttattcgcgttctcacgcgcccggccaggaaagaacacaacaaaccagaatcttctgtgacaaaactttattgcttacatcttcaggagccaggagcgcaaacccccagccccaaaagcgaaagccacccccttcttacatctttaggagccagagctccagcgcgccaaagcgcagagcgcgctctattgtttacatctttaggcagcgagagagcgcagggcgcgcagagccagagagatgccagcgagagagaatggcggaaaccccgtcccctttaaggaggagttatccttcgcttaggacgcatcactccctgattggctgcagcccatggccgagctgacgttcacgggaaaggcagagtacaagtagtcgtaaaatacccttggcacatgcgcagattatttgtttac	599	82	14%	78	13%
4	7836451	7836900	gcgagttctttaatctgcacgtattctaccggagcgtggacacgcccaccctcggctccttcaaagaccggaaatgcctgttgtattttcctttgttcctctctgggaatgaatgagtctgcgcactgcctctctgcgcactgcctctctgcgcactgcctctctgcgcactgcctctctgcgcactgcctctctgcgcactgcctctctgcgcattgcctctctgcgcattgcctctctgcgcattgctgacgcactatgcagggcgggggctccgcatagggcggaccttgaaaccgactgcccggaggttgaacagtacgctggctttcgccagccgcttttggcttttttcttgaccaattagctggctggtaatgggctgcttcttcctcccagtctgtttcctcagaggagaattcttcatctgcttcagagctactaagagc	449	50	11%	46	10%
4	8393251	8393850	tttcatttggtgcattggccgggaaAcagcgcgaccacccagaggtcctagacccacttagaggtaagattctttgttctgttttggtctgatgtctgtgttctgatgtctgtgttctgtttctaagtttggtgcgatcgcagtttcagttttgcggacgctcagtgagaccgcgctccgagagggagtgcggggtggataaggatagacgtgtccaggtgtccaccgtccgttcaccctgggagacgtcccaggaggaacaggggaggatcagggacgcctggtggacccctttgaaggccaagagaccatttggggttgcgagatcgtgggttagagtcccacctcgtgcccagttgcgagatcgtgggttcgagtcccacctcgtgttttgttgcgagatcgtgggttcgagtcccacctcgtgtctggtcacgggatcgtgggttcgagtcccacctcgtgttttgttgcgagatcgtgggttcgagtcccacctcgcgtctggtcacgggatcgtgggttcgagtcccacctcgtgttttgttgcgagatcgtgggttcgagtcccacctcgcgtctggtcacgggatcgtggg	599	94	16%	56	9%
4	9728401	9728550	gtgccgaaaacccgggacaagaaacatcttcaggcacgagcgaagaccccctactacagggaggattcagaactgcatcgcggggaaggagcggttaataaaggttcccgtaaaacagactgctgagaaggatccggcgtggattcaga	149	20	13%	18	12%
4	10003801	10004100	agcagcccattaccagccagctaattggtcaagaaaaaagccaaaagcggctggcgaaagccagcgtactgttcaacctccgggcagtcggtttcaaggtccgccctatgcggagcccccgccctgcgtagtgagtcagcaatgcgcagagaggcaatgcgcagagaggcaatgcgcagagaggcagtgcgcagagaggcagtgcgcagagaggcagtgcgcagagaggcagtgcgcagactcattcattcccagagaggaacaaaggaaaatacaacaggcatttccggtctttgaag	299	34	11%	64	21%
4	12136801	12137550	gactcccttcctgatggggtgggattccacgtccactcccactctggcagagagaacaccctcaggtggccagcccactccaaacgttggccactcggaggcgcaaaaggtctgccacggaccctttctgacctccaccgactggttgtgggctctgacccgcacctctttccaatgctccagagtcagagaaaggggagtggacacagattgtcccatttctagaaaaacagtagtcacaacaagaacggacacgagactaagacaaaaaagaaaccagaagaatcagatggcctctctaaggccggccaattgagaccctctgcacgaggtgggactcgaacccacgatcccgtgaccagacgcgaggtgggactcgaacccacgatcttgcaacaaaacacgaggtgggactcgaacccacgatctcgcaactgggcacgaggtgggactcgaacccacgatctcgcaaccccaaatggtctcttggccttcaaaggggtccaccaggcgtccctgatcctcccctgttcctcctgggacgtctcccagggcgaacggacggtggacacctggacacgtctatccttatccaccccgcactccctctcggagcgcggtctcactgagcgtccgcaaaactgaaactgcgatcgcaccaaacttagaaacagaacacagacatcagaacacagacatcagaccaaagcagaacaaagaatcttacctctaagtgggtctaggacctc	749	80	11%	132	18%
4	14048401	14048850	ctcaccagaggtcttagggtcccgtggggagtcccgtgtgggcccttgcgggtgttgggcaagactctgctggcaaggtagcccggggctcgagtctcgagtcgagcggaagggacttgtgccccagatcacgcccgggtagcctgcttccctatgtaccgcagtctcaagttccgcgcgattggattggggcaggcactgtgatccactcaccagaggtcttagggtcccgtggggagtcccgtgtgggcccttgcgggtgttgggcaagactctgctggcaaggtagcccggggctcgagtctcgagtcgagcggaagggacttgtgccccagatcaggcccgggtagcctgcttccctatgtaccgcagtctcaagttccgcgtgattggattggggcaggcactgtggtccactcaccagaggtcttagggtcccgtggggagtc	449	54	12%	48	11%
4	15237151	15237450	ggttaatcttatctttaaggggttttgagaacgctggacctttcatgtcggtcctgatgctgttccggccggaggggttgttgtcgcttttacgtgagcggcgtggatccacgcagcgatgccgtctactttgagagcggtgggggtggtcagcaggacggtgtagggtcctttccagcgaggttccaagttcttagtctggtgccggcgtacccacacggtgtcgccgacacggaaggggtgtggtatcacaggctggtcttgttggtcctgataggcagcggccagaggcttccaga	299	42	14%	30	10%
4	15916501	15916650	ctacgcaatcaaaaagaaaaggaacgagccctgtgaaaaggaacagaaaggcttctaacgctggagaaagttcaaggccagacataccttgtaaagctgtaaagtcccgtagttctgaacccgccccgtgaaatgggggtctcctatca	149	12	8%	14	9%
4	16326301	16326450	GGGTGTCCTCCCTGAGGAGGCTCGGCCTTCAGTCTGTCCATCTGTCACGTGCTTTTAGCCATtgccctgacccatgccgtgacccatgccggatgcatactctgcaaatccgttcccaatctctgggttgtttcctttactctgagcat	149	10	7%	20	13%
4	18479851	18480300	acccgttaacaagtcaaaagtccaatctctctgctctggagtcaaagcagctgcgtttgctcgggcctgcgcttgtgcagcttcgtgccaaagcgctctccattccatatacttgcccatactagggagagcggcttttacaatcgtttgccagtcggcaggcgttagtgccatgccggcaagcctgtctaactgcaccaaggtaaaattagcattggttccgtatttacggaccgactcggcgagttctttaatctgcacgtattctaccggagcgtggacacgcccaccctcggctccttcaaagaccggaaatgcctgttgtattttcctttgttcctctctgggaatgaatgagtctgcgcattgcctctctgcgcattgtctctctgcgcattgcctctctgcgcattgcctctctgcgcattgtctctctgcgcatggctgac	449	56	12%	56	12%
4	19821451	19821750	AAAGGCTGGGATAATTTGTGACTTGAAGTGAGTCTTtatgagtgtgtatgtgtgtatgtgtgtatatgtgtatatgtgtgtgtgtgtgtgtgtgtgtgtatgtgtgtatgcgtgtgtgtatgtgtgtgtgtatgtgtggttatatgtttgtgtatgtatgtgtgtgtatgtgtgtgtgtgtatgtgtgtgtgtatgtgtgtatgcgtgtgtgtgtatgtgtgtatatgtgtgtatgtgtgtgtgtatgtgtgtgtatgtgtgtgtatgtgtgtgtgtgtgtgtgtgtgtgtgtgtgtgt	299	4	1%	0	0%
4	21829201	21829500	tgtttgtgtgtctgtgtgtgtgagtgcacgtgtgtttgtgtctctgtgtgtctgtgtgtgtgtctatgtgtgtctgtgtgtgtgtctgtgtttgtgtgtgtgtgtgagagtgtgtgtgtttgtgtgtgagtgtgtatgtgtatgtgtgtctgtgtttctgtctctgtgtgtctgtgtgtgtgtgtctctgtgtgtttgtgtctgtgtctgtgtgtgtctgtgtgtgtgtctttgtgtgtgtgtgagtgtgtgtgtgtctgtgtgtgagcgtgtctgtgtgtgtgtgtgtctgtctgtgt	299	4	1%	2	1%
4	23083051	23083200	gcactgactccatagttacggaccgactcggcaagctctttaatctgtatatacgctaccggagcgtggacacgcccaccctcggctccttcaaagaccggaaatgcctgttgtattttcctttgttcctcctttggaatgaacgagtc	149	20	13%	12	8%
4	24324301	24324750	caagccccaaagccccccattgcttacatctttaggagccagagcgccagagcgccagagcgcagagcaagagctctattgtttacatctttaggagcaagagagcaagcccccaaagcccaaaaacgaaagcgaaaccccgtccctcttaaggagagttatccttcgcctaggacgtatcactccctgattggctgcagcccatggccgagttgtagtcacggggaaggcagagcacatggggtggagaactacctttggcacatgcgcagattatttgtttaccacttagaacacagctgtcagcgccatcttgtaacggcgaatgtgggggcggcttcccacacctatcagaattacaccagacAGCTATATTGTACCTATTTATAATAATAAATAAATctttttttaaaaagactttttactttttacaatttaatgaaaataag	449	30	7%	70	16%
4	25852501	25853700	gccagtcagcaggagttagtgccatgccagcgagcctgtctaactgcaccaaggtaaaattagcattggttccgtatttacgaaccgactcggcaatttctttaatttgtaagtattctaccggagcgtggacacgcccaccctcggctccttcaaagaccggaaatgcctgttgtattttcctttgttcctctctgggaatgaatgagtctgcgcactgcctctctgcgcactgcctctctgcgcagggctgacgcactacgcagggcggggactccgcatagggcggaccttgaaaccgactgccctgaggccaatcagcaaactggccttcgccagccgcttttggcttccttaactgattagctagcattttacctggctggtacccttttttctcataatgagctgcttcttcctcccagtctgtttcctcagaggagaattcttcatctgcttcagagctactaagagctggctccccgagcccatccagcgatgagcacaggctccttttcctagagacctccgctaattgatctttcttcttttccctttttcctctttttcttctaatctctctccaggtattcctacctaaccttaacttttcctcgggttcaagacccttggaaaggcctgtatacttattttgtgtaccatatttcctctttgttcctactctctctccccactttacttctgatagcttgtcctgaatttcatccagaatccgccctgccttaaccacttgataacatgtgaaaaggaacaaaagggctcctaacaccagaaaaaattcaaggccaaacatattccactttacttctgatagactgtcttgaatttccttagaaagttcaaggccaggcttacctcgtaaagctatactcactggtactctcgttccccagctgaaaagttctgaattcatacagttgaatccttcttaacagtctgctttacgggaacctttattaccgcgacccgcagttctggttctggaatgagggatcttccttgcgccagtcccgagttttttctcgtcccggaattcggcaccaattgttattagacgcgttctcacgaccggccaggaagaacaccacagaccagaatcttctgcggcaaagctttatttcttacatcttcaggagccagggtgcaggaagcaagagagcaagaagcaagagagagag	1199	84	7%	144	12%
4	28412101	28413450	gtatatatgtgcttatatgtatatatgagatgtatatgtgtatgtatgtgttgggagccgcccccacattcgccgtcacaagatggcgctgacatcctgtgttctaagtggtaaacaaataatctgcgcatgtgccaagagtaattttccactacatgtactctgcctttactcggccatgggctgcagccaatcagggagtgatgcgtcctaggcgaaggataactctcctaaatagggacagggtttcgctttcgttttgggggcctttcgtttttggggcttggggaaaactcgggacgggagttaaccgtcaccggcgcaaggaagatccctcattccggaaccagaactgcgggtcacggtaataaaggttcccgtaaaacagactgttgagaaggattcaactgcatgaattcaaaactcttcagctggggaacaggagtaccagtgagtacagctttacaaggtaagtctggtcttgaactttctaaggaaagtcaagacagtctatcagaagtaaagtggaaaatagctttacaaggtatgtttggccttgaactttttctagtgttaggagcccttttgttctttttcacatgttatcaagtgattaagatagggctgaaaattctagatgaaattcaggacaatctatcagaagtaaagcggggagagagagtaggagcaaagaggaaatatggtgcacagaataagtatacaggcctttccaagggtcttgaacccaaggaaaagtttaggtcaggtaagaatacctggggagagattagaaggaaggaaaagaaaaaagaaaagaaaaaagatcaattagcggaggtctctaggagatactcgtcactagatgagctcaggaagccagctcttagtagctctgaagcagatgaagaattctcctctgaagaaacagactgggaggaagaagcagctcattaccagccagataaagtgctagtcggtcaagaaaaaagccaaaagcggctggcgaaagccagcatgctgttcagcctccgggcagtcggcttcaaggtccgccctatgcggagcccccgccctgcgtagtgcgtcagccctgcgcagagagacaatgcgcagagagacaatgcgcagagagacaatgcgcagagagacaatgcgcagagaggcaatgcgcagactcattcattcccagagaggaacaaaggaaaatacaacaggcatttccggtctttgaaggagccgagggtgggcgtgtccacgctccggtagaatacgtgcagattaaagaacttgccgagtcggtccgtaaatatggaaccaatgctaattttaccttggtgcagttagacagg	1349	96	7%	174	13%
4	30234301	30235800	aagcgctctccattccatatatttgcccatactagggagagcggcttttacaatcgtttgccagtcagcaggagttagtgccatgccggcgagcctgtctaactgcaccaaggtaaaattagcattggttccgtatttacggaccgactcggcgagttctttaatctgcacgtattctaccggagcgtggacacgcccaccctcggctccttcaatgactggaaatgcctgttgtattttcctttgttcctctctgggaatgaatgagtctgcgcactgcctctctgcgcactgcctctctgcgcactgcctctctgtgcactgcctctctgcgcattgcctctctgcgcattgcctctctgcgcactgcctctctgcgcattgctgacgcactacgcagggcgggggctccgcatagggcggaccttgaaaccgactgcccggaggttgaacagtacgctggcttttgccagccgcttttggcttttttcttgaccaattagctggctggtaatgggctgcttcttcctcccagtctgtttcttcagaggagaattcttcatctgcttcagagctactaagagctggcttcctgagctcatctagtgacgagtatctcctagagacctccgctaatcgatcttttttcttttcttttttcttttccttccttctaatctctccccaggtattcttacctgacctaaacttttcctcgggttcaagacccttggaaaggcctgtatacttattttgtgtaccatattttctctttgctcctactctctctccccgctttacttctgatagattgccctgaatttcatccagaattttcagccctatcttaatcacctgataacatgtgaaaaggaacaaaagggctcctaacactagaaaaaattcaaggccaaacataccttgtaaagccattttccactttacttctgatagactgtcttgaatttccttagaaagttcaagaccagacttaccttgtaaagctgtactcactggtactctgttcccccagctgaaaagttctgaattcatgcagttgaatccttcttaacagtctgctttacgggaacctttattaccgcgacccgcagttctggttctggaatgagggatcttccttgcgccggtcccgagttttcttgtattttttcgtcccgggtttCGGCACCAATtcttacacgcgttctcacgcccggccaggaaagaacacaacaaaccagaatcttctgcggcaaaactttattgcttacatcttcaggagccaggagcgcaaacccccagccccaaaagcgaaagccaccccaatcttacatctttaggagccagagctccggcgcgccaaagcgcagagcgcgctctattgtttacatctttaggagcaagcgagcaggcgccagagccagcgagagaaatggcggaaaccccgtcccctttaaggaggagttatccttcgcttaggacgcatcactccctgattg	1499	132	9%	172	11%
4	30234301	30235800	aagcgctctccattccatatatttgcccatactagggagagcggcttttacaatcgtttgccagtcagcaggagttagtgccatgccggcgagcctgtctaactgcaccaaggtaaaattagcattggttccgtatttacggaccgactcggcgagttctttaatctgcacgtattctaccggagcgtggacacgcccaccctcggctccttcaatgactggaaatgcctgttgtattttcctttgttcctctctgggaatgaatgagtctgcgcactgcctctctgcgcactgcctctctgcgcactgcctctctgtgcactgcctctctgcgcattgcctctctgcgcattgcctctctgcgcactgcctctctgcgcattgctgacgcactacgcagggcgggggctccgcatagggcggaccttgaaaccgactgcccggaggttgaacagtacgctggcttttgccagccgcttttggcttttttcttgaccaattagctggctggtaatgggctgcttcttcctcccagtctgtttcttcagaggagaattcttcatctgcttcagagctactaagagctggcttcctgagctcatctagtgacgagtatctcctagagacctccgctaatcgatcttttttcttttcttttttcttttccttccttctaatctctccccaggtattcttacctgacctaaacttttcctcgggttcaagacccttggaaaggcctgtatacttattttgtgtaccatattttctctttgctcctactctctctccccgctttacttctgatagattgccctgaatttcatccagaattttcagccctatcttaatcacctgataacatgtgaaaaggaacaaaagggctcctaacactagaaaaaattcaaggccaaacataccttgtaaagccattttccactttacttctgatagactgtcttgaatttccttagaaagttcaagaccagacttaccttgtaaagctgtactcactggtactctgttcccccagctgaaaagttctgaattcatgcagttgaatccttcttaacagtctgctttacgggaacctttattaccgcgacccgcagttctggttctggaatgagggatcttccttgcgccggtcccgagttttcttgtattttttcgtcccgggtttCGGCACCAATtcttacacgcgttctcacgcccggccaggaaagaacacaacaaaccagaatcttctgcggcaaaactttattgcttacatcttcaggagccaggagcgcaaacccccagccccaaaagcgaaagccaccccaatcttacatctttaggagccagagctccggcgcgccaaagcgcagagcgcgctctattgtttacatctttaggagcaagcgagcaggcgccagagccagcgagagaaatggcggaaaccccgtcccctttaaggaggagttatccttcgcttaggacgcatcactccctgattg	1499	132	9%	172	11%
4	33358651	33358950	acacaagtccgtgggaagcatatgcacgtgtgtgtgagggtgtgtgcacacaagtccgtgggaagcatatgcacgtgtgtgtgagggtgtgtgcacacaagtccgtgggaagcatatgcacgtgtgtgtgagggtgtgtgcacacaagtccgtgggaagcatatgcacgtgtgtgtgagggtgtgtgcacacaagtccgtgggaaggtgtcagattccccgggactagagttactgacagctgtgcacaggcttacatggtgctACTACAGCAGTGCAGGCTTCCACTGCCGAGCTTTG	299	22	7%	62	21%
4	34193851	34194300	actcttgctcctgaagatgtaagcaataaagttttgccgcagaagattctggtttgctgtgttcttcctggccggtcgcgagaacgcgtgtaagaGttggtgccgaaacccgggacgagaagacctaggacgagaagacctgggacgagaaaacctgggacggttaccatcaccggcgcaaggaagatccctcattccggaaccagaactgcgggtcatggtaatgaagtgttcccgtaaaacagactgttgagaaggattcaactgcgtgaattcagaactcttcagctggggaacggtggtaataaagtgttcccgcatcacagactgttgagaaggattcaactgcgtgaattcagaactcttcagctggggaacagggtacccgtaagtatagctttacaaggtaagtctggtcttgaactttctaacgaaattcaagacagtct	449	46	10%	44	10%
4	34353601	34353900	gaaggatcctgtagcagcgtcgttcttcctggccagttgagcgcgcgcaacaagtggtgctgaaacccgggacgagaagacctgggacgaggaaacccgggaaaagaaacatcttcaggcaagagtgaagaccccctgctacagggaggattcagaactgcataacggggaagaaggggttaataaagtgttcccataaaacagactgttgagaaggatctggcgtggattcagaactcttcagctggggaacggtactgatgaagagaaagaagaaagatgaagactgaataaactgc	299	24	8%	28	9%
4	34506151	34506600	agagcggcttttgcaatcatttgccagtcggcaggagttagtgccatgccggcaagcctgtctaactgcaccaaggtaaaattagcattggttccatatttacggaccgactcggcaagctctttaatctgcacatattctaccggagcgtggacacatccaccctcggctccttcaaagaccggaaatgcctgttgtattttcctttgttcctcctttggaatgaacgagtctgcgcattgcctctctgcgcagggctgacgcactacgcagggcgggggctccgcatagggcggaagtgcactatgaccttgaagccgactgcccggaggctgagcagcttgctggccttcgccagccgcttttggcttttttcttgaccaattagctcgcattttatctggctggcacttttctctctcataacgagctgcttcctcctccaagtc	449	48	11%	60	13%
4	34507201	34507650	agttgaatccttctcaacagtctgtgttgtgggaacacttcattaccaccattccccagctgaagagttctgaattcacgcagttgaatccttctcaacagtctgttttacgggaacacttatgaccgtgacccgcagttctggttccggaatgagggatcttccttgcgccggtggtggtaaccgtcccaggttttctcatcccaggatttctcgtcccaggtcttctcgtcccgggtttcagcaccaaCtcttacatgcattcacgaccggccaggaagaacacagcaaaccagaatcttctgcggcaaaactttattgcttacatcttcaggagtaagagtgcaagagagagaatggcgaaaccccgtccctttttaaggagaattatcctccgcctaggacgtgtgactccctgattggctgcagcccatcggccgagttgtcgt	449	42	9%	68	15%
4	34540801	34542150	ggagagcggcttttacaaccgtttgccagtcagcaggagttagtgccatgccggcgagcctgtctaactgcaccaaggtaaaattagcattggttccatatttacggaccgactcggcaagctctttaatttgtaagtattctaccggagcgtggacacgcccaccctcggctccttcaaagaccggaaatgcctgttgtattttcctttgttcctctctgggaatgaatgagtctgcgcactgcctctctgcgcactgcctctctgcgcattgctgacgcactacgcagggcgggggctccgcatagggcggaccttgaaaccgactgccgggaggttgaacagtacgctggctttcgccagccgcttttggcttttttcttgaccaattagctggctggtaatgggctgcttcttcctcccagtctgtttcctcagaggagaattcttcatctgcttcagagctactaagagctggcttcctgagctcatctagtgacgagtatctcctagagacctccgctaattgatctttcttcttttccctttttcctctttttcttctaatctctctccaggtattcctacctaaccttaacttttcctcgggttcaagacccttggaaaggcctgtatacttattttgtgtaccatattttctctttgctcctactctctctccccgctttacttctgatagcttgtcctgaatttcatctagaatccgccctatcttaaccacttgataacatgtgaaaaggaacaaaagggctcctaacaccagaaaaaattcaaggccaaacatattccactttacttctgatagactgtcttgaatttccttagaaagttcaagatcagacttacctcgtaaagctgtactcactggtactctcgttccccagctgaaaagttctgaattcatacagttgaatccttcttaacagtctgctttacgggaacctttattaccgcgacccgcagttctggttctggaatgagggatcttccttgcgccagtcccgagtttttttctcgtcccggaattcggcaccaattgttattagacgcgttctcacgaccggccaggaaagacgcaacaaaccagaatcttctgcggcaaagctttattgcttacatcttcaggagccagagtgcaagaagcaagagcgagagaaaacgaaaccccgtccctattaaagagaattctccttcgcctaggacgtgtcactccctgattggctgcagcccatcggccgagttgacgtcacggggaaggcagagcacatggagtgaagaaccaccctcggcacatgcgcagattatttgtttaccacttagaacacagc	1349	116	9%	152	11%
4	34540801	34542150	ggagagcggcttttacaaccgtttgccagtcagcaggagttagtgccatgccggcgagcctgtctaactgcaccaaggtaaaattagcattggttccatatttacggaccgactcggcaagctctttaatttgtaagtattctaccggagcgtggacacgcccaccctcggctccttcaaagaccggaaatgcctgttgtattttcctttgttcctctctgggaatgaatgagtctgcgcactgcctctctgcgcactgcctctctgcgcattgctgacgcactacgcagggcgggggctccgcatagggcggaccttgaaaccgactgccgggaggttgaacagtacgctggctttcgccagccgcttttggcttttttcttgaccaattagctggctggtaatgggctgcttcttcctcccagtctgtttcctcagaggagaattcttcatctgcttcagagctactaagagctggcttcctgagctcatctagtgacgagtatctcctagagacctccgctaattgatctttcttcttttccctttttcctctttttcttctaatctctctccaggtattcctacctaaccttaacttttcctcgggttcaagacccttggaaaggcctgtatacttattttgtgtaccatattttctctttgctcctactctctctccccgctttacttctgatagcttgtcctgaatttcatctagaatccgccctatcttaaccacttgataacatgtgaaaaggaacaaaagggctcctaacaccagaaaaaattcaaggccaaacatattccactttacttctgatagactgtcttgaatttccttagaaagttcaagatcagacttacctcgtaaagctgtactcactggtactctcgttccccagctgaaaagttctgaattcatacagttgaatccttcttaacagtctgctttacgggaacctttattaccgcgacccgcagttctggttctggaatgagggatcttccttgcgccagtcccgagtttttttctcgtcccggaattcggcaccaattgttattagacgcgttctcacgaccggccaggaaagacgcaacaaaccagaatcttctgcggcaaagctttattgcttacatcttcaggagccagagtgcaagaagcaagagcgagagaaaacgaaaccccgtccctattaaagagaattctccttcgcctaggacgtgtcactccctgattggctgcagcccatcggccgagttgacgtcacggggaaggcagagcacatggagtgaagaaccaccctcggcacatgcgcagattatttgtttaccacttagaacacagc	1349	116	9%	152	11%
4	34691251	34691400	tcacacacacacacacacatacaaaacacatacacacacaaatacacaacacatatatttacacactaccacaaatcacacatacacatacaacacacaccacatcctcgcatacatacacacaacacacacatcacacacatacagca	149	2	1%	100	67%
4	35377501	35377800	ccgatgggctgcagccaatcagggagtgacacgtcctaggcgagggataactctcctaaaatagggacggggtttcgttttcgctctctcttgcttcttacactcttgctcctgaagatgtaagcaataaagttttgccgcagaagattctggtttgttgcgtctttcctggccggtcgtgagaacgcgtctaataacaattggtgccgaattccgggacgagaaaaaactcgggactggcgcagggaagatccctcattccagaaccagaactgcgggtcgcggtaataaaggttccc	299	40	13%	24	8%
4	40059901	40061400	taactgcaccaaggtaaaattagcattggttccgtatttacggaccgactcggcgagttctttaatctgcacgtattctaccggagcgtggacacgcccaccctcagctccttcaaagactggaaatgcctgttgtattttcctttgttcctctctgggaatgaatgagtctgcgcactgcctctctgcgcactgtctctctgcgcactgcctctctgcgcactgcctctctgcgcattgcctctctgcgcattgcctctctgcgcactgcctctctgcgcattgctgacgcactacgcagggcgggggctccgcatagggcggaccttgaaaccgactgcccggaggttgaacagtacgctggctttcgccagccgcttttggcttttttcttgaccaattagctggctggtaatgggctgcttcttcctcccagtctgtttcctcagaggagaattcttcatctgcttcagagctactaagagctggcttcctgagctcatctagtgacgagtatctcctagagacctccgctaatcgatcttttttcttttcttttttcttttccttccttctaatctctccccaggtattcttacctgacctaaacttttcctcgggttcaagacccttggaaagacctgtatacttattttgtgtaccatattttctctttgctcctactctctctccccgctttacttctgatagattgccctgaatttcatccagaattttcagccctatcttaatcacctgataacatgtgaaaaggaacaaaagggctcctaacactagaaaaaattcaaggccaaacataccttgtaaagccattttccactttacttctgatagactgtcttgaatttccttagaaagttcaagaccagacttaccttgtaaagctgtactcactggtactctgttcccccagctgaaaagttctgaattcatgcagttgaatccttcttaacagtctgttttacgggaacctttattaccgtgacccgcagttctggttctggaatgagggatcttccttgcgccggtgatggtaattttcgtcccaggttttctcttcccggggttttctcgtcccgggttttctcgtcccgtaatttctcgtcccggaattcggcaccaattcttatacgcgttctcacgaccggccaggaaagaacacaacaaaccaaaatcttctgcggcaaaactttattgcttacatcttcaggagccaggagcgcaaacccccagccccaaaagcgaaagccaccccaataatgaaaccgaaaccccttccctatttaggagagttatctttcgcctaggacgcatcactccctgattggctgcagcccatggccgagctgacgttcacgggaaaggcagagtacaagtagtcgtaaaatacccttggcacatgcgcagattatttgtttaccacttagaacacaggatgtcagcgccatcttgtgacggcgaatgtgggggcggctccc	1499	130	9%	166	11%
4	40059901	40061400	taactgcaccaaggtaaaattagcattggttccgtatttacggaccgactcggcgagttctttaatctgcacgtattctaccggagcgtggacacgcccaccctcagctccttcaaagactggaaatgcctgttgtattttcctttgttcctctctgggaatgaatgagtctgcgcactgcctctctgcgcactgtctctctgcgcactgcctctctgcgcactgcctctctgcgcattgcctctctgcgcattgcctctctgcgcactgcctctctgcgcattgctgacgcactacgcagggcgggggctccgcatagggcggaccttgaaaccgactgcccggaggttgaacagtacgctggctttcgccagccgcttttggcttttttcttgaccaattagctggctggtaatgggctgcttcttcctcccagtctgtttcctcagaggagaattcttcatctgcttcagagctactaagagctggcttcctgagctcatctagtgacgagtatctcctagagacctccgctaatcgatcttttttcttttcttttttcttttccttccttctaatctctccccaggtattcttacctgacctaaacttttcctcgggttcaagacccttggaaagacctgtatacttattttgtgtaccatattttctctttgctcctactctctctccccgctttacttctgatagattgccctgaatttcatccagaattttcagccctatcttaatcacctgataacatgtgaaaaggaacaaaagggctcctaacactagaaaaaattcaaggccaaacataccttgtaaagccattttccactttacttctgatagactgtcttgaatttccttagaaagttcaagaccagacttaccttgtaaagctgtactcactggtactctgttcccccagctgaaaagttctgaattcatgcagttgaatccttcttaacagtctgttttacgggaacctttattaccgtgacccgcagttctggttctggaatgagggatcttccttgcgccggtgatggtaattttcgtcccaggttttctcttcccggggttttctcgtcccgggttttctcgtcccgtaatttctcgtcccggaattcggcaccaattcttatacgcgttctcacgaccggccaggaaagaacacaacaaaccaaaatcttctgcggcaaaactttattgcttacatcttcaggagccaggagcgcaaacccccagccccaaaagcgaaagccaccccaataatgaaaccgaaaccccttccctatttaggagagttatctttcgcctaggacgcatcactccctgattggctgcagcccatggccgagctgacgttcacgggaaaggcagagtacaagtagtcgtaaaatacccttggcacatgcgcagattatttgtttaccacttagaacacaggatgtcagcgccatcttgtgacggcgaatgtgggggcggctccc	1499	130	9%	166	11%
4	40235701	40236000	tcctccactccttcatgtatgcacactcccgtcctccactccttcatgtatgcacactcccgtcctccactccttcatctatgcactctcccgtcctcctctccttcatctatgcacactcccgtcctcctctccttcatctatgcacactcccgtcctccactccttcatgtatgcacactcccgtcctccactccttcatatgcacactcccgtcctccactccttcatgtatgcacactcccgtcctccactccttcatgtatgcacactcccgtcctccactccttcatctatgc	299	18	6%	70	23%
4	40659151	40659600	ggcaactctgcgtcgaccacaagcaactcaaagaatcagatggcctctctaaggccggccgattgagaccctctgcacgaggtggaactcgaacccacgatcccgtgaccaaacgcgaggcgggactcgaacccacggtctcgcaacaaggcgcgaggtgggactcaaacccacgatctcgcaacaaaacgcgaggtgggactcgaacccacgatctcgcaactgggcacgaggtgggactcaaacccacgatctcgcaaccccaaatggtctcttggcctccaaaggggtccaccaggcgtccctggtcctcccctgttcctcctgggacgtctcccagggtgaacggacggtggacacctggacacgtctatccttatccaccccgcgttccctctcggagcgcggtctcactgagcatccgcaaaaccgaaactgcgatcgcatca	449	80	18%	70	16%
4	41454901	41455050	gacacgtccgaggcgaaggagaatgctccttaagagggacggggtttcgttctctctctctctcttgcttctctctcttgctttttcgctctcttgcttttctctctctcttgcttcttgctctcttgcttcttgcactctgttcctga	149	12	8%	4	3%
4	41455801	41456250	taatcggtcaagaaaaaagccaaaagcggctggcgaaggccagtttgctaattggcctcagggcaatcggctaccaggtgcactcccgccctatgcggagtccccgccctgcgtagtgcgtcagcccgtagtgcgtcagcaatgcgcagagaggcagtgcgcagactcattcattccccgagaggaacaaaggaaaatagaacaggcatttccagtctttgaaggagccgagggtgggcgtgtccacgctccggtagaatacgtacagattaaggaaattgccgagtcggttcgtaaatacggaaccaatgctaattttaccttggcgcagttagacaggctcgctggcatggcactaactcctgccgattggcagacggttgtaaaagccgctctccctagtatgggcaaatatatggaatggaaagcgctttggcacgaagctgcac	449	60	13%	60	13%
4	42029101	42029400	aagcagcccattaccagccagctaattggtcaagaaaaaagccaaaagcggctggcgaaggccagtttgctgattggcctcagggcagtcggcttcaaggtccgccctatgcggagtccccgccctgcgtagtgcgtcagcaatgcgcagagaggcagtgcgcagagaggcagtgcgcagactcattcattcccagagaggaacaaaggaaaatacaacaggcatttccggtctttgaaggagccgagggtgggcgtgtccacgctccggtagaatacttacaaattaaagaaattgcc	299	32	11%	52	17%
4	42381451	42381750	gcaatgcgcagagaggcagtgcgcagagaggcagtgcgcagactcattcattcccagagaggaacaaaggaaaatacaacaggcatttccggtctttgaaggagccgagggtgggcgtgtccacgctccggtagaatacttacaaattaaagaaattgccgagtcggtccgtaaatatggaaccaatgctaattttaccttggtgcagttagacaggctcgccggcatggcactaactcctgctgactggcaaacggttgtaaaagccgctctccctagtatgggcaaatatatggaat	299	30	10%	44	15%
4	42464701	42465150	cgtttgctcgggcctgcgcttgtgcagcttcgtgccaaagcgctctccattccatatatttgcccatactagggagagcggcttttacaaccgtttgccagtcagcaggagttagtgccatgccggcgagcctgtctaactgcaccaaggtaaaattagcattggttccatatttacggaccgactcggcaatttctttaatttgtaagtattctaccggagcgtggacacgcccaccctcggctccttcaaagaccggaaatgcctgttgtattttcctttgttcctctctgggaatgaatgagtctgcgcactgcctctctgcgcactgcctctctgcgcattgctgacgcactacgcagggcggggactccgcatagggcggaccttgaagccgactgccctgaggccaatcagcaaactggccttcgccagccgcttttggcttt	449	56	12%	56	12%
4	43301551	43302150	aagagagagagaaaacgaaaccccgtccctattaaggagaattatccttcgcctaggacgtgtcactccctgattggctgcagcccatcggccgagttgacgtcacggggaaggcagagcacatggagtgaagaaccaccctcggcacatgcgcagattatttgtttaccacttagaacacagctgtcagcgccatcttgtaacggcgaatgtgggcgcggctcccaacatcattgttattagacgcgttctcacgaccggccaggaaagacgcaacaaaccagaatcttctgcggcaaagctttattgcttacatcttcaggagccagagtgcaagaagcaagagagagagaaaacgaaaccccgtccctattaaggagaattatccttcgcctaggacgtgtcactccctgattggctgcagcccatcggccgagttgacgtcacggggaaggcagagcacatggagtgaagaaccaccctcggcacatgcgcagattatttgtttaccacttagaacacagctgtcagcgccatcttgtaacggcgaatgtgggcgcggctcccaacacttgcctccaacctaatatcctcctgcc	599	72	12%	98	16%
4	43753351	43753650	atttgccgagctgcgattcaaccgcataagggaacgacagatttggcgggatatgtccgcctttgcgcagacatcgggccttcctgcgagaccttgcagggaacccacgcgcaggcaatgttctcaaggaaacgagggaaaaatgtatgctttaagtgtggaagtttagatcattttagaattgattgtcctcagaacaagggtgccgaggttagacaaacaggccgtggcccaggaatatgtccccggtgtgggaagggccgccactgggcaaaagattgtaagcataaaacgagggt	299	34	11%	38	13%
4	44358001	44358450	gcccggggctcgagtcgagcggaagggacttgtgccccagatcaggcccgggtagcctgcttccctatgtaccgcagtctcaagttccgcgcgattggattggggcaggcgctgtgttccactcaccggaggtcttagggtcccgtggggagtcccgtgtgggcccttgcgggtgttgggcaagactctgctggcaaggaagcccagggctcgagtcgagcggaagggacttgtgccccagatcaggcccgggtagcctgcttccctatgtaccgcagtctcaagttccgcgcgattggattggggcaggcgctgtgttccactcaccggaggtcttagggtcccgtggggagtcccgtgtgggcccttgcgggtgttgggcaagactctgctggcaaggaagcccggggcttgagtcCGTTACTGTTCTTTTAAAAGATTACTTATTA	449	58	13%	38	8%
4	46354801	46355100	ttgtatatacatacactcacacatgcatacatacacacttatacatacatacactcactcacacacacattacatacatacacgtacatctgctcacacacacatattacatacctatacatacactcacacacacatacacatatacacacttgtacacacagatacatacacacacacacaaagaaggatctaaaattttccactttagtagacaaagtctttctacctatggtggtgcatgtgtgtgcgtgcgtgtgtgtgtgtgtgtgtgtttaagtacaagtacgcttgttctg	299	8	3%	106	35%
4	46512151	46512600	aagcggctggcgaaggccagtttgctgattggcctcagggcagtcggcttcaaggtccgccctatgcggagtccccgccctgcgtagtgcgtcaacaatgcgcagagaggcagtgcgcagagaggcagtgcgcagactcattcattcccagagaggaacaaaggaaaatacaacaggcatttccggtctttgaaggagccgagggtgggcgtgtccacgctccggtagaatacttacaaattaaggaaattgccgagtcggttcgtaaatacggaaccaatgctaattttaccttggtgcagttagacaggctcgctggcatggcactaactcctgccgactggcaaacggttgtaaaagccgctctccctagtatgggcaaatatatggaatggagagcgctttggcacgaagctgcacaagcgcaggcccgagcaaacgcagctgct	449	58	13%	66	15%
4	46576351	46576800	cattcacctctcgtgtgtttgtgtctgttcgccatcccgtctccgctcgtcacttatccttcactttccagagggtccccccgcagaccccggtgaccctcaggtcggccgactgcggcagctggcgcccgaacagggaccctcggataagtgacccttgtctctatttctactatttggtgttcgtcttgtattgtctctttcttgtctggctatcatcacaagagcggaacggactcaccacagggagctgcagtcccgcctacggaggagaggtaggttacggtgagccattggatatgggggtctcgggctcaaaagggcagaaactcttcgtttctgtactacaaaggcttctctcagagaggggtctccatgtgaaagagagcagtgcaatagaattttatcagttcctaataaaagtttccccttggtttcctgaagaggga	449	42	9%	52	12%
4	46581001	46581300	gccgcggcgcttaggtttcagtttcacatcactcgtgaacaagcacgagaaatagtaaaactatgtccaaattgccccgactggggacatgcgccacaactaaaagtaaaccccaggggccttaagccccgagttctatggcaaatggatgttactcatgtctcagaatttaaaaaattaaagtacgtacatgtgacagtagatacctattctcattttactttcgctaccgcccaaacgggcgaagcaaccaaagatgtgttacaacacttggctcaaagctttacatacatgggcat	299	26	9%	52	17%
4	51099451	51099600	agtgcgcagagaggcagtgcgcagactcattcattcccagagaggaacaaaggaaaatacaacaggcatttccggtctttgaaggagccgagggtgggcgtgtccacgctccggtagaatacttacaaattaaggaaattgccgagtcg	149	18	12%	24	16%
4	51871651	51872550	accgcgccaattcctcccccagccccactccttttctataaaaccccctagcttccaagcctcgtggtcgaatccactgtctcctgttgtgtgagatacgtttcgacccggagctccgccattaaaaaacctcttgttgttacatcaaggtgttgtgttctattcgcgattcttgggtgcacgccgaatcgggagctgagtgggggtttccccactgagttctttcatttggaggtcccaccgagatctgcgtgacacccaggaaccccgaaggaccccttggaggtgcgtttgtttgtgtgagtcttgttatgttgtctgttgtctaagtgtctaagtgtagcactgctgaatttgtgtcttagtttttcagttctgagattgtgggtttgagccccacctgtgttaccagttctggtattctgtattctggcagctgccactgcggaccgtaaggaccctagtggctgtgggaagacgacggtctatttccccacaggctgcacccttggaagacattccgagggagaccctggagtgcccggggtacggaacagtcaggaggacctggctgttgcctggcagagtgaagaagagtgagtgctcttcctgccagaggagtggagcggaatcccactccatcagaggtagcgtttggctggttgtgtaagtccagacgcagacgagtgtgcttggatgtcttagtgttttccgtctctgtcattgtgttgtgtttactcttattcttcactatgggacagaccgtgtctactcctttatctttaactaaggaccattggacggacgttagggctagaggacaaaatttgtcagtaaaagtgaagaaaaagccatggatgactttctgttcctcagaatggcctgtttttggagtaggt	899	64	7%	82	9%
4	51895801	51896250	taccagccgccaagtaaagtgctaactagtcatttaaggaaaaagccaaaagcggctggcgaaggccagtttgctaattggcctcagggcaatcggctaccaggtgcactcccgccctatgcggagtccccgccctgcgtagtgcgtcagcccgtagtgcgtcagcaatgcgcagagaggcagtgcgcagagaggcagtgcgcagactcattcattccccgagaggaacaaaggaaaatacaacaggcatttccagtctttgaaggagccgagggtgggcgtgtccacgctccggtagaatatgtgcagattaaagaaattgctgagtcggttcgtaaatacggaaccaatgctaattttaccttggtgcagttagacaggcttgccggcatggcactaactcctgccgactggcaaatgattgcaaaagccgctctccctaatatggg	449	50	11%	66	15%
4	52189951	52190100	ttacaaccgtttgccaatcaccaggagtcatagcgtgattcgcaagcctttccacttgtgctatagtgaaattagcactgactccatagttacggaccgactcggcaagctctttaatctgtatatacgctaccggagcgtggacacgc	149	20	13%	22	15%
4	56434951	56435100	catagggaagcaggctacccaggcctgatctggggcacaagtcccttccgctcgactcgagactcgagccccgggctaccttgccagcagagtcttgcccaacacccgcaagagccacacgggactccccacgggaccctaagacctct	149	16	11%	26	17%
4	57571951	57572100	tatgtgtatcatgtataaatgtgtgtgtgcatgtgtgtggtgtgtgCACATGCATGTTATCTGAGTGCATGTATGTGCATATTCGAGTACGTGTGTGTCATGTACACACATGTTACACATGCATAATGCATttgtgtgttatctgtata	149	4	3%	30	20%
4	60057751	60058050	cgtgtgtgtgtatgtgtgtgtgtgtgtgtgtgtgtgtgtgtgtgtgtgtgtgtgtgtgtgtaggcctgatatcaaccttgcgtgttctttgccagagtctgtccactgtatttggaaaccaggcgtgttcttttcttgaaacccagtaggataagctataggctgggctggccgctgacaagctgagccctagggatctgactgtctccatctgcccagggctgctattaatgctccaccaagctcaactcctttattgatctgggcatcaaactcaggacctcacactgcacagcaag	299	8	3%	38	13%
4	60109201	60109650	gccacctaaacaaagatcaagctatgtgcgcatgtgcaaggagtgaaagcacaccaagtcacaagcccacccccggggcgtatgagatcgtgggtaaagcaaccattcaggcatggacatgccacaccagggggtatttaagcagcgcctttctgaggcttatttgtcttcctcatcaatatgtaataaagtttggctgcagaaagattcttgtgtcccgtgtgcgttcttgctagcgagaacaatagctcgggacaTAAtggcgccgaaacccgggaacgcctcaccatcgctgggtgccaagggggccccccactcgtggggagggatccagaactgcagGACTTGAAGGTAAGCTCTGAGAGACATGTGAagcatgtcagaaacagagcggggtaaaagattaagagctcagagaaaataattaagaaataaggcccttccaaaga	449	32	7%	74	16%
4	60408001	60408450	cagatgaagaattctcctctgaggaaacagactgggaggaagaagcagcccattatcagccagctaattggtcaagaaaaaagccaaaagcggctggcgaaagccagcgtactgttcaacctccgggcagtcggtttcaaggtccgccctatgcggagcccccgccctgcgtagtgcgtcagcaatgcgcagagaggcagtgcgcagagaggcaatgcgcagagaggcaatgcgcagagaggcaatgcgcagagaggcagtgcgcagagaggcagtgcgcagagaggcagtgcgcagagaggcagtgcgcagagaggcagtgcgcagactcattcattcccagagaggaacaaaggaaaatacaacaggcatttccagtctttgaaggagccgagggtgggcgtgtccacgctccggtagaatacgtacagattaaagaactcgccgag	449	54	12%	86	19%
4	60456451	60456900	gtggcattctgttcttgtggctgtcttcttttaggtttgttgagggattaccttcttgttttttctagggcgttgttcccgttcttgtattggttttttctgttattatcctttgaagggctggattcgtggagagataatgcgtgaatttggttttgtcgtggaatactttggtttctccctctatgataattgagagtttggctgggtatagtagcctgggctgcagtttgtgttctcttagtgtctgtataacatctgtccaggctcttctggctttcatagtctctggtgaaaaatctggtgtaattctgataggcttgcctttatatgttacttgacctttttcccttactgcttttagtattctatctttatttagtgcatttgatgttctgattattatgtgtcggggggaatttcttttctggtccagtctatttggagtt	449	12	3%	14	3%
4	61571551	61571850	GCTGCCACTCCTGCGGACGTGGGGGAAGAGTGCTGAAAAGAGGGTGGACGGACCCGGGTCCCCCAGCCTCTCCTCGACCTCGCAATGGCTACCAGCCCCACCGACCCCTTGGGGTGGTGGGGACAAAAGAAGAAATAGCTGTAATGTGGAGGAGGGAGCGGCGAAAGCTTCACACATCCTTTATTACATTTTACGCTAGTGACGAGTGGGGGCGGCCTCTGAGACAGGACTGGCGGGAGGGAAGTGCTCCTTTGGCTTCCTAGAGCAGCCACACTTCATTTGGCTCCTCTCAGAGTGTG	299	26	9%	32	11%
4	68115601	68116050	agggacggggttttcgtttctctctctctcttgctttttcgctctcttgcttttctctctctcttgcttttctctctctcttgcttcttgctctcttttcctgaagatgtaagaataaagctttgccgcagaagattctggtctgtggtgttcttcctggccggtcgtgagaacgcgtcgaataacaattggtgccgaattccgggacgagaaaatccgggacgagaaaaaactccggactggcgcaggagggatacttcattccagaaccagaactgcgaatcaaggttataaggttcccgtaacacagactgttgagaaggattcaactgccgaattcagaactcatcagctggggaacgacggtgataaaggttcccgtaaagcagactgttgagaaggattcaactgccgaattcagaactcatcagctggggaacgacggtgat	449	50	11%	36	8%
4	68966401	68966850	ggcctgcgcttgtgcagcttcgtgccaaagcgctctccattccatatatttgcccatactagggagagcggcttttacaaccgtttgccagtcggcaggagttagtgccatgccagcgagcctgtctaactgcaccaaggtaaaattagcattggttccgtatttacgaaccgactcggcaatttccttaatttgtaagtattctaccggagcgtggacacgcccaccctcggctccttcaaagaccggaaatgcctgttgtattttcctttgttcctctctgggaatgaatgagtctgcgcactgcctctctgcgcactgcctctctgcgcatctctctgcgcattgctgacgcactacgcagggcggggactccgcatagggcggaccttgaagccgactgccctgaggccaatcagcaaactggccttcgccagccgcttttggct	449	56	12%	56	12%
4	71963401	71963700	ttgcgggcttgctctcttgcttcttgcgggcttgctctcttgcactctggctcctgaagatgtaagcaataaagctttgccgcagaagattctggtttgttgcgtctttcctggccggtcgtgagaacgcgtctaataacaattggtgccgaaacccgggacgagaaaaaactcgggactggcgcaaggaagatccctcattccagaaccagaactgcgggtcgcggtaataaaggttcccgtaaagcagactgttaagaaggattcaactgtatgaattcagaacttttcagctgggg	299	34	11%	24	8%
4	73203151	73203600	gtcactagatgagctcaggaagccagctcttagtagctctgaagcagatgaagaattctcctctgaggaaacagactgggaggaagaagcagctcattatgagaaaaaagggtaccagccaggtaaagtgctagctaatcagttaaggaagccaaaagcggctggcgaaggccagtttgctgattggcctcagggcagtcggcttcaaggtccgccctatgcggagtccccgccctgcgtagtgcgtcagccctgcgcagagagacaatgcgcagagaggcagtgcgcagactcattcattcccagagaggaacaaaggaaaatacaacaggcatttccagtctttgaaggagccgagggtgggcgtgtccacgctccggtagaatacttacagattaaagagcttgccgagtcggtccgtaaatatggaaccaatgctaattttacct	449	36	8%	64	14%
4	75067351	75068400	tgagatacgtttcgacccggagctccgccattaaaaaacctcttgttgttacatcaaggtgttgtgttctattcgtgattcttgggtgcacgccgaatcgggagctgagtgggggtttccccactgagttctttcatttggaggtcccaccgagatctgcgtgacacccaggaaccccgaaggaccccttggaggtgcgtttgtttgtgtgagtcttgttatgttgtctgttgtctaagtgtctaagtgtggcactgctgaatttgtgtcttagtttttcagttctgagattgtgggtttgagccccacctgtgttaccagttctggtattctgtattctggcagctgccactgcggaccgtaaggaccctagtggctgtgggaagactacggtctatttccccacaggctgcacccttggaagacattccgagggagaccctggagtgcccggggtacggaacagtcaggaggacctggctgttgcctggcagagtgaagaagagtgagtgctcttcctgccagaggagtggagcggaatcccactccatcagaggtagcgtttggctggttgtgtaagtccagacgcagacgagtgtgcttggatgtcttagtgttttccgtctctgtcattgtgttgtgtttactcttattcttcactatgggacagaccgtgtctactcctttatctttgactaaggaccattggacggacgttagggctagaggacaaaatttgtcagtaaaagtgaagaaaaagccatggatgactttctgttcctcagaatggcctgtttttggagtaggttggccagcagaaggaactttttacttacccaccataagggctgtgaaggccattgtttttcaggaaggaccagggtcgcatccagaccaacaaccgtacatcatggtatgggaggacttggcacgctacccacccccgtgggttcgcccattcctcccgcctctccgccctggcaccaagattctagccatccgagaaaatggtgagaaagagaaaccgaaaccaccgctcgggagagatg	1049	74	7%	112	11%
4	78835201	78835350	tcaaacccaaaaacgaaagtgaaaccccgtccctatttaggagagttatccttcgcctaggacgtatcactccctgattggctgcagcccatggccgagttgttgccacggggaaggcagagtacatggggtggagaaatacccttggc	149	12	8%	16	11%
4	80409001	80409450	attttccactacatgtactctgcctttactcggccatgggctgcagccaatcagggagtgatgcgtcctaggcgaaggataattctccttaaaaggggacggggtttccgccattctctctcttacttgcgctctcttgcttgcgctttcgctctggcgcgctggcgcgctggcgctctggctcctaaagatgtaagcgggggcctttcgtttttggggcttgcgctcctggcgcctgaagatgtaagcaataaagtcttgccgcagaagattctggtttgttgtgttcttcctggccggtcgtgagaacgcgtataagaGTTGGTGCTGaaatccgggacgagaaaatacaagaaaactcggaccggcgcaaggaagatccctcattccggaaccagaactgcgggtcacggtaataaaggttcccgtaaaacagactgttgagaagg	449	62	14%	30	7%
4	83540701	83541150	tcccatttttagaaaaacagtagtcacaacaagagcggacacgagactaagacaaaaaagaaaccagaagaatcagatggcctctccaaggccggccgattgagaccctctgcacgaggtgggactcgaacccacgatcccgtgaccagacgcgaggtgggactcgaacccacggtctcgcaacaaggtgcgaggtgggactcaaacccacgatctcgcaacaaaacgcgaggtgggactcgaacccacgatctcgcaactgggcacgaggtgggactctaacccacgatctcgcaaccccaaatggtctcttggccttcaaaggggtccaccaggcgtccctgatcctcccctgttcctcctgggacgtctcccagggtgaacggacggtggacacctggacacgtctatccttatccaccccgcactccctctcggagcgcggtctc	449	66	15%	68	15%
4	88774351	88774800	TGAAGAGGCCAAGAGAGCAGGGCCAGTCCTGTCCACTGCCTTTTGCCCTGGCCATCCGCACCTACTTCCGAGGGTTCTTCCGCTATCTGAAGGCAAAGGCACACAGCGCTTGCTCCTGGGAGATCGTCAGAGTCCAATTGCAAGTGGACCTTCCAGCGTTCCCACTGTCTGCGAGAAGAGGCCCAAGATGAGGAGAAGCCCCGTGCAGGAATCTCTCTGCTCTCGTGACACCACGCTCCCTCTCTCCATTCAAAGCAGACACACGGATTCGGATTCAGCACCAACAGGCGAAATGGGCGTGCATCGACCAAGAACATCGAGTTCTTTATGTCTTCCCTGCCAGAGGCCCCGAAGCATCCTACTGTACATCATACACTGCGAAAGATGTTTGAAAGAAAACCTGTGCTCTTGCATTTGAGGTGGCTTCTGAATAAATTGATGATCTCGGT	449	38	8%	74	16%
4	88789051	88789350	TACTTCCGAGGGTTCTTCCGCTATCTGAAGGCAAAGGCACACAGCGCTTGCTCCTGGGAGATCGTCAGAGTCCAATTGCAAGTGGACCTTCCAGCGTTCCCACTGTCTGCGAGAAGAGGCCCAAGATGAGGAGAAGCCCCGTGCAGGAATCTCTCTGCTCTCGTGACACCACGCTCCCTCTCTCCATTCAAAGCAGACACACGGATTCGGATTCAGCACCAACAGGCGAAATGGGCGTGCATCGACAAAGAACATCGAGTTCTTTATGTCTTCCCTGCCAGAGGCCCGGAAGCATCCTA	299	32	11%	54	18%
4	88800751	88801050	TTCTTCCGCTATCTGAAGGCAAAGGCACACAGCGCTTGCTCCTGGGAGATCGTCAGAGTCCAATTGCAAGTGGACCTTCCAGCGTTCCCACTGTCTGCGAGAAGAGGCCCAAGATGAGGAGAAGCCCCGTGCAGGAATCTCTCTGCTCTCGTGACACCACGCTCCCTCTCTCCATTCAAAGCAGACACACGGATTCGGATTCAGCACCAACAGGCGAAATGGGCGTGCATCGACCAAGAACATCGAGTTCTTTATGTCTTCCCTGCCAGAGGCCCAGAAGCATCCTACTGTACATCATA	299	28	9%	60	20%
4	88806451	88806750	CCACCTCTTTGACACAGAGGCCAGCAGAGCTGCCTGGCACGAGAGGGCGCTGGACCAGCTACTATCTAGCCTGTGGCGTGAGCTGCAAGTGCTGAAGAGGCCAAGAGAGCAGGGCCAGTCCTGTCCACTGCCTTTTGCCCTGGCCATCCGCACCTACTTCCGAGGGTTCTTCCGCTATCTGAAGGCAAAGGCACACAGCGCTTGCTCCTGGGAGATCGTCAGAGTCCAATTGCAAGTGGACCTTCCAGCGTTCCCACTGTCTGCGAGAAGAGGCCCAAGATGAGGAGAAGCCCCGTGCA	299	22	7%	50	17%
4	89186401	89186550	gcgcagagaggcagtgcgcagactcattcattcccagagaggaacaaaggaaaatacaacaggcatttccagtctttgaaggagccgagggtgggcgtgtccacgctccggtagaatacttacaaattaaagaacttgccgagtcggtc	149	16	11%	26	17%
4	91972501	91973850	ataatctgcgcatgtgccgagggtggttctccactccatgtgctctgccttccccgtgacgtcaactcggccgatgggctgcagccaatcagggagtgacacgtcctaggcgaaggataattctccttaatagggacggggtttcgttttctcgctctcttgcttcttacactcttgctcctgaagatgtaagcaataaagttttgccgcagaagattctggtttgctgtgttcttcctggccgggcgtgagaacgcgctaataacaattggtgccgaattccgggacgagaaaaaactcgggacgagagtttaccatcactggcgcaaggaagatccctcattccagaaccagaactgcgggtcgcggtaataaaggttcccgtaaagcagactgttaagaaggattcaactgtatgaattcagaacttttcagctggggaacgagagtaccagtgagtacagctttacgaggtaagcctggccttgaactttctaaggaaattcaagacagtctatcagaagtaaagtggaaaatgtttggccttgaattttttctagtgttagaagcccttttgttccttttcacatgttatcaagtggttaaggcagggcggattctagatgaaattcaggacaagctatcagaagtaaagtggggagagagagtaggaacaaagaggaaatatggtacacaaaataagtatacaggcctttccaagggtcttgaacccgaggaaaagttaaggttaggtaggaatacctggagagagattagaagaaaaagaggaaaaagggaaaagaagaaagatcaattagcggaggtctctaggaaaaggagcctgtgctcatcgctggatgggctcggggatccagctcttggtagctctgaatcagatgatgaattctcctctgaagaaacagactgggaggaagaagcagctcattatgagaaaaaagggtaccagccaggtaaagtgctagctaatcagttaaggaagccaaaagcggctggcgaaggccagtttgctgattggcctcagggcagtcggcttcaaggtccgccctatgcggagcccccgccctgcgtagtgcgtcagccctgcgcagagagacaatgcgcagagaggcagtgcgcagactcattcattcccagagaggaacaaaggaaaatacaacaggcatttccagtctttgaaggagccgagggtgggcgtgtccacgctccggtagaatacttacaaattaaagaactcgccgagtcggtccgtaaatacggaaccaatgctaattttaccttggtgcagttagacaggcttgccggcatggcactaactcctgccgactggc	1349	110	8%	150	11%
4	93003451	93003750	tcggcaatttctttaatttgtaagtattctaccggagcgtggacacgcccaccctcggctccttcaaagaccggaaatgcctgttgtattttcctttgttcctctctgggaatgaatgagtctgcgcactgcctctctgcgcattgcctctctgcgcatctctctgcgcattgctgacgcactacgcagggcgggggctccgcatagggcggaccttgaagccgactgccctgaggccaatcagcaaactggccttcgccagccgcttttggcttttttcttgaccaattagctggctg	299	36	12%	32	11%
4	94818301	94818450	ttcctttgttcctctctgggaatgaatgagtctgcgcactgcctctctgcgcagggctgacgcactacgcagggcggggactccgcatagggcggaccttgaagccgactgccctgaggccaatcagcaaactggcctttgccagccgc	149	18	12%	18	12%
4	95258701	95259150	gccagacctcacagaccaaccttggccaggggcgatgacttggttcacggacggaagcagctttgtggtagaaggtaagcggaaggctggggcggcagtagtagatggaaaggctgtcatatgggccagcagtctgccggagggtacatcagctcaaaaagcggaactaatcgcattaattcaagccttaaggctggcagaaggaagggctcttaatgtctataccgacagccggtacgcttttgccacggctcatgttcacggagcaatataccgacaccgtggactgctgacgtctgccggcaaagatatcaaaaataaagaagaaattctcagcttattagaagctgttcatttgccccgtagggtggcaattatccattgcccaggacaccagaagggaactgggcccgttgaaaagggaaatcaaatggcagaccaagaagcta	449	38	8%	70	16%
4	96155551	96156000	cagtcagcaggagttagtgccatgccggcgagcctgtctaactgcaccaaggtaaaattagcattggttccgtatttacggaccgactcggcaagttctttaatttgtaagtattctaccggagcgtggacacgcccaccctcggctccttcaaagaccggaaatgcctgttgtattttcctttgttcctctctgggaatgaatgagtctgcgcactgcctctctgcgcagggctgacgcactacgcagggcggggactccgcatagggcggaccttgaagccgactgccctgaggccaatcagcaaactggccttcgccagccgcttttggcttccttaacggattagctagcactttacctggctggtacccttttttctcataatgagctgcttcttcctcccagtctgtttcttcagaggagaattcttcatctgattcagagct	449	44	10%	52	12%
4	96946651	96948300	ggcgctgacatcctgtgttctaagtggtaaacaaataatctgcgcatgtgccaagggtattttaccactacttgtactctgcctttcccgtgacgtcagctcggccatgggctgcagccaatcagggagtgatgcgtcctaagcgaaggataactctcctaaatagggacggggggtttcgctttcgtttagagaggggcgctttcgtttttggggcttggggttttgcgctcctggctcctgaagatgtaagcaataaagttttgccgcagaagattctggtttgttgtgtctttcctggccggtcgtgagaacgcgaataaGAGTTGGTGCTGaaatccgggacgaaaaaatacaagaaaactcgggaccggcgcaaggaagatccctcattccagaaccagaactgcgggtcacggtaataaaggttcccgtaaaacagactgttgagaaggattcaactgcatgaattcagaacttttcagctggggaacagaagtaccagtgagtacagctttacaaggtaagtctggtcttgaactttctaaggaaagtcaagacagtctatcagaagtaaagtggaaaatagctttacaaggtatgtttggccttgaatcttttctagtgttaggagcccttttgttctttttcacatgttatcaggtgattaagatagggctgaaaattctggatgaagttcaggacaatctatcagaagtaaagcggggagagagaataggagcaaagagaaaatatggttcacaaaataagtatacaggcctttccaagggtcttgaacccgaggaaaagtttaggtcaggtaagaatacctggggagagattagaaggaaggaaaagaaaaaagaaaagaaaaaagatcaattagcggaggtctctaggagatactcgtcactagatgagctcaggaagccagttcttagtagctctgaagcagatgaagaattctcctctgaggaaacagactgggaggaagaagcagctcattaccagccagctaatcggtcaagaaaaaagccaaaagcggctggcgaaagccagcatactgttcagcctccgggcagtcggcttcaaggtccgccctatgcggagcccccgccctgcgtagtgcgtcagcaatgcgcagagagacaatgcgcagagaggcaatgcgcagagaggcaatgcgcagagagacaatgcgcagagaggcaatgcgcagagaggcaatgcgcagagagacaatgtgcagagagacaatgcgcagagaggcaatgcgcagagaggcaatgcgcagagagacaatgcgcagagaggcaatgtgcagactcattcattcccagagaggaacaaaggaaaatacaacaggcatttccggtctttgaaggagccgagggtgggcgtgtccacgctccggtagaatacgtgcagattaaagaactcgccgagtcggtccgtaaatacggaaccaatgctaattttaccttggtgcagttagacaggcttgccggcatggcactaactcctgccgactggcaaacgattgtaaaagccgctctccctagtatgggcaagtatatggaatggagagcgctttggcacgaagctgcacaagcgcaggcccgagcaaacgcagctgctttgactccaga	1649	142	9%	220	13%
4	100936501	100936800	ttccatatatttgcccatactagggagagcggcttttacaaccgtttgccagtcggcaggagttagtgccatgccggcaagcctgtctaactgcaccaaggtaaaattagcattggttccgtatttacggaccgactcggcgagttctttaatttgtaagtattctaccggagcgtggacacgcccaccctcggctccttcaaagaccggaaatgcctgttgtattttcctttgttcctctctgggaatgaatgagtctgcgcactgcctctctgcgcattgtctctctgcgcactgct	299	34	11%	32	11%
4	102875701	102875850	aacaaccagaatcttctacggcaaagctttattgcttacatctttttgggggccagagtgtaagaagcaagagagagaagcaagagagagagaaaacgaaaccccttctattttaaagagaacaaccattgcctagggcgcatcactcc	149	6	4%	22	15%
4	102881401	102882600	tgaaattagcattggttccgtatttacgaaccgactcggcaatttccttaatctgtacgtattctaccggagcgtggacacgcccaccctcggctccttcaaagactggaaatgcctgttgtattttcttttgttcctctcggggaatgaatgagtctgcgcactgcctctctgcgcactgcctctctgcgcacctctctgcgcactgcctctctgcgcacctctctgcgcactgcctctctgcgcacctctctgcgcattgcccctctgcgcattgctgacgcactacgcagggcgggggctccgcatagggcggaccttgaaaccgactgccgggaggttgaacagtacgctgactttcgccagccgcttttggcttttttcttgaccaattagctggctggtaatgggctgcttcttcctcccagtctgtttcctcagaggaggattcttcacttgcttcagagctactaagagctggcttcctgagctcatctagtgacgagtatctcctagagacctccgctaatcgatcttttttcttctccctttttcctctttttcttctaatctctctccaggtattcctacctaaccttaacttttcctcgggttcaagacccttggaaaggcctgtatacttattttgtgtaccatacttcctctttgttcctactctctctccccgctttacttctgatagattgtcctgaatttcctctagaattttcagccctatcttaatcacttgatagcatgtgaaaaagaacaaaagggctcctaacaccagaaaaaattcaaggccaaacatactcactggtactctcgttccccagctgaaaagttctgaattcatacagttgaatccttcttaacagtctgctttacgggaacctttatcaccgtcgttccccagctgatgagttctgaattcggcagttgaatccttctcaacagtctgtgttacgggaacctttataaacgtgatccgcagttctggttctggaatgaagtatccctcctgcgccagtccggagttttttctcgtcccggattttctcgtcccggaattcggcaccaattgttattcgtcgcgttctcacgaccggccaggaagaacacaacaaccagaatcttctacggcaaagctttattgcttacatctttttgggggccagagtgtaagaagcaagagagag	1199	110	9%	122	10%
4	103563451	103563750	CAAAGCCGGCTTTGCTGGCGACGACGCCCCCAGGGCCGTGTTCCCTTCCATCGTAGGGCGCCCCCGACACCAGGGCGTCATGGTGGGCATGGGCCAGAAAGACTCATACGTGGGTGACGAGGCCCAGAGCAAGAGGGGTATCCTGACCCTGAAGTACCCTATCGAACACGGCATTGTCACTAACTGGGACGACATGGAGAAGATCTGGCACCACACCTTCTACAATGAGCTGCGTGTGGCTCCTGAGGAGCACCCGGTGCTTCTGACCGAGGCCCCCCTGAACCCCAAAGCTAACAGAG	299	34	11%	44	15%
4	105438151	105438600	gccgagggtggttctccactccatgtgctctgccttccccgtgacgtcaactcggccgatgggctgcagccaatcagggagtgacacgtcctaggcgaaggataattctccttaatagggacggggtttcgttttctcgctctcttgcttcttacactcttgctcctgaagatgtaagcaataaagttttgccgcagaagattctggtctgtggtgttcttcctggccgggcgtgagaacgcgtctaataacaattggtgccgaattccgggacgagaaaaaactcgggactggcgcaaggaagatccctcattccagaaccagaactgcgggtcgcggtaataaaggttcccgtaaagcagactgttaagaaggattcaactgtatgaattcagaacttttcagctggggaacgagagtaccagtgagtacagctttacgaggtaagt	449	52	12%	42	9%
4	108284101	108285450	tacaagatggcgctgacagctgtgttctaagtggtaaacaaataatctgcgcatgtgccgagggtggttctccactccatgtgctctgccttccccgtgacgtcaactcggccgatgggctgcagccaatcagggagtgacacgtcctaggcgaaggataattctccttaatagggacggggtttcgttttctctctctcttgcttcttacactcttgctcctgaagatgtaagcaataaagttttgccgcagaagattctggtctgtggtgttcttcctggccgggcgtgagaacgcgtctaataacaattggtgccgaattccgggacgagaaaaaactcgggactggcgcaaggaagatccctcattccagaaccagaactgcgggtcgcggtaataaaggttcccgtaaagcagactgttaagaaggattcaactgtatgaattcagaacttttcagctggggaacgagagtaccagtgagtacagctttacgaggtaagtctggtcttgaactttctaaggaaattcaagacagtctatcagaagtaaagtggaatatgtttggccttgaattttttctggtgttaggagcccttttgttccttttcacatgttatcaagtgattaagatagggctgaaaattctagaggaaattcaggacaagctatcagaagtaaagtggggagagagagtaggaacaaagaggaaatatggtacacaaaataagtatacaggcctttccaagggtcttgaacccgaggaaaagttaaggttaggtaggaatacctggagagagattagaagaaaaagaggaaaaagggaaaagaagaaagatcaattagcggaggtctctaggaaaaggagcctgtgctcatcgctggatgggctcggggagccagctcttggtagctctgaatcagatgatgaattctcctctgaagaaacagactgggaggaagaagcagctcattatgagaaaaaagggtaccagccaggtaaagtgctagctaatcagttaaggaagccaaaagcggctggcgaaggccagtttgctgattggcctcagggcagtcggcttcaaggtccgccctatgcggagtccccgccctgcgtagtgcgtcagccctgcgcagagaggcaatgcgcagagaggcagtgcgcagactcattcattcccagagaggaacaaaggaaaatacaacaggcatttccggtctttgaaggagccgagggtgggcgtgtccacgctccggtagaatacttacaaattaaagagcttgccgagtcggtccgtaaatacggaaccaatgctaattttaccttggtgcagttagacaggctcgc	1349	104	8%	144	11%
4	115281301	115281450	cgagagcgagtggcggaaacccatccccttttttaggagcgttatatttcgcctaggacgcatcactccctgattggctgcagcccatggccgagctgacgttcacgggaaaggcagagtacaagtagtcataaaatacccttggcaca	149	18	12%	22	15%
4	115605901	115606350	taatcgcgttctcacgcccggccaggaagaacacaacagaccagaatcttctgcggcaaaactttattgcttacatcttcaggagcaggagtgcaaaaaccccaaaccccaaaaacgaaagcccccttcttacatctttaggagccagagctccggcgcgccggggcgcagagcgcgctctattgtttacatctttaggcagcgagcgagcgcagggcgcgcagagccagagagatgccagcgagagagaatggcggaaaccccgtccccttttttaggagcgttatatttcgcctaggacgcatcactccctgattggctgcagcccatggccgagctgacgttcatgggaaaggcagagtacaagtagtcgtaaaatacccttggcacatgcgcagattatttgtttaccacttagaacacaggatgtcagcgccatcttgtgacgg	449	60	13%	74	16%
4	117192151	117193500	ttacaagatggcgctgacatcctgtgttctaagtggtaaacaaataatctgcgcatgtgccaagggtatcttatgactacttgtgctctgccttccccgtgacgtcaactcggccgatgggctgcagccaatcagggagtgacacgtccgaggcgaaggagaatgctccttaagagggacggggtttcgttttctctcgctcttgcttcttgctctcttgcttcctgcaccctggctcctgaagatgtaagaaataaagctttgccgcagaagattctggtctgtggtgttcttcctggccggtcgtgagaacgcgtctaataacaattggtgccgaattccgggacgagaaaaaactcgggactggcgcaaggaagatccctcattccagaaccagaactgcgggtcgcggtaataaaggttcccgtaaagcagactgttaagaaggattcaactgtatgaattcagaacttttcagctggggaacgagagtaccagtgagtacagctttacgaggtaagtccgatcttgaactttctaacgaaattcaagacagtctatcagaagtaaagtggaatatgtttggccttgaattttttctagtgttagaagcccttttgttccttttcacatgttatcaagtggttaagatagggcggattctagatgaaattcaggacaagctatcagaagtaaagcggggagagagagtaggaacaaagaggaaatatggtacacaaaataagtatacaggcctttccaagggtcttgaacccgaggaaaagttaaggttaggtaggaatacctggagagagattagaagaaaaagaggaaaaagggaaaagaagaaagatcaattagcggaggtctctaggaaaaggagcctgtgctcatcgctggatgggctcggggagccagctcttagtagctctgaagcaggtgaagaatcctcctctgaggaaacagactgggaggaagaagcagcccattaccagccagctaattggtcaagaaaaaagccaaaagcggctggcgaaggccagtttgctgattggcctcagggcagtcggcttcaaggtccgccctatgcggagtccccgccctgcgtagtgcgtcagcaatgcgcagagaggcagtgcgcagagaggcagtgcgcagactcattcattcccagagaggaacaaaggaaaatacaacaggcatttccggtctttgaaggagccgagggtgggcgtgtccacgctccggtagaatacttacaaattaaggaaattgccgagtcggttcgtaaatacggaaccaatgctaattttaccttggtgcagttagacaggctcgctggcatggca	1349	114	8%	146	11%
4	117192151	117193500	ttacaagatggcgctgacatcctgtgttctaagtggtaaacaaataatctgcgcatgtgccaagggtatcttatgactacttgtgctctgccttccccgtgacgtcaactcggccgatgggctgcagccaatcagggagtgacacgtccgaggcgaaggagaatgctccttaagagggacggggtttcgttttctctcgctcttgcttcttgctctcttgcttcctgcaccctggctcctgaagatgtaagaaataaagctttgccgcagaagattctggtctgtggtgttcttcctggccggtcgtgagaacgcgtctaataacaattggtgccgaattccgggacgagaaaaaactcgggactggcgcaaggaagatccctcattccagaaccagaactgcgggtcgcggtaataaaggttcccgtaaagcagactgttaagaaggattcaactgtatgaattcagaacttttcagctggggaacgagagtaccagtgagtacagctttacgaggtaagtccgatcttgaactttctaacgaaattcaagacagtctatcagaagtaaagtggaatatgtttggccttgaattttttctagtgttagaagcccttttgttccttttcacatgttatcaagtggttaagatagggcggattctagatgaaattcaggacaagctatcagaagtaaagcggggagagagagtaggaacaaagaggaaatatggtacacaaaataagtatacaggcctttccaagggtcttgaacccgaggaaaagttaaggttaggtaggaatacctggagagagattagaagaaaaagaggaaaaagggaaaagaagaaagatcaattagcggaggtctctaggaaaaggagcctgtgctcatcgctggatgggctcggggagccagctcttagtagctctgaagcaggtgaagaatcctcctctgaggaaacagactgggaggaagaagcagcccattaccagccagctaattggtcaagaaaaaagccaaaagcggctggcgaaggccagtttgctgattggcctcagggcagtcggcttcaaggtccgccctatgcggagtccccgccctgcgtagtgcgtcagcaatgcgcagagaggcagtgcgcagagaggcagtgcgcagactcattcattcccagagaggaacaaaggaaaatacaacaggcatttccggtctttgaaggagccgagggtgggcgtgtccacgctccggtagaatacttacaaattaaggaaattgccgagtcggttcgtaaatacggaaccaatgctaattttaccttggtgcagttagacaggctcgctggcatggca	1349	114	8%	146	11%
4	118547101	118548750	ggaggtagaggtggcagtgggcgtgcaggagaagctgaggtcgggaggtagaggtggcagtgggcgtgcaggagaagctgtaggtcggaaggtagaagtggcagtgggcgtgcaggagaagctgtaggtcgggaggtagaggtggcagtgggcgtgcaggagaagctgtaggtcagggggtagaggtggcagtgggcgtgcaggagaagctgtaggtcgggaggtagaggtggcagtgggcgtgcaggagaagctgtaggtcagggggtagaggtggcagtgggcgtgcaggagaagctgtaggtcaggaggtagaggtggcagtgggcgtgcaggagaagctgtaggtcagggggtagaggtggcagtgggcgtgcaggagaagctgtaggtcaggaggtagaggtggcagtgggcgtgcaggagaagctgtaggtcaggaggtagagttggcagtgggcgtgcaggagaagctgtaggtcggagaggtagaggtggcagtgggcgtgcaggagaagctgtaggtcagggggtagaggtggcagtgggcgtgcaggagaagctgtaggtcagagtggataggtggcagtgggcgtgcaggagaagctgtaggtcaggaggtagaggtggcagtgggcgtgcaggagaagctgtaggtcaggaggtagaggtggcagtgggcgtgcaggagaagctgtaggtcaggaggtagagttggcagtgggcgtgcaggagaagctgtaggtcggagaggtagaggtggcagtgggcgtgcaggagaagctgtaggtcggggggtagaggtggcagtgggcgtgcaggagaagctgtaggtcggggggtagaggtggcagtgggcgtgcaggagaagctgtaggtcgggaggtagaggtggcagtgggcgtgcaggagaagctgtaggtcagggggtagaggtggcagtgggcgtgcaggagaagctgtaggtcggagaggtagaggtggcagtgggcgtgcaggagaagctgtaggtcggggggtagaggtggcagtgggcgtgcaggagaacctgtaggtcagggggtagaggtggcagtgggcgtgcaatagaagctgtaggtcggggggtagaggtggcagtgggcgtgcaggagaagctgtaggtcagagtggagaggtggcagtgggcgtgcaggagaagctgtaggtcagggggtagaggtggcagtgggcgtgcaggagaagctgtaggtcagggggtagaggtggcagtgggcgtgcaggagaagctgtaggtcaggaggtagaggtggcagtgggcgtgcaggagaaggtgtaggtcagggggtagaggtggcagtgggcgtgcaggagaagctgtaggtcgggaggtagaggtggcagtgggcgtgcaggagaagctgtaggtcagggggtagaggtggcagtgggcgtgcaggagaagctgtaggtcggggggtagaggtggcagtgggcgtgcaggagaaggtgtaggtcaggaggcagaggtggcagtgggcgtgcaggagaagctgtaggtcgggaggtagaggtggcagtgggcgtgcaggagaagctgtaggtcgggaggtagaggtggcagtgggcgtgcaggagaagctgtaggtcggagAGGGTGCAGAGTGGAG	1649	108	7%	192	12%
4	118547101	118548750	ggaggtagaggtggcagtgggcgtgcaggagaagctgaggtcgggaggtagaggtggcagtgggcgtgcaggagaagctgtaggtcggaaggtagaagtggcagtgggcgtgcaggagaagctgtaggtcgggaggtagaggtggcagtgggcgtgcaggagaagctgtaggtcagggggtagaggtggcagtgggcgtgcaggagaagctgtaggtcgggaggtagaggtggcagtgggcgtgcaggagaagctgtaggtcagggggtagaggtggcagtgggcgtgcaggagaagctgtaggtcaggaggtagaggtggcagtgggcgtgcaggagaagctgtaggtcagggggtagaggtggcagtgggcgtgcaggagaagctgtaggtcaggaggtagaggtggcagtgggcgtgcaggagaagctgtaggtcaggaggtagagttggcagtgggcgtgcaggagaagctgtaggtcggagaggtagaggtggcagtgggcgtgcaggagaagctgtaggtcagggggtagaggtggcagtgggcgtgcaggagaagctgtaggtcagagtggataggtggcagtgggcgtgcaggagaagctgtaggtcaggaggtagaggtggcagtgggcgtgcaggagaagctgtaggtcaggaggtagaggtggcagtgggcgtgcaggagaagctgtaggtcaggaggtagagttggcagtgggcgtgcaggagaagctgtaggtcggagaggtagaggtggcagtgggcgtgcaggagaagctgtaggtcggggggtagaggtggcagtgggcgtgcaggagaagctgtaggtcggggggtagaggtggcagtgggcgtgcaggagaagctgtaggtcgggaggtagaggtggcagtgggcgtgcaggagaagctgtaggtcagggggtagaggtggcagtgggcgtgcaggagaagctgtaggtcggagaggtagaggtggcagtgggcgtgcaggagaagctgtaggtcggggggtagaggtggcagtgggcgtgcaggagaacctgtaggtcagggggtagaggtggcagtgggcgtgcaatagaagctgtaggtcggggggtagaggtggcagtgggcgtgcaggagaagctgtaggtcagagtggagaggtggcagtgggcgtgcaggagaagctgtaggtcagggggtagaggtggcagtgggcgtgcaggagaagctgtaggtcagggggtagaggtggcagtgggcgtgcaggagaagctgtaggtcaggaggtagaggtggcagtgggcgtgcaggagaaggtgtaggtcagggggtagaggtggcagtgggcgtgcaggagaagctgtaggtcgggaggtagaggtggcagtgggcgtgcaggagaagctgtaggtcagggggtagaggtggcagtgggcgtgcaggagaagctgtaggtcggggggtagaggtggcagtgggcgtgcaggagaaggtgtaggtcaggaggcagaggtggcagtgggcgtgcaggagaagctgtaggtcgggaggtagaggtggcagtgggcgtgcaggagaagctgtaggtcgggaggtagaggtggcagtgggcgtgcaggagaagctgtaggtcggagAGGGTGCAGAGTGGAG	1649	108	7%	192	12%
4	119926351	119926800	GGGCTGGCTCAGGTAGCAAGGGTAGGATGTGAGGGAAGGTAAGAGCAGGTCTGGGAAGGAGCAGAGGCTGTGAGAGCCTGGCtattgcgtcccgctcgaccggcaagaaagacgcaacaaaccagaatcttccgcggcaaaagctttattgcttgcttctcaggaagatcccaaaccgggaaaatggcgctgcttttataacccgcagcgtgacgtttcagcacctgatatggcgtgacagctcccgattcgttgcttgcccatcaccccactattacaccccgagaatgggagtgactaggagtgaattcactcttgcacctgcgtacaggacttgtttactagttaggcacagcggaggcccgcgccatcttataatggcgattgctcgcggcacacacggctctcctcagagattactggcagcacgcatgcgattgctcgcagca	449	54	12%	68	15%
4	119930251	119930550	aaccagaatcttccgcggcaaaagctttattgcttgcttctcaggaagatcccaaaccgggaaaatggcgctgcttttataacccgcagcgtgacgtttcagcacctgatatggcgtgacagctcccgattcgttgcttgcccatcaccccactattacaccccgagaatgggagtgactaggagtgaattcactcttgcacctgcgtacaggacttgtttactagttaggcacagcggaggcccgcgccatcttataatggcgattgctcgcggcacacacggctctcctcagagatt	299	38	13%	44	15%
4	120111901	120112350	tcaccgtgaacttaccctgccggcaaccactgactgctgaaagttctgaactcggtgggggagtcggttccccgtacgggccaccaattgtcgcgcccgctctcgaccagcaagaacgatgcgaccaccagtccttctaacagcagtttattcagtcttcatctctcttctttctcttcatcagtaccgttccccagctgaagagttctgaatccacgccggatccttctcaacagtctgtttcacgggaacctttattaaccccttcttccccgttatgcagttctgaatcctccctgtagcagggggtcttcgcttgtgcctgaagatgtttcttttcccgggtttcggcaccaCTtgttgcgcgcgctcaactggccaggaagaacgacgctgctacaggatccttctgcacacatttattcagtcctgtttcttctttctccata	449	50	11%	64	14%
4	121172551	121173150	acctgtcttggtctggtgtctgtgttctgtttctaagtttggtgtgaccgcagttttggttttgcggacgctcagtgagaccgcgctccgagagggaacgcggggtggataaggatagacgtgtccaggtgtccaccgtctgttcgccctgggagacgtcccaggaggaacaggggaggaccagggacgcctggtggacccctttggaggccaagagaccatctggggttgcgagatcgtgggttcgagtcccacctcgtgccttgttgcgagatcgtgggttcaagtcccacctcgtgttttgttgcgagatcgtgggttcgagtcccacctcgcgccttgttgcgagaccgtgggttcgagtcccacctcgtgttttgttacgggatcgtgggttcgagtcccacctcgtgcagagggtctcaatcggccagccttggaaaggccatctgattctttgagttgcttgtggtcgacgtgaagtcgccgctgcttttggtttcttttttgtcttagtctcgtgttcgctcttgttgtgtctactattattctggaaatgggacaatctgtgtccactcccctttctttaactctggagc	599	80	13%	42	7%
4	122213101	122213400	ctgaagatgtaagaataaagctttgccgcagaagattctggtctgtggtgttcttcctggccggtcgtgagaacgcgtctaataacaattggtgccgaattccgggacgagaaaaaaactcgggactggcgcaaggaggatccctcattccggaaccagaactgcggatcacgtttataaaggttcccgtaacacagactgttgagaaggattcaactgccgaattcagaactcatcagctggggaacgacggtgataaagtgttcccataaaacagactgttgagaaggattcaactg	299	34	11%	30	10%
4	127013251	127013400	tacaattagttttgttatctagaagatctcctgtttatattactcatgttagagcccattcaggcctacctggccccatggctctgggaaatgatttggcagataaggccactaaagtggtggctgctgccctatcatccccggtagag	149	2	1%	16	11%
4	128355001	128356350	cggcaggagttagtgccatgccggcaagcctgtctaactgcaccaaggtaaaattagcattggttccgtatttacggaccgactcggcaagctctttaatttgtaagtattctaccggagcgtggacacgcccaccctcggctccttcaaagaccggaaatgcctgttgtattttcctttgttcctctctgggaatgaatgagtctgcgcactgcctctctgcgcattgcctctctgcgcagggctgacgcactacgcagggcggggactccgcatagggcggaccttgaagccgactgccctgaggccaatcagcaaactggccttcgccagccgcttttggcttccttaactgattagctagcactttacctggctggtacccttttttctcataatgagctgcttcttcctcccagtctgtttcttcagaggagaattcttcatctgcttcagagctactaagagctggctccccgagcccatccagcgatgagcacaggctccttttcctagagacctccgctaattgatctttcttcttttccctttttcctctttttcttctaatctctctccaggtattcctacctaaccttaacttttcctcgggttcaagacccttggaaaggcctgtatacttattttgtgtaccatatttcctctttgttcctactctctctccccactttacttctgatagcttgtcctgaatttcctctagaatcctccctgccttaaccacttgataacatgtgaaaaggaacaaaagggcttctaacactagaaaaaattcaaggccaaacattttccactttacttctgatagactgtcttgaatttccttagaaagttcaagatcagacttacctcgtaaagctgtactcactggtactctcgttccccagctgaaaagttctgaattcatacagttgaatccttcttaacagtctgctttacgggaacctttattaccgcgacccgcagttctggttctggaatgagggatcttccttgcgccagtcccgagttttttctcgtcccggaatttctcgtcccggaattcggcaccaattgttattagacgcgttctcacgcccggccaggaagaacaccacagaccagaatcttctgcggcaaaactttattgcttacatcttcaggagccagagtgcaagaagcaagagagagagaaaacgaaaccccgtcccttttttaggagagttatatttcgcctaggacgtgtcactccctgattggctgcagcccatcggccgagttgacgtcacggggaaggcagagcacatggagtggagaaccaccctcggcatatgcgcagtttatttgtt	1349	108	8%	150	11%
4	135660751	135660900	catgtgcttatatgtgtgtgtatgtgtgcatgcacatgtgtatgtgtgtatatatatgtgtgtgtgtgcacatgagtgtgtgcattatgtgtgtgtacgcacatgtatgtatgtgtatatatgtgtgggtctgtgtatgtttacacaca	149	2	1%	24	16%
4	137195551	137195700	CTCTGTCCATCTGAGGTGCCTCATGTTTCTTCCAAAGAAGGAAGAAAAAGCACACAGGCCAGGTGACAATGcacagagcacacgtacatgcacacacacacacacaaaacacatacacacgtaacacatgcatatgcacacatacacac	149	4	3%	66	44%
4	137506051	137506350	acacacgaagaaatagttgggaatgtgtttgtgtgtttatgtgtgtacacaccattctttatgtaaTGTAGGCATATTGTACAGATGGATTTGGTTATTATTTTTCTGGCATCTGCTAGTTGCGTATGTGTTATATGTGCACATGTGGGTGTGCATGTACTTACACATGCAAATGTCCGGCTCATCTGACACTAGAGAGTTCAATCCACAATTCCAACGCAAGATCATTGTGCTGCCCAGCCGTCCGTTACTGTGATGTAGTCAGCGTAGACGGGAGAAAGATTTCCTTTGGTTCACAG	299	16	5%	52	17%
4	138327451	138327600	acaaataatctgcgcatgtgccaagggtattttacgactacttgtactctgcctttcccgtgaacgtcagctcggccatgggctgcagccaatcagggagtgatgcgtcctaggcgaaatataactctcctaaaaaggggacgggtttt	149	16	11%	16	11%
4	140369851	140370300	acacatatgtacatacatgcaggaacacacatgcatgcacatacataagcacacacgcgcacatgcacacacacatatgcacatgtacacacgcatacatacatgcacaccatacatacagacacatgtatgcacatacacaaccacacacacatgcacatgcacacacatatgcacatgtacacacacatacatacatgcacaccatacatgcagacatatgtacatgcatgtagaaacacacatgtatgcacacacacgcacacacgcacacacgcacacacacacacattcataccatcaccagctcctcaaaggcATCGTGAGCTCCCATGTGACACACATGGGTTCCTCTCAGCACCAGAGTCGCAGGGCCTGGCACATAAAAGCAACTCCTCAGAGCtacccaaggttggatcatttataaagaactgaaatgaattctccca	449	16	4%	214	48%
4	141517051	141517500	ATGTCGTCCCTGTAGATATCCCTGTGTACCACACTGGGCAGTGTAAACTGCTCCCGGGCCCTAGGTTCGTATCGGGGGTCATGAGCATCAAAGCGGTTTGGACTTCGACTCCGAGAAGTGTAATAGAGCCCGTGTTGTAAAGTCCGCTCTCGAGGGTCTCTATAGTAATCCTGATCGTAATGTCTTGTCCGATCAAATGCTCCTGTCCCCCGTTCATGGTGTCCATAGGCACTATGTTCATAAGCACGCTCCCTGTTATCTGAAGCCCTGCATTTAGGAGGGGAAAATATTTAATCAGAAAGGAGCACGCAAAACTGAATGCAAGTCATGCAAACATTCACGTCAGAGCTGCCTTTACGCCTCGCCTCTTTCTGAGCAGCACAAACCTCGGTGTAAGCAAACACTCACATGCCAGGCGTCTCACCTGACTCCAGACGGCACGAACGTGC	449	46	10%	66	15%
4	142936501	142936800	ggtttgtggcacaggcgccggcgggagccttcttggctccgggactccgcggagggcaggctgcacgggtgaccgtgtggaatacagagtgccagccgtttctgggacgggcgagagagtcgcagagattctggggcggcgccatcttcagctccagacaaccagccaccttcccggcaagagccacagagcttctgaggcggcgccaacctcagctccagacggccggcctccttccggacaagagccacagagcttctgaggcggcgacatcttcgactccagacaactggccacct	299	46	15%	52	17%
4	145455601	145455750	atctctaatgttgttgtactaaatattgacCATGGCTGAGACCGAGGATCGGAGCCTGGAAAACTTCTTCGCCAAGAGGGACAAGAAGAAGAAGGAACGAAGCAGTCGGGCGGCCAATTCGGTGAGCAACATGGACGGGAGCAGCACGT	149	18	12%	18	12%
4	145456951	145457250	CAAGCTGCTGTCTGAAATGATGTGTTTGtgtgcagagccgtgcagcgatcaatcgagtgtgtgctgtgagcaatcgccattataagatggcgctggcttccactgtgcctaactagtaaataagccttatgcgcaagtgcaagagtaaactcacgcctagtcactgcccatctcgcggcatagtaatgggatgatgggcaagcaatgaatcaggagctgtcaagccacatcaggtgctgaaatatcacgctgcaggctatataagcagcgccattttcccggttcggggtcttccctcc	299	26	9%	48	16%
4	146060251	146060400	ctagtcactgcccatctcgtggcatagcaatgggatgatgggcgagcaatgaatcaggagctttcaagccacatcaggtgctgaaacatcacgctgcaggctatataagcagcgccattttcccggttcggggtcttccctcctgataa	149	12	8%	30	20%
4	146825551	146825700	gaactcagaacctcttgcagaactgtcagtgctcccacccactgagccatatctccagccTAACTAATTTTTAAAAAAGATTTTTTGGTTACCTTTGTTatatacacagggacacatacacgcatgtacgcatacacacacacatgctg	149	4	3%	38	26%
4	147086701	147087150	GAGCATTGGGGTCTTTTATCTTTCCTTTCTTACCCCCTTTGGGAGGAACATAGTTCTTCATCTCCCTGTCATAACGAGCTTTGTCGCTCTTGGCCAAATCTTCAAATTTGGACTTTTCCTTTGAAGACATGGTCTTCCATCTCTCGGAGCATTTCTTGGAGAACTCAGCGAAGTTCACCGACGAGTGGGGATGCTTCTTCTTGTGCTCCTCGCGGCAGGTCTGTACGAAGAAGGCGCGTACGAGGACATTTTGCCCCGCGGCTTGTTGGGGTCACCCTTGCCCATGACGATGGCTCTGCGTCTGTCTACCTGCTGCGAGCGCTGCTTCCCTCAGACCTCCGCAGAGAGACTTCCTTCCCCAAGCTCCAGCGAGAACTGGTTTCTCGCTAACGCACTCCCCAGCCTCTTGTTTTGCAGAGTTCTCCGCGCCACGGAAACTTGACcatgat	449	50	11%	48	11%
4	147181501	147181800	ccccagaaatggtgctacttatataggcctagggagtgacatgtccataactgattggttatgctaccagtacctcattaatatgcctcgagccaggcagtgactctgcaaaaaactctggcacatgcgcacattggttgtttacccatattcatgggcattggcttactgaaaccagtgccatcttgtaatggcgtttgcggcttcccacatctccccctttttattgtaataaaatgatgctggattaggcctatgcaattatgtccatccgctacggctcctgttttaggtcgttc	299	14	5%	42	14%
4	147268651	147269100	CATACTCTGTAGGCTGTGGCTATGTTAGACTCCCTGGATCAAGCTGCTGTCTGAAATGATGTGTTTGtgtggagagccgtgccgcgagcaatcgcgtgcctgccgtgagcaatcgccattataagatgtcgctggcttccactgcgcctaactagtaaataagccttatgcgcaagtgcaagagtgaactcacgcctagtcactgtccatctcgctgcgtagtaatggggtgatgggcgaacaacgaatcaggagctgtcacgccacatcaggtgctgaaacgtcacactgcaggctatagaagcagcgccattttcccggttcggggtcttccctcctgataagtaagcaataaaagctttgccgcagaagattccagttgtcctgagtgtgttcttgccggcggggacaaaagctcgggataAGtggcgctgagaagcccaggaact	449	50	11%	54	12%
4	147271801	147272250	ggtggcgatagggttaccctatgacaggaaaggctgtgacattggaggaatgacctaagacaggagccacagcagatggacatgactgcagaggcctagaccagcctcaaattttaataaaataaaaagggggagatgtggagagccgtgctgcgagcaaatgcgtgcgtgccgtgagcaatcgccattataagatggcgctggcttccactgcgcctaactagtaaataagccttatgcgcaagtgcaagagtgaactcacgcctagtcaatgcccatctcgcggcgtagtaatgggatgatgggcaagcaacgaatcaggagctgtcatgccacatcaggtgctgaaatgtcacgctgcgggctatataagcaacgccattttcccggttcgggatcttccctcctgataagtaagcaataaaagctttgccgcagaagattccggt	449	44	10%	62	14%
4	147528001	147528300	TGCATCTTCTTCAGGCCTTTCTTGTTGTGCTTCTTGGCAAAGCGCATGTTTCTCAGGAACTTGGGGTCAACCCCCTTAAGAGGTTCGTATCTTTGCGACCGGGGTTTCTTGATGCCATTTCTGTGCCATTTGCGGGACTGGTTGTGTGTGGTGTGGTTCTTGGACTTGGTCATGTCTGCACGGTAACCCGCGGCTCCCCTAGATTTTTTTGATCTGGAATATTTGGAGAATTCTTTAGATACTCTTCATTTCACGGTGCAGATAGTTTGTGCATATTCACATGTCATGTTTCCATTGTT	299	18	6%	36	12%
4	147545251	147545400	tgtccggtgcaccaatctgttctcgtgttcaattcatgtatgttcgtgtccagtctgtatgaatgaatgttctatgttttgtgttagataataaagatggtataaaaaactttatctgcaaagccgagagctgccacgtgtttcatcca	149	10	7%	18	12%
4	147651751	147651900	ctcacctcgtccagcaagaaaaaacgcaacacggtcggattcttctcaacagccttttttatttcaggaacacctcgatgctacgggaactctggaaacccagggaggactgcttatatacaccccagcactggggagagctacgagtc	149	14	9%	26	17%
4	147667501	147667800	ccgcccagacggactcctagagtccttcccctcgctcagggcgttcccagagcgagcagcagccggtgattccagcacgtctgctgttcacactcagtgcctcatcccgaggcaaaggtctctgtttctcacgaaacgtcgcggctgcaaatttcagcacagaacctagccggcttacagaaatatttttggacaaaaaaaatctcacctccaagtgggtcttcggagacatgggtggtcacgccaatcccggacgagcccccaaatgaaagactccatgaggagcccctcgctcaggc	299	36	12%	54	18%
4	149881351	149881800	tacacaaagacacatagacacacaatcacacgaatacagacatacacatagacacacagacacacagacacacacacacagaaacacacacacacacacacacacagacacacagatgcatacacacagagacacaaacacacacacacaaacacacagagacgcatacacacagaaacacaaatatagacacacacatgcacacacagacacatacatactaacacagacacacatacatacacaaagacacacagacacacaaatacagacatacacatagacacacaatcacacaaatacagacatacacatagacacacaatcacacagacacagacatacacatagacacacaatcacacaaatacagacatacatatagacacacaatcacacagacacacagatacacacacacacacacacacacacacacacagtgagcg	449	6	1%	286	64%
4	150514801	150515550	cgtccaggtgttcgtgcaggcatgtgtgtgtgtgtgtgtaaggggaaggatactgacgtccaggcgtctgtgcaggcatgtgtgtgtaaggggaaggatactgatgtccaggcatctgtgcaggcatgtgtgtgtgtgtgtaaggggaaggatactgtcgtccaggcgtccgtgcaggcatgtgtgtgtaaggggaaggatactgacgtccaggcgtccgtgcaggcatgtgtgtgtaaggggaaggatactgacgtccaggcgtccgtgcaggcatgtgtgtgtaaggggaaggatactgacgtccaggcatccgtgcaggcatgtgtgtgtaaggagaaggatactgacttccaggcatccgtgcaggcatgtgtgtgtaaggggaaggatactgacgtccaggcatccgtgcaggcatgtgtgtgtaaggagaaggatactgacttccaggcatccgtgcaggcatgtgtgtgtaaggggaaggatactgacgtccaggcgtccgtgcaggcatgtgtgtgtaaggggaaggatactgacgtccaggcatccgtgcaggcatgtgtgtgtaaggggaaggatactgacgtccaggcatccgtgcaggcatgtgtgtgtaaggagaaggatactgacgtccaggcatccgtgcaggcatgtgtgtgtaaggggaaggatactgacgtccaggcatccgtgcaggcatgtgtgtgtaaggagaaggatactgacttccaggcatccgt	749	62	8%	112	15%
4	151146301	151146450	gtgtgtatgtgtttgtgtgtggtgtgtatgtgtggtgtaagtgtgtatgtgtgtggtatgtaatcatgtgtgtgtatgtgtgtgtgtgtgtgtggtatgtgtgtggaatgtaatcatgtgagtgtgtgtgtgagtgcgtgtgGCTTTTC	149	2	1%	4	3%
4	151866001	151866150	tgtgtgtgtacagtgtatctatgcagtgtgtatgcagtgtgtgtgtgcagtgtgtgctgtgtgtctgtgtgtgtggtatgtgtgtgtgtgtgtatgtgcgtgtgcagtgcgtctatgcagtgtgtgtgtgtgtgcagtacgtgtgtgca	149	6	4%	16	11%
4	154680751	154680900	tcctgtgccattgtacatcctgtgccattgtacatcctgtgccattgtatgtcctgtgccattgtacatcctgtgccattgtatgtcctgtgccattgtatgtcctgtgccattgcacatcctgtgccattgtacgtcctgtgccattg	149	2	1%	28	19%
5	3436651	3436800	ctctgcagtgtgaggccatgtctaaggttacccatgctctgcagtgtgaggccatgtctaaggttacccgtgctctgcagtgtgaggccatgtctaaggttacccatgctctgcagtgtgaggccatgtctaaggttacccgtgctctg	149	4	3%	20	13%
5	3437551	3437850	ccgtgtctaaggttacccatgctctgcagtgtggggccatgtctaaggttacccgtgctctgcagtgtgaggccgtgtctaaggttacccatgctctgcagtgtgaggccgcagtgtgaggccatgtctaaggttacccgtgctctgcagcgtgaggccatgtctaagattactgtgctctgcagtgtgaggccgtgtctaaggttacccgtgctctgcagtgtgaggccgtgtctaaggttacccatgctctgcagtgtggggccatgtctaaggttacccgtgctctgcagtgtgag	299	20	7%	32	11%
5	3613651	3614400	tattgtgtgtgtgctttattgtgtgtgtgctttattgtgtgtgtgctttattgtgtgtgtgctttattgtgtgtgtgctttattgtgtgtgtgctttattgtgtgtgcgctttattgtgtgtgcgctttattgtgtgtgcgctttattgtgtgtgcgctttattgtgtgtgcgctttattgtgtgtgcgctttattgtgtgtgcgctttattgtgtgtgcgctttattgtgtgtgcgctttattgtgtgtgcgctttattgtgtgtgcgctttattgtgtgtgcgctttattgtgtgtgcgctttattgtgtgtgcgctttattgtgtgtgcgcttcattgtgtgtgcgcttcattgtgtgtgcgcttcattgtgtgtgcgcttcattgtgtgtgcgcttcattgtgtgtgcgcttcattgtgtgtgcgcttcattgtgtgtgcgcttcattgtgtgtgcgcttcattgtgtgtgcgcttcattgtgtgtgcgcttcattgtgtgtgcgcttcattgtgtgtgcgcttcattgtgtgtgcgcttcattgtgtgtgcgcttcattgtgtgtgcgcttcattgtgtgtgcgcttcattgtgtgtgcgcttcattgtgtgtgcgcttcattgtgtgtgcgcttcattgtgtgtgcgcttcattgtgtgtgcgcttcattgtgtgtgcgcttcattgtgtgtgcgcttcattgtgtgtgcgcttcattgtgtgtgcgcttcattgtgtgtgtg	749	80	11%	52	7%
5	5945101	5945250	acctgtaatctagtcttctttattatacgcatgtttatacctgtaatctagtttatacctgtaatctagtcttctttattatacgcatgtttatacctgtaatctagtttatacctgtaatctagtcttctttattatacgcatgttta	149	6	4%	6	4%
5	6257551	6257700	tacttgctctctcttacttgcgctctcttgtttgcgctctgcgctctggcgctctggcgcgctggcgctctggctcctaaagatgtaagcgggggggctttcgtttttgggcttgggggcttgcgctcctgctcctgaagatgtaagca	149	20	13%	2	1%
5	10622101	10622550	cgctccgagagggaacgtggggtggataaggatagatgtgtccaggtgtccaccgtccgttcaccctgggagacgtcccaggaggaacaggggagaaccagggacgcctggtggacccctttggaggccaagagaccatttggggttgcgagatcgtgggtttgagtcccacctcgtgcccagttgcgagatcgtgggttcgagtcccacctcacgttttgttgcgagatcgtgggtttgagtcccacctcgcaccttgttgcgagaccgtgggttcgagtcccacctcgcgtttggtcacgggatcgtgggttcgagtcccacctcgtgcagagggtctcaatcggccggccttagagaggccatctgattctttgagttgcttgtggtcgacgcggagtcgccgccgtttctggtttcttttttgtcttagtctcgtgtccgctctt	449	72	16%	40	9%
5	13862701	13863900	gtttgccagtcggcaggagttagtgccatgccggcaagcctgtctaactgcaccaaggtaaaattagcattggttccgtatttacggaccgactcggcaatttctttaatttgtaagtattctaccggagcgtggacacgcccaccctcggctccttcaaagaccggaaatgcctgttgtattttcctttgttcctctctgggaatgaatgagtctgcgcactgcctctctgcgcagggctgacgcactacgcagggcggggactccgcatagggcggaccttgaagccgactgccctgaggccaatcagcaaactggccttcgccagccgcttttggcttccttaactgattagctagcactttacctggctggtacccttttttctcataatgagctgcttcttcctcccagtctgtttcttcagaggagaattcttcatctgattcagagctaccaagagctggctccccgagcccatccagcgatgagcacaggctccttttcctagagacctccgctaattgatctttcttcttttcttttttcttttctttccttctaatctctccccaggtattcttacctgacctaaacttttcctcgggttcaagacccttggaaaggcctgtatacttattttgtgtaccatatttcctctttgttcctactctctctccccactttacttctgatagcttgccctgaatttcatctagaatccgccctgccttaaccacttgataacatgtgaaaaggaacaaaagggcttctaacactagaaaaaattcaaggccaaacattttccactttacttctgatagactgtcttgaatttccttagaaagttcaaggccaggcttacctcgtaaagctatactcactggtactctcgttccccagctgaaaagttctgaattcatacagttgaatccttcttaacagtctgctttacgggaacctttattaccgcgacccgcagttctggttctggaatgagggatcttccttgcgccagtcccgagttttttctcgtcccggaattcggcaccaattgttattagacgcgttctcacgaccggccaggaaagacgcaacaaaccagaatcttctgcggcaaaactttattgcttacatcttcaggagcaagagtgtaagaagcaagagagagagaaaacgaaaccccgtcccttttttag	1199	90	8%	130	11%
5	16291651	16291950	cgacgcgttctcacgaccggccaggaagaacaccacagaccagaatcttctgcggcaaagctttattcttacatcttcaggaaaagagagcaagaagcaagagagagagaaaacgaaaaccccgtccctcttaaggagcattctccttcgcctcggacgtgtcactccttgattggctgcagcccatcggccgagttgacgtcacggggaaggcagagcacaagtagtcataagatacccttggcacatgcgcagattatttgtttaccacttagaacacaggatgtcagcgccatctt	299	34	11%	56	19%
5	16453501	16453950	ATTAATTCTCTAATATTATAAAACAATGGCTTAACCATTTTCAGCTTAAAACACTCATTTGTTATCTCAGAGTGTGTAACTTTCTGCTTCATTAGAAAAAGGAGTAACAAAAGATATACTTATTAAACATGCTGCTTtcttacacgtgttcacgcaaccggccaggaaagacgcaacaaaccggaatcttctgcggcaaagctttattgcttacatctttaggagccagagtgcaagagagcaagaaagcaagagtacaagagtgcaagagagaaagagagcaagagcaagagcaagagagagcaagaaagcaagaaagcaagaaaaagaacaagaacaagaaagcaagagcaagaaaaagaacaagaacaagaaagcaagaagaacaagaaagcaagagagagaaaaagaaagcaagagagagaaaaagaatggcaaaaccccgtccc	449	14	3%	80	18%
5	16455601	16456050	agaaagttcaaggccagacttaccttgtaaagctatacttacgggtaccctgttccccagctgaagagttctgaattcacgcagttgaatccttctcaacagtctgttttacgggaacacttcattaccaccattccccagctgaagagttctgaattcacgcagttgaatccttctcaacagtctgttttacgggaacacttcattaccatgacccacagttctggttccggaatgagggatcttccttgcaccggtgatggtaaccgtcccaggttttcttgtcccaggtcttctcgtcccgggtcttctcgtcccgggtttcggcaccaaCtcttacacgcgttcacgaccggccaggaagaacgcagcaaaccggaatcttctgcggcaaagctttattgcttacatcttcaggagcaagagagcaagagagcaagagagcaaga	449	40	9%	76	17%
5	16673251	16674600	cacgcccaccctcggctccttcaaagactggaaatgcctgttgtattttcctttgttcctctctgggaatgaatgagtctgcgcactgcctctctgcgcactgcctctctgcgcactgcctctctgcgcatctctctgcgcattgcctctctgcgcatctctctgcgcattgcctctctgcgcatctctctgcgcattgcctctctgcgcatctctctgcgcattgcctctctgcgcatctctctgcgcattgcctctctgcgcatctctctgcgcattgcctctctgcgcattgctgacgcactacgcagggcgggggctccgcatagggcggaccttgaaaccgactgccgggaggttgaacagtacgctggctttcgccagccgcttttggcttttttcttgaccaattagctggctggtaatgggctgcttcttcctcccagtctgtttcctcagaggagaattcttcatctgcttcagagctactaagagctggcttcctgagctcatctagtgacgagtatctcctagagacctccgctaatcgatcttttttcttttcttttttcttttccttccttctaatctctccccaggtattcttacctgacctaaacttttcctcgggttcaagacccttggaaaggcctgtatacttattttgtgtaccatattttctctttgctcctactctctctccccgctttacttctgatagattgccctgaatttcatccagaattttcagccctatcttaatcacctgataacatgtgaaaaggaacaaaagggctcctaacattagaaaaaattcaaggccaaacattttccactttacttctgatagactgtcttgaatttccttagaaagttcaaggccaggcgtacctcgtaaagctgtactcactggtactctcgttccccagctgaaaagttctgaattcatgcagttgaatccttcttaacagtctgctttacgggaacctttattaccgcgacccgcagttctggttctggaatgagggatcttccttgtgccggtcccgagttttcttgtattttttcgtcccggattttttctcgtcccggatttcagcaccaattcttaatAgcgttctcacgcccggccaggaaagacgcaacaaaccaaaatcttctgcggcaaaactttattgcttacatctttgggagccaggagggcaagcgcccagcgcccagccccaaaaacgaaagccccttcaataatgaaaccgaaaccccttccctatttaggagagttatatttcgcctaggacgcatcactccctgattggctgcagcccatggccgagctgacgttcacggga	1349	120	9%	146	11%
5	16673251	16674600	cacgcccaccctcggctccttcaaagactggaaatgcctgttgtattttcctttgttcctctctgggaatgaatgagtctgcgcactgcctctctgcgcactgcctctctgcgcactgcctctctgcgcatctctctgcgcattgcctctctgcgcatctctctgcgcattgcctctctgcgcatctctctgcgcattgcctctctgcgcatctctctgcgcattgcctctctgcgcatctctctgcgcattgcctctctgcgcatctctctgcgcattgcctctctgcgcattgctgacgcactacgcagggcgggggctccgcatagggcggaccttgaaaccgactgccgggaggttgaacagtacgctggctttcgccagccgcttttggcttttttcttgaccaattagctggctggtaatgggctgcttcttcctcccagtctgtttcctcagaggagaattcttcatctgcttcagagctactaagagctggcttcctgagctcatctagtgacgagtatctcctagagacctccgctaatcgatcttttttcttttcttttttcttttccttccttctaatctctccccaggtattcttacctgacctaaacttttcctcgggttcaagacccttggaaaggcctgtatacttattttgtgtaccatattttctctttgctcctactctctctccccgctttacttctgatagattgccctgaatttcatccagaattttcagccctatcttaatcacctgataacatgtgaaaaggaacaaaagggctcctaacattagaaaaaattcaaggccaaacattttccactttacttctgatagactgtcttgaatttccttagaaagttcaaggccaggcgtacctcgtaaagctgtactcactggtactctcgttccccagctgaaaagttctgaattcatgcagttgaatccttcttaacagtctgctttacgggaacctttattaccgcgacccgcagttctggttctggaatgagggatcttccttgtgccggtcccgagttttcttgtattttttcgtcccggattttttctcgtcccggatttcagcaccaattcttaatAgcgttctcacgcccggccaggaaagacgcaacaaaccaaaatcttctgcggcaaaactttattgcttacatctttgggagccaggagggcaagcgcccagcgcccagccccaaaaacgaaagccccttcaataatgaaaccgaaaccccttccctatttaggagagttatatttcgcctaggacgcatcactccctgattggctgcagcccatggccgagctgacgttcacggga	1349	120	9%	146	11%
5	19978351	19978800	gggtaccctgttccccagctgaagagttctgaattcacgcagttgaatccttctcaacaatctgttttacgggaacacttcattaccaccattccccagctgaagagttctgaatccacgctggatccttctcaacggtctgttttacgggaacctttatgaccgtgacccgcagttctggttccggaatgaggaatcttccttgcgccggtgatggttaactcccgtcccgagtttttcttcccgggtttccggcaccaaCtcttacacgcgttctcgcgaccggccaggaagaacacagcaaaccagaatcttctgcggcaaaactttattgcttacatcttcaggagtaagagtgtaaaccccccattgcttacatctttaggagccagagcgccagagcgccagagcgcactctattgtttacatctttaggagcaagagagcaa	449	46	10%	66	15%
5	21100801	21102150	aaacaaataatctgcgcatgtgccgagggtggttctccactccatgtgctctgccttccccgtgacgtcaactcggccgatgggctgcagccaatcagggagtgacacgtcctaggcgaaggataattctccttaatagggacggggtttcgttttctctctctcttgcttcttacactcttgctcctgaagatgtaagcaataaagttttgccgcagaagattctggtttgctgtgttcttcctggccgggcgtgagaacgcgtttaataacaattggtgccgaattccgggacgagaaaaaactcgggactggcgcaaggaagatccctcattccagaaccagaactgcgggtcgcggtaataaaggttcccgtaaagcagactgttaagaaggattcaactgtatgaattcagaacttttcagctggggaacgagagtaccagtgagtacaactttacgaggtaagtctggtcttgaactttctaaggaaattcaagacagtctatcagaagtaaagtggaaaatgtttggccttgaattttttctagtgttagaagcccttttgttccttttcacatgttatcaagtggttaaggcagggaggattctagatgaaattcaggacaatctatcagaagtaaagcggggagagagagtaggagcaaagagaaaatatggtacacaaaataagtatacaggcctttccaagggtcttgaacccgaggaaaagtttaggtcaggtaagaatacctggggagagattagaaggaaggaaaagaaaaaagaaaagaaaaaagatcgattagcggaggtctctaggagatactcgtcactggatgagctcaggaagccagctcttagtagctctgaagcagatgaagaattctcctctgaggaaacagactgggaggaagaagcagctcattatgagaaaaaagggtaccagccaggtaaagtgctagctaatcagttaaggaagccaaaagcggctggcgaaggccagtttgctgattggcctcagggcagtcggcttcaaggtccgccctatgcggagtccccgccctgcgtagtgcgtcagccctgcgcagagaggcaatgcgcagagaggcagtgcgcagactcattcattcccagagaggaacaaaggaaaatacaacaggcatttccagtctttgaaggagccgagggtgggcgtgtccacgctccggtagaatacttacaaattaaagaactcgccgagtcggtccgtaaatatggaaccaatgctaattttaccttggtgcagttagacaggcttgccggcatggcactaactcctgccgactggcaaacggttgtaaaagccg	1349	108	8%	152	11%
5	21100801	21102150	aaacaaataatctgcgcatgtgccgagggtggttctccactccatgtgctctgccttccccgtgacgtcaactcggccgatgggctgcagccaatcagggagtgacacgtcctaggcgaaggataattctccttaatagggacggggtttcgttttctctctctcttgcttcttacactcttgctcctgaagatgtaagcaataaagttttgccgcagaagattctggtttgctgtgttcttcctggccgggcgtgagaacgcgtttaataacaattggtgccgaattccgggacgagaaaaaactcgggactggcgcaaggaagatccctcattccagaaccagaactgcgggtcgcggtaataaaggttcccgtaaagcagactgttaagaaggattcaactgtatgaattcagaacttttcagctggggaacgagagtaccagtgagtacaactttacgaggtaagtctggtcttgaactttctaaggaaattcaagacagtctatcagaagtaaagtggaaaatgtttggccttgaattttttctagtgttagaagcccttttgttccttttcacatgttatcaagtggttaaggcagggaggattctagatgaaattcaggacaatctatcagaagtaaagcggggagagagagtaggagcaaagagaaaatatggtacacaaaataagtatacaggcctttccaagggtcttgaacccgaggaaaagtttaggtcaggtaagaatacctggggagagattagaaggaaggaaaagaaaaaagaaaagaaaaaagatcgattagcggaggtctctaggagatactcgtcactggatgagctcaggaagccagctcttagtagctctgaagcagatgaagaattctcctctgaggaaacagactgggaggaagaagcagctcattatgagaaaaaagggtaccagccaggtaaagtgctagctaatcagttaaggaagccaaaagcggctggcgaaggccagtttgctgattggcctcagggcagtcggcttcaaggtccgccctatgcggagtccccgccctgcgtagtgcgtcagccctgcgcagagaggcaatgcgcagagaggcagtgcgcagactcattcattcccagagaggaacaaaggaaaatacaacaggcatttccagtctttgaaggagccgagggtgggcgtgtccacgctccggtagaatacttacaaattaaagaactcgccgagtcggtccgtaaatatggaaccaatgctaattttaccttggtgcagttagacaggcttgccggcatggcactaactcctgccgactggcaaacggttgtaaaagccg	1349	108	8%	152	11%
5	21105751	21105900	aatatctccatgtgtccattgacacatgttctggcatcatgtttgcttctccgttaaccggagaaaaagcctcacatgtgattcaacattgtcttgaggcatggagtgcttgggggaaacccagactccttaagactgataatggacca	149	4	3%	26	17%
5	21241051	21241500	cccatactagggagagcggcttttacaaccgtttgccagtcggcaggagttagtgccatgccggcaagcctgtctaactgcaccaaggtaaaattagcattggttccatatttacggaccgactcggcaagctctttaatttgtaagtattctaccggagcgtggacacgcccaccctcggctccttcaaagaccggaaatgcctgttgtattttcctttgttcctctctgggaatgaatgagtctgcgcactgcctctctgcgcattgtctctctgcgcactgcctctctgcgcatctctctgcgcattgcctctctgcgcatctctctgcgcattgcctctctgcgcattgctgacgcactacgcagggcgggggctccgcatagggcggaccttgaagccgactgccctgaggccaatcagcaaactggccttcgccagccgcttt	449	56	12%	58	13%
5	23570101	23570550	ccccagaaacgaaagcccctcaataattttaggagccagagctccggcgccgccaaagcgcagagcgtgctctattgtttacatctttaggcagcgagcgagcgcagggcgcgcagagccagagagatgccagcgagagagaatggcggaaaaccccgtcccctttaaggaggagtgacccttcacttaggacgcatcactccctgattggctgcagcccatggccgagctgacgttcacgggaaaagcagagtacaagtagtcataaaatacccttggctcatgcgcagattatttgtttaccacttagaacacaggatgtcaacgccatcttgtgacggcgaatgtgggggcggctcccaacatctccccctttccttttaataagagcaaataggccacccatattaatgagagtggagatagaggtcaaatccccagtgtgtagg	449	46	10%	68	15%
5	23572951	23573400	caccacagaccaaaatcttctgcggcaaaactttattgcttacatctttgggagccaggagagcaagcgcccagcgcccagccccagaaacgaaagcccctcaataattttaggagccagagctccggcgccgccaaagcgcagagcgtgctctattgtttacatctttaggcagcgagcgagcgcagggcgcgcagagccagagagatgccagcgagagagaatggcggaaaaccccgtcccctttaaggaggagtgacccttcacttaggacgcatcactccctgattggctgcagcccatggccgagctgacgttcacgggaaaagcagagtacaagtagtcataaaatacccttggctcatgcgcagattatttgtttaccacttagaacacaggatgtcaacgccatcttgtgacggcgaatgtgggggcggctcccaacaAAA	449	52	12%	78	17%
5	26072701	26073000	agcagtctaatgttagtcattttctaagagccactattactttacgatgtgtcaccccacaaaagattagtataagaaaagatcatctaaagacactaaatgattttcaaaaattattaggagatattgtcctacagtgtggtaaatgtgtagaatttattaataccccttccgtgggtgttaatcctcgcggattgcgacccctagatgtttggcaaatggacgtcacgcatatcccatcttttgggaaattacaatatgtacatgtaaccatcgataccagttctggtgtcctacat	299	16	5%	38	13%
5	33327901	33328200	acgaaagcgccccgcttacatctttaggagccagagctccggcgcgccaaagcgcagagcgcgctctattgtttacatctttaggaccaagcgagcaggcgccagagccagagagagaatggcggaaaccccgtcccctttaaggaggagttatccttcgcttaggacgcatcactccctgattggctgcagcccatggccgagctgacgttcacgggaaaggcagagtacaagtagtcgtaaaatacccttggcacatgcgcagattatttgtttaccacttagaacacaggatgtca	299	40	13%	46	15%
5	33759601	33760200	AAGAATAAAAATGTGAAGAACTTTaaaaaaaaaaaaaaaaaaaaGGAAACGAGGGCTGAGGATAtgttgggagccgcccccacattcgccgtcacaagatggcgctgacatcctgtgttctaagtggtaaacaaataatctgcgcatgtgccaagggtattttacgactacttgtactctgcctttcccgtgaacgtcagctcggccatgggctgcagccaatcagggagtgatgcgtcctaggcgaaatataacgctcctaaaaaaggggacgggttttccgccattctctctcgctggcatctctctggctctgcgcgccctgcgctctctcgctgcctaaagatgtaaacaatagagcgcgctctgcgctttggcgcgccggagctctggctcctaaagattatagaaggggctttcgcttttggggctgggggttttgcgctcctagctcctgaagatgtaagcaataaagttttgccgcagaagattctggtctgttgtgttcttcctggccgggcgtgagaacgctattaagaAggataaaactcaggagtctgggtgcttacatagcaggggaggctatggattctcccaag	599	64	11%	44	7%
5	37687951	37688100	ttagattGTTGTCAAATTTTATCTActcatgtaggggtaaaccctcgtggcgtcaggccattacaggtctggcaaatggatgtcacgcatatttcctcctttgggagaaatcaatatttacgtgtctctattgacacatgttctggcat	149	8	5%	24	16%
5	38134351	38134800	ctcacgaccggccaggaagaacaccacagaccagaatcttctgcggcaaagctttatttcttacatcttcaggagcaagagtgtaagaagcaagagagcaagaagcaagagagagagaaaacgaaaccccgtccctcttaaggagaattctccttcgcctaggacgtgtcactccctgattggctgcagcccatcggccgagttgacgtcacggggaaggcagagcacatggagtgaagaaccaccctcggcacatgcgcagattatttgtttaccacttagaacacagctgtcagcgccatcttgtaacggcgaatgtgggcgcggctcccaacaGCCCATGGTGGACTCCAGAGGGATACCATCCTCATAACCTACTATACTTCCCATAGGGCAGCTCTCTTCTTTCTCAGGGGGGCTTTTTGCTTAGGCCTCTGGGGCAGTCACTG	449	36	8%	80	18%
5	38412451	38412900	ctatctccactctcattaatatgggtggcctatttgctcttattaaaaggaaagggggagatgttgggagccgcgcccacatgcgccgttacaagatggcgctgacagctgtgttctaagtggtaaacaaataatctgcgcatgtgccgagggtggttctccactccatgtgctctgccttccccgtgacgtcaactcggccgatgggctgcagccaatcagggagtgacacgtcctaggcgaaggataattctccttaatagggacggggtttcgttttctctctctcttgcttcttacactcttgctcctgaagatgtaagcaataaagttttgccgcagaagattctggtctgtggtgttcttcctggccgggcgtgagaacgcgtctaataacaACAGACACCTTGAATTTTAACGGGTTGACTCCAGGGAAGAAATGGTCTCAG	449	42	9%	46	10%
5	38474551	38474700	cttttacaaccgtttgccaatcaccaggagtcatagcgtgattcgcaagcctttccacttgtgctatagtgaaattagcactgactccatagttacggaccgactcggcaagctctttaatctgtatatacgctaccggagcgtggaca	149	18	12%	22	15%
5	39067051	39067500	ataggtgtggacacattaatcagtgcacacacgtgcataggtgtggacacattaatcagtgcacactcgtgcataggtgtggacacattaatcagtgcacacacgtgcataggtgtggacacattaatcagtgcacacacgtgaataggtgacacattaatcagtgcacacacgtgcataggtgtggacacattaatcagtgcacacatgtgcataggtgtgtacacattaatcagagcacacatgtgcataggcgacacattaatcagtgcacacacgtgcataggtgtgtacacattaatcaatgcacacacatgcataggtgacacattaatcagtgcacacacgtgcataggtgtgtacacattaaccagtgcacacacgtgcataggtgacacaatcagtgcacacatgtgcataagtgtgtacacattaatcagtgcacacac	449	18	4%	178	40%
5	40477051	40477650	tttacaaccgtttgccagtcggcaggagttagtgccatgccggcaagcctgtctaactgcaccaaggtaaaattagcattggttccgtatttacggaccgactcggcaatttctttaatttgtaagtattctaccggagcgtggacacgcccaccctcggctccttcaaagaccggaaatgcctgttgtattttcctttgttcctctctgggaatgaatgagtctgcgcactgcctctctgcgcactgcctctctgcgcactgcctctctgcgcatctctctgcgcactgcctctctgcgcatctctctgcgcattgcctctctgcgcatctctctgcgcattgcctctctgcgcatctctctgcgcattgcctctctgcgcattgctgacgcactacgcagggcgggggctccgcatagggcggaccttgaaaccgactgccgggaggttgaacagtacgctggctttcgccagccgcttttggcttttttcttgaccaattagctggctggtaatgggctgcttcttcctcccagtctgtttcctcagaggagaattcttcatctgcttcagaactactaagagctggcttcctgag	599	68	11%	68	11%
5	40602001	40602750	GATTCTACAAAAAAGTTAGAATACTAGAAGTCGTTGACATGCTGGCAAATATGGACCCAATCAAATGTATATATTTTAACAGCAGCCAAATCACACTTTATTTATGATAACAACTAAGTTTCTAAAAACCTAATTAGTTTGAAAATTAGAAATATTGCTGTCAGTTTATTTTATAAATATATTGTCACACTTTGTCTATTTGGCTTACTGAATGAGCTCATTAGAAACTGTATCACAATGCCTAAAGATCTAACTTCAGAGTCAAGTTTATAAATTTATTTTATCTAAGAAAAGTCCCATTTCTGTGGCAGAAAACAAGTGAAGTCTATTTAATTCTAAGAATATTTAATTAACATTTTACAAGTTGTTGAATAACTTTTAGACAAATTACATGATATTGTTTTAAACAACTTTGGGCAAATAATCTTACTTTGAATTTAAGAAACTATGAACATAATGAGTAGTATTTTAAAGGAGAATTTAAAAAACATTTTTCTCATAGGGAAAGTCACCCAATATTTAAATTAGAGAAATCATTTGAGCTGTTCTGCAATTATGTATTTTAGTATTACATAGCAGGTAAAATTTAGATTTAAGATTTGtcttacccgcgttcacgcgaccggccaggaagaatgcaacaaaccggaatcttctgcggcaaaactttattgcttacatcttcaggagcaagagtgcaagagagcaagagctctattgcttacatctttaggagccagagcgcaaga	749	18	2%	100	13%
5	40604551	40605150	ttgtaaagctatttcccactttacttctgatagactgtcttgaatttcgttagaaagttcaagaccagacttaccttgtaaagctatacttacgggtaccctgttccccagctgaagagttctgaattcacgcagttgaatccttctcaacagtctgtgttgcgggaacacttcattaccaccgttccccagctgaagagttctgaattcacgcagttgaatccttctcaacagtctgttttacgggaacacttcattaccatgacccgcagttctggttccggaatgagggatcttccttgcgccggtgatggtaaccgtcccaggttttctcgtcccgggatttctcgtcccaggtcttctcatcccgggttttctcgtcccaggttttctcgtcccaggtcttctcgtcccgggtttcggcaccaACtcttacacgtgttctcgcgaccggccaggaagaacgcaacaaaccggaatcttctgcggcaaaactttattgcttacatcttcaggagcaagagtgcaagagagcaagagctctactgcttacatcttcaggagccagagcgcaagagcgctagagtgcaagagccaga	599	60	10%	86	14%
5	41400901	41401500	gcttgtgcagcttcgtgccaaagcgctctctattccatatatttgcccatactagggagagcggcttttacaaccgtttgccagtcagcaggagttagtgccatgtcggcgagcctgtctaactgcaccaaggtaaaattagcattggttccgtatttacggaccgactcggcaatttctttaatttgtaagtattctaccggagcgtggacacgcccaccctcggctccttcaaagactggaaatgcctgttgtattttcctttgttcctctctgggaatgaatgagtctgcgcactgcctctctgcgcactgcctctctgcgcactgcctctctgcgcatctctctgcgcactgcctctctgcgcatctctctgcgcattgcctctctgcgcatctctctgcgcattgctgacgcactacgcagggcgggggctccgcatagggcggaccttgaaaccgactgccgggaggttgaacagtacgctggctttcgccagccgcttttggcttttttcttgaccaattagctggctggtaatgggctgcttcttcctcccagtctgtttcctcagaggagaatttttcatctgcttcaga	599	66	11%	70	12%
5	42285001	42285150	gcactgcctctctgcgcactgcctctctgcgcatctctctgcgcattgcctctctgcgcatctctctgcgcattgcctctctgcgcattgctgacgcactacgcagggcgggggctccgcatagggcggaccttgaagccgactgccct	149	24	16%	20	13%
5	42285901	42286350	attcggcaccaattgttattaacgcgttctcacgcccggccaggaagaacacagcaaaccagaatcttctgcggcaaaactttattgcttacatcttcaggagcaagagtgtaagaagcaagagagcgagaaaacgaaaccccgtccctattaaggagaattatccttcgcctaggacgtgtcactccctgattggctgcagcccatcggccgagttgacgtcacggggaaggcagagcacatggagtggagaaccaccctcggcacatgcgcagattatttgtttaccacttagaacacagctgtcagcgccatcttgtaacggcgaatgtgggcgtggctcccaacaAaacacaaataattcaaccataatagaacaactaatctgatgaaaaattggtaatagatatgtgggcatttctcaagggaagatatacaaattgaaaatc	449	42	9%	78	17%
5	43834501	43835850	gggagagcggcttttacaatcgtttgccagtcagcaggagttagtgccatgccggcgagcctgtctaactgcaccaaggtaaaattagcattggttccgtatttacggaccgactcggcgagttctttaatttgtaagtattctaccggagcgtggacacgcccaccctcggctccttcaaagactggaaatgcctgttgtattttcctttgttcctctctgggaatgaatgagtctgcgcactgcctctctgcgcactgcctctctgcgcatctctctgcgcattgcctctctgcgcatctctctgcgcattgcctctctgcgcatctctctgcgcattgcctctctgcgcatctctctgcgcattgcctctctgcgcatctctctgcgcattgcctctctgcgcattgctgatgcactacgcagggcgggggctccgcatagggcggaccttgaaaccgactgccgggaggttgaacagtacgctggctttcgccagccgcttttggcttttttcttgaccaattagctggctggtaatgggctgcttcttcctcccagtctgtttcctcagaggagaattcttcatctgcttcagagctactaagagctggcttcctgagctcatctagtgacgagtatctcctagagacctccgctaatcgatcttttttcttttcttttttcttttccttccttctaatctctccccaggtattcttacctgacctaaacttttcctcgggttcaagacccttggaaaggcctgtatacttattttgtgtaccatattttctctttgctcctactctctctccccgctttacttctgatagattgccctgaatttcatccagaattttcagccctatcttaatcacctgataacatgtgaaaaggaacaaaagggctcctaacattagaaaaaattcaaggccaaacattttccactttacttctgatagactgtcttgaatttccttagaaagttcaaggccaggcgtacctcgtaaagctgtactcactggtactctcgttccccagctgaaaagttctgaattcatgcagttgaatccttcttaacagtctgctttacgggaacctttattaccgcgacccgcagttctggttctggaatgagggatcttccttgtgccggtcccgagttttcttgtattttttcgtcccggattttttctcgtcccggatttcagcaccaattcttaatcgcgttctcacgcccggccaggaagaacacaacagaccagaatcttctgcggcaaaactttattgcttacatctttgggagccaggagggcaagcgcccagtgcccagccccaaaaacgaa	1349	120	9%	146	11%
5	43834501	43835850	gggagagcggcttttacaatcgtttgccagtcagcaggagttagtgccatgccggcgagcctgtctaactgcaccaaggtaaaattagcattggttccgtatttacggaccgactcggcgagttctttaatttgtaagtattctaccggagcgtggacacgcccaccctcggctccttcaaagactggaaatgcctgttgtattttcctttgttcctctctgggaatgaatgagtctgcgcactgcctctctgcgcactgcctctctgcgcatctctctgcgcattgcctctctgcgcatctctctgcgcattgcctctctgcgcatctctctgcgcattgcctctctgcgcatctctctgcgcattgcctctctgcgcatctctctgcgcattgcctctctgcgcattgctgatgcactacgcagggcgggggctccgcatagggcggaccttgaaaccgactgccgggaggttgaacagtacgctggctttcgccagccgcttttggcttttttcttgaccaattagctggctggtaatgggctgcttcttcctcccagtctgtttcctcagaggagaattcttcatctgcttcagagctactaagagctggcttcctgagctcatctagtgacgagtatctcctagagacctccgctaatcgatcttttttcttttcttttttcttttccttccttctaatctctccccaggtattcttacctgacctaaacttttcctcgggttcaagacccttggaaaggcctgtatacttattttgtgtaccatattttctctttgctcctactctctctccccgctttacttctgatagattgccctgaatttcatccagaattttcagccctatcttaatcacctgataacatgtgaaaaggaacaaaagggctcctaacattagaaaaaattcaaggccaaacattttccactttacttctgatagactgtcttgaatttccttagaaagttcaaggccaggcgtacctcgtaaagctgtactcactggtactctcgttccccagctgaaaagttctgaattcatgcagttgaatccttcttaacagtctgctttacgggaacctttattaccgcgacccgcagttctggttctggaatgagggatcttccttgtgccggtcccgagttttcttgtattttttcgtcccggattttttctcgtcccggatttcagcaccaattcttaatcgcgttctcacgcccggccaggaagaacacaacagaccagaatcttctgcggcaaaactttattgcttacatctttgggagccaggagggcaagcgcccagtgcccagccccaaaaacgaa	1349	120	9%	146	11%
5	45395401	45396000	tagttcatattattgttccacctattgttgggagccgcgcccacattcgccgttacaagatggcgctgacatcctgtgttctaagtggtaaacaaataatctgcgcatgtgccaagggtatcttatgactacttgtgctctgccttccccgtgacgtcaactcggccgatgggctgcagccaatcagggagtgacacgtccgaggcgaaggagaattctccttaaaaagggacggggtttcgttttctctctctcttgcttcttgctctcttgcttcctgcaccctggctcctgaagatgtaagaaataaagctttgccgcagaagattctggtctgtggtgttcttcctggccggtcgtgagaacgcgtctaataacaattggtgccgaattccgggacgagaaaaaactcgggactggcgcaaggaagatccctcattccagaaccagaactgcgggtcgcggtaataaaggttcccgtaaagcagactgttaagaaggattcaactgtatgaattcagaacttttcagctggggaacgagagtaccagtgagtacagctttacgaggtaagtccgatcttgaactttctaacgaaa	599	66	11%	54	9%
5	45396601	45396750	gcagtgcgcagactcattcattcccagagaggaacaaaggaaaatacaacaggcatttccagtctttgaaggagccgagggtgggcgtgtccacgctccggtagaatacttacaaattaaggaaattgccgagtcggttcgtaaatacg	149	18	12%	24	16%
5	45414601	45415050	gggaaggtggctggttgtctggagctgaagatggcgccacccagaagctctgcgactctcgcccgtcccagaaatggctggcactctgtattccacacggtcacccgtgcagcctgccctccgcggagtcccggagccaagaaggctcccgccggcgcctgtgccacaaacctctcaggccgggcagacccccgtgctctcaccaggaaggtggccggctgtctggagctgaagatggcgccgcccagaagctctgcgactctcgcccgtcccagaaatggctggcactctgtattccacacggtcacccgtgcagcctgccctccgcggagtcccggagccaagaaggctcccgccggcgcctgtgccacaaacctctcaggccgggcagacccccgtgctctcaccaggaaggtggccggctgtctggagctCGCAGGTGATTTTTT	449	64	14%	60	13%
5	49191451	49192050	ttttatacctttcctgccatgaaggattgtatattttcaaatgaaaagctaaaTtgttgggagccgcccccacattcgccgtcacaagatggcgctgacatcctgtgttctaagtggtaaacaaataatctgcgcatgtgccaagggtattttaccactacatgtactctgcctttactcggccatgggctgcagccaatcagggagtgatgcgtcctaggcaaagaataattctccttaaaaggggacggggtttccgccattctctctcttacttgcgctctcttgcttgcgctttcgctctggcgcgctggcgcgctggcgctctggctcctaaagatgtaagcgggggctttcgtttttggggcttggggcttgcgctcctggctcctgaagatgtaagcaataaagttttgccacagaagattcgggtttgttatgttcttcctggccggtcgtgagaacgcgtttaagaGttggtgctgaaacccgggacgggacgagaaaatcctgggacaagaaaacctgggacggttaccatcaccggcgcaaggaagatccctcattccggaaccagaactgcgggtcacggtaataaa	599	68	11%	56	9%
5	49697251	49697400	aaaccccgtccctattaaggagaattctccttcgcctaggacgtgtcactccctgattggctgcagcccatcggccgagttgacgtcacggggaaggcagagcacatggagtagagaaccaccctcggcatatgcgcagattatttgtt	149	18	12%	20	13%
5	49700701	49702050	gcgagttctttaatttgtaagtattctaccggagcgtggacacgcccaccctcggctccttcaaagaccggaaatgcctgttgtattttcctttgttcctctctgggaatgaatgagtctgcgcactgcctctctgcgcactgcctctctgcgcattgctgacgcactacgcagggcgggggctccgcatagggcggaccttgaagccgactgccctgaggccaatcagcaaactggccttcgccagccgcttttggcttccttaactgattagctagcactttacctggctggtacccttttttctcataatgagctgcttcttcctcccagtctgtttcctcagaggagaattcttcatctgcttcagagctactaagagctggcttcctgagctcatctagtgacgagtatctcctagagacctccgctaatcgatcttttttcttttcttttttcttttccttccttctaatctctccccaggtattcttacctgacctaaacttttcctcgggttcaagacccttggaaaggcctgtatacttattttgtgtaccatatttcctctttgttcctactctctctccccgctttacttctgatagcttgtcctgaatttcctctagaattttcagccctatcttaatcacttgataacatgtgaaaaggaacaaaagggctcctaacaccagaaaaaattcaaggccaaacatattccactttacttctgatagactgtcttgaatttccttagaaagttcaagatcagacttacctcgtaaagctgtactcactggtactctcgttccccagctgaaaagttctgaattcatacagttgaatccttcttaacagtctgctttacgggaacctttattaccgcgacccgcagttctggttctggaatgagggatcttccttgcgccagtcccgagttttttctcgtcccggaattcggcaccaattgttattagacgcgttctcacgcccggccaggaagaacaccacagaccagaatcttctgcggcaaaactttattgcttacatcttcaggagcaagagtgtaagaagcaagagagagagaaaacgaaaccccgtccctattaaggagaattctccttcgcctaggacgtgtcactccctgattggctgcagcccatcggccgagttgacgtcacggggaaggcagagcacatggagtagagaaccaccctcggcatatgcgcagattatttgtttaccacttagaacacagctgtcagcgccatcttgtaacggcgaatgtgggcgcggctcccaacaTCATACAATAAAGAGTCCCTCCATATTCCCATCTTCTCAGAGTA	1349	106	8%	154	11%
5	51973801	51973950	cttcctggtgagagcacgggggtctgcccggcctgagaggtttgtggcacaggcgccggcgggagccttcttggctccgggactccgcggagggcaggctgcacgggtgaccgtgtggaatacagagtgccagccgtttctgggacggg	149	24	16%	14	9%
5	53582851	53583000	ccacttcatcagcacgcttcacacctgatagtccgccacacatacctgctccttggcccaggccactgcatcagcacgcttcacacctgatagtccgccacacatacctgctctttggcccaggccactgcatcagcacgcttcacacc	149	10	7%	52	35%
5	54551101	54551550	taccgttccccagctgaagagttctgaatccacgccagatccttctcaacagtctgttttacgggaacactttattaaccccttcttccccgttatgcagttctgaatcctccctgtagcagggggtcttcactcatgcctgaagatgtttcttttcccgggtttcctcgtcccaggtcttctcgtcccaggtcttctcgtcccaggtcttctcgtcccgtcccgagtttttcttcccgggtttcagcaccaACtgttacgcgcgttcacgcgaccaggaagaacgacgctgcaacaggatctttctgcacacgtttattcagtcctgtttcttcttgtttatatctcccttgtttatatctcccttgtttatatctcccccaaaccctgggcctctcactcttttatactctcagttcccatccacgcacagcaggccacgccacctc	449	44	10%	66	15%
5	54551101	54551550	taccgttccccagctgaagagttctgaatccacgccagatccttctcaacagtctgttttacgggaacactttattaaccccttcttccccgttatgcagttctgaatcctccctgtagcagggggtcttcactcatgcctgaagatgtttcttttcccgggtttcctcgtcccaggtcttctcgtcccaggtcttctcgtcccaggtcttctcgtcccgtcccgagtttttcttcccgggtttcagcaccaACtgttacgcgcgttcacgcgaccaggaagaacgacgctgcaacaggatctttctgcacacgtttattcagtcctgtttcttcttgtttatatctcccttgtttatatctcccttgtttatatctcccccaaaccctgggcctctcactcttttatactctcagttcccatccacgcacagcaggccacgccacctc	449	44	10%	66	15%
5	55652851	55653450	gaacgtcagctcggccatgggctgcagccaatcagggagtgatgcgtcctaggcgaaatataacgctcctaaaaaaggggacgggttttccgccattctctctcgctggcatctctctggctctgcgcgccctgcgctctctcgctgcctaaagatgtaaacaatagagcgcgctctgcgccccggcgcgccggagctctggctcctaaagatgtaagaagggggctttcgtttttggggtttggggtttttgcactcctgctcctgaagatgtaagcaataaagttttgccgcagaagattctggtctgttgtgttcttcctggccgggcgtgagaacgctattaagaATtggtgctgaaatccgggacgagaaattccgggacgagaaaaaatccgggaagaaaaaacccgggaggaaactcgggacgggagcttcaccggagcaaggaagatccctcattccagaaccagaactgcgggtcgcggtaataaaggttcccgtaaagcagactgttaagaaggattcaactgcatgaattcagaacttttcagctggggaacggcggtaacccgtaagtatagctttacgaggtacgc	599	84	14%	42	7%
5	57691501	57691800	actcggccgatgggctgcagccaatcaaggagtgacacgtccgaggcgaaggagaatgctccttaagagggacggggttttcgttttctctctctcttgcttcttgctctcttttcctgaagatgtaagaataaagctttgccgcagaagattctggtctgtggtgttcttcctggccggtcgtgagaacgcgtcgaataacaattggtgccgaattccgggacgagaaaatccgggacgagaaaaaactccggactggcgcaggagggatacttcattccagaaccagaactgcgaat	299	42	14%	20	7%
5	58325251	58325850	tctgcgtcgaccacaagcaactcaaagaatcagatggcctctctaaggccggccgattgagaccctctgcacgaggtgggactagaacccacgatcccgtgaccaaacgcgaggtgggactcgaacccacgatctcgcaactgggcacgaggtgggactcaaacccacgatctcgcaaccccaaatggtctcttggcctccaaaggggtccaccaggcgtccctggtcctcccctgttcctcctgggacgtctcccagggtgaacggacggtggacacctggacacgtctatccttatccaccccgcgttccctctcggagcgcggtctcactgagcgtccgcaaaaccgaaactgcgatcgcaccaaacttagaaacagaacacagacatcagaccaaaacagaacaaagaatcttacctctaagtgggtctaggacctctgggtggtcgcgctgATTCCCGGCCAATGCACCAAAAtgaaagacccccgaagggagaccctcactcaggcctcaggacagccgcgtacccaagaagacactgagaccatacataaaatgtagaaggtaagatttaataaagcagcaacatgaaagca	599	72	12%	98	16%
5	59954251	59954700	gcggccctttccacaccggggacatattcctgggccacggcctgtttgtctaacctcggcacccttgttctgaggacaatcaattctaaaatgatctaaacttccacacttaaagcatacatttttccctcgtttccttgagaacattgcctgcgcgtgggttccctgcaaggtctcgcaggaaggcccgatgtctgcgcaaaggcggacatatctcgccaaatctgtcgttcccttatgcggttgaatcgcagctcggcaaattgcattagcattctcataagccaattgcataacgaaaggacttcccgtgtccggatttccaaggattctactagctgaaatcaatagcctatccacaaaatcctgatatggttcatcagaactctgccgaatgctagctaaacttccaccaatctctcctttgactggcaaccttccccaagcac	449	40	9%	70	16%
5	60758401	60758700	atagactgtcttgaatttccttagaaagttcaagatcagacttacctcgtaaagctatactcactggtactctcgttccccagctgaaaagttctgaattcatacagttgaatccttcttaacagtctgctttacgggaacctttattaccgcgacccgcagttctggttctggaatgagggatcttccttgcgccagtcccgagttttttctcgtcccgggtttcggcaccaattgttattagacgcgttctcacgaccggccaggaaagacgcaacaaaccagaatcttctgcggca	299	34	11%	34	11%
5	62977051	62977650	tgtgtccaactcgaccagcaaggaaatcacaaacactggttcttcttaaagcagtttactcagtgtggaaagccggtacatgctgcaagcaatcgcatgtgtgccgccagtaatctctgaggagagccgtgtgtgccgcgagcaatcgccattataagatggtgcgggcctccgctgtgcctaactagtaaacaagccttgtacgcaggtgcgagagtgaattcactcctagtcactcccattctcggggtgtaatagtggggtgatgggcaagcaacgaatcgggagctgtcacgccatatcaggtgctgaaacgtcacgctgcaggttataaaagcagcgccattttcccggttcggaatcttcctgagaagcaagcaataaagcttttgccgcggaagattctggtttgttgcgtctttcttgccggtcgagcgggacgcaataagtggcgccgaagaaccagggaactgtcatcacaccggcgcaaggaagatccctcgttcacggggcagaatcagaaccgtgggacaaaaggctctacaaggtacatacaatcttgaaatttctccagagttagaagcccttttgattgtttg	599	70	12%	90	15%
5	64030951	64031400	ctttcccgtgaacgtcagctcggccatgggctgcagccaatcagggagtgatgcgtcctaggcgaaatataactctcctaaagagggaaggggtttccgccattctctctcgctggcatctctctggctctgcgcgccctgcgctcgctcgctgcctaaagatgtaaacaatagaacacgctctgcgctttggcgcgccggagctctggctcctaaaaatattgaaggggctttcgtttttggggctgggcgctgggcgcttgccctcctggctcccaaagatgtaagcaataaagttttgccgcagaagattctggtctgttgcgtctttcctggccgggcgtgagaacgcgtctaataacaattggtgctgaaatccgggacgagaaattccgggacgagaaaaaactcgggactggcgcagggaagatccctcattccagaaccag	449	64	14%	34	8%
5	64032151	64032600	gagaggcaatgcgcagagagatgcgcagagaggcagtgcgcagagagatgcgcagagaggcagtgcgcagagagatgcgcagagaggcagtgcgcagagaggcagtgcgcagagaggcagtgcgcagactcattcattcccagagaggaacaaaggaaaatacaacaggcatttccagtctttgaaggagccgagggtgggcgtgtccacgctccggtagaatacttacaaattaaagaaattgccgagtcggtccgtaaatacggaaccaatgctaattttaccttggtgcagttagacaggcttgccggcatggcactaactcctgccgactggcaaacggttgtaaaagccgctctccctagtatgggcaaatatatggaatggagagctctttggcatgaaactgcacaagcgcaggcccgagcaaacgcagctgctttgactcc	449	48	11%	76	17%
5	64037851	64038300	caagatggcgctgacatcctgtgttctaagtggtaaacaaataatctgcgcatgagccaagggtattttatgactacttgtactctacctttcccgtgaacgtcagctcggccatgggctgcagccaatcagggagtgatgcgtcctaggcgaaatataactctcctaaagagggaaggggtttccgccattctctctcgctggcatctctctggctctgcgcgccctgcgctcgctcgctgcctaaagatgtaaacaatagaacacgctctgcgctttggcgcgccggagctctggctcctaaaaatattgaaggggctttcgtttttggggctgggcgctgggcgcttgccctcctggctcccaaagatgtaagcaataaagttttgccgcagaagattctggtctgttgcgtctttcctggccgggcgtgagaacgcgtctaaTAA	449	56	12%	34	8%
5	64889851	64890150	cagagctccggcgcgccaaagcgcagagcgcgctctattgtttacatctttaggcagcgagagagcgcagggcgcgcagagccagagagatgccagcgagagagaatggcggaaaaccccgtccccttttttaggagcgttatatttcgcctaggacgcatcactccctgattggctgcagcccatggccgagctgacgttcacgggaaaggcagagtacaagtagtcgtaaaatacccttggcacatgcgcagattatttgtttaccacttagaacacaggatgtcagcgccatcttg	299	44	15%	48	16%
5	64894951	64895400	tctccattccatatatttgcccatactagggagagcggcttttacaatcgtttgccagtcagcaggagttagtgccatgccggcgagcctgtctaactgcaccaaggtaaaattagcattggttccgtatttacggaccgactcggcaagttctttaatttgtaagtattctaccggagcgtggacacgcccaccctcggctccttcaaagaccggaaatgcctgttgtattttcctttgttcctctctgggaatgaatgagtctgcgcactgcctctctgcgcactgcctctctgcgcactgcctctctgcgcattgcctctctgcgcattgctgacgcactacgcagggcgggggctccgcatagggcggaccttgaaaccgactgcccggaggttgaacagtacgctggctttcgccagccgcttttggcttttttcttgaccaat	449	56	12%	52	12%
5	68137801	68137950	cacaagtcccttccgctcgactcgagactcgagccccgggctaccttgccagcagagtcttgcccaacacccgcaagggcccacacgggactccccacgggaccctaagacctctggtgagtggaacacagcgcctgccccaatccaat	149	18	12%	28	19%
5	68220901	68221350	agggtcccgtggggagtcccgtgtggacccttgcgggtgttgggcaagactctgctggcaaggtagcccggggctcgagtctcgagtcgagcggaagggacttgtgccccagatcaggcctgggtagcctgcttccctatgtactgcagtctcaagttccgcgcgattggattggggcaggcactgtggtccactcaccagaggtcttagggtcccgtggggagtcccgtgtggacccttgcgggtgttgggcaagactctgctggcaaggtagcccggggctcgagtctcgagtcgagcggaagggacttgtgccccagatcaagcccgggtagcctgcttccctatgtaccgcagtctcgagttccgcgcgattggattggggcaggcactgtgatccactcagcagaggtcttagggtcccgtggggagtcccgtgtggacccttg	449	54	12%	42	9%
5	68414101	68414400	ttcaaggtccgccctatgcggagtccccgccctgcgtagtgcgtcagccctgcgcagagaggcagtgcgcagagaggcagtgcgcagactcattcattcccagagaggaacaaaggaaaatacaacaggcatttccggtctttgaaggagccgagggtgggcgtgtccacgctccggtagaatacttacaaattaaagaaattgccgagtcggtccgtaaatacggaaccaatgctaattttaccttggtgcagttagacaggctcgccggcatggcactaactcctgctgactggcaa	299	38	13%	44	15%
5	68493001	68493450	gcgcatgtgccaagagtaattttccactacatgtactctgcctttcccgtgacgtcagctcggccatgggctgcagccaatcagggagtgatgcgtcctaagcgaaggataactctcctaaatagggacggggggtttcgctttcgttttagaaggggcgctttcgtttttggggcttggggcttgcgctcctggctcctgaagatgtaagcaataaagttttgccgcagaagattctggtttgttgtgtctttcctggccggtcgtgagaacgcgtataaGAGTTGGTGCTGaaatccgggacgagaaaatacaagaaaactcgggaccggcgcaaggaagatccctcattccggaaccagaactgcgggtcacggtaataaaggttcccgtaaaacagactgttgagaaggattcaactgcatgaattcagaacttttcagctgggg	449	52	12%	42	9%
5	69123601	69124200	tcaggcccgggtagcctgcttccctatgtaccgcagtctcaagttccgcgcgattggattggggcaggcactgtgatccactcaccagaggtcttagggtcccgtggggagtcccgtgtggacccttgcgggtgttgggcaagactctgctggcaaggtagcccggggctcgagtctcgagtcgagaggaagggacttgtgccccagatcaggcccgggtagcctgcttccctatgtaccgcagtctcaagttccgcgcgattggattggggcaggcactgtgatccactcaccagaggtcttagggtcccgtggggagtcccgtgtggacccttgcgggtgttgggcaagactctgctggcaaggtagcccggggctcgagtctcgagtcgagaggaagggacttgtgccccagatcaggcccgggtagcctgcttccctatgtaccgcagtctcaagttccgcgcgattggattggggcaggcactgtgatccactcaccagaggtcttagggtcccgtggggagtcccgtgtggacccttgcgggtgttgggcaagattctgctggcaaggtagcccggggctcgagtctcgagtc	599	70	12%	64	11%
5	69697951	69698100	agaagaaagatgaagactgaataaactgctgttagaaggactggtggtcgcgtcgttcttgctggtcgagagtgggcgcgacaattggtggcccgtacggggaaccgactcccccaccgagttcagaactttcagcagtcagtggttgc	149	20	13%	12	8%
5	70761751	70762500	cctgagaggtttgtggcacaggcgccggcgggagccttcttggctccgggactccgcggagggcaggctgcacgggtgaccgtgtggaatacagagtgccagccgtttctgggacgggcgagagagtcgcagagcttctgggcggcgccatcttcagctccagacagccggccaccttcctggtgagagcacgggggtctgcctggcctgagaggtttgtggcacaggcgccggcgggagccttcttggctccgggactccgcggagggcaggctgcacgggtgaccgtgtggaatacagagtgccagccgtttctgggacgggcgagagagtcgcagagcttctgggcggcgccatcttcagctccagacagccggccaccttcctggtgagagcacgggggtctgcctggcctgagaggtttgtggcacaggcgccggcgggagccttcttggctccgggactccgcggagggcaggctgcacgggtgaccgtgtggaatacagagtgccagccgtttctgggacgggcgagagagtcgcagagcttctgggcggcgccatcttcagctccagacagccggccaccttcctggtgagagcacgggggtctgcctggcctgagaggtttgtggcacaggcgccggcgggagccttcttggctccgggactccgcggagggcaggctgcacgggtgaccgtgtggaatacagagtgccagccgtttctgggacgggcgagagagtcgca	749	120	16%	92	12%
5	72075451	72075750	caatttctttaatttgtaagtattctaccggagcgtggacacgcccaccctcggctccttcaaagactggaaatgcctgttgtattttcctttgttcctctctgggaatgaatgagtctgcgcactgcctctctgcgcactgcctctctgcgcattgctgacgcactacgcagggcggggactccgcatagggcggaccttgaagccgactgccctgaggttgaacagtacgctggctttcgccagccgcttttggcttttttcttgaccaattagctggctggtaatgggctgcttct	299	32	11%	26	9%
5	73464751	73465200	gccaaagcgctctccattccatatatttgcccatactagggagagcggcttttacaaccgtttgccagtcggcaggagttagtgccatgccagcgagcctgtctaactgcaccaaggtaaaattagcattggttccgtatttacgaaccgactcggcaatttccttaatttgtaagtattctaccggagcgtggacacgcccaccctcggctccttcaaagaccggaaatgcctgttgtattttcctttgttcctctctgggaatgaatgagtctgcgcactgcctctctgcgcactgcctctctgcgcattgctgacgcactacgcagggcggggactccgcatagggcggaccttgaagccgactgccctgaggccaatcagcaaactggccttcgccagccgcttttggcttttttcttgaccaattagctggctggtaatgggct	449	50	11%	54	12%
5	73906801	73907250	ggcaactttatacttgcctcaattttatccgaggtccttcccaaactcctggggtcgcaagtttcactcaccgtgaacttaccctgctggcaaccactgactgctgaaagttctgaactcggtgggggagtcggttccccatacgggccaccaattgtcgcgcccgctctcgaccagcaagaacgacacgaccaccagtccttctaacagcagtttattcagtcttcatctttcttctttctcttcatcagtaccgttccccagctgaagagttctgaatccacgccggatccttctcaacagtctgttttacgggaacactttattaaccgctccttcccagtgatgcagttctgaatcctccctgtagcagggggtcttcgctcatgcctgaagatgtttcttttcccgggttttGGCACCACTTCttgcgcgcgcccaactggcca	449	44	10%	70	16%
5	74988001	74988750	caaggagtaatacgtcctaggcggagaataattctccttaaaagggacggggtttcgccattctctcctttgctctcttgcttttgctcttgcactcttgctcctgaagatgtaagcaataaagttttgccgcagaagattctggtttgttgcgttcttcctggccggtcgcgagaacgcgtgtaagaGTtggtgctgagacccgggacgagaagacctgggacgaaaaaacccgggacaagaaaaccctggacggttaccatcaccggcgcaaggaagatccctcattccggaaccagaactgcgggtcacggtggtaatgaagtgttcccgtaaaacagactgttgagaaggattcaactgcgtgaattcagaactcttcagctggggaatggtggtaatgaagtgttcccgtaaaacagactgttgagaaggattcaactgcgtgaattcagaactcttcagctggggaacagggtacccgtaagtatagctttacaaggtaagtctggtcttgaactttctaacgaaattcaagacagtctatcagaagtaaagtgggaaatagctttacaaggtacgcctggccttgaactttctaacgaaattcaagacagtctatcagaagtaaagtgggaaatagctttacaaggtatgtttggccttgaactttttctagtgttaggagcctttttgttccttttcacatgttatcaagcggttaaggcagggctgaaaattctggatga	749	60	8%	68	9%
5	75305251	75305850	ttttttttCTGTAAAATACtgttgggagccgcccccacattcgccgtcacaagatggcgctgacatcctgtgttctaagtggtaaacaaataatctgcgcatgtgccaagggtattttacgactacttgtactctgcctttcccgtgacgtcagctcggccatgggctgcagccaatcagggagtgatgcgtcctaagcgaaggataactcctccttaaaggggacggggtttccgccattctctctctggctctggcgcctgctcgcttgctcctaaagatgtaaacaatagagctcttgcttgcgcttttgcgctctgcgcgctggcgctctggctcctaaagatgtttagaagggggcttttgtttttggggcttggggttttgcgctcctgctcctgaagatgtaagcaataaagttttgccgcagaagattctggtttgctgcgtctttcctggccggtcgcgtgaacgcgggtaagaGttggtgctgagacccgggacgagaagacctgggaagaaagaacctgggacaagaaaacccgcgaagaaaaactcgggacgggagttaaccatcaccggcgcaaggaagattcttc	599	72	12%	42	7%
5	75309601	75310200	gccgtcacaagatggcgctgacatcctgtgttctaagtggtaaacaaataatctgcgcatgtgccaagggtattttacgactacttgtactctgcctttcccgtgacgtcagctcggccatgggctgcagccaatcagggagtgatgcgtcctaagcgaaggataactcctccttaaaggggacggggtttccgccattctctctctggctctggcgcctgctcgcttgctcctaaagatgtaaacaatagagctcttgcttgcgcttttgcgctctgcgcgctggcgctctggctcctaaagatgtttagaagggggcttttgtttttggggcttggggttttgcgctcctgctcctgaagatgtaagcaataaagttttgccgcagaagattctggtttgttgtgttctttcctggccggtcgtgagaacgtgtgtaagaAAATACCTTTTTATAAATTATATGTTATATATTACGACTATATTATCTTTCATTAGGTTACCGTTTTCTCATTCAGTTTGAAAAGGTTTAAAATATTTATATATGGATACCAGTAACCTAAAGGTTAAGTAACTTATTCTGGTTTGTATATTATTTT	599	50	8%	38	6%
5	77019001	77019150	ggaaagacgcagcaaaccagaatcttctgcggcaaaactttattgcttacatcttcaggagcaagagtgcaagccccaagcccaaaaacgaaagcgaaaccccgtccctcttaaggagagttatccttcgcctaggacgtatcactccc	149	14	9%	22	15%
5	77022751	77023200	cttctcaacagtctgttttacgggaacacttcattaccaccattccccagctgaagagttctgaatccacgctggatccttctcaacagtctgttttacgggaacacttcattaccgtgacccgcagttctggttccggaatgagggatcttccttgcgccggtgatggtaaccgtcctgggttttttcgtcccaggatttctcgtcccaggtctcgtcccgggtttcggcaccaaCtcttacatgcgttcgcgaccggccaggaaagacgcagcaaaccagaatcttctgcggcaaaactttattgcttacatcttcaggagcaagagtgcaagccccaagcccaaaaacgaaagcgaaaccccgtccctcttaaggagagttatccttcgcctaggacgtatcactccctgattggctgcagcccatggccgagttgtagtcacggg	449	54	12%	66	15%
5	77268451	77268900	ATCACATCCGGATTCACAGCGCTAAGAAGTTCTTTGTGGAGGAAAGTGCAGAGAAACAGGCCAAAGCCTGGGAGTCGGGGTCGTCTCCGGCCGAAGAGGGCGAGTTCTCCAAAGGCCCCATCCGCTGTGACCGCTGTGGCTACAATACCAACCGGTATGACCACTACATGGCACACCTGAAGCACCACCTGCGAGCTGGCGAGAACGAGCGCATCTACAAGTGCATCATCTGCACGTACACGACGGTCAGCGAGTACCACTGGAGGAAACACCTGAGAAACCATTTCCCCAGGAAAGTCTACACCTGCAGCAAGTGCAACTACTTCTCAGACAGAAAAAATAACTACGTTCAGCACGTGCGAACTCACACAGGTAAGGGAGCCTAAGTTGTAGTTTCCAAACTGTGACTTCGTTTAAACTTGGATTATATAAACTGAACCCATCTAAGA	449	44	10%	82	18%
5	77280751	77281050	GCATGAAGTGACCCGACATGCAAGACAGGTTCACAACGGGCCTAAACCTCTTAATTGCCCGCACTGTGACTACAAAACAGCAGATAGAAGCAACTTCAAAAAGCACGTGGAGCTGCATGTTAACCCACGGCAGTTCAACTGCCCCGTGTGTGACTACGCGGCTTCTAAGAAGTGTAATCTACAATACCATTTCAAATCTAAGCATCCCACCTGTCCCAGCAAAACAATGGATGTCTCCAAAGTGAAGCTAAAGAAAACCAAAAAGAGAGAGGCTGACCTGCTTAATAACGCCGTCAGCA	299	20	7%	58	19%
5	80059351	80059650	agtgcgtcagcaatgcgcagagaggcagtgcgcagagaggcagtgcgcagactcattcattcccagagaggaacaaaggaaaatacaacaggcatttccggtctttgaaggagccgagggtgggcgtgtccacgctccggtagaatacttacaaattaaggaaattgccgagtcggttcgtaaatacggaaccaatgctaattttaccttggtgcagttagacaggctcgctggcatggcactaactcctgccgactggcaaacggttgtaaaagccgctctccctagtatgggcaaat	299	34	11%	46	15%
5	83549251	83549700	gaagatgtaagcaataaagctttgccgcagaagattctggtttgttgcgtctttcctggccggtcgtgagaacgcgtctaataacaattggtgccgaaacccgggacgagaaaaaatccgggacgaaaaaatacgagaaaaaactcgggactggcgcaaggaagatccctcattccagaaccagaactgcgggtcgcggtaataaaggttcccgtaaagcagactgttaagaaggattcaactgtatgaattcagaacttttcagctggggaacgagagtaccagtgagtatagctttacgaggtaagcctggccttgaactttctaaggaaattcaagacagtctatcagaagtaaagtggaaaatagctttataaggtatgtttggccttgaactttttctagtgttaaaagcccttttgttccttttcacatgttatcaagtggtt	449	40	9%	36	8%
5	85477051	85477200	TACAACAGTATCAGTTGCCAAATTTTTTAAAAAGAACAAAATATtgttattagacgcgttctcacgcccggccaggaagaacacaacagaccagaatcttctgcggcaaaactttattgcttacatcttcaggagcaagagtgtaagaa	149	10	7%	30	20%
5	86318551	86318850	ggaggagttattcttcgcttaggacgcatcactccctgattggctgcagcccatggccgagctgacgttcacgggaaaggcagagtacaagtagtcgtaaaatacccttggcacatgcgcagattatttgtttaccacttagaacacaggatgtcagcgccatcttgtgacggcgaatgtgggggcggctcccaacactggtgaatatgtggagaagaggaatactcctccattgctggtgggattacaagcttgtacaaccactctggaagtcagtctggaggttcctcagaaaattg	299	22	7%	46	15%
5	89953051	89953500	cgggcgagagtcgcagagcttctgggcggcgccatcttcagctccagacagccagccaccttcctggtgagagcacgggggtctgcccggcctgagaggtttgtggcacaggcgccggcgggagccttcttggctccgggactccgcggagggcaggctgcacgggtgaccgtgtggaatacagagtgccagccgtttctgggacgggcgagagtcgcagagcttctgggcggcgccatcttcagctccagacagccggccaccttcctggtgagagcacgggggtctgcccggcctgagaggtttgtggcacaggcgccggcgggagccttcttggctccgggactccgcggagggcaggctgcacgggtgaccgtgtggaatacagagtgccagccgtttctgggacgggcgagagtcgcagagcttctgggcggcgccatcttcag	449	76	17%	60	13%
5	96274051	96274350	taatcagttaaggaaaaagccaaaagcggctggcgaaggccagcatgctgctcagcctccgggcagtcggcttcaaggtcatagtgcacttccgccctatgcggagcccccgccctgcgtagtgcgtcagccctgcgcagagaggcaatggacagagaggcaatgcacagactcgttcattccaaaggaggaacaaaggaaaatacaacaggcatttccggtctttgaaggagccgagggtgggcgtgtccacgctccggtagaatatgtgcagattaaagagcttgccgagtcggtct	299	36	12%	48	16%
5	100017751	100018500	ggcgcacatcacccacacagaaacacatacatgcatgtacacataaacacacacaaaacacatatcacatacatatcatacataaacacacatacaagcacacacacaaacgcaaatacacacatcacacacagagaaatatatacatgcatctacacataaacacacacaggcatatacaaacacacataaacacacacatgtaggcacacataaacacaaacacacatcacacacacagaaacatacatgcatgcacacataaacacacacatatataaaaacacacataaacacacaaacacacacacacacaaacacatatcacacacaataatacataaatacacataaacacacacacaaatacacacatatatacacacacattaatacacacatacataaacacacaaaccacacacatctgcaaacactcatacatagacacacacatcacacacacacacaagcacatacacagaaacacacacgcacacatatataaacacacacaaaaacacacacatatgcaaaaccacacatatccacacacaaatacacacacatcactcctatcacacatacaaacacacacacacacacgcaaacacacatacacacaaactctgagaaaaaacttgaatagaaaCAGTTGTTAATTAACCAATTAATTAAtttagtggtggtgggaatcaaacccaaacccagtacatactagacaagtgctcaaccactgagccacacta	749	8	1%	400	53%
5	100746301	100746600	gtcggcaggagttagtgccatgccggcgagcctgtctaactgcaccaaggtaaaattagcattggttccgtatttacggaccgactcggcaagctctttaatttgtaagtattctaccggagcgtggacacgcccaccctcggctccttcaaagaccggaaatgcctgttgtattttcctttgttcctctctgggaatgaatgagtctgcgcactgcctctctgcgcattgcctctctgcgcagggctgacgcactacgcagggcggggactccgcatagggcggaccttgaagccgac	299	42	14%	30	10%
5	103408651	103409100	tatacttacgagtaccctgttccccagctgaagagttctgaattcacgcagttgaatccttctcaacagtctgtgttacaggaacacttcattaccatgacccgcagttctggttccggaatgagggatcttccttgcgccggtgatggtaaccgtcccaggttttctcatcccaggatttctcgtcccgggttttctcgtctcgggtttcagcaccaaCtcttacacgcgttctcgcgaccggccaggaagaacgcaacaaaccggaatcttctgtggcaaaagctttattgcttacatcttcaggagccagagagcaagagagcaagaacaagaaaaagaagaagaacaagaaaagcaagagagcaagaatgagaaaacaagagagagaaaaagaatggcaaaaccccgtcccttttaaggagaattatcctccgcctaggacgtat	449	42	9%	64	14%
5	104191801	104192250	gatccttctcaacagtctgttttacgggaacacttcattaccaccgttccccagctgaagagttctgaatccacactggatccttctcaacagtctgttttatgggaacctttatgaccgtgacccgcagttctggttctggaatgagggatcttccttgcgccggtggtggtaactcccgtcccgggttttctcgtcccgggttttctcgtcccaggtcttctcgtcccgggtcttggcaccaactcttaCActtacacgcattctcgcgaccggccaggaaagacgcaacaaaccggaatcttctgcggcaaaagctttattgcttacatcttcaggagcaagagagagaatgacgaaaccccgtcccttttaaggagaattatcctccgcctaggatgtgtcactccctgattggctgcagcccatcggccgagttgtcgtcacag	449	52	12%	58	13%
5	105423301	105423450	cctcggctccttcaaagactggaaatgcctgttgtattttcctttgttcctctcggggaatgaatgagtctgcgcactgcctctctgcgcactgcctctctgcgcattgctgacgcactacgggctgacgcactacgcagggcggggac	149	20	13%	14	9%
5	106779601	106780050	AGGGAGTCTCCATCAAATCCAAACTTTTTTTATGACTTCTTTTCCCCTacacacacacacacacacacacacacacacacacacacattcgtacatacatgctcacatacaagcataaacacacacatacatactcacacatacatacatacacacacactcaaacacacacatacacattcatacacacacactcaaacacacacacattcatacatacacacacatacgcacacttacatacacatacacacatatacacatgcatatacacatatacacacaaacatacacacatacgcacaataaacacatacatataaacacacacagatgcacgcatgcacacacatgtacacaaacacacacacacactcacacacatacatatacatacatacacatacccacatacatatgcacacatacatatactcacacatacacat	449	8	2%	260	58%
5	107255701	107256150	gatataaacaagggagatatatggagaaagaagaaacaggactgaataaatgtgtgcagaaggatcctgtagcagcgtcgttcttcctggccagttgagcgcgcgcaacaGTTGGTGCCGAAACCCGGGAAGAAAAACTCGGGACgggacgagaagacctgggaagagaagacctgggacgagaagacctgggacgagaaaacccgggaaaagaaacatcttcaggcatgagcgaagaccccctgctacagggaggattcagaactgcatcacggggaactgtggtaatgaagtgttcccgtgaaacagactgttgagaaggatctggcgtggattcagaactcttcagctggggaacggtactgataaagaagagagaggaagactgaaatttgctgaataaactgctgttaaaaggactggtggtcacgtcgttcttgctggtcgag	449	40	9%	36	8%
5	111126451	111126750	tctgtgtgtatatgtctgtatctgtatgtgtataatgtgtgtgtatgcatgcgtgtgtatatgtgtatgcatgtgtatgtgtgtaaatgtgtgtgtctttctgtctgtgtgtgtgtctgtgtatatgtgcgtgtatgtctatgtgtgtatatatgtgtgtgcatgtatatctctgtgtgtatgcttgtgtatatgtgtgtatgtgtgtgtatatgtgtttatatgtgtatgtgtgtgtatatatgtatgtgtatgtatatctctgtgcgtatgcctgtgtatatctgtgtatacatgtg	299	6	2%	8	3%
5	111440851	111441000	GAGAGGTGGGTAACATCGGGACACCCCGACTCTGGCCTCTAGACAGTTTGCtgcagacactgcatgtgtagacactgtgtgtgcagacactgcatgtgtagacactgtgtgtgcagacactgtatgtgcagacactgtgtgtgtgtgta	149	4	3%	30	20%
5	113690551	113691300	CACTCCCATGTGGAAGTCAGAAGTCACACTCCAGTGGTGAAttttcaaggcagggtctctttctgggacgtgaggcttgccaattaggctagactggctggccagtgagccctaggaacccacctgtctgcgcatccctgatactggaaatatacataatcttagcttttttatatggattctgagggccaaacttctggaggccagcacatagcaagcactttaccaactgagccatctccccagttccCTCCCCTCCAGGAAGGGCACTGGCCACTGGGAAGACTGGGGGAGGCTGTTTCTGCTGTGCGCTGGCCTTGTAGCCCCCACAAGATCCTTGTGGCCATGAATACACCTTCCTCAAAGAGTGCTGGGTATGGTTTTGGTGGTGGTGGTGTTATAGGGATGCCTCTCTGTGTGTAGTCTATGTGTGCATGTACATGCCATATGTGAGTacacactgtgtgcacgccatgtatgtatacactgtgtgtgtgtacatgccatgtgtgtgtacacactgtgtgagcatgtctgagtgtgtgtgtatatgccatgtgtgagtacacactgtgtgtgtatgccatgtgtgtgtacacattgtctgttgtatgctgcgtgtgtacacactgtgtgagtatgtgagtgtgtgtacatgtcatgtgtgtacacactgtgtgtatgtgtgtgtgagtgtatgtgagtgtgtgtgtgtgcaaaccatgtgtgtgtgcacactgtgtgtgaat	749	10	1%	118	16%
5	114290701	114290850	atgtgattatgtgtggagagtgtttgaatgtgtgtgtgagagcatgtgtaaatgtgggtgagtgtgAAGATGAGCgtgtatgtgtaagacagagtcagtgtgtgtgtgaatgtgtgtatgtgagagtatgagtgtgtatgagtatgtgt	149	0	0%	6	4%
5	116427151	116427300	gtgtatgtgtgtgagtgtgtatgagtgtgtgaatgtgtgagtgtgcacacgaatgcatgtgtgtgtgaatgtgtaagtgtacatatgagagtgcatatatgtgtgtgagtgtgtatatgagtgtgtatgtgtgtgagtgtgtatgagtg	149	2	1%	10	7%
5	117435001	117435300	tgtaattgtcctctgccctccacatgcattccgtagcacacgtgcacgtgcacacccacacactcactcacacacacgcagccatacacatacacactcacacactctcacgcacagtcatatacatattcacacacactctcacacatatagtgatacacatacacactcacacatacacacactcacacacactctcatacatatagtcacatatacacactcacatacactgacacacacggtcacactcacacatacacacacacacacactctcatacatatagtcacatatac	299	12	4%	158	53%
5	118534201	118534350	ATGTGCCATGCATATGGAatgtcatgtgtgttgtgtctaatgtgtcatgtgttgtgtgtatgtCATACGTGCTGTATGACGTGTATTATCTTCTATATGTGACATGTTTTACATATGTCATTGTGTCAAGTATGCTGTGTACGGTGTTC	149	6	4%	18	12%
5	119728651	119729100	gtatgtgtacatgtgtgtgtgaacatgtgtgtgtagtgtgtctaactgtgtgtataggggtatgagtgtgtgtgtctatgcgtgtgtacatgtgagtgtgagtgtgtgtagtgtgtgtgtagtgtgtgtatacatgtgaatgtgagtctgagtatctgtgtgtgtatgcatgtgtgtgtgtgtgtatgagtgtctatgtgtgtgtacatgtgtatgtgtgtgagtgtttgtgactgtgtttctgtgtgtgtgggtatgagtgtgtgtgtgtctgtctatgtatgtgtacatgtgtgtgtgaacatgtgtgtgtagtgtgtctagctgtgtgtataggggtatgagtgtgtgtgtctatgcgtgtgtacatgtgagtgtgagtgtgtgtagtgtgtgtggggtatgagtgcgtgtctgtgtgtctatgcatgtgtacatgtatgtatgtg	449	6	1%	22	5%
5	119863951	119864400	ggtgtgtgtgtatgtgtgtgtgtctgtgcgtgtctgtatatgtatgtgtgtgtatctgtgtatgtgtgtgtatgtatgcatatgtgtatgtatatgtgtgtttatgtgtgtacatatatgtgtatgtgtgtgtatgtttgtatgtgtgtgtatgtatgtatatatgtacatttgtatgtgtatgtatgtgtatgcatgtgtatgtatatgtgtgtatgtatgtgtttatctgtgtgcatatatgtatatttgtgtgcatgtgtatgttttttatgtgtatgtatgtgtgtgcatgtgtatgcatatgtgtgtatgtgtgtgcatatatgtgtatttgtgtatgtatgtatgtttgtgtgtgtcttgtgtatgtatgtgtatgcacgtgtatgtatatgtgtgtatgtgtttatgtgtgagagtatatgtgtatttgtatgtatatgtat	449	4	1%	20	4%
5	119904151	119905500	cagcaggagttagtgccatgccggcgagcctgtctaactgcaccaaggtaaaattagcattggttccgtatttacggaccgactcggcaagttctttaatttgtaagtattctaccggagcgtggacacgcccaccctcggctccttcaaagactggaaatgcctgttgtattttcctttgttcctctctgggaatgaatgagtctgcgcactgcctctctgcgcactgcctctctgcgcactgcctctctgcgcactgcctctctgcgcattgtctctctgcgcattgctgacgcactacgcagggcgggggctccgcatagggcggaccttgaaaccgactgcccggaggttgaacagtacgctggctttcgccagccgcttttggcttttttcttgaccaattagctggctggtaatgggctgcttcttcctcccagtctgtttcctcagaggagaattcttcatctgcttcagagctactaagagctggcttcctgagctcatctagtgacgagtatctcctagagacctccgctaatcgatcttttttcttttcttttttcttttccttccttctaatctctccccaggtattcttacctgacctaaacttttccttgggttcaagacccttggaaaggcctgtatacttattttgtgtaccatattttctctttgctcctactctctctccccgctttacttctgatagattgccctgaatttcatccagaattttcagccctatcttaatcacctgataacatgtgaaaaggaacaaaagggctcctaacactagaaaaaattcaaggccaaacattttccactttacttctgatagactgtcttgaatttccttagaaagttcaagaccagacttacctcgtaaagctgtactcactggtactctcgttccccagctgaaaagttctgaattcatgcagttgaatccttcttaacagtctgctttacgggaacctttattaccgcgacccgcagttctggttctggaatgagggatcttccttgcgccggtcccgagttttcttgtattttttcgtcccggattttttctcgtcccggaatttctcgtcccggaatttctcgtcccggaattcggcaccaAttcttaatagcgttctcacgcccggccaggaagaacacaacagaccagaatcttctgcggcaaaactttattgcttacatcttcaggagctaggagcgcaaacccccagccccaaaagcgaaagccacccctataatgaaaccgaaacccctttcctatttaggagagttatatttcgcctaggacgcatcactccctgattggctgcagcccatggccg	1349	116	9%	136	10%
5	119904151	119905500	cagcaggagttagtgccatgccggcgagcctgtctaactgcaccaaggtaaaattagcattggttccgtatttacggaccgactcggcaagttctttaatttgtaagtattctaccggagcgtggacacgcccaccctcggctccttcaaagactggaaatgcctgttgtattttcctttgttcctctctgggaatgaatgagtctgcgcactgcctctctgcgcactgcctctctgcgcactgcctctctgcgcactgcctctctgcgcattgtctctctgcgcattgctgacgcactacgcagggcgggggctccgcatagggcggaccttgaaaccgactgcccggaggttgaacagtacgctggctttcgccagccgcttttggcttttttcttgaccaattagctggctggtaatgggctgcttcttcctcccagtctgtttcctcagaggagaattcttcatctgcttcagagctactaagagctggcttcctgagctcatctagtgacgagtatctcctagagacctccgctaatcgatcttttttcttttcttttttcttttccttccttctaatctctccccaggtattcttacctgacctaaacttttccttgggttcaagacccttggaaaggcctgtatacttattttgtgtaccatattttctctttgctcctactctctctccccgctttacttctgatagattgccctgaatttcatccagaattttcagccctatcttaatcacctgataacatgtgaaaaggaacaaaagggctcctaacactagaaaaaattcaaggccaaacattttccactttacttctgatagactgtcttgaatttccttagaaagttcaagaccagacttacctcgtaaagctgtactcactggtactctcgttccccagctgaaaagttctgaattcatgcagttgaatccttcttaacagtctgctttacgggaacctttattaccgcgacccgcagttctggttctggaatgagggatcttccttgcgccggtcccgagttttcttgtattttttcgtcccggattttttctcgtcccggaatttctcgtcccggaatttctcgtcccggaattcggcaccaAttcttaatagcgttctcacgcccggccaggaagaacacaacagaccagaatcttctgcggcaaaactttattgcttacatcttcaggagctaggagcgcaaacccccagccccaaaagcgaaagccacccctataatgaaaccgaaacccctttcctatttaggagagttatatttcgcctaggacgcatcactccctgattggctgcagcccatggccg	1349	116	9%	136	10%
5	120640351	120640500	gcacacacatgcacaaacacgtgtgtacacactcaaacatgcaaacatgaactcacacccacacgtacatgcacatacacacatgcacactcacacacatgcaatacacacacatgctcacaatgcatacgcacatgtacaaacatgtg	149	6	4%	82	55%
5	122647951	122648250	tcacacgtcctcagtcacacgtcctcagtcacatgtcctcagtcacatgactcagtcacatgtcctcagtcacatgtcctcagtcacacgtcctcagtcacatgactcagtcacatgtcctcaatcacacgtcctcagtcacacgtcctcagtcacacgtcctcagtcacatgactcagtcacatgtcctcagtcacatgtcctcagtcacatgtcctaagtcacacgtcctcagtcacatgtcctcagtcacatgactcagtcacatgtcctcagtcgcacgtcctcagtcacacgtc	299	20	7%	126	42%
5	125721001	125722200	tccattccatatatttgcccatactagggagagcggcttttacaaccgtttgccagtcggcaggagttagtgccatgccggcaagcctgtctaactgcaccaaggtaaaattagcattggttccgtatttacggaccgactcggcaatttctttaatttgtaagtattctaccggagcgtggacacgcccaccctcggctccttcaaagaccggaaatgcctgttgtattttcctttgttcctctctgggaatgaatgagtctgcgcactgcctctctgcgcactgcctctctgcgcagggctgacgcactacgcagggcggggactccgcatagggcggaccttgaagccgactgccctgaggccaatcagcaaactggccttcgccagccgcttttggcttccttaactgattagctagcactttacctggctggtacccttttttctcataatgagctgcttcttcctcccagtctgtttcctcagaggagaattcttcatctgcttcagagctactaagagctggctccccgagcccatccagcgatgagcacaggctccttttcctagagacctccgctaattgatctttcttcttttccctttttcctctttttcttctaatctctctccaggtattcctacctaaccttaacttttcctcgggttcaagacccttggaaaggcctgtatacttattttgtgtaccatatttcctctttgttcctactctctctccccgctttacttctgatagcttgtcctgaatttcctctagaattttcagccctatcttaatcacttgataacatgtgaaaaggaacaaaagggctcctaacaccagaaaaaattcaaggccaaacatattccactttacttctgatagactgtcttgaatttccttagaaagttcaagatcagacttacctcgtaaagctgtactcactggtactctcgttccccagctgaaaagttctgaattcatacagttgaatccttcttaacagtctgctttacgggaacctttattaccgcgacccgcagttctggttctggaatgagggatcttccttgcgccagtcccgagttttttctcgtcccggaatttctcgtcccggaattcggcaccaattgttattagacgcgttctcacgaccggccaggaaagacgcaacaaaccagaatcttctgcggca	1199	96	8%	130	11%
5	133954051	133954650	ctggtaaagccatttctcacttccgttccccagctgatgagttctgaattcggcagttgaatccttctcaacagtctgctttacgggaacctttatcaccgtcgttccccagctgatgagttctgaattcggcagttgaatccttctcaacagtctgctttacgggaacctttatcaccgtcgttccccagctgatgagttctgaattcggcagttgaatccttctcaacagtctgtgttacgggaaccttataaccttgattcgcagttctggttctggaatgaagtatccctcctgcgccagtccggagttttttctcgtcccggattttctcgtcccggaattcggcaccaattgttattcgacgcgttctcacgaccggccaggaagaacaccacagaccagaatcttctgcggcaaagctttattcttacatcttcaggaaaagagagcaagaagcaagagagagcgagaagcaagagagcgaaaaagcaagagagagagaaaagcaagagagcgaagcaagagagagagaaaacgaaaaccccgtccctcttaaggagcattctccttcgcctcggacgtgtcactccttgat	599	66	11%	74	12%
5	134029051	134029200	cgactcgagccccgggcttccttgccagcagagtcttgcccaacacccgcaagggcccacacgggactccccacgggaccctaagacctctggtgagtggaacacagcgcctgccccaatccaatcgcgcggaacttgagactgcggta	149	22	15%	24	16%
5	135260251	135260400	tgtgtgtgtgtgtgtgtgtgtgtgtgtatgtgtcgccccaaagaaataaatgtgaaaaaagAAAGagctaggtgtggtggcgcaggcctttagtcccagcattcaggaggtagaggcaggagaatgtctgtgagttggaggccagcctg	149	4	3%	14	9%
5	136055701	136055850	acacacacagacacatacacacagagactcagacatatatatacacacaggcacacacagacacacacagagacacagacacatacacggacacacacagacctagacacatacacaaacacacacagacatacacagacacacacaca	149	2	1%	94	63%
5	136155901	136156200	gcttgctctcttgcactctggctcctgaagatgtaagcaataaagctttgccgcagaagattctggtttgttgcgtctttcctggccggtcgtgagaacgcgtctaataacaattggtgccgaaacccgggacgagaaaaaactcgggactggcgcaaggaagatccctcattccagaaccagaactgcgggtcgcggtaataaaggttcccgtaaagcagactgttaagaaggattcaactgtatgaattcagaacttttcagctggggaacgagagtaccagtgagtacagctttac	299	32	11%	28	9%
5	136156801	136157100	gcttcaaggtcatagtgcacctccaccctatgctgagcccccggcctgcgtagtgcatcagccctgcgcagagaggcaatggacagagaggcaatgcacagactcgttcattccaaaggaggaacaaaggaaaatacaacaggcatttccggtctttgaaggagccgagggtgggcgtgtccacgctccggtagcgtatatacagattaaagagcttgccgagtcggtccgtaactatggagtcagtgctaatttcactatagcacaagtggaaaggcttgcgaatcacgctatgactc	299	30	10%	50	17%
5	136204351	136204950	agctcggccatgggctgcagccaatcagggagtgatgcgtcctaggcgaaatataacgctcctaaaaaaggggacggggtgtttccgccattctctctcgctggcatctctctggctctgcgcgccctgcgctcgctcgctgcctaaagatgtaaacaatagagcgcgcgcgccggagctctggctcctaaagatgtaattgaaggggctttcgtttttggggctgggcgctgggtgcttgccctcctggttcccaaagatgtaagcaataaagttttgccgcagaagattttggtttgttgcgtctttcctggccgggcgtgagaacgcgattaagaATTGGTGCTGaaacccgggacgagaaattccgggacgagaaaaaatccgggaagaaaaaacccgggaggaaactcgggacgggagtttcaccggcgcagggaagatccctcattccagaaccagaactgcgggtcgcggtaataaaggttcccgtaaagcagactgttaagaaggattcaactgcataaattcagaacttttcagctggggaacggcggtaacccgtaagtatagctttacgaggtaagcctggccttgaa	599	86	14%	40	7%
5	137488801	137488950	acatacacacatacacacacaatacacatacgcacacatacacacataaatacacacatacacacagccaacacatagaaagagacacacatacacttatacacacacatacacatatacacacatacacacacaatacacatatacac	149	2	1%	90	60%
5	138046201	138046800	tggctctcgccaggaaggtggccggccgtctggagccgaagatggcgccgcctcagaagctctgtggctctcgccaggaaggtggctggttgtctggagccgaagatggcgccgccccagaagctctgcgactctcgcccgtcccagaaacggctggcctctgtattccacacggtcacccgtgcagcctgccctctgcggagtcccggagccaagaagtctcccgccggcgcctgtgacacaaacctctcaggccgggcagacccctgtgctctcaccaggaaggtggccggctgtctggagccgaagatggcgtcgccccagaagctctgcgactctcatccgtcccagaaacggctggcctctgtattccacacggtcacccgtgcagcctgccctctgcggagtcccggagccaagaaggctcccgccggcgcctgtgacacaaacctctcaggccgggcagacccctgtgctctcaccaggaaggtggccagctgtctggagccgaagatggcgccgccccTTGttttgtttttttgagacagggtttctctgtgtagccctggctgttctggaactcactctgtaggacagga	599	80	13%	68	11%
5	139918651	139918800	TAGAACTCTTGTGAGTCTCGTGATCTGGGCTGGCGACGCAGGTGATGGGGAAACAGTGACTTCTCTTTTGACATTGCTTGAATGGCTGGCGCTgagccagcaagatggtgcagtgggtaaagacacttgcggcccagcctgactacggt	149	12	8%	16	11%
5	139954501	139954650	tgcatgtgctcacttacatggatgtctatatgtgtgtttgcacacacgtgcgcacacgcacattttgtgtgcacgtacgtgtgcatatgcacatatatatgtgtgtgagtgcatgcacacgtgtgtatgtgcttgcacgcatgtgcata	149	14	9%	40	27%
5	140899651	140899800	CACCGTACCTGGTCCCGCTCCCGCTCCACCTCCTCCAGCTGCAGCATAACTGTGTTCATGCGGTGCTTGTACATTTCACAGTCCTTCCCCAGGGTTGAACACTTGAGTTCCAGGTCTTCCTTCTCCTCCAGGTACtgcgagagagcaat	149	10	7%	28	19%
5	142068901	142069200	ccttgtaaagctatacttacgggtaccctgttccccagctgaagagttctgaattcacgcagttgaatccttctcaacagtctgttttacgggaacacttcattaccaccattccccagctgaagagttctgaatccacgctggatccttctcaacagtctgttttacgggaacctttatgaccgtgacccgcagttctggttccggaatgaggaatcttccttgcgccggtgatggttaactcccgtcccgagttttcttgtcccgggtttcggcaccaaCtcttacacgcgttctcg	299	34	11%	34	11%
5	142302001	142302300	gtatgtatatgtgtatatggtatgtgtgcatatgtatgtagtatgtgtatgtatatagtattgtgtatgtgtgcgtatgtagtactgtgtgtgtggtatgtgtgtatgtatgtatgtggtatgtatgtgtatgtgttatgtgtgtatatggtatgtgtgtgtatgtgtgtagtatgtgtgtgtatagtatttgtgtatgtgtgtgtatgtagtactgtgtgtgtatgtatgtagtatgtgtgtgtgtatagtatgtgtgtatgtgtgcgtatgtagtactgtgtgtgtggtatgtgtgt	299	4	1%	2	1%
5	142595251	142595400	cacatgcacacacacacacatcaaaggaaaagggagaaagaaagaccaggcatggtggaacatgcctgtcgcacacctgcacacacacatatgcacatacacactcacacacgcatgtgcacacacacacCAAAGGAAAAGGGAGAAAG	149	4	3%	68	46%
5	143811451	143811600	gttcacgtggtaaaggtgagatcaactcagacggagttaatgtacacgacaaagtgtcctctgacatgctctacggagcgcatgctcacatgcatacaGCCATGTGCGCACACGGAAAATACATAAGAATGTGATTTTTTAAATTCAAG	149	14	9%	32	21%
5	144300751	144301050	acatgtacatgtgtgtatgtgggcacaacactcatgcaacgggcgcatggcacatgtacatgtgtgtatgtgggcacaacactcatgcaccgggcgcatggcacatgtacatgtgtgtatgtgggcaaacactcatgcaccgggcgcatggcacatgtacatgtgtgtatgtgggcacaacactcatgcaacaggcgcatggcacatgtacatgtgtgtatgtgggcaaaacactcatgcaccgggcgcatggcacatgtacatgtgtgtatgtgggcaaaacactcatgcaccgggcg	299	22	7%	100	33%
5	145558051	145558350	acctcatcctgtagttctgaatctgccccgcaaaaacggagggtcccctctcggtgcctggctatggtatgttcctgggtttcggcgccaATATTGTcccgagctagtgtcttgccggcaagaacacactcgcacaaccggattcttctacagtaaagcttcactgtttcatcagaaggaagaccccaaacccggaaaatggcactgcttatatacccctccacgcggcatgtcagcacctgatttgttgcttgcccatcacctcactgctatgccccgggatgggcagtgacttggca	299	26	9%	46	15%
5	145692151	145692450	ggcattggctcttgcctgtgcttggcaggaatcttgccacaaagatttccatcctagatacattcccatattaggggctgcagcttttacaacagtcatccaatccccgggagtcatagccaaagtagcaagcctttcgacttgcgctatagtaaaattggtgctgactccatagttacggactgactcagcaagctctttaatctgtatatactacaccggagcgtgaacgcctctgccatcggcgccttcaaagaccggaaacgcttgctgcacttttctctgttcctcttttggaa	299	22	7%	44	15%
5	146542201	146542500	cgtcctaggcgaaatataactctcctaaaaaagggacggggtttcgttttctctctctcttgcttcttgcactctggctcctgaagatgtaagcaataaagctttgccgcagaagattctggtttgttgcgtctttcctggccggtcgtgagaacgcgttaataacaattggtgccgaattccgggacgagaaaaaactcgggactggcgcaaggaagatccctcattccagaaccagaactgcgggtcgcggtaataaaggttcccgtaaagcagactgttaagaaggattcaactgt	299	38	13%	20	7%
5	147035251	147035400	ggataaagaagacggcatgtacacgtaatgacattttcttcaaccatgaaaactgaaaaccatgacacccactggaggatggatcacactgtacaataagtcagctgtggaaagacgtctactgcacgctctctcacataCACTCTCAC	149	8	5%	34	23%
5	147347401	147347700	cctacacacaaacacacacatacatacacatattccacacatatatacacacatacacataaacacacacatacacacatacaacacacgcatacacataaacacatactctatacacaaacacacacacatacttacatacacatatcctccacacatatacacacatacaaacatatacacacatacatacatataaacacacaccctacacaaaaacacatatacacataaacacaaaccttacatacacattcatcatatatatatacacacactcgacacacatacacacacat	299	4	1%	164	55%
5	149289601	149289750	catagatggcacacagacatgtgcacacacagagacaaacacacacacagactcacgcgcacacacacaacccagatacacacacacagacatatgtgcacatgcatgtgcacagacacacacagacatatacacccagacacatacat	149	4	3%	86	58%
6	4177651	4178100	tccagtatctgaaattttgaggaaaatacaaaattgtattttgatgcgtgagcatcccttttatattcaacatattagagcacatacatcattacctggacctatggttaagggaaatgcaattgctgattcagccaccagagatatggttttcctatcacaaagctctatagacagtgctaagaattttcatcagctttatcatgtccctgcttctacattacgacaaaaatttaagctcacacgaacagaagcccgagatattgtcctacagtgtggtaaatgtgtagaatttattaatgcaccttccgtgggtgttaatcctcgcggattgcgacccctagatgtttggcaaatggacgtcacgcatatcccatcttttgggaaattacaatatgtacatgtatccatcgataccagttctggtgtcctacatgcctctcccttga	449	22	5%	70	16%
6	5330551	5331000	caaagagctctccattccatatatttgcccatactagggagagcggcttttacaaccgtttgccagtcagcaggagttagtgccatgccggcgagcctgtctaactgcaccaaggtaaaattagcattggttccgtatttacggaccgactcggcaatttctttaatttgtaagtattctaccggagcgtggacacgcccaccctcggctccttcaaagaccggaaatgcctgttgtattttcctttgttcctctctgggaatgaatgagtctgcgcactgcctctctgcgcagggctgacgcactacgcagggcggggactccgcatagggcggaccttgaagccgactgccctgaggccaatcagcaaactggccttcgccagccgcttttggcttccttaactgattagctagcactttacctggctggtacccttttttctcata	449	46	10%	54	12%
6	7100101	7100400	ttatacgcgttctcacgaccggccaggaaagacacaacaaaccagaatcttctgcggcaaaactttattgcttacatcttcaggagcaggagcgcaaaaccccaagccccaaaaacgaaagcccccttctaaacgaaagcgaaaccccccgtccctatttaggagagttatccttcgcttaggacgcatcactccctgattggctgcagcccatggccgagctgacgtcacgggaaaggcagagtacaagtagtggtaaaatacccttggcacatgcgcagattatttgtttaccactt	299	32	11%	48	16%
6	7105651	7106100	aatctctctgctctggagtcaaagcagctgcgtttgctcgggcctgcgcttgtgcagcttcgtgccaaagcgctctccattccatatacttgcccatactagggagagcggcttttacaatcgtttgccagtcggcaggagttagtgccatgccggcaagcctgtctaactgcaccaaggtaaaattagcattggttccgtatttacggaccgactcggcgagttctttaatctgcacgtattctaccggagcgtggacacgcccaccctcggctccttcaaagaccggaatgcctgttgtattttcctttgttcctctctgggaatgaatgagtctgcgcattgcctctctgcgcattgtctctctgcacattgcctctctgcgcattgtctctctgcgcattgtctctctgcgcattgcctctctgcgcattgctgacgcactacgc	449	56	12%	56	12%
6	10712701	10712850	tgcgtcagcccgtagtgcgtcagcaatgcgcagagaggcagtgcgcagagaggcagtgcgcagactcattcattccccgagaggagcgggggaaaatacagcaggcatttccagtctttgaaggagccgagggtgggcgtgtccacgct	149	22	15%	30	20%
6	13459651	13460100	ttagagaaaggggagtggacacagattgtcccatttctagaataatagtagacacaacaagagcgaacacgagactaagacaaaaaagaaaccaaaagcggcggcgacttcgcgtcgaccacaagcaactcagagaatcagatggcctttctaaggccggccgattgagaccctctgcacgaggtgggactcgaacccacgatctcgtaacaaggcacgaggtgggactcgaacccacaatctcgcaaccccagatggtctcttggccttcaaaggggtccaccaggcgtccctggtcctcccctgttcctcctgggacgtctcccagggcgaacggacggtggacacctggacacgtctatccttatccaccccgcgttccctctcggagcgcggtctcactgagcgtccgcaaaaccgaaactgcgatcacaccaaacttagaaaca	449	64	14%	70	16%
6	13528801	13529100	gataaaatgcgagttaattggtcaagaaaaaagccaaaagcggctggcgaaggccagtttactgcttggcctccgggcagtcggcttcaaggtgcacttccgccctatgcggagcccccgccctgcgtagtgcgtcagccctgtgcagagagacaatgcgcagagagacaatgcgcagagaggcaatgcgcagactcattcattcccagagaggaacaaaggaaaatacaacaggcatttccggtctttgaaggagccgagggtgggcgtgtccacgctccggtagaatatgtgcagat	299	36	12%	46	15%
6	13766851	13767000	gcgttctcacgaccggccaggaagaacaccacagaccagaatcttctgcggcaaagctttatttcttacatcttcaggagcaagagtgtaagaagcaagagagcaagaagcaagagagagagaaaacgaaaccccgtccctcttaagga	149	12	8%	26	17%
6	13772551	13772850	atgctggcgagcctgtctaactgcaccaaggtaaaattagcattggttccgtatttacggaccgactcggcaatttctttaatttgtaagtattctaccggagcgtggacacgcccaccctcggctccttcaaagaccggaaatgcctgttgtattttcctttgttcctctctgggaatgaatgagtctgcgcactgcctctctgcgcactgcctctctgcgcattgctgacgcactacgcagggcggggactccgcatagggcggaccttgaagccgactgccctgaggccaatcagc	299	38	13%	30	10%
6	13773451	13773900	ccttcttaacagtctgctttacgggaacctttattaccgcgacccgcagttctggttctggaatgagggatcttccttgcgccagtcccgagttttttctcgtcccggaattcggcaccaattgttattagacgcgttctcacgaccggccaggaagaacaccacagaccagaatcttctgcggcaaagctttatttcttacatcttcaggagcaagagtgtaagaagcaagagagcaagaagcaagagagagagaaaacgaaaccccgtccctcttaaggagcattctccttcgcctcggacgtgtcactccctgattggctgcagcccatcggccgagttgacgtcacggggaaggcagagcacaagtagtcataagatacccttggcacatgcgcagattatttgtttaccacttagaacacagctgtcagcgccatcttgtaacg	449	52	12%	70	16%
6	14090851	14091000	ttctaccggagcgtggacacgcccaccctcggctccttcaaagaccggaaatgcctgttgtattttcctttgttcctctctgggaatgaatgagtctgcgcactgcctctctgcgcactgcctctctgcgcattgctgacgcactacgc	149	20	13%	14	9%
6	14460001	14461500	gggagtgatgcgtcctaggcgaaatataactctcctaaatagggaaggggtttcggtttcattattgaaggggctttcgtttttggggctgggcgctgggcgcttgccctcctggctcccaaagatgtaagcaataaagttttgccgcagaagattctggtctgttgcgtctttcctggccggtcgcgtgagaacgcgattaagaattggtgctgaaatccgggacgagaaaaaatccgggacgaaaaaatacaagaaaactcgggaccggcacaaggaagatccctcattccagaaccagaactgcgggttgcggtaataaaggttcccgtaaagcagactgttaagaaggattcaactgcatgaattcagaacttttcagctggggaacgagagtaccagtgagtacagctttacgaggtacgcctgtccttgaactttctaaggaaattcaagacagtctatcagaagtaaagtggaaaatgtttggccttgaattttttctaatgttaggagcccttttgttccttttcacatgttatcaggtgattaagatagggctgaaaattctggatgaaattcagggcaatctatcagaagtaaagcggggagagagagtaggagcaaagagaaaatatggtacacaaaataagtatacaggcctttccaagggtcttgaacccgaggaaaagtttaggtcaggtaagaatacctggggagagattagaaggaaggaaaagaaaaaagaaaagaaaaaagatcgattagcggaggtctctaggagatactcgtcactagatgagctcaggaagccagctcttagtagctctgaagcagatgaagaattctcctctgaggaaacagactgggaggaagaagcagcccattaccagccagctaattggtcaagaaaaaagccaaaagcggctggcgaaagccagcgtactgttcaacctcccggcagtcggtttcaaggtccgccctatgcggagcccccgccctgcgtagtgcgtcagcaatgcgcagagaggcaatgcgcagagagatgcgcagagaggcaatgcgcagagagatgcgcagagaggcaatgcgcagagagatgcgcagagaggcaatgcgcagagagatgcgcagagaggcagtgcgcagagaggcagtgcgcagagaggcagtgcgcagactcattcattcccagagaggaacaaaggaaaatacaacaggcatttccagtctttgaaggagccgagggtgggcgtgtccacgctccggtagaatacgtacagattaaagaactcgccgagtcggtccgtaaatacggaaccaatgctaattttaccttggtgcagttagacaggctcgccggcatggcactaactcctgctgactggcaaacgattgtaaaagccgctctccctagtatgggcaaatatatggaatggagagcgctttggcacgaagctgcacaagcgcaggcccgagcaaacgcagctgctttgact	1499	142	9%	182	12%
6	18449401	18449550	gtacacacatatacatgtacacacacatatacatgtacacacatatacatgtacacacacatatacatgtacacacacatatacgtgtacacacacatatacatgtacacacacatatacatgtacacacacatatacatgtacacaca	149	2	1%	80	54%
6	18758551	18759000	gaagaaagatcaattagcggaggtctctaggagaaggagcctgtgctctgaagaaacagactgggagaaaaaagcggctcattatgaaagaaaaggataccagccgccaagtaaagtgctaactagtcatttaaggaaaaagccaaaagcggctggcgaaggccagtttgctaattggcctcagggcaatcggctaccaggtgcactcccgccctatgcggagtccccgccctgcgtagtgcgtcagcccgtagtgcgtcagcaatgcgcagagaggcagtgcgcagagaggcagtgcgcagactcattcattccccgagaggaacaaaggaaaatacaacaggcatttccagtctttgaaggagccgagggtgggcgtgtccacgctccggtagaatatgtgcagattaaagaaattgctgagtcggttcgtaaatacggaaccaatg	449	48	11%	60	13%
6	21843001	21843450	ctgaattccccttaaagagatagcctctctggccatctatcccttgcttcagggaagatgagcggggatgagagccctgggatgtatgcttgttatagtgcatgtgcgttgtgtgtttggcacatgtgttaggtgcagcgtgtgcaggcccgcacttttgccatggtagcgtaggcttttgctgcagtggaggcgggacaatctcctcagattcggtttgccgctctaaaagaaattatgctgcgttatgccgtggggtgcgaggctaagcactgcacagaggatagcttgctgttggcatcctgtggaaggcacgtctgattgcatgaaggttcagtgtcctagttcccttccctcaggaaaaacgacacgggagctggccaagacctctctgggtgatgagcctaagggatggttttgtgtagggcccctatgcttgcacactgggg	449	28	6%	48	11%
6	23158651	23159400	CTCATAAAGCTTCCTGCATCTGTCAAACTCTCGAAGCTGCAGCTCCAGGGCTATGTAGCCTTTGAACAACTTGTTCTTTGGACATTTGCCTAGGGAAGTGCCCAAAGCTCTTCTGGCCAATGGCAGATTCTTCTGTCGTATTTCAAACTGGGCGTAATACAACCACATTTTGGCAAAGGTGAACTTTGTGTGAGGAATGAGCTGCAGAGACGCTTGATAGACGCGTCTCGTCCTCTCGGGATCCTTGGCCTCCAGCTCTTCATAGAGCGCATAGTTAACCCAGAGGTAGATGTAGCGCTTCCAGTGCCTCTTCTCCAGCACCGGTGGCACACTGGCGATGGCTCTCTCATAGACTTCCCGCACGGTGTCGGCTTCTGCCTCACTTTCCACCAAGCGTAAGTAATCAAACCACGCGTCGTAATTGTGCGGATTAGCCTTCACTTCTTCTTCGTAGTGGAATCGGCGTTTTCTCACGATGCTCTCTTCTACATCCCTCCGCTCACCAAACTTCTTCTCAAAGATGGTGTAGTTTGTCAAGAGTTCTTGGGCCTCCTGTCTGGAAATCCTATCCAGGGCATATCTGTAGATAACTCGCACCCTTTCCAGTTCTTTCTGATTCTCCTCGAACTTTGCAAAGGCCACATAGAGGTGTTGGTCCATATGCTCCTCCCCGAAAAACTCCACGGCTCTCTCGTAGACTTTCCGCGCATGAGCAACAGAAGCGTGCTGCTCTTCAAACCGAGCATACT	749	68	9%	106	14%
6	24928351	24928650	cagtcggcttcaaggtccgccctatgcggagtccccgccctgcgtagtgcgtcagcaatgcgcagagaggcaatgcgcagagagatgcgcagagaggcagtgcgcagagaggcagtgcgcagactcattcattcccagagaggaacaaaggaaaatacaacaggcatttccggtctttgaaggagccgagggtgggcgtgtccacgctccggtagaatacttacaaattaaagaaattgccgagtcggtccgtaaatacggaaccaatgctaattttaccttggtgcagttagacaggc	299	40	13%	48	16%
6	25542301	25542600	gcttcagagaagatgagcggggatgagagccctgggatgtatgcttgttatagtgcgtgtgcgttgtgtgtttggcacatgtgttaggtgcagcgtgtgcaggcccgcacttttgccatggtagcgtaggcttttgctgcagtggaggcgggacaatctcctcagattcggtttgccgctctaaaagaaattatgctgcgttatgccgtggggtgcgaggctaagcactgcacagaggatagcttgctgttggcatcctgtggaaggcacgtctgattgcatgaaggttcagtgtccta	299	26	9%	34	11%
6	26064751	26065050	gcagaaggatcctgtagcagcgtcgttcttcctggcctgttgagcgcgcgcaacaAGTGGTGCCGaaacccgggacaagaaacatcttcaggcaagagcgaagaccccctgctacagggaggattcagaactgcatcacggggaaggagtggttaataaagtgttcccgtaaaacagactgttgagaaggatccggcatggattcagaactcttcagctggggaacggtactgatgaagagaaagaagaaagatgaagactgaagacggaataaactgctgttagaaggactggtggtc	299	26	9%	32	11%
6	27118201	27118350	gccaggtaaagtgctagctaatcagttaaggaagccaaaagcggctggcgaaggccagtttgctgattggcctcagggcagtcggcttcaaggtccgccctatgcggagtccccgccctgcgtagtgcgtcagccctgcgcagagagac	149	18	12%	18	12%
6	31045351	31045800	gtgagatggaggagcctcgtgtgagatggagcctcgtgtgagatggaggagcctcgtgtgagatggagcctcatgtgagatggagcctcgtgtgagatggagcctcgtgtgagatggaggagcctcgtgtgagatggagcctcatgtgagatggagcctcgtgtgagatggagcctcgtgtgagatggaggagcctcgtgtgagatggagcctcatgtgagatggagcctcgtgtgagatggaggagcctcgtgtgagatggagcctcgtgtgagatggaggagcctcgtgtgagatggaggagcctcgtgtgagatggaggagcctcgtgtgagatggaggagcctcgtgtaagatggaggagcctggtgtgagatggagcctcgtgtgagatggaggagcctcgtgtgagatggaggagcctcgtgtgagatggaggagcctcgtgt	449	40	9%	6	1%
6	31850101	31850250	cttctgcggcaaagctttattgcttacatcttcaggagccagagtgcaagaagcaagagagagagaaaacgaaaccccgtccctattaaggagaattctccttcgcctaggacgtgtcactccctgattggctgcagcccatcggccga	149	14	9%	18	12%
6	31852951	31853250	gagagcggcttttacaaccgtttgccagtcagcaggagttagtgccatgccggcgagcctgtctaactgcaccaaggtaaaattagcattggttccgtatttacggaccgactcggcgagttctttaatttgtaagtattctaccggagcgtggacacgcccaccctcggctccttcaaagaccggaaatgcctgttgtattttcctttgttcctctctgggaatgaatgagtctgcgcactgcctctctgcgcagggctgacgcactacgcagggcggggactccgcatagggcggac	299	42	14%	32	11%
6	31853851	31854450	tctcgttccccagctgaaaagttctgaattcatacagttgaatccttcttaacagtctgctttacgggaacctttattaccgcgacccgcagttctggttctggaatgagggatcttccttgcgccagtcccgagttttttctcgtcccggaattcggcaccaattgttattaaacgcgttctcacgaccggccaggaaagacgcaacaaaccagaatcttctgcggcaaagctttattgcttacatcttcaggagccagagtgcaagaagcaagagagagagaaaacgaaaccccgtccctattaaggagaattctccttcgcctaggacgtgtcactccctgattggctgcagcccatcggccgagttgacgtcacggggaaggcagagcacatggagtagagaaccaccctcggcatatgcgcagattatttgtttaccacttagaacacagctgtcagcgccatcttgtaacggcgaatgtgggcgcggctcccaacaATTGTGCAGGCACACAATCCTGAATAACCTCTGTCAACACATCTTGTGTGCAGAAGTGGGCCTCGGCAGCTGCCAAGCTTCTTCGTGAGCCTTGACG	599	68	11%	92	15%
6	32689801	32690250	cacttcattaccaccattccccagctgaagagttctgaattcacgcagttgagtccttctcaacagtctgttttgcgggaacctttatgaccgtgacccgcagttctggttccggaatgaggaatcttccttgcgccggtgatggttaactcccgtcccgagttttcttgtcccgggttttttcttcccggattttctcgtcccggatttcggcaccaaCtcttacacgcgttctcacgaccggccaggaagaacacaacaaaccagaatcttctgcggcaaaactttattgcttacatcttcaggagcaagcgtgcaagcctcaaaccccccattgcttacatctttaggagccagagcgccagagcgccagagcgccagagcgcgctctattgtttacatctttaggagccagagcgccagagcgccagagcgccagagcgagagct	449	58	13%	72	16%
6	34431751	34432500	gagtttcagtggtcagagcagtctctgcaggcaagctctcctctttcagggaggtgcacagttatctggtgtttggacctcctcctggccgaagatgaaggcccaaaacaggatctttcccagaagctgtgttgctttggcctgcagactgcccgctgcggagtcccagaatcaaggtggcccccgcggaacgtgaggcagaagcctcccgggctgtgcggacacctgtgctctgaccaggaaggtggcaggttgtctggagccgaaaatggcgccgcctcagaggctctgtggctcccgcccgttccagaagctgctggcctctgtgttccacactctcacccgcagaccgcccaccgcggagtcctggaaccaaggtggcccccacagaacgtgaggcagaagcctctcgggccgggtggacccctgtgctctcaccaggaaggtggccggttgtctggagccggaaatggcgccgcctcagaggctctgtggctcccgcccgttccagaagccgctggcctctgtgttccccactctcacccgcagaccgccggccacggggtctcggaaccaaggtgacccccgcggaacgtgaggcagaagcctcctgggctgtgcggacacctgtgctctgaccaggaaggtggcaggttgtctgtagccgaaaatgtaggaatttcataaattcattctttttaatagctgagtagtactccattgtgcaaatgtaccacattttctgtatc	749	74	10%	96	13%
6	35702851	35703000	ccgtacgggccaccaattgtcgcgcctgctctcgaccagcaagaacgacgcgaccaccagtccttctaacagcagtttattcagtcttcatctttcttctttctcttcatcagtaccgttccccagctgaagagttctgaatccatgct	149	18	12%	28	19%
6	35721751	35722050	cggcaaaaagctttattgcttacttctcaggaggaagaccccgaaccggagaaatggcgctgcttatatagcccacagcgtgacgtttcagcacctgatgtggcgtgacagctcctgattcattgcttgcccatcaccccattactacgctgcaagatgggcagtgactaggcgtgagttcattcttgcacttgtgcataaggcttgtttactagataggcgcagtggaagccagcgccatcttataatggcaattgctcacggcacgcacgcgattgctcgcggcacagctcttcaAA	299	34	11%	52	17%
6	37548601	37548750	ggagagcggcttttacaaccgtttgccaatcaccaggagtcatagcgtgattcgcaagcctttccacttgtgctatagtgaaattagcactgactccatagttacggaccgactcggcaagctctttaatctgtatatacgctaccgga	149	18	12%	20	13%
6	38282401	38283000	cctaacaccagaaaaaattcaaggccaaacatattccactttacttctgatagactgtcttgaatttccttagaaagttcaagatcagacttacctcgtaaagctgtactcactggtactctcgttccccagctgaaaagttctgaattcatacagttgaatccttcttaacagtctgctttacgggaacctttattaccgcgacccgcagttctggttctggaatgagggatcttccttgcgccagtcccgagttttttctcgtcccggaattcggcaccaattgttattagacgcgttctcacgcccggccaggaagaacaccacagaccagaatcttctgcggcaaaactttattgcttacatcttcaggagcaagagtgtaagaagcaagagagagagaaaaacgaaaccccgtcccttttttaggagagttatatttcgcctaggacgtgtcactccctgattggctgcagcccatcggccgagttgacgtcacggggaaggcagagcacatggagtggagaaccaccctcggcatatgcgcagattatttgtttaccacttagaacacagctgtcagcgccatcttgtaacgg	599	56	9%	86	14%
6	39332701	39333000	GCTGGGAGCAAAACGAGTTGTTAGAGGGAAGAATGAATTAGGACAAGAAGGAAGGGATGCGTACAGCCATCACAGCACGATGTGAACTAACAGTCCAATTCTGTATGAGCAAGGAAAGCAATGTCAGCCTGTGGTctgcacacagccatgcacgtacacacatgcgtgtgcgcgcgcacacacacacacgctcacataagcacacatacacactctcacataaacacacatacacacatgcatacatacacacatgcagataaatacacacacatgcatataaacacaaacacatgcac	299	18	6%	114	38%
6	41200951	41201700	gacacagattgtcccatttctagaaaaacagtagtcacaacaagagcggacacgagactaagacaaaaaagaaaccagaagaatcagatggcctctctaaggccggccgattgagaccctctgcacgaggtgggactcgaacccacgatcccgtgaccagacgcgaggtgggactcgaacccacgatctcgcaacaaaacacgaggtgggactcgaacccacgatctcgcaactgggcacgaggtgggactctaacccacgatctcacaaccccaaatggtctcttggccttcaaaggggtccaccaggcgtccctgatcctcccctgttcctcctgggacgtctcccagggcgaacggacggtggacacctggacacgtctatccttatccaccccgcactccctctcggagtgcggtctcactgagcatccgcaaaactgaaactgcgatcgcaccaaacttagaaacagaacacagacatcagaacacagacatcagaacacagacatcagaccaaagcagaacaaagaatcttacctctaagtgggtctaggacctctgggtggtcgcgctgtttcccggccaacgcaccaaatgaaagattctcgaattcccggccaatgcaccaaatgaaagattttcgaattcccggccaaatgaaagaccctcgaggggagaccctcactcagacactcaagtcccgggacagccgcgtacccaagaagacactgagaccatacataaaat	749	86	11%	140	19%
6	41242801	41243550	tgtcaggtatggaatactaacctgtgagttattggtcaaataggCtgttgggagccacccccacattcgccgtcacaagatggcgctgacatcctgtgttctaagtggtaaacaaataatctgcgcatgtgccaagggtattttatgactacttgtactctacctttcccgtgaacgtcagctcggccatgggctgcagccaatcagggagtgatgcgtcctaggcgaaatataacgctcctaaaaaaggggacggggtttccgccattctctctcgctggcatctctctggctctgcgcgccctgcgctctctcgctgcctaaagatgtaaacaatagagcgcactctgcgccccggcgcgccggagctctggctcctaaagatgtagattgaaggggctttcgtttttggggctgggcgctgggcgcttgccctcctggctcccaaagatgtaagcaataaagttttgccgcagaagattttggtttgttgcgtctttcctggccgggcgtgagaacgcgattaagaattggtgccgaaacccgggacgagaaattccgggacgagaaaaaatccgggaagaaaaaacccgggaggaaactcgggacgggagtttcaccggcgcagggaagatccctcattccagaaccagaactgcgggtcgcggtaataaaggttcccgtaaagcagactgttaagaaggattcaactgcatgaattcagaacttttcagctggggaacggcggt	749	98	13%	66	9%
6	41562901	41563350	CACCAACTGCAATTTTGTCACCACCATGGAACTGCTCTGTCATTATTTAGTTAGTTTCCTTAGAAATAATTCTAAGAGCTTCAAAATCCAACAGAATAGtcttatacgcgttctcacgcccggccaggaaagaacacaacaaaccagaatcttctgcggcaaaactttattgcttacatcttcaggagccaggagcgcaaacccccagccccaaaagcgaaagccaccccaattacatctttaggagccagagctccggcgcgccaaaacgcagagcgcgctctattgtttacatctttaggagcaagcgagcaggcgccagagccagagagatgccagcgagagagaatggcggaaaccccgtcccctttaaggaggagttatccttcgcttaggacgcatcactccctgattggctgcagcccatggccgagctgacgtttacggga	449	46	10%	78	17%
6	42018901	42019200	gcctgcgcgtgggtttcctgtaaggtctcgcaggaaggcccgatgtctgcgcaaaggcggacatatcccgccaaatctgtcgttcccttatgtggttgaatcgcagctcggcaaattgcgttagcattctcataagccaattgcataacgaaaggacttcccgtgtccggattttcaaggattctactagctgaaatcaatagcctgtccacaaaatcctgatatggttcatcagaactctgtcgaatgctagctaaacttccaccaatctctcctttgactggcaaccttccccaagc	299	30	10%	40	13%
6	42123451	42123900	gtctgcctggcctgagaggtttgtggcacaggcgccggcgggagccttcttggctccgggactccgcggagggcaggctgcacgggtgaccgtgtggaatacagagtgccagccgtttctgggacgggcgagagagtcgcagagcttctgggcggcgccatcttcagctccagacagccggccaccttcctggtgagagcacgggggtctgcctggcctgagaggtttgtggcacaggcgccggcgggagccttcttggctccgggactccgcggagggcaggctgcacgggtgaccgtgtggaatacagagtgccagccgtttctgggacgggcgagagagtcgcagagcttctgggcggcgccatcttcagctccagacagccggccaccttcctggtgagagcacgggggtctgcctggcctgagaggtttgtggcacaggcgccg	449	68	15%	56	12%
6	43786051	43786200	gagaggcaatgcgcagagaggcagtgcgcagagaggcagtgcgcagagaggcagtgcgcagactcattcattcccagagaggaacaaaggaaaatacaacaggcatttccggtctttgaaggagccgagggtgggcgtgtccacgctcc	149	16	11%	32	21%
6	47662951	47663100	GGCGAGGTGTGTGTTGGAATGGAACAAATGGAAGCCCGAATGAAGCAAAGGCCAAGGCCAACGGCAAAGGCGAGGCGAAAGGAGTGGTTGTGTTGTGGCAAGGGGGGCGACAGGCAGAGCCAAAGAGAGCATTGGTGTGGTCGGGACGC	149	16	11%	20	13%
6	47673901	47674200	ctagaatgttccccttcctcatagaacagcaagagagctgcatcgttgagagaaggagcacatgagcttccgtgccttccaagcatgtactcgtaggagcaagaaaattaggcctgggacaagttcatgctcacagagagcatccgttcaacgttgggcctgacttcctggatcttgtgatctaagcctgtggccataagtgctcggtgtgcacctcgaagagacacacggctaggaataaacagcaaatcgctctattacgagtgtcagaatagagggtaggcgattgcccagattac	299	22	7%	46	15%
6	47678251	47678550	catagaacagcaagagagctgcatcgttgagagaaggagcacatgagcttccgtgccttccaagcatgtactcgtaggagcaagaaaattaggcctgggacaagttcatgctcacagagagcatccgttcaacgttgggcctgacttcctggatcttgtgatctaagcctgtggccataagtgctcggtgtgcacctcgaagagacacacggctaggaataaacagcaaatcgctctattacgagtgtcagaatagagggtaggcgattgcccagattacctgaacaacaagacttcaa	299	22	7%	52	17%
6	47739751	47739900	GTGGAGTTGTGGTGGTGCCGGGTCGGGTGTTGGGCCTCGGGTGTTTTGAAGAGTGCAAAGAAGAGGAGGAGCGCAGGGGTGAGTGTGTAAGAAGTGTGTTGAGGAAAGGGTGAGGAGCGGAGGGTGAaaaaaatgtgtaccccggctgg	149	12	8%	4	3%
6	47749351	47749500	GAGGCTCAGCGGGAGCACCCCGTGCTCCAACCTGGTGCTCCTCCAACACCCACAGCTCTGCTTTTCTTTCTTCCCTTTCTGGAAGGCCTGGGCCTTGGGCCACGAGACCACCCTGACCACAGCCAAGTCTCCGGGGCCAGGAGCCAGGC	149	8	5%	28	19%
6	47764801	47764950	agtctacttcgggatcaagactagaatgttccccttcctcatagaacagcaagagagctgcatcgttgagagaaggagcacatgagcttccgtgccttccaagcatgtactcgtaggagcaagaaaattaggcctgggacaagttcatg	149	8	5%	24	16%
6	48000451	48001200	tcagcgcgaccacccagaggtcctagacccacttagaggtaagattctttgttctgttttggtctgatgtctgtgttctgtttctaagtttggtgcgatcgcagtttcggttttgcggacgctcagtgagaccgcgctccgagagggaacgcggggtggataaggatagacgtgtccaggtgtccaccgtccgttcaccctgggagacgtcccaggaggaacaggggaggaccagggacgcctggtggacccctttggaggccaagagaccatttggggttgcgagatcgtgggtttgagtcccacctcgtgcccagttgcgagatcgtgggttcgagtcccacctcgcgttttgttgcgagatcgtgggtttgagtcccacctcgcgtcttgttgcgagaccgtgtgttcgagtcccacctcgtgcagagggtctcaatcggccggccttaaagaggccatctgattctttgagttgcttgtggtcgacgcagagtcgccgccgtttctggtttcttttttgtcttagtctcgtgtccgctcttgttgtgactactgtttttctagaaatgggacaatctgtgtccactcccctttctctgactctggagcattggaaggaggtgcgggtcagagcccacaaccagtcggtggaggtcagaaagggtccgtggcagaccttttgcgcctccgagtggccaacgtttggagtgggctggccacctgagggtgcttttgacttgtcacta	749	96	13%	70	9%
6	50608801	50609850	GACGCAGAAGAATTCAATGATTACAAACTCCGGAGAAGAAAGGCCTTTGAAGAAAACCTCAGACAGAAGAGGACTGTGATTAGCAACTGGATCAAATACGCACAATGGGAGGAAAGCCTGAAGGAGCTCGATAGGGCTCGATCCATATACGAGCGTGCTTTAGATGTGGACTACCGCAATCTTACCCTCTGGCTGAAATACGCAGAGATGGAGATGAAGAACCGCCAGGTCAACCATGCCCGAAACATCTGGGACCGTGCCATCACAACTCTGCCCCGAGTCAAGCAGTTGTGGTACAAGTACACGTACATGGAGGAGCTGTTGGGCAACGTCGCTGGTGCTCGTCAGGTGTTTGAGCGCTGGATGGAATGGCAGCCTGAGGAGCAGGCCTGGCACTCGTACATCAACTTGGAGCTGAGGTACAAAGAGGTGGAGCGGGCCCGCACCATTTATGAACGCTTTGTGCTCGTGCACCCTGCTGTGAAGAACTGGATCAAGTATGCTCGGTTTGAAGAGCGGCACGCTTCTGTTGCTCATGCGCGGAAAGTCTACGAGAGGGCCGTGGAGTTTTTCGGGGAGGAGCATATGGACCAACACCTCTATGTGGCCTTTGCAAAATTCGAGGAGAATCAGAAAGAACTGGAAAGGGTGCGAGTTATCTACAGATATGCCCTGGATAGGATTTCCAAACAGGAGGCCCAAGAACTCTTGACAAACTACACCATCTTTGAGAAGAAGTTTGGTGAGCGGAGGGATGTAGAAGAGAGCATCGTGAGAAAACGCCGATTCCACTACGAAGAAGAAGTGAAGGCTAATCCGCACAATTACGACGCGTGGTTTGATTACTTACGCTTGGTGGAAAGTGAGGCAGAAGCCGACACCGTGCGGGAAGTCTATGAGAGAGCCATCGCCAGTGTGCCACCGGTGCTGGAGAAGAGGCACTGGAAGCGCTACATCTACCTCTGGGTTAACTATGCGCTCTATGAAGAGCTGGAGGCCAAGGATCCCGAGAGGACGAGACGCGTCTATCAAGCGTCTCTGCAGCTCAT	1049	110	10%	130	12%
6	50620501	50621700	ACTCTCGAAGCTGCAGCTCCAGGGCTATGTAGCCTTTGAACAACTTGTTCTTTGGACATTTGCCTAGGGAAGTGCCCAAAGCTCTTCTGGCCAATGGCAGATTCTTCTGCCGTATTTCAAACTGGGCGTAATACAACCACATTTTGGCAAAGGTGAACTTTGTGTGAGGAATGAGCTGCAGAGACGCTTGATAGACGCGTCTCGTCCTCTCGGGATCCTTGGCCTCCAGCTCTTCATAGAGCGCATAGTTAACCCAGAGGTAGATGTAGCGCTTCCAGTGCCTCTTCTCCAGCACCGGTGGCACACTGGCGATGGCTCTCTCATAGACTTCCCGCACGGTGTCGGCTTCTGCCTCACTTTCCACCAAGCGTAAGTAATCAAACCACGCGTCGTAATTGTGCGGATTAGCCTTCACTTCTTCTTCGTAGTGGAATCGGCGTTTTCTCACGATGCTCTCTTCTACATCCCTCCGCTCACCAAACTTCTTCTCAAAGATGGTGTAGTTTGTCAAGAGTTCTTGGGCCTCCTGTTTGGAAATCCTATCCAGGGCATATCTGTAGATAACTCGCACCCTTTCCAGTTCTTTCTGATTCTCCTCGAATTTTGCAAAGGCCACATAGAGGTGTTGGTCCATATGCTCCTCCCCGAAAAACTCCACGGCCCTCTCGTAGACTTTCCGCGCATGAGCAACAGAAGCGTGCCGCTCTTCAAACCGAGCATACTTGATCCAGTTCTTCACAGCAGGGTGCACGAGCACAAAGCGTTCATAAATGGTGCGGGCCCGCTCCACCTCTTTGTACCTCAGCTCCAAGTTGATGTACGAGTGCCAGGCCTGCTCCTCAGGCTGCCATTCCATCCAGCGCTCAAACACCTGACGAGCACCAGCGACGTTGCCCAACAGCTCCTCCATGTACGTGTACTTGTACCACAACTGCTTGACTCGGGGCAGAGTTGTGATGGCACGGTCCCAGATGTTTCGGGCATGGTTGACCTGGCGGTTCTTCATCTCCATCTCTGCGTATTTCAGCCAGAGGGTAAGATTGCGGTAGTCCACATCTAAAGCACGCTCGTATATGGATCGAGCCCTATCGAGCTCCTTCAGGCTTTCCTCCCATTGTGCGTATTTGATCCAGTTGCTAATCACAGTCCTCTTCTGTCTGAGGTTTTCTTCAAAGGCCTTTCTTCTCCGGAGTTTGTAA	1199	114	10%	184	15%
6	52350301	52351050	acttacgggtaccctgttccccagctgaagagttctgaattcacgcagttgaatccttctcaacagtctgttttacgggaacacttcattaccaccgttccccagctgaggagttctgaatccaggctggatccttctcaacagtctgttttacgggaacacttcattaccatgacccgcagttctggttccggaatgagggatcttccttgcgccggtgatggtaaccgtcccaggttttctcgtcccaggtcttctcgtcccaggtcttctcgtcccgggtcttctcatcccgggtttcggcaccaaCtcttacccgcgttctcgcgaccggccaggaagaacgcaacaaaccagaatcttctgcggcaaagttttattgcttacatcttcaggagccagagagcaagagagcaagagctctattgcttacatctttaggagccagagcgcaagagtgcaagagtgcaagagcgagggcaagagagagaaagaaagcaagaaaaagaacaagaacaagaaaacaagagagagaatggcaaaaccccgtcccttttaaggagaattatcctccgcctaggacgtattactccctgattggctgcagcccatcggcccagttgtcatcacgggaaaggcagaacacatggcgggaaaactgcccctgcacgtgtgcagattatgtttactacttagaacacagctgtcagcgccatcttataatggcaaatgtgagggcggctcctcac	749	68	9%	118	16%
6	56246701	56248200	tgtattccacacggtcacccgtgcagcctgccctccgcggagtcccggagccaagaaggctcccgccggcgcctgtgccacaaacctctcaggccaggcagacccccgtgctctcaccaggaaggtggccggctgtctggagctgaagatggcgccgcccagaagctctgcgactctctcgcccgtcccagaaacggctggcactctgtattccacacggtcacccgtgcagcctgccctccgcggagtcccggagccaagaaggctcccgccggcgcctgtgccacaaacctctcaggccaggcagacccccgtgctctcaccaggaaggtggccggctgtctggagctgaagatggcgccgcccagaagctctgcgactctctcgcccgtcccagaaacggctggcactctgtattccacacggtcacccgtgcagcctgccctccgcggagtcccggagccaagaaggctcccgccggcgcctgtgccacaaacctctcaggccaggcagacccccgtgctctcaccaggaaggtggccggctgtctggagctgaagatggcgccgcccagaagctctgcgactctctcgcccgtcccagaaacggctggcactctgcattccacacggtcacccgtgcagcctgccctccgcggagtcccggagccaagaaggctcccgccggcgcctgtgccacaaacctctcaggccaggcagacccccgtgctctcaccaggaaggtggccggctgtctggagctgaagatggcgccgcccagaagctctgcgactctctcgcccgtcccagaaacggctggcactctgtattccacacggtcacccgtgcagcctgccctccgcggagtcccggagccaagaaggctcccgccggcgcctgtgccacaaacctctcaggccaggcagacccccgtgctctcaccaggaaggtggccggctgtctggagctgaagatggcgccgcccagaagctctgcgactctctcgcccgtcccagaaacggctggcactctgtattccacacggtcacccgtgcagcctgccctccgcggagtcccggagccaagaaggctcccgccggcgcctgtgccacaaacctctcaggccaggcagacccccgtgctctcaccaggaaggtggccggctgtctggagctgaagatggcgccgcccagaagctctgcgactctctcgcccgtcccagaaacggctggcactctgtattccacacggtcacccgtgcagcctgccctccgcggagtcccggagccaagaaggctcccgccggcgcctgtgccacaaacctctcaggccaggcagacccccgtgctctcaccaggaaggtggccggctgtctggagctaaagatggcgccgcccagaagctctgcgactctctcgcccgtcccagaaacggctggcactctgtattccacacggtcacccgtgcagcctgccctccgcggagtcccggagccaagaa	1499	234	16%	222	15%
6	58068751	58069050	tgcttcttgctctcttgcttcttgcactctggctcctgaagatgtaagcaataaagctttgccgcagaagattctggtctgttgcgtctttcctggccggtcgtgagaacgcgtctaataacaattggtgccgaattccgggacgagaaaaaactcgggactggcgcaaggaagatccctcattccagaaccagaactgcgggtcgcggtaataaaggttcccgtaaagcagactgttaagaaggattcaaatgtatgaattcagaacttttcagctggggaacgagagtaccagtgag	299	32	11%	26	9%
6	60879751	60880050	acccccgtgctctcaccaggaaggtggccggctgtctggagctgaagatggttccgcctcagaagctctgtggctctcgccaggaaggtggccagttgtctggagacgaagatggcgccgccccagaagctctgcgactctcgcccgtaccagaaatggctggcctctgtattccacacagtctcccgtgcagcctgccctccgcggagtcccggagccaagaaggctcccgccggcgcctgtgacacaaacctctcaggccgggcagacccccgtgctctcaccaggcagctctcacc	299	38	13%	40	13%
6	61511701	61512450	tctaacactagagaaagttcaaggccaaacataccttataaagctattttccactttacttctgatagactgtcttgaatttccttagaaagttcaaggccaggcttacctcgtaaagctatacttacgggttaccgccgttccccagctgaaaagttctgaattcatgcagttgaatccttcttaacagtctgctttacgggaacctttattaccgcgacccgcagttctggttctggaatgagggattttccctgcgccggtgaaactcccgtcccgagtttcctcccgggttttttcttcccggattttttctcgtcccggaatttctcgtcccggatttCAGCACCAATtcttaatagcgttctcacgccaggccaggaaagacgcaacaaaccaaaatcttctgcggcaaaactttattgcttacatctttgggagccaggagggcaagcgcccagcgcccagccccaaaaacgaaagccccttctatatttttaggagccagagctctggcgcgccaaagcgcagagcgtgctctattgtttacatctttaggcagcgagcgagcgcagggcgcgcagagccagagagatgccagcgagagagcgatggcggaaaccccgtccccttttttaggagcgttatatttcgcctaggacgcatcactccctgattggctgcagcccatggccgagctgacgttcacgggaaaggtagagtacaagtagtcataaaatacccttggc	749	88	12%	88	12%
6	67006651	67006950	cgctgtgttccactcaccagaggtcttagggtcccgtggggagtcccgtgtgggcccttgcgggtgttgggcaagactctgctgtcaaggtagcccggggctcgagtctcgagtcgagcggaagggacttgtgccccagatcaggcccgggtagtctgcttccctatgtaccgcagtctcaagttccgcgcgattggattggggcaggcactgtggtccactcaccagaggtcttagggtcccgtggggagtcccgtgtggacccttgcgggtgttgggcaagactctgctggcaaggt	299	34	11%	32	11%
6	67710301	67710600	cgctctcgaccagcaagaacgacgcgaccaccagtccttctaacagcagtttattcagtcttcatctttcttctttctcttcatcagtaccgttccccagctgaagagttctgaatccacgccggatccttctcaacagtctgttttacgggaacactttattaaccgctccttccccgtgatgcagttctgaatccttcctgtagcagggggtcttcgctcatgcctgaagatgtttcttttcccgggtttCGGCACCACTtgttgcgcgcgctcaactggccaggaagaacgacgct	299	38	13%	44	15%
6	68245351	68245500	tcccgcagttgttcagggtatggcatatgcagcagccatgagaggacaaaagtattctacttttgtaaagcaaacatatggtgggggaaaaggaggtcaaggagcagaagggccagtttgtttttcctgtggtaagacaggacatatca	149	2	1%	30	20%
6	68248201	68249250	tagagtcagctcaagaaagccacgcactacatcatcaaaatgccgcggcgcttaggtttcagtttcacatcactcgtgaacaagcacgagaaatagtaaaactatgtccaaattgccccgactgggggcatgcgccacaactaggagtaaaccccaggggccttaagccccgagttctatggcaaatggatgttactcatgtctcagaatttggaaaattaaagtacgtacatgtgacagtagacacctattctcattttactttcgctaccgcccgaacgggcgaagcaaccaaagatgtgttacaacacttggctcaaagctttgcatacatgggcattcctcaaaaaataaaaacagataatgcccctgcatatgtgtcccgttctatacaggaatttctggccagatggaaaatatctcacgtcacggggatcccttacaatccccaaggacaggccattgttgaacgaacacaccaaaatataaaggcacagcttaataaacttcaaaaggctggaaaatactatacaccccaccatctattggcacatgctctttttgtgctgaatcatgtaaatatggacaatcaaggccatacggcggccgaaagacattggggtccaatttcagccgatccaaaacctatggttatgtggaaagatcttctcacagggtcctggaaaggacccgatgtcctaataacagccggacgaggctatgcttgtgtttttccacaggatgccgaatcaccaatttgggtccctgaccgattcatccgacctttcactgaacggaagggatcgacgcccacgcctagcgctgcggagaaaacgccgccgcgagatgagaaagatcaccaagaaagtccggaaaatgaccctagaccccatcaaagaaaagacggcttggcaacaactgcaggcgttgatctccgaagcggaggaggttcttaaaacctcacaaactccccaaacctctctgaccttatttcttgctttgttgtctgtcctcggccccctgcctgtgaccggggaaagttattgggc	1049	92	9%	166	16%
6	68660851	68661150	ctttatgaccgtgacccgcagttctggttccggaatgagggatcttccttgcgccggtggtggtaaccgtcccaggttttctcatcccaggatttctcgtcccaggtcttctcgtcccgggtctcagcaccaaCtcttaaacgcgttcacgcaaccggccaggaagaacacagcaaaccggaatcttctgcggcaaaaactttattgcttacatcttcaggagcaagagagagagaaaaagaatggcaaaaccccgtcccttttaaggagaattatcctccgcctaggacttgttactc	299	34	11%	38	13%
6	71955451	71955750	ggccaggaagaacaccacagaccagaatcttctgcggcaaagctttattcttacatcttcaggaaaagagagcaagaagcaagagagcgaagcaagagagagaagccagagagcgaagcaagagagagagagaacgaaaaccccgtccctcttaaggagcattctccttcgcctcggacgtgtcactccttgattggctgcagcccatcggccgagttgacgtcacggggaaggcagagcacaagtagtcataagatacccttggcacatgcgcagattatttgtttaccacttagaac	299	26	9%	52	17%
6	73212901	73214100	ctccttaaagagggacggggtttcgttttctctctctcttgcttcttgctctcttgcttcttacacgcttgctcctgaagatgtaagaaataaagctttgccgcagaagattctggtctgtggtgttcttcctggccggtcgtgagaacgcgtctaataacaATTGGTGCCGaattccgggacgaaaaaaaaactcgggactggcgcaaggaagatccctcattccagaaccagaactgcgggtcgcggtaataaaggttcccgtaaagcagactgttaagaaggattcaactgtatgaattcagaacttttcagctggggaacgagagtaccagtgagtacagctttacgaggtaagtctgatcttgaactttctaacgaaattcaagacagtctatcagaagtaaagtggaatatgtttggccttgaattttttctggtgttaggagcccttttgttccttttcacatgttatcaagtgattaagatagggctgaaaattctagaggaaattcaggacaagctatcagaagtaaagcggggagagagagtaggagcaaagaggaaatatggtacacaaaataagtatacaggcctttccaagggtcttgaacccgaggaaaagttaaggttaggtaggaatacctggagagagattagaagaaaaagaggaaaaagggaaaagaagaaagatcaattagcggaggtctctaggaaaaggagcctgtgctcatcgctggatgggctcggggagccagctcttagtagctctgaagcaggtgaagaatcctcctctgaggaaacagactgggaggaagaagcagcccattaccagccagctaattggtcaagaaaaaagccaaaagcggctggcgaaggccagtttgctgattggcctcagggcagtcggcttcaaggtccgccctatgcggagtccccgccctgcgtagtgcgtcagcaatgcgcagagagatgcgcagagaggcagtgcgcagagaggcagtgcgcagactcattcattcccagagaggaacaaaggaaaatacaacaggcatttccggtctttgaaggagccgagggtgggcgtgtccacgctccggtagaatacttacaaattaaagaaattgccgagtcggttcgtaaatacggaaccaatgctaattttaccttggtgcagttagacaggctcgctggcatgg	1199	94	8%	126	11%
6	79904701	79906200	ggagagcggcttttacaaccgtttgccagtcggcaggagttagtgccatgccggcaagcctgtctaactgcaccaaggtaaaattagcattggttccgtatttacggaccgactcggcaatttctttaatttgtaagtattctaccggagcgtggacacgcccaccctcggctccttcaaagaccggaaatgcctgttgtattttcctttgttcctctctgggaatgaatgagtctgcgcactgcctctctgcgcagggctgacgcactacgcagggcggggactccgcatagggcggaccttgaagccgactgccctgaggccaatcagcaaactggccttcgccagccgcttttggcttccttaactgattagctagcactttacctggctggtacccttttttctcataatgagctgcttcttcctcccagtctgtttcttcagaggagaattcttcatctgcttcagagctactaagagctggctccccgagcccatccagcgatgagcacaggctccttttcctagagacctccgctaattgatctttcttcttttccctttttcctctttttcttctaatctctctccaggtattcttacctaaccttaacttttcctcgggttcaagacccttggaaaggcctgtatacttattttgtgtaccatattttctctttgctcctactctctctccccgctttacttctgatagcttgtcctgaatttcatccagaatccgccctgccttaaccacttgataacatgtgaaaaggaacaaaagggctcctaacattagaaaaaattcaaggccaaacattttccactttacttctgatagactgtcttgaatttccttagaaagttcaagatcagacttacctcgtaaagctgtactcactggtactctcgttccccagctgaaaagttctgaattcatacagttgaatccttcttaacagtctgctttacgggaacctttattaccgcgacccgcagttctggttctggaatgagggatcttccttgcgccagtcccgagttttttctcgtcccggaattcggcaccaattgttaatagacgcgttctcacgcccggccaggaagaacaccacagaccagaatcttctgcggcaaagctttattgcttacatcttcaggagcaggagtgcaagaagcaagagagagagaaaacgaaaccccgtccctattaaggagaattatccttcgcctaggacgtgtcactccctgattggctgcagcccatcggccgagttgacgtcacggggaaggcagagcacatggagtgaagaaccaccctcggcacatgcgcagattatttgtttaccacttagaacacagctgtcagcgccatcttgtaacggcgaatgtgggcgcggctcccaacacatcttcaccgattgaaccaagatctggcagtcctctgtgttggttccctcatatcagctgatgtatactgcctgattggttgtcca	1499	122	8%	184	12%
6	81855451	81855750	aaaaagggtaccagccaggtaaagtgctagctaatcagttaaggaagccaaaagcggctggcgaaggccagtttgctgattggcctcagggcagtcggcttcaaggtccgccctatgcggagcccccgccctgcgtagtgcgtcagccctgcgcagagagacaatgcgcagagaggcagtgcgcagactcattcattcccagagaggaacaaaggaaaatacaacaggcatttccggtctttgaaggagccgagggtgggcgtgtccacgctccggtagaatacttacaaattaaagaa	299	32	11%	46	15%
6	84005551	84005700	ccggcgtggattcagaactcttcagctggggaacggtattgatgaagagaaagaagaaagatgaagactgaataaactgctgttagaaggactggtggtcgcgtcgttcttgctggtcgagagcgggcgcgacaattggtggcccgtac	149	22	15%	6	4%
6	87396151	87396450	TTATTCTTACGCTGTCTTCCTTTCCCACGCATcttactctgtcagcgtccttatgtgtaacatcacagcacttactctgtcagcgtcgttatgtgtgacatcacagcaTCTTTGTGTGAAACACAGAGCAGCTATGGGGCACAGTCCTTGTGAAGAACCTCCCGATGCAGATCCGAGTCAAAACAGATACATTGCAGCACATGTGCCATGTACCGTTCCTAACGTATTGATCTCCACTCTCGCGCGTGGTCTATCTCAAAGCCcttttctttttcttcttcttttttttttttGTAAGA	299	24	8%	54	18%
6	87407851	87408300	ggttccgtatttacgaaccgactcggcaatttccttaatctgtacgtattctaccggagcgtggacacgcccaccctcggctccttcaaagactggaaatgcctgttgtattttcttttgttcctctcggggaatgaatgagtctgcgcactgcctctctgcgcactgcctctctgcgcacctctctgcgcactgcctctctgcgcacctctctgcgcactgcctctctgcgcacctctctgcgcattgcccctctgcgcattgctgacgcactacgcagggcgggggctccgcatagggcggaccttgaaaccgactgccgggaggttgaacagtacgctgactttcgccagccgcttttggcttttttcttgaccaattagctggctggtaatgggctgcttcttcctcccagtctgtttcctcagaggaggattcttcacttgctt	449	58	13%	44	10%
6	95042551	95043000	ttagaaaaacagtagtcacaacaagagcggacacgagactaagacaaaaaagaaaccagaagaatcagatggcctctccaaggccggccgattgagaccctctgcacgaggtgggactcgaacccacgatcccgtgaccagacgcgaggtgggactcgaacccacggtctcgcaacaaggtgcgaggtgggactcaaacccacgatctcgcaacaaaacacgaggtgggactcgaacccacgatctcgcaactgggcacgaggtgggactctaacccacgatctcgcaaccccaaatggtctcttggccttcaaaggggtccaccaggcgtccctgatcctcccctgttcctcctgggacgtctcccagggtgaacggacggtggacacctggacacgtctatccttatccaccccgcactccctctcggagcgcggtctcactgagcg	449	66	15%	70	16%
6	95475601	95476200	tgtgttctaagtggtaaacaaataatctgcgcatgagccaagggtattttatgactacttgtactctacctttcccgtgaacgtcagctcggccatgggctgcagccaatcagggagtgatgcgtcctaggcgaaatataactctcctaaatagggaaggggtttcggtttcattattgaaggggctttcgtttttggggctgggcgctgggcgcttgccctcctggctcccaaagatgtaagcaataaagttttgccgcagaagattttggtttgttgcgtctttcctggccgggcgtgagaacgcgattaagaaTtggtgctgaaatccgggacgagaaattccgggacgagaaaaaatccgggaagaaaaaacccgggaggaaactcgggacgggagtttcaccggcgcaaggaagatccctcattccagaaccagaactgcgggtcgcggtaataaaggttcccgtaaagcagactgttaagaaggattcaactgcatgaattcagaacttttcagctggggaacggcggtaacccgtaagtatagctttacgaggtaagcctggccttgaactttctaaggaaattcaagacag	599	68	11%	48	8%
6	96151501	96151650	tgctgaaagttctgaactcggtgggggagtcggttccccatacgggccaccaattgtcgcgcccgctctcgaccagcaagaatgacgcgaccaccagtccttctaacagcagtttattcagtcttcatctttcttctttctcttcatca	149	18	12%	26	17%
6	97905001	97906200	tctccttaaaaagggatggggtttcgccatttgcttgcttgctctcttgcactctggctcctgaagatgtaagcaataaagctttgccgcagaagattctggtttgttgcgtctttcctggccggtcgtgagaacgcgtctaataacaattggtgccgaattccgggacgagaaaaaaaaactcgggactggcgcaaggaagatccctcattccagaaccagaactgcgggtcgcggtaataaaggttcccgtaaagcagactgttaagaaggattcaactgtatgaattcagaacttttcagctggggaacgagagtaccagtgagtacagctttacgaggtaagtctgatcttgaactttctaaggaaattcaagacagtctatcagaagtaaagtggaatatgtttggccttgaattttttctggtgttaggagcccttttgttccttttcacatgttatcaagtggttaagatagggaggattctagaggaaattcaggacaagctatcagaagtaaagcggggagaaagagtaggagcaaagaggaaatatggtacacaaaataagtatacaggcctttccaagggtcttgaacccgaggaaaagttaaggttaggtaggaatacctggagagagattagaagaaaaagaggaaaaagggaaaagaagaaagatcaattagcggaggtctctaggaaaaggagcctgtgctcatcgctggatgagctcaggaagccagctcttagtagctctgaagcagatgaagaattctcctctgaggaaacagactgggaggaagaagcagctcattatgagaaaaaagggtaccagccaggtaaagtgctagctaatcagttaaggaagccaaaagcggctggcgaaggccagtttgctgattggcctcagggcagtcggcttcaaggtccgccctatgcggagtccccgccctgcgtagtgcgtcagcaatgcgcagagagatgcgcagagaggcagtgcgcagagaggcagtgcgcagactcattcattcccagagaggaacaaaggaaaatacaacaggcatttccggtctttgaaggagccgagggtgggcgtgtccacgctccggtagcgtatatacagattaaagagcttgccgagtcggtccgtaactatggagtcagtgctaatttcactatagcacaagtggaaaggcttg	1199	86	7%	132	11%
6	98823151	98823300	caccaaggtaaaattagcattggttccgtatttacgaaccgactcggcaatttccttaatttgtaagtattctaccggagcgtggacacgcccaccctcggctccttcaaagaccggaaatgcctgttgtattttcctttgttcctctc	149	18	12%	14	9%
6	100739251	100739400	ttcatcagtaccgttccccagctgaagagttctgaatccacgccggatccttctcaacagtctgttttacaggaacttttattaaccactccttccccgtgatgcagttctgaatcctccctgtagcagggggtcttcgctcatgcctg	149	10	7%	22	15%
6	109712101	109712250	ccctcggctccttcaaagactggaaatgcctgttgtattttcctttgttcctctctgggaatgaatgagtctgcgcactgcctctctgcgcattgtctctctgcgcagggctgatgcactacgcagggcggggactccgcatagggcgg	149	16	11%	14	9%
6	111672001	111672300	ctctccattccatatatttgcccatactagggagagcggcttttacaaccgtttgccaatcaccaggagtcatagcgtgattcgcaagcctttccacttgtgctatagtgaaattagcactgactccatagttacggaccgactcggcaagctctttaatctgtatatacgctaccggagcgtggacacgcccaccctcggctccttcaaagaccggaaatgcctgttgtattttcctttgttcctcctttggaatgaacgagtctgtgcattgcctctctgtccattgcctctctgcg	299	30	10%	36	12%
6	114501001	114501150	AAATTTACAGGTACACAAGcacgtgcgcacgtgcacacgtgcacaAGcacacacacacacacacacacacacacacacacacacacacacacacacacCCCTCCTCAGGATCCTGGGAGGGTTGATGACATCTGGGCCTTAAATGTGTG	149	8	5%	72	48%
6	114503251	114503400	GACAAAAAAGGAAGAGTCTACGTTTGGATATGGCCGCCCTCTTATCCCTTGTGCTGTTGCCCCTCTACTTCTGCATTCCTCCTTATGTCAAGACCCCTGGGAACTGCCACCAAATCACACAGAGGCTCCCACATCCACACACTGAGGTC	149	4	3%	26	17%
6	114533101	114533400	GCctctctctcgctcgctctctctcCAAGTCCCTCTTGGGAGCATCCTGGAGGAGTAGGACGTCCTCAGGTCTTGTGTGCCATGGATCCCATCCCGGGGAGGATGAGGAAGGTGACCCCCTTGTGAGGTGCAGGCCTCCTGGAGGCCTAGGACCATCCTGATTTCCCGCGGGAACCGGTCACGGGAGAAAGAAGACCCCCAGGAACGGTCGAGTCAGGGAACAAGAAAGGGCTCAACGTCTTCCAGAAGGTGCGCAGGACACTGCAGAGACCGTCGGTCCCGAAGACAGTCATGCTGGG	299	30	10%	36	12%
6	114551251	114551850	GCTCAGCTTGCCCGAGAGTCCCTGCTCCATTAAGACCTTCTCCACTGGAGCTGCTGTCAGCCCAGCACTGCGACGACATGAGCCTCCAGGACAAAAAAGGAAGAGTCTACGTTTGGATATGGCCGCCCTCTTATCCCTTGTGCTGTTGCCCCTCTACTTCTGCATTCCTCCTTATGTCAAGACCCCTGGGAACTGCCACCAAATCACACAGAGGCTCCCACATCCACACACTGAGGTCTCCCCGAAATTTACAGGTacacaagcacgtgcgcacgtgcacacgtgcacaagcacacacacacacacacacacacacacacacacacacacacacacacacacacacacaTCTCCTCAGGATCCTCTTGCTGGTCCTGGGAGGGTTGATGACATCTGGGCCTTAAATGTGTGCAGCCAGCTTGTGTCCTGAGATAtctctctctccctctctctctctctctctctctctctttctctctctctgtctctctctctctctcttgctctctctctctctcttgctctctctctctgtctcgctctctctctcttttgctctctctctctctctctctctctctctctctcaatctctctct	599	22	4%	128	21%
6	114553651	114554100	TTGAGTTAGCGCGGGTTTGGTGGGGTGGTAGGGGCACTAGGAATAATCAGAAGCCTGAATTGGGCTCAGCTTGCCCGAGAGTCCCTGCTCCATTAAGACCTTCTCCACTGGAGCTGCTGTCAGCCCAGCACTGCGACGACATGAGCCTCCAGGACAAAAAAGGAAGAGTCTACGTTTGGATATGGCCGCCCTCTTATCCCTTGTGCTGTTGCCCCTCTACTTCTGCATTCCTCCTTATGTCAAGACCCCTGGGAACTGCCACCAAATCACACAGAGGCTCCCACATCCACACACTGAGGTCTCCCCGAAATTTACAGGTACACAAGcacgtgcgcacgtgcacacgtgcacaAGcacacacacacacacacacacacacacacacacacacacacacacacacacaTCTCCTCAGGATCCTCTTGCTGGTCCTGGGAGGGTTGATGACA	449	24	5%	120	27%
6	114561001	114561600	TTGGTGGGGTGGTAGGGGCGCTAGGAATAATCAGAAGCCTGAATTGGGCTCAGCCCGCGCGAGAGTCCCTGCTCCATTAAGACCTTCTCCACTGGAGCTGCTGTCAGCCCAGCACTGCGACGACATGAGCCTCCAGGACAAAAAAGGAAGAGTCTACGTTTGGATATGGCCGCCCTCTTATCCCTTGTGCTGTTGCCCCTCTACTTCTGCATTCCTCCTTATGTCAAGACCCCTGGGAACTGCCACCAAATCACACAGAGGCTCCCACATCCACACACTGAGGTCTCCCCGaaatttacaggtacacaagcacgtgcgcacgtgcacacgtgcacaagcacacacacacacacacacacacacacacacacacacacacacatctcctcaggatcctcttgctggtcctggGAGGGTTGATGACATCTGGGCCTTAAATGTGTGCAGCCAGCTTGTGTCCTGAGATAtctctctctccctctctctctctctctctctctctctctctctgtctctctctctctctcttgctctctctctctgtctcgctctctctctcttttgctctctctctctctctctctctctctctctctctc	599	28	5%	114	19%
6	114565951	114566250	CCCTGCTCCATTAAGACCTTCTCCACTGGAGCTGCTCTCAGCCCAGCACTGCGACGACATGAGCCTCCAGGACAAAAAAGGAAGAGTCTACGTTTGGATATGGCCGCCCTCTTATCCCTTGTGCTGTTGCCCCTCTACTTCTGCATTCCTCCTTATGTCAAGACCCCTGGGAACTGCCACCAAATCACACAGAGGCTCCCACATCCACACACTGAGGTCTCCCCGAAATTTACAGGTACACAAGcacgtgcgcacgtgcacacgtgcacaAGcacacacacacacacacacacacacac	299	18	6%	84	28%
6	114611551	114611850	AGGCCTCCTGGAGGCCTAGGACCATCCTGATTTCCCGCGGGAACCGGTCACGGGAGAAAGAAGACCCCCAGGAACGGTCGAGTCAGGGAACAAGAAAGGGCTCAACGTCTTCCAGAAGGTGCGCAGGACACTGCAGAGACCGTCGGTCCCGAAGACAGTCATGCTGGGGTCCTCTGGGGTCGCTAGCAGGACTGCAGCCCCTTCCTGAGAAGCCTGAGCCAGAGGCTGCAGCAGGCTGGAGTTACACCCCTCTCAGCTCGGTGCTAGGGACCCATTTTTCCCAGGCGCCTGTGCGCATG	299	30	10%	44	15%
6	114614101	114614250	AGAAAGGGCTCAACGTCTTCCAGAAGGTGCGCAGGACACTGCAGAGACCGTCGGTCCCGAAGACAGTCATGCTGGGGTCCTCTGGGGTCGCTAGCAGGACTGCAGCCCCTTCCTGAGAAGCCTGAGCCAGAGGCTGCAGCAGGCTGGAG	149	12	8%	24	16%
6	114625051	114625350	AGCTGCTGTCAGCCCAGCACTGCGACGACATGAGCCTCCAGGACAAAAAAGGAAGAGTCTACGTTTGGATATGGCCGCCCTCTTATCCCTTGTGCTGTTGCCCCTCTACTTCTGCCTTCCTCCTTATGTCAAGACCCCCGGGAACTGCCACCAAATCACACAGAGGCTCCCACATCCACACACTGATGTCTCCCCGAAATTTACAGGTacacaagcacgtgcgcacgtgcacacgtgcacaagcacacacacacacacacacacacacacacacacacacacacCTCCTCAGGATCCTC	299	20	7%	94	31%
6	116551051	116552400	tagaagaaaggaggatgggatagggggttgcagaggggaaaccagggaaggggtttacatttgaaatgtaagtaaataaaaaattttaaggtctttcagcggaatcaggatcatgGCGACCACGGCCAGGATGGCGACATCTGTCTCGGCGCGGAAGCGGCTGCTCAAAGAGGAGGGCATGACCAAAGTGGAGTTCGAGACCAGCGAGGAGGTGGACAGGACCCTCACGTTCGACACCATGGGCCTGCGAGAGGACCTGCTGCGCGGCATCTACGCCTACGGTTTTGAAAAACCTTCAGCGATCCAGCAGCGTGCTATCAAGCAGATAATTAAAGGGAGAGATGTCATTGCACAGTCTCAGTCTGGCACAGGCAAGACGGCCACCTTCAGTATCTCAGTGCTCCAGTGCTTGGATATCCAGGTTCGAGAAACCCAAGCTTTGATCCTGGCTCCAACCAGAGAGTTAGCGGTGCAGATTCAGAAGGGTCTGCTCGCTCTGGGGGATTACATGAACGTGCAGTGCCATGCCTGCATTGGGGGCACCAATGTCGGGGAGGACATCCGGAAGCTGGACTACGGGCAGCATGTGGTGGCAGGCACGCCGGGACGCGTCTTTGATATGATCCGCCGGAGAAGTTTACCGACACGGGCTATCAAGATGCTGGTTTTGGATGAGGCTGATGAGATGTTGAACAAAGGTTTCAAGGAGCAGATCTATGATGTGTACAGGTATTTGCCACCAGCCACACAGGTCGTTCTCATCAGTGCCACACTGCCTCATGAGATCCTGGAGATGACCAACAAGTTCATGACCCACCCCATCCGCATCCTGGTGAAGCGTGATGAGTTGACTCTGGAAGGCATCAAACAGTTCTTTGTGGCCGTGGAAAGAGAGGAATGGAAGTTTGATACTCTGTGTGATCTCTACGACACGCTGACCATCACCCAGGCCGTCATCTTCTGCATCACCAAGAGGAAGGTTGACTGGCTGACAGAGAAAATGAGAGAAGCCAATTTCACTGTGTCGTCCATGCATGGAGACATGCCCCAGAAAGAACGAGAGTCTATCATGAAGGAGTTCCGGTCAGGTGCCAGCCGGGTGCTCATCTCCACAGACGTCTGGGCTCGGGGCCTGGATGTCCCTCAGGTGTCCCTCATCATTAACTATGACCTGCCCAACAACAGAGAACTGTACATTCACAGAATTGGAAGATCGGGTCGGTATGGACGAAAAGGTGTGGCCATCAATTTTGTGAAGAATGATGACATCCGGATTCTCAGGGACATCGAGCAGTACTACTCCACCCAGATAGACGAGATGCCCATGAACCTGGCTGACCTCATCTGAA	1349	108	8%	232	17%
6	117338701	117339900	tcggctccttcaaagaccggaaatgcctgttgtattttcctttgttcctctctgggaatgaatgagtctgcgcactgcctctctgcgcactgcctctctgcgcattgctgacgcactacgcagggcggggactccgcatagggcggaccttgaagccgactgccctgaggccaatcagcaaactggccttcgccagccgcttttggcttttttcttgaccaattagctggctggtacccttttttctcataatgagctgcttcttcctcccagtctgtttcctcagagcacaggctccttctcctagagacctccgctaattgatctttcttcttttccctttttcctctttttcttctaatctctctccaggtattcctacctaaccttaacttttcctcgggttcaagacccttggaaaggcctgtatacttattttgtgtaccatatttcctctttgttcctactctctctccccgctttacttctgatagcttgtcctgaatttcctctagaattttcagccctatcttaatcacttgataacatgtgaaaaggaacaaaagggctcctaacaccagaaaaaattcaaggccaaacatattccactttacttctgatagactgtcttgaatttcgttagaaagttcaaggccaggcttacctcgtaaagctgtactcactggtactctcgttccccagctgaaaagttctgaattcatacagttgaatccttcttaacagtctgctttacgggaacctttatcaccgtcgttccccagctgatgagttctgaattcggcagttgaatccttctcaacagtctgtgttacgggaacctttataaacgtgatccgcagttctggttctgaaatgaaggatcttccttgcgccagtcccgagtttttttctcgtcccggatttcggcaccaattgttattagacgcgttctcacgaccggccaggaagaacaccacagaccagaatcttctgcggcaaagctttattcttacatcttcaggagccagggtgcaggaagcaagagagcgagaagcaagagagagagaaaacgaaaccccgtccctttttaaggagaattctccttcgcctcggacgtgtcactccttgattggctgcagcccatcggccgagttgacgtcacggggaaggcagagcacaagtagtcataagataccctt	1199	92	8%	134	11%
6	117591001	117591300	aggagttagtgccatgccggcgagcctgtctaactgcaccaaggtaaaattagcattggttccgtatttacggaccgactcggcaatttctttaatttgtaagtattctaccggagcgtggacacgcccaccctcggctccttcaaagactggaaatgcctgttgtattttcctttgttcctctctgggaatgaatgagtctgcgcactgcctctctgcgcatctctctgcgcattgctgacgcactacgcagggcgggggctccgcatagggcggaccttgaaaccgactgccctgag	299	38	13%	28	9%
6	117591901	117592350	gctgaaaagttctgaattcatacagttgaatccttcttaacagtctgctttacgggaacctttattaccgcgacccgcagttctggttctggaatgagggatcttccttgcgccagtcccgagttttttctcgtcccgggtttcggcaccaattgttattagacgcgttctcacgcccggccaggaaagacgcaacaaaccaaaatcttctgcggcaaaactttattgcttacatctttgggagccaggagggcaagcgcccagcgcccagccccaaaaacgaaagccccttcaataatgaaaccgaaaccccttccctctttaggagagttatatttcctaggacgcatcactccctgattggctgcagcccatggccgagctgacgttcacgggaaaggtagagtacaagtagtcataaaatacccttggctcatgcgcagattatt	449	48	11%	58	13%
6	119875351	119875650	gaatgaaggatcttccttgcgccagtgatggtaaccgtcctgggttttctcgtcccaggatttctcgttccaggtcttctcgtcccgtcccgggtctcagcaccaaCtcttacacgcattctcgcgaccggacaggaagaacacaacaaaccggaatcttctgcggcaaaagctttattgcttacatcttcaggagcaagagagcaagagagagaaaaagaacaagaacaagaaagcaagaaagagaaaaagcaagaacaagagagagagagcaagagccagagcaagagagagaaaaa	299	26	9%	50	17%
6	120134251	120134550	cccgcagttctggttctggaatgagggatcttccttgcgccagtcccgagttttttctcgtcccggaattcggcaccaattgttattagacgcgttctcacgcccggccaggaagaacaccacagaccagaatcttctgcggcaaagctttattgcttacatcttcaggagccagagtgcaagaagcaagagagagagaaaacgaaaccccgtccctattaaggagaattttccttcgcctaggacgtgtcactccctgattggctgcagcccatcggccgagttgacgtcacggggaa	299	38	13%	40	13%
6	123678451	123678900	tgttcaacctcccggcagtcggtttcaaggtccgccctatgcggagcccccgccctgcgtagtgcgtcagcaatgcgcagagaggcaatgcgcagagagatgcgcagagaggcaatgcgcagagagatgcgcagagaggcagtgcgcagagagatgcgcagagaggcagtgcgcagagagatgcgcagagaggcagtgcgcagagagacagtgcgcagactcattcattcccagagaggaacaaaggaaaatacaacaggcatttccagtctttgaaggagccgagggtgggcgtgtccacgctccggtagaatacttacaaattaaagaaattgccgagtcggtccgtaaatacggaaccaatgctaattttaccttggtgcagttagacaggctcgccggcatggcactaactcctgccgactggcaaacggttgtaaaagccgctc	449	62	14%	76	17%
6	124285651	124285950	aacaaagctctgatgccccttttctgctgacatgtaatctttctgttaatgaatcaatcccgtgccttttgtcaaaattccttgtactcccaaccttttgcttctttaaaagcccctagcttccgagtctcgtggtcgactcccctgcctcctgcgcgaggtacgtgtcaacccagagctctgccaaataaacctcatgcgtcttgcaacaagagaggattcttgtgttcgtgggtgcttcctgttcctggattagagcggggtccctaaatttggggtcctacaagccaaactctcaa	299	20	7%	28	9%
6	124546051	124546350	caggagcaagaagcaagagccagagcaagagagagaatggcgaaaccccgtcccttttaaggagaattattctccacctaggacgtattactccctgattggctgcagcccatcggccgagttgtcgtcacggggaaggcagagcacgtagggtggaaaactacccttggcacatgcgcagattatttgtttaccacttagaacacaggatgtcagcgccatcttgcaacggcgaatgtgagggcggctccccacaGGGCAGAAAGGCTTTCTCTTGGACTTCATGCTTGTCGGGTACA	299	28	9%	50	17%
6	124975051	124975500	gaagaagcagctcattatgagaaaaaagggtaccagccaggtaaagtgctagctaatcagttaaggaagccaaaagcggctggcgaaggccagtttgctgattggcctcagggcagtcggcttcaaggtccgccctatgcggagcccccgccctgcgtagtgcgtcagcaatgcgcagagaggcaatgcgcagagagatgcgcagagaggcagtgcgcagagaggcagtgcgcagactcattcattcccagagaggaacaaaggaaaatacaacaggcatttccagtctttgaaggagccgagggtgggcgtgtccacgctccggtagaatacttacaaattaaagaactcgccgagtcggtccgtaaatacggaaccaatgctaattttaccttggtgcagttagacaggcttgccggcatggcactaactcctgccgactggcaaac	449	48	11%	72	16%
6	126959251	126961050	ttacacagctagtgtgttcagacaggcagccttacacagctagtgtgttcagacaggcagcgttacacagctagtgtgttcagacagggagcgttacacagctagtgtgttcagacaggcagcgttacacagctagtgtgttcagacaggcagcgttacacagctagtgtgttcagacagggagcgttacacagctagtgtgttcagaaagggagcgttacacagctagtgtgttcagatagggagcgttacacagctagtgtgttcagacagggagcgttacacagctagtgtgttcagacagggagcgttacacagctagtgtgttcagacagggagcgttacacagctagtgtgttcagacaggcagcgttacacagctagtgtgttcagacaggcagcgttacacagctagtgtgttcagacagggagcttaacacagctagtgtgttcagacagggagcgttacacagctagtgtgttcagacagggagcgttacacagctagtgtgttcagacagggagcgttacacagctagtgtgttcagacaggcagcgttacacagctagtgtgttcagacaggcagcgttacacagctagtgtgttcagacagggagcgttacacagctagtgtgttcagacagggagcgttacacagctagtgtgttcagacagggagcgttacacagctagtgtgttcagacagggagcgttacacagctagtgtgttcagacaggcagcattacacagctagtgtgttcagacagggagcgttacacagctagtgtgttcagacaggcagcgttacacagctagtgtgttcagacaggcagcgttacacagctagtgtgttcagacagggagcgttacacagctagtgtgttcagacagggagcgttacacagctagtgtgttcagacagggagcgttacacagctagtgtgttcagacagggagccttacacagctagtgtgttcagacagggagcgttacacagctagtgtgttcagacaggcagcgttacacagctagtgtgttcagacagggagcgttacacagctagtgtgttcagacagggagcgttacacagctagtgtgttcagacagggagcgttacacagctagtgtgttcagacaggcagcgttacacagctagtgtgttcagacaggcagcgttacacagctagtgtgttcagacagggagcgttacacagctagtgtgttcagacagggagcgttacacagctaatgtgttcagaaagggagcgttacacagctagtgtgttcagacagggagcgttacacagctagtgtgttcagacaggcagcgttacacagctagtgtgttcagacagggagcgttacacagctagtgtgttcagacagggagcgttacacagctagtgtgttcagacagggagcgttacacagctagtgtgttcagacagggagcgttacacagctagtgtgttcaggcagggagcgttacacagctagtgtgttcagatagggagcgttacacagctagtgtgttcagacagggagcgttacacagctagtgtgttcagacagggagcgttacacagctagtgtgttcagacaggcagcgttacacagctagtgtgttcagacagggagcgttacacagctagtgtgttcagacaggcagcgttacacagctagtgtgttcagacagggagcgttacacagctagtgtgttcagacagggagtgttacacagctagtgtgttcagacagggTTTTGAGTTCTGTTTTAGTGTGTGCTGTTTAATAAC	1799	102	6%	484	27%
6	128910151	128910450	caaagcagctgcgtttgctcgggcctgcgcttgtgcagcttcgtgccaaagcgctctccattccatatatttgcccatactagggagagcggcttttacaaccgtttgccagtcggcaggagttagtgccatgccagcgagcctgtctaactgcaccaaggtaaaattagcattggttccgtatttacgaaccgactcggcaatttccttaatttgtaagtattctaccggagcgtggacacgcccaccctcggctccttcaaagaccggaaatgcctgttgtattttcctttgttcct	299	36	12%	38	13%
6	130955701	130956150	agggtaccagccaggtaaagtgctagctaatcagttaaggaagccaaaagcggctggcgaaggccagtttgctgattggcctcagggcagtcggcttcaaggtccgccctatgcggagtccccgccctgcgtagtgcgtcagccctgcgcagagaggcagtgcgcagactcattcattcccagagaggaacaaaggaaaatacaacaggcatttccggtctttgaaggagccgagggtgggcgtgtccacgctccggtagaatacttacaaattaaagaaattgccgagtcggttcgtaaatacggaaccaatgctaattttaccttggtgcagttagacaggctcgctggcatggcactaactcctgctgactggcaaacggttgtaaaagccgctctccctagtatgggcaaatatatggaatggagagcgctttggcacgaagctg	449	48	11%	58	13%
6	131550601	131551050	gaatgagggatcttccttgcgccggtcccgagttttcttgtattttttcgtcccggatttCAGCACCAATtcttaatagcgttctcacgcccggccaggaagaacacaacagaccagaatcttctgcggcaaaactttattgcttacatcttcaggagctaggagcgcaaacccccagccccaaaagcgaaagccaccccaataacatctttaggagccagaactccggcgcgccaaagcgcagagcgcgctctattgtttacatctttaggcagcgagagagcgcagggcgcgcagagccagagagatgccagcgagagagaatggcggaaaaccccgtccccttttttaggagcgttatatttcgcctaggacgcatcactccctgattggctgcagcccgtggccgagctgacgttcacgggaaaggcagagtacaagtagtcgta	449	64	14%	66	15%
6	132560551	132561000	gagttttcttgtattttttcgtcccggatttttctcgtcccgggtttcagcaccaattcttaatcgcgttctcacgcccggccaggaagaacacaacagaccagaatcttctgcggcaaaactttattgcttacatcttcaggagctaggagcgcaaaaacccccagccccaaaagcgaaagccccttctatttacatctttaggagccagagctccggcgcgccaaagcgcagagcgcgctctattgtttacatcttttggcagcgagagagcgcagggcgcgcagagccagagagatgccagcgagagagagagagagaatggcggaaaacccgtccccttttttaggagcgttatatttcgcctaggacgcatcactccctgattggctgcagcccatggccgagctgacgttcacgggaaaggcagagtacaagtagtcgtaaaa	449	62	14%	64	14%
6	132969001	132969450	ccactcagggggttcttcaatctctggatagatcttggggggtttcgtcactggtgtgctgcgatcatcatctctcccgagcggtggtttcggtttctctttctcaccattttctcggatggctagaatcttggtgccagggcggagaggcgggaggaatgggcgaacccacgggggtgggtagcgtgccaagtcctcccataccatgatgtacggttgttggtctggatgcgaccctggcccttcctgaaaaacaatggccttcacagcccttatggtgggtaagtaaaaagttccttctgctggccaacctactccaaaaacaggccattctgaggaacagaaagtcatccatggctttttcttcacttttactgacaaattttgtcctctagccctaatgtccgtccaatggtccttagtcaaagataaaggagtagacacggtct	449	30	7%	56	12%
6	134691751	134692200	agcaaccactgactgctgaaagttctgaactcggtgggggagtcggttccccgtacgggccaccaattgtcgcgtctgctctcgaccagcaagaacgacacgaccaccagtccttctaacagcagcttattcagtcttcatctttcttctttctcttcatcagtaccgttccccagctgaagagttctgaatccacgccggatccttctcaacagtctgttttacaggaacctttattaacagctccttccccatgatgcagttctgaatcctccctgtagcagggggtcttcgctcgtgcctgaagatgtttcttgtcccgggtttcggcaccaaCTCTCGAgcgcgcccccaactcgccagcaagaacgacgctgctacaggatccttctgcacacgtttattcagtcctatttcttctttctctatatctcccttgtttatatctc	449	46	10%	66	15%
6	136328401	136329000	gtgggtaggtgggtgggggagcagcctcatagaagaaaggaggatgggatagggggttgcagaggggaaaccagggaaggggtttacatttgaaatgtaagtaaataaaaAATTTTAAGGTCTTTCAGCGGAATCGGGATCATGGCGACCACGACCAGGATGGCGACGTCTGGCTCGGCGCGGAAGCGGCTGCTCAAAGAGGACGGCATGACCAAAGTGGAGTTCGAGACCAGCGAGGAGGTGGACGCGACCCCCACGTTCGACACCATGGGCCTGCGAGAGGACCTGCTGCGCGGCATCTACGCCTACGGTTTTGAAAAACCTTCAGCGATCCAGCAGCGTGCTATCAAGCAGATAATGAAAGGGAGAGATGTCATCGCACAGTCTCAGTCTGGCACAGGCAAGACGGCCACCTTCAGTATCTCAGTGCTCCAGTGCTTGGATATCCAGGTTCGAGAAACCCAAGCTTTGATCCTGGCTCCAACCAGAGAGTTAGCGGTGCAGATTCAGAAGGGTCTGCTCGCTCTGGGAGATTACATGAACGTGCAGTGCCATGCCTGCGTTGGGGGCACCAATGTCGGGGAGGACATCCGGAAGCT	599	66	11%	90	15%
6	136328401	136329000	gtgggtaggtgggtgggggagcagcctcatagaagaaaggaggatgggatagggggttgcagaggggaaaccagggaaggggtttacatttgaaatgtaagtaaataaaaAATTTTAAGGTCTTTCAGCGGAATCGGGATCATGGCGACCACGACCAGGATGGCGACGTCTGGCTCGGCGCGGAAGCGGCTGCTCAAAGAGGACGGCATGACCAAAGTGGAGTTCGAGACCAGCGAGGAGGTGGACGCGACCCCCACGTTCGACACCATGGGCCTGCGAGAGGACCTGCTGCGCGGCATCTACGCCTACGGTTTTGAAAAACCTTCAGCGATCCAGCAGCGTGCTATCAAGCAGATAATGAAAGGGAGAGATGTCATCGCACAGTCTCAGTCTGGCACAGGCAAGACGGCCACCTTCAGTATCTCAGTGCTCCAGTGCTTGGATATCCAGGTTCGAGAAACCCAAGCTTTGATCCTGGCTCCAACCAGAGAGTTAGCGGTGCAGATTCAGAAGGGTCTGCTCGCTCTGGGAGATTACATGAACGTGCAGTGCCATGCCTGCGTTGGGGGCACCAATGTCGGGGAGGACATCCGGAAGCT	599	66	11%	90	15%
6	139140751	139140900	aatctgcacatattctaccggagcgtggacacgcccaccctcggctccttcaaagactggaaatgcctgttgtattttcctttgttcctctcggggaatgaatgagtctgcgcactgcctttctgcgcactgcctctctgcgcattgct	149	16	11%	16	11%
6	140311501	140311650	aatacgtcctaggcggaggataattctccttaaaagggacggggttttgccatgctttttctctctcttgttcttgctttttctctctcttgttcttgctttttctctctcttgttcttgctttttctctctcttgttgttcttcttgc	149	6	4%	2	1%
6	140322151	140322600	aatctgcgcatgtgccaagggtattttatgactacttgtactctgcttttcccgtgaacgtcagctcggccatgggctgcagccaatcagggagtgatgcgtcctaggcgaaatataactctcctaaatagggaaggggtttcggtttcattattgaggggctttcgtttttgggggctgggcgctgggcgcttgccctcctggctccaaaagatgtaagcaataaagttttgccgcagaagattttggtttgttgtgttcttcctcgtcgggcgtgagaacgcTattaagaattggtgccgaaacccgggacgagaaattccgggacgagaaaaaatccgggaagaaaaaacccgggaggaaactcgggacgggagtttcaccggcgcagggaagatccctcattccagaaccagaactgcgggtcgcggtaataaaggttcccataa	449	58	13%	34	8%
6	140326651	140326800	aaatataactctcctaaatagggaaggggtttcggtttcattattgaggggctttcgtttttgggggctgggcgctgggcgcttgccctcctggctccaaaagatgtaagcaataaagttttgccgcagaagattttggtttgttgtgt	149	10	7%	8	5%
6	140845801	140846100	atgcacatatatgtgtgaatacatgtaacatgtgaatgtatgtgtgtatatgtgtatgcatatatgtacatatgcacacatgtatgtgagtgtgcatgcatgtatatgtgtgcacatgtatgcatatgtgtatatgtacgtatatgtgtgtatgtagtatgtgtgtatgtgtgtgtagatgtacatgtgtacgtgtgtatgcgtgtatatgtatgcatgcatgtgcatgtctatttgtgtatatgtatgtatatgtgtatctgtgtatgcatgcgtttgtatatatgaatgtatgtgta	299	8	3%	38	13%
6	140989801	140991600	gtcaaagcagctgcgtttgctcgggcctgcgcttgtgcagcttcgtgccaaagcgctctccattccatatatttgcccatactagggagagcggcttttacaatcgtttgccagtcagcaggagttagtgccatgccggcgagcctgtctaactgcaccaaggtaaaattagcattggttccgtatttacggaccgactcagcgagttctttaatctgtacgtattctaccggagcgtggacacgcccaccctcggctccttcaaagactggaaatgcctgttgtattttcctttgttcctctctgggaatgaatgagtctgcgcactgcctctctgcgcactgcctctctgcgcatctctctgcgcattgcctctctgcgcatctctctgcgcattgctgacgcactacgcagggcgggggctccgcatagggcggaccttgaaaccgactgccgggaggttgaacagtacgctggctttcgccagccgcttttggcttttttcttgaccaattagctggctggtaatgggctgcttcttcctcccagtctgtttcctcagaggagaattcttcatctgcttcagagctactaagagctggcttcctgagctcatctagtgacgagtatctcctagagacctccgctaatcgatcttttttcttttcttttttcttttccttccttctaatctctccccaggtattcttacctgacctaaacttttcctcgggttcaagacccttggaaaggcctgtatacttattttgtgtaccatattttctctttgctcctactctctctccccgctttacttctgatagattgccctgaatttcatccagaattttcagccctatcttaatcacctgataacatgtgaaaaggaacaaaagggctcctaacactagaaaaaattcaaggccaaacattttccactttacttctgatagactgtcttgaatttccttagaaagttcaaggccaggcgtacctcgtaaagctgtactcactggtactctcgttccccagctgaaaagttctgaattcatgcagttgaatccttcttaacagtctgctttacgggaacctttattaccgcgacccgcagttctggttctggaatgagggatcttccctgcgccggtcccgagttttcttgtattttttcgtcccggatttcagcaccaattcttaatAgcgttctcacgcccggccaggaaagacgcaacagaccagaatcttctgcggcaaaactttattgcttacatcttttggagccaggagggcaagcgcccagcgcccagccccaaaaacgaaagcccctccaatattacatctttaggagccagagctccggcgccgccaaagcgcagagcgcgctctattgtttacatctttaggcagcgagcgagcgcagggcgcgcagagccagagagatgccagcgagagagaatggcggaaacccccgtcccctttttaggaggagttatccttcacttaggacgcatcactccctgattggctgcagcccatggccgagctgacgttcacgggaaaaagcagagtacaagtagtcataaaatacccttggcacatgcgcagattatttgtttaccacttagaacacaggatgtcagcgccatcttgtgacggcgaatgtgggggcggctcccaacaCTTTTTGATTCTTGTCGAGGTTATAAGTCTGTAAAGGCCATGTCAGATGAAAACCAGTGTTTAAAGTCTCGCTTCTCCCCCGTGCCCTGTCCTGGTTCTTTCCCTCTTGGAGCTGCCAG	1799	170	9%	214	12%
6	140989801	140991600	gtcaaagcagctgcgtttgctcgggcctgcgcttgtgcagcttcgtgccaaagcgctctccattccatatatttgcccatactagggagagcggcttttacaatcgtttgccagtcagcaggagttagtgccatgccggcgagcctgtctaactgcaccaaggtaaaattagcattggttccgtatttacggaccgactcagcgagttctttaatctgtacgtattctaccggagcgtggacacgcccaccctcggctccttcaaagactggaaatgcctgttgtattttcctttgttcctctctgggaatgaatgagtctgcgcactgcctctctgcgcactgcctctctgcgcatctctctgcgcattgcctctctgcgcatctctctgcgcattgctgacgcactacgcagggcgggggctccgcatagggcggaccttgaaaccgactgccgggaggttgaacagtacgctggctttcgccagccgcttttggcttttttcttgaccaattagctggctggtaatgggctgcttcttcctcccagtctgtttcctcagaggagaattcttcatctgcttcagagctactaagagctggcttcctgagctcatctagtgacgagtatctcctagagacctccgctaatcgatcttttttcttttcttttttcttttccttccttctaatctctccccaggtattcttacctgacctaaacttttcctcgggttcaagacccttggaaaggcctgtatacttattttgtgtaccatattttctctttgctcctactctctctccccgctttacttctgatagattgccctgaatttcatccagaattttcagccctatcttaatcacctgataacatgtgaaaaggaacaaaagggctcctaacactagaaaaaattcaaggccaaacattttccactttacttctgatagactgtcttgaatttccttagaaagttcaaggccaggcgtacctcgtaaagctgtactcactggtactctcgttccccagctgaaaagttctgaattcatgcagttgaatccttcttaacagtctgctttacgggaacctttattaccgcgacccgcagttctggttctggaatgagggatcttccctgcgccggtcccgagttttcttgtattttttcgtcccggatttcagcaccaattcttaatAgcgttctcacgcccggccaggaaagacgcaacagaccagaatcttctgcggcaaaactttattgcttacatcttttggagccaggagggcaagcgcccagcgcccagccccaaaaacgaaagcccctccaatattacatctttaggagccagagctccggcgccgccaaagcgcagagcgcgctctattgtttacatctttaggcagcgagcgagcgcagggcgcgcagagccagagagatgccagcgagagagaatggcggaaacccccgtcccctttttaggaggagttatccttcacttaggacgcatcactccctgattggctgcagcccatggccgagctgacgttcacgggaaaaagcagagtacaagtagtcataaaatacccttggcacatgcgcagattatttgtttaccacttagaacacaggatgtcagcgccatcttgtgacggcgaatgtgggggcggctcccaacaCTTTTTGATTCTTGTCGAGGTTATAAGTCTGTAAAGGCCATGTCAGATGAAAACCAGTGTTTAAAGTCTCGCTTCTCCCCCGTGCCCTGTCCTGGTTCTTTCCCTCTTGGAGCTGCCAG	1799	170	9%	214	12%
6	142149151	142150350	cgaaggataattctccttaagagggacagggtttcgttttctctctctcttgcctcttgcactctggctcctgaagatgtaagcaataaagttttgccgcagaagattctggtctgttgcgtctttcctggccggtcgtgagaacgcgtctaataacaattggtgccgaattccgggacgagaaaaaactcgggactggcgcagggaagatccctcattccagaaccagaactgcgggtcgcggtgatagaggttcccgtaaagcagactgttaagaaggattcaactgtatgaattcagaacttttcagctggggaacgagagtaccagtgagtacagctttacgaggtaagtctggtcttgaactttctaaggaaattcaagacagtctatcagaagtaaagtggaatatgtttggccttgaattttttctggtgttaggagcccttttgttccttttcacatgttatcaagtggttaaggcagggcggattctggatgaaattcaggacaagctatcagaagtaaagtggggagagagagtaggaacaaagagaaaatatggtacacaaaataagtatacaggcctttccaagggtcttgaacccgaggaaaagttaaggttaggtaggaatacctggagagagattagaagaaaaagaggaaaaagggaaaagaaaaaagatcaattagcggaggtctctaggaaaaggagcctgtgctcatcgctagatgggctcggggagccagctcttagtagctctgaagcaggtgaagaatcctcctctgaggaaacagactgggaggaagaagcagctcattatgagaaaaaagggtaccagccaggtaaagtgctagctaatcagttaaggaagccaaaagcggctggcgaaggccagtttgctgattggcctcagggcagtcggcttcaaggtccgccctatgcggagcccccgccctgcgtagtgcgtcagcaatgcgcagagaggcaatgcgcagagaggcagtgtgcagagaggcagtgcgcagactcattcattcccagagaggaacaaaggaaaatacaacaggcatttccggtctttgaaggagccgagggtgggcgtgtccacgctccggtagaatatttacaaattaaagaaattgccgagtcggttcgtaaatacggaatcaatgctaattttaccttggtgcagtta	1199	88	7%	130	11%
6	142883701	142883850	gtgtgtatgtctgtgtgcatgtgtgtgtacatgtgtgtgtatgtgtgtctgtatgtgtgtgtgtgtgtggtatgtgcgtttacatgtgcttgcacatttgaatatgtctgctgtccagagagctctaaggaatcctcctgcctctattt	149	2	1%	12	8%
6	143441851	143442000	gtatgagtgtgagtgtagtgtggggagccgccctcacattcgccgttgcaagatggcgctgacatcctgtgttctaagtggtaaacaaataatctgcgcatgtgccaagggtagttccccaccccatgtgctctgccttccccgtgacg	149	14	9%	18	12%
6	143511451	143511600	agcctgtctaactgcaccaaggtaaaattagcattggttccgtatttacggaccgactcggcgagttctttaatctgtacgtattctaccggagcgtggacacgcccaccctcggctccttcaaagactggaaatgcctgttgtatttt	149	20	13%	12	8%
6	143886301	143886900	ttaatatgggtggcctatttgctcttattaaaaggaaagggggagatgttgggagccgcccccacattcgccgtcacaagatggcgttgacatcctgtgttctaagtggtaaacaaataatctgcgcatgagccaagggtattttatgactacttgtactctgcttttcccgtgaacgtcagctcggccatgggctgcagccaatcagggagtgatgcgtcctaagtgaagggtcactcctccttaaaggggacggggttttccgccactctctctcgctggcatctctctggctctgcgcgccctgcgctcgctcgctgcctaaagatgtaaacaatagagcacgctctgcgctttggcgcgccggagctctggctcctaaaattattgaggggctttcgtttttggggctgggcgctgggcgcttgctctcctggctcccaaagatgtaagcaataaagttttgccgcaaaagattttggtctgtggtgttcttcctggccggtcgtgagaacgcgtctaaTAACAGGCAATGGTGTCTGTTGTGATGTTCATCCCTTGAGGGAGTAACAGAGCCACTCGTTGCATGAGGCGGTAAC	599	64	11%	54	9%
6	147079351	147079500	agctgaagagttctgaatccacgccggatccttctcaacagtctgttttacaggaacttttattaaccactccttccccgtgatgcagttctgaatcctccctgtagcagggggtcttcactcgtgcctgaagatgtttcttgtcccgg	149	10	7%	16	11%
6	148166401	148166700	cttctgcggcaaaactttattgcttacatcttcaggagccaggagcgcaaacccccagccccaaaagcgaaagcccccttcttacatctttaggagccagagctccggcgcgccaaagcgcagagcgcgctctattgtttacatctttaggcagcgagagagcgcagggcgcgcagagccagagagatgccagcgagagagaatggcggaaaacccgttcccttttttaggagcattatatttcgcctaggacgcatcactccctgattggctgcagcccatggccgagctgacgttca	299	40	13%	46	15%
6	148170751	148171200	taccttgtaaagctatacttacgggttaccgccgttccccagctgaaaagttctgaattcatgcagttgaatccttctcaacagtctgctttacgggaacctttattaccgtgacccgcagttctggttctggaatgagggatcttccttgcgccggtgaaactcccgtcccgagtttcctcccgggttttttcttcccggattttctcgtcccggattttctcgtcccggatttcggcaccaattcttacacgcgttctcacgaccggccaggaaagaacacaacaaaccaaaatcttctgcggcaaaactttattgcttacatcttcaggagccaggagcgcaaacccccagccccaaaagcgaaagcccccttcttacatctttaggagccagagctccggcgcgccaaagcgcagagcgcgctctattgtttacatctttaggca	449	60	13%	56	12%
7	4199701	4200150	gggaacactttatcaccgtcgttccccagctgatgagttctgaattcggcagttgaatccttctcaacagtctgtgttacgggaacctttataaacgtgatccgcagttctggttccggaatgagggatcctccttgcgccagtcccgagtttttttctcgtcccggaattcggcaccaattgttattagacgcgttctcacgaccggccaggaagaacaccacagaccagaatcttctgcggcaaagctttatttcttacatcttcaggagccagggtgcaggaagcaagagagcaagaagcaagagagagagaaaaacgaaaccccgtccctcttaaggagcattctccttcgcctcggacgtgtcactccctgattggctgcagcccatcggccgagttgacgtcacggggaaggcagagcacaagtagtcataagatacccttgg	449	52	12%	66	15%
7	6251701	6252000	cactgactgctgaaagttctgaactcggtgggggagtcggttccccgtacgggccaccaattgtcgcgcccgctctcgaccagcaagaacgacgcgaccaccagtccttctaacagcagtttattcagtcctcatctttcttctttctcttcatcagtaccgttccccagctgaagagttctgaatccacgccagatccttctcaacagtctgttttacgggaacactttattaaccccttcttccccgttatgcagttctgaatcctccctgtagcagggggtcttcgctcttgcctg	299	32	11%	42	14%
7	6624301	6624450	acacaggcgcgagagtgaactcactcctagtcactgcccattctcggggcgtaatagtggggtgatgggcgagcaacgaatcaggagctgtcacgccacatcaggtgctgaaacgtcacactgcgggctatataagcagcaccattttc	149	18	12%	32	21%
7	6912151	6912450	tatatgcatatttgcatgtgtatgtacgtgtatgtgtatatgtgagtacacttgcgtctacatggatatatacgtgtgtgtatgtgtgtatgtacttatgtacatatatgtatacatgtatctatatgtgtacatgtgtgagtttacatatgtatttacatgtgtgtatatgtgtatttatgtatgtatttatgtgtatatgtgcctgcatgtgtatggatgtatatatgcatacatatatgtgtatgtatacatacgcatgtggatatatgagtataaacctggatttacatctatct	299	8	3%	30	10%
7	7277851	7278450	ggagggagaaggaaggagaaggaaggagaaggaaggagaagggagaaCCGGGGGCTGCGGGACTCGTGGAAGCCGGGATGGGTCCCTCGATGGCGGACGCCGACGCCAGGCAGCCCCGGGTggaagggaggaggaggaggaggagagagagacttagagtcagacagagggacagagagagagacttagacacagagacagagagacagagagagGCTCTGTCCCTGCACTCCTACAGGTACAACCTGGAGCAGCGGACGCGGACCTGAACCCCCGTCTGCCCGGGGACGCCGCCGCCACGGCCACACCGCTCGTCTGGAACCACGGCTGGCCTTCGGGTCCCAGATCCGTCCCCACGAGGCAGAGAACCGGGGGTGCACTTGCGCGTTTTTCGCCACCGGGTGGCCCCGGAGATCGGCGCTGGGCCCTAGACGCACTACAGCTCCCATGAGCGCCTGGGCCCGACTTCCTGTCCAAAATGGAGGCACTTCCTGTATCTCACAAAGTACAACCTCCCGGGGATTGACCGATGGAAAACGCGACCGCCTCGCGGGGTCGGATCCACCAGCCTGGCCGGCTTCCCCTCACCCTGGCCGGGA	599	92	15%	66	11%
7	8595151	8595450	cctgcgtagtgcgtcagccctgcgcagagagacaatgcgcagagagacaatgcgcagagaggcaatgtgcagactcattcattcccagagaggaacaaaggaaaatacaacaggcatttccggtctttgaaggagccgaggttgggcgtgtccacgctccggtagaatatgtgcagattaaagaacttgccgagtcggtccgtaaatacggaaccaatgctaattttaccttggtgcagttagacaggcttgccggcatggcactaactcctgccgactggcaaacgattgtaaaagcc	299	34	11%	46	15%
7	9149401	9149700	TCGAAGCTTGAATTAGATAACACGGGCTGTCGAAAACCTCAGCTCTGTCTCCGTGATGGAGGAAAAACGCCTCAACTCTACCGTTTTTCTGCCATGACCAATACTGATAAAACTAGTTTTCTGTGAAGCAGACTGACAGATCCAGAAAGTTTCAAAGAACCTCCTGCATGCAAAGCCGAAAGTCCCGCCCAGCGTCCTTTTGTTGTCACTAACGCGCCTGTTTTCATTGGCTTTTTTCGGTGCAATGTCTTCTGGACAATGTAGTTCAGACGTGATCAAGCGCCAGGAAGTGGACACAC	299	28	9%	42	14%
7	9749101	9749400	gtgcgcagactcattcattcccagagaggaacaaaggaaaatacaacaggcatttccggtctttgaaggagccgagggtgggcgtgtccacgctccggtagaatacttacaaattaaagaaattgccgagtcggtccgtaaatatggaaccaatgctaattttaccttggtgcagttagacaggctcgccggcatggcactaactcctgctgactggcaaacggttgtaaaagccgctctccctagtatgggcaaatatatggaatggagagcgctttggcacgaagctgcacaagcgc	299	32	11%	40	13%
7	10910401	10910700	aagccaaaagcggctggcgaaggccagtttgctgattggcctcaaggcagtcggcttcaaggtccgccctatgcggagtccccgccctgcgtagtgcgtcagcaatgcgcagagaggcaatgcgcagagagatgcgcagagaggcaatgcgcagagagatgcgcagagaggcagtgcgcagactcattcattcccagagaggaacaaaggaaaatacaacaggcatttccagtctttgaaggagccgagggtgggcgtgtccacgctccggtagaatacttacaaattaaagaactcgc	299	38	13%	52	17%
7	11057251	11057550	atgccagcgagcctgtctaactgcaccaaggtaaaattagcattggttccgtatttacgaaccgactcggcaatttccttaatttgtaagtattctaccggagcgtggacacgcccaccctcggctccttcaaagaccggaaatgcctgttgtattttcctttgttcctctctgggaatgaatgagtctgcgcactgcctctctgcgcactgcctctctgcgcatctctctgcgcattgctgacgcactacgcagggcggggactccgcatagggcggaccttgaagccgactgccctg	299	40	13%	30	10%
7	11058151	11058450	cagttgaatccttcttaacagtctgctttacgggaacctttattaccgcgacccgcagttctggttctggaatgagggatcttccttgcgccagtcccgagttttttctcgtcccggaattcggcaccaattgttattagacgcgttctcacgaccggccaggaagaacaccacagaccagaatcttctgcggcaaagctttatttcttacatcttcaggagccagggtgcaggaagcaagagagcaagaagcaagagagagaagcaagagagagagaaaacgaaaccccgtccctctt	299	32	11%	42	14%
7	11574001	11574600	tttttctctctcttgctttcttgttctttttctctctcttgctctctggctctcttgctctcttgctcctgaagatgtaagcaataaagattccgcagaagattccggtttgctgcgtctttcctggccggtcacgagagcgcgtgcaagaGTTGGTGCCGaaacccgggacgggacgagaaaacccgggacgggacgagaagacctgggacgagaaaacccgggacgagaagacctgggacgagaagacctgggacgagaagacctgggacgagaaaacccgggacaagaaaacctgggacggttaccatcaccgccgcaaggaagatccctcattccggaaccagaactgcgggtcatggtaatgaagtgttcccgtaaaacagactgttgagaaggattcaactgcgtgaattcagaactcttcagctggggaacggtggtaatgaagtgttcccgtaaaacagactgttgagaaggattcaactgcgtgaattcagaactcttcagctggggaatggtggtaatgaagtgttcccacaacacagactgttgagaaggattcaactgcgtgaattcagaactcttcagctggggaa	599	64	11%	52	9%
7	12546601	12546900	accctcggctccttcaaagactggaaatgcctgttgtattttcctttgttcctctcggggaatgaatgagtctgcgcactgcctctctgcgcactgcctctctgcgcattgctgacgcactacgggctgacgcactacgcagggcggggactccgcatagggcgggagtgcacctggtagccgattgccctgaggccaattagcaaactggccttcgccagccgcttttggctttttccttaaatgactagttagcactttacttggcggctggtatccttttctttcataatgagccg	299	34	11%	28	9%
7	14821801	14823300	tataatagtagacacaacaagagcgaacacgagactaagacaaaaaagaaaccaaaagcagtggcgacttcgcgtcgaccacaagcaactcaaagaatcagatggcctttctaaggccagccgattgagaccctctgcacgaggtgggactcgaacccacgatcccatagcaaaacacgaggtgggactcaaacccacgatctcgcatcaaggcacgaggtgggactcgaacccacgatctcgcaaccccagatggtctcttggcctccaaaggggtccaccaggcatccctggtcctcccctgttcctcctgggacgtctcccagggcgaacggacggtggacacctggacacgtctatccttatccaccccgcgttccctctcggagcgcggtctcactgagcgtccgcaaaaccgaaactgcgatcgcaccaaacttagaaacagaacacagacaccagaccaagacagaacaaagaatcttacctttaagtgggtctaggacctctgggtggtcgcgctgatcccggacgagcccccaaatgaaagacccccgaagggagaccctcactcaagcctcgggacagccgcggacccaagaagacactgagaccgaactcaaaatgttgaaggcaagatttaataaagcaacagcaagaaagcacatagaccagagctctggggtcgaaactcatgcaccaagtatggtgtagaggagaatcgacctcaagccaaatttttcacaggcttatataggaaaaactcaagggtgtggggagccgccctcacattcgccgttgcaagatggcgctgacatcctgtgttctaagtggtaaacaaataatctgcgcatgtgccaagggtagttttccaccccatgtgctctgccttccccgtgacgacaactcggccgatgggctgcagccaatcagggagtaatacgtcctaggcggagaataattctccttaaaaagggacggggttccgccattctctctcttgcttttgctcttgcactcttgcgctcttgcgctctggctcctaaagatgtaagcaatagagctcttgcactcttgcactcttgctcctgaagatgtaagcaataaagttttgccgcagaagattccggtttgctgcgttcttcctggccggtcgcgagaacgcgggtaagaGTtggtgctgaaacccgagacgagaaaacccgagacgagaaaacccgggacgagaaatcctgggatgagaaaacccgggacggttaccatcaccggcacaaggaagatccctcattccggaaccagaactgtgggtcatggtaatgaagtgttcccgtaaaacagactgttgagaaggatccagcctggattcagaactcctcagctggggaacggtggtaatgaagtgttcccgtaaaacagactgttgagaaggattcaactgcgtgaattcagaactcttcagctggggaacagggtacccgtaagtatagctttacaaggta	1499	162	11%	210	14%
7	15595951	15596400	aataatctgcgcatgtgccgagggtggttctccactccatgtgctctgccttccccgtgacgtcaactcggccgatgggctgcagccaatcagggagtgacacgtcctaggcgaaggataattctccttaatagggacggggtttcgttttctctctctcttgcttcttacactcttgctcctgaagatgtaagcaataaagttttgccgcagaagattctggtttgctgtgttcttcctggccgggcgtgagaacgcgttaataacaattggtgccgaattccgggacgagaaaaaactcgggactggcgcaaggaagatccctcattccagaaccagaactgcgggtcgcggtaataaaggttcccgtaaagcagactgttaagaaggattcaactgtatgaatacagaacttttcagctggggaacgagagtaccagtgagtatag	449	50	11%	42	9%
7	15597151	15597300	gcgtgtccacgctccggtagaatacttacaaattaaagaactcgccgagtcggtccgtaaatacggaaccaatgctaattttaccttggtgcagttagacaggcttgccggcatggcactaactcctgccgactggcaaacggttgtaa	149	22	15%	16	11%
7	15804151	15804450	ttacaagatggcgctggcttccgcagtgcctaacttgtaaacaagcaatgtgcacaggtgctggagtaaattcataccaagtcactgcccatctcagggtgtagcagtggggtgatgagtgagcagctaatcaggagctgacacgtcacacggaggggtatttaagcagctccattttccgggttcggggtcttcctgagaattaagcaataaaagctttgccgtagaaggacccggttgtccgagtgtgttttgctggcaagacgttacaaggacaaagtggtgctgaaacccgggaa	299	22	7%	46	15%
7	17661751	17661900	actgtccaattgtcttcgtggttttcttcatcttgactggcggccctcttgacgtgggaggcgtggatccaggaggcaatcccgtcaacttttaccgcagtaggggttgtcagtaacaccaaatagggtcccttccaccgtggctcgag	149	16	11%	20	13%
7	18541801	18542100	ccacggagttgaatccttctcaacagtctgtgttacgggaacacttcattaccaccgttccccagctgaagagttctgaatccacgccgtatccttctcaacagtctgttttacgggaacctttatcaaccactccttccccgcgatgcagttctgaatcctccctgtagcagggggtcttcactcgtgcctgaagatgtttctcgtcccgggtttcggcaccattTCTtgcacgcgctcaactggccaggaagaacgatgctgcaacaggatccttctgcacacatttattgggagag	299	30	10%	50	17%
7	23557651	23557950	agagcggcttttacaaccgtttgccagtcagcaggagttagtgccatgccggcgagcctgtctaactgcaccaaggtaaaattagcattggttccatatttacggaccgactcggcaatttctttaatttgtaagtattctaccggagcgtggacacgcccaccctcggctccttcaaagaccggaaatgcctgttgtattttcctttgttcctctctgggaatgaatgagtctgcgcactgcctctctgcgcagggctgacgcactacgcagggcggggactccgcatagggcggacc	299	38	13%	36	12%
7	24105601	24105900	gcgagaagcccttcgagtgtaatcactgtgggaagtcgttcagctggagctcgcagctggtgtcgcatcagagaacccacacaggagagaaaccttacgagtgtaatgagtgtgggaagtcattcaaccggagctcacaccttgtcatgcaccagagaactcacactggggagaagccgtatcagtgcaagcagtgcgggaaatccttcagtcagagctacgtcctcgtcgttcatcagaggacgcacactggggaaaagccctacgagtgcggccagtgtgggaagacgttcaggcag	299	32	11%	58	19%
7	24582751	24583050	cagcaggagttagtgccatgccggcaagcctgtctaactgcaccaaggtaaaattagcattggttccgtatttacgaaccgactcggcaatttctttaatttgtaagtattctaccggagcgtggacacgcccaccctcggctccttcaaagaccggaaatgcctgttgtattttcctttgttcctctctgggaatgaatgagtctgtgcactgcctctctgcgcactgcctctctgcgcattgctgacgcactacgcagggcggggactccgcatagggcggaccttgaagccgactg	299	36	12%	34	11%
7	24748651	24749100	ctgtctgtctctgtgtgcgtatgcacatacgtgttgtgtctgtgtgtgtgtacgtgtgtctgtctgtgtgtctgtctgtctgtctctgtgtgtacatatgtgtctgtgtctgtctgtgtgtacatgtgtgtctatgtgtgtacatgtatgtctatgcctgtgtgtatgtactatgtgtttgtctatctgtctgtgtgtgtatacatgtgtgtctatgtgtgtgtgtatttgtctgtgtgtgtacatgtgtacatgtgtgtgtttgtgtgtgtacatgtgtgtgtacatgtgtacatgtgtgtctctgtctgtgtgtatgtctgtctgtcagtgtctgtgtgtgtgtctgtctgtctgtctgtctgtgtctgtgtgtatgtatatatgtgtctgtgcctgtgtgtgtctctgtgtgtgcatgcgtacatgtgtatctcggtgtgtgtcca	449	10	2%	30	7%
7	26502751	26503200	ctttcttgctctctcttgctttcttgttcttgttctttttcttgcttttgctcttgcactcttgcgctcttgcgatcttgcgctctggctcctaaagatgtaagcaatagagctcttgctctggctcttgcttcttgctcctgaagatgtaagcaataaagttttgccgcagaagattacggtttgttgcgttcttcctggccggtcgcgtgaacgcgggtaagaGTtggtgctgagacccgggacaagaagacccgggacgagaagacctaggacgagaagacctgggacgagaaaacctgggacggttaccatcaccggcgcaaggaagatccctcattccggaaccagaactgcgggtcatggtaatgaagtgttcccgtaaaacagactgttgagaaggattcaactgcgtgaattcagaactcttcagctggggaacggtggta	449	48	11%	30	7%
7	27535051	27535200	gtgtgcttatgtgcatgagtgtgtgtgagtctatgtgtgtgtgtgtgtgtgtatgtgtgcttatgtgcatgagtgtgtgtgagtctatgtgtgtgggggcgtgtgtgcgtgcatgcgtgcttatgtgcatgtgtgtgtctgtgtgtgtg	149	6	4%	8	5%
7	28026751	28027200	ctgccacagaccctttctgacctccaccgactggttgtgggctctgacccgcacctccttccaatgctccagagtcagagaaaggggagtggacacagattgtcccatttctagaaaaacagtagtcacaacaagagcggacacgagactaagacaaaaaagaaaccagaaacggcggcgactctgcgtcgaccacaagcaactcaaagaatcagatggcctctctaaggccggccgattgagaccctctgcacgaggtgggactcgaacccacgatcccgtgaccaaacgcgaggtgggactcgaacccacggtctcgcaacaaggcgcgaggtgggactcaaacccacgatctcgcaacaaaacgcgaggtgggactcgaacccacgatctcgcaaccccaaatggtctcttggcctccaaaggggtccaccaggcgtccctggtcc	449	60	13%	76	17%
7	28260751	28261050	gaacccacgatctcgcaacaaaacacgaggtgggactcgaacccacgatctcgcaactgggcacgaggtgggactcgaacccacgatctcgcaaccccaaatggtctcttggccttcaaaggggtccaccaggcgtccctgatcctcccctgttcctcctgggacatctcccagggtgaacggacggtggacacctggacatgtctatccttatccaccccgcactccctctcggagcgcggtctcactgagcgtccgcaaaactgaaactgcgatcgcaccaaacttagaaacagaac	299	42	14%	48	16%
7	29344501	29344950	gtctgtggtatgtgtggtgtgtgtgtgtggtgtgtaggtctgtggtgtgtggtgtgtgtatgtgtgtgtggttgtggtatgtatgtctgtggtgtgtgtgtttatggtgtatatgtatgtagtgtgtgggtggtgtgtctacgtgtgtgttgtgtggtgtgtgtatgtgtatgtctgtggtatgtgtggtgtgtgtgtgtgtgtggtgtatatgtatgtggtgtctgtgtgtgtgtatgtatgtggtgtgtaggtctgtggtgtgtgtatgtgtgtgtggttgtggtatgtatgtctgtggtgtgtgtgtgtttatggtgtatatgtatgtagtgtgtgagtggtgtatctacgtgtgtattgtgtgggtcgtgtgtgtcgtgtgtgtgtgcgtgtgtgAGACTCATGTCCTTGCCACAgaccctcctgcctcagctcttccctgtgct	449	10	2%	8	2%
7	29894251	29895300	tctctcctgtgtgaattcgctgatgcacttggagctgggatttcttagtgaaggatttcccgcagtcgccgcaatcgtacggcttctccccagtgtggattctgtggtgTGTAATCAGCTCTGACTTCTGCCTGAAGGACTTCCCACACTCTGAACACGCGTACGGCTTCTCCCCAGTGTGAGTCTTCTGGTGCTTGCTGAGATTTGACCTGCCGCTAAAGGCtttcccacactcggcacacacgtaaggtttctcgccggtgtggattggccggtgcaccaggagctgcgacttggaggtaaaggacttgccgcagtcggtgcatccataaggtttctcgccagtatggatgcgctgatgGGTGATGAAGTTGGACTTGCGGATGAAAGCTCGCCCGCACTCGGCACACACGTGCGGTTTCTCCCCCGTGTGGATTTTCTGGTGCACGATGAGTATGGATTTCTGGTTGAAGGCTTTCCCACAGTCTCGGCATCCGTACTGTCtctctccggtgtgaatcttctcgtgtatactgaggtgtgatttctgggtaaaggctttcccgcaggtgctacacccatatggcttctctccggtatgtatcctctggtgtgtaaccaggtctgacctctgagtgaatgctttcccacaccttgcacagacataggctttctcccctgtatgagttttctgatgtgtgatgagatttgacctgttggcaaaggccttcccacagttactgcacacatagggtttttcccccgtgtgaatccgcttgtgcacgtggagttgcgacttggaagtgaagaatttcccacaatgaccacactggtaaggtttttctccagtgtgaatcacctggtgTGCATCCAAGTGTGCCCTTTGCACGAAGGCTAGCCCGCACttcacacacacatacgacttctcccccgtgtggattcttcggtgcacggtgagggctgacttctgggtgaaggctttgccacagtccccgcactgataaggcttctctcccgtgtgagttctctgatgaatgattagctccgac	1049	94	9%	126	12%
7	30161851	30162300	agggttgagaactgagaaaaggccttcccacattcattgcacccgtagggtttctcacccgtatggctcctcacatgcacggttagagatgagctctgagagaaggctttcccacatacattgcactcgtaaggcttatcgcctgaatggattctcacatgcacaatcagcgacgtgcgctgcgagaaggccttgccgcactcgttgcactcgtacggcttctccccggtgtggatgttttggtgctttatcaggtactttttctggccaaaagccgttccgcactcgttgcacttgaagggcttctctccgatgtgaatcttctcgtgctccgtcagattggatttgccactgaaggttttcccacactccttacatatgaagggcttctcccccgtgtgagttctctgatgtctgatgaggtttgacttctgaatgaaggctttccc	449	42	9%	56	12%
7	30402151	30402300	tgcacatgcacacacatacacacacctgctcaagtgtacatacacacatgcacacacctgctcgagtgtatatacacacacatatatatatgggtgagtgcacacacatgtacatacatacacatatacacacatatgcatacacatgt	149	2	1%	70	47%
7	30927751	30927900	cttggtcatgatgtttgggcagtgttattagacgcgttctcacgaccggccaggaaaaacaccacagaccagaatcttctgcggcaaagctttattgcttacatcttcaggagcaggagtgcaagaagcaagagagagagaaaacgaaa	149	12	8%	28	19%
7	30932851	30933150	aagcgctctccattccatatatttgcccatactagggagagcggcttttacaaccgtttgccagtcggcaggagttagtgccatgccggcaagcctgtctaactgcaccaaggtaaaattagcattggttccgtatttacggaccgactcggcaatttctttaatttgtaagtattctaccggagcgtggacacgcccaccctcggctccttcaaagaccggaaattcctgttgtattttcctttgttcctctctgggaatgaatgagtctgcgcactgcctctctgcgcactgcctct	299	32	11%	34	11%
7	30933751	30934200	ttgaatttccttagaaagttcaaggccaggcttacctcgtaaagctatactcactggtactctcgttccccagctgaaaagttctgaattcatacagttgaatccttcttaacagtctgctttacgggaacctttattaccgcgacccgcagttctggttctggaatgagggatcttccttgcgccagtcccgagttttttctcgtcccggaattcggcaccaattgttattagacgcgttctcacgaccggccaggaaaaacaccacagaccagaatcttctgcggcaaagctttattgcttacatcttcaggagcaggagtgcaagaagcaagagagagagaaaacgaaaccccgtcccttttttaggagagttatatttcgcctaggacgtgtcactccctgattggctgcagcccatcggccgagttgacgtcacggggaaggca	449	48	11%	56	12%
7	32184601	32185950	tccacttgttgggagccgcgcccacattcgccgttacaagatggcgctgacagctgtgttctaagtggtaaacaaataatctgcgcatatgccgagggtggttctccactccatgtgctctgccttccccgtgacgtcaactcggccgatgggctgcagccaatcagggagtgacacgtcctaggcgaaatataactctcctaaaaaagggacggggtttcgttttctctctctcttgcttcttacactcttgctcctgaagatgtaagcaataaagttttgccgcagaagattctggtctgtggtgttcttcctggccgggcgtgagaacgcgtctaataacaATTGGTGccgaattccgggacgagaaaaaactcgggactggcgcaaggaagatccctcattccagaaccagaactgcgggtcgcggtaataaaggttcccgtaaagcagactgttaagaaggattcaactgtatgaattcagaacttttcagctggggaacgagagtaccagtgagtacagctttacgaggtaagtctgatcttgaactttctaaggaaattcaagacagtctatcagaagtaaagtggaatatgtttggccttgaattttttctggtgttaggagcccttttgttccttttcacatgttatcaagtgattaagatagggctgaaaattctagaggaaattcaggacaagctatcagaagtaaagcggggagagagagtaggaacaaagaggaaatatggtacacaaaataagtatacaggcctttccaagggtcttgaacccgaggaaaagttaaggttaggtaggaatacctggagagagattagaagaaaaagaggaaaaagggaaaagaagaaagatcaattagcggaggtctctaggaaaaggagcctgtgctcatcgctggatgggctcggggagccagctcttagtagctctgaagcagatgaagaattctcctctgaagaaacagactgggaggaagaagcagctcattatgagaaaaaagggtaccagccaggtaaagtgctagctaatcagttaaggaagccaaaagcggctggcgaaggccagtttgctgattggcctcagggcagtcggcttcaaggtccgccctatgcggagcccccgccctgcgtagtgcgtcagccctgcgcagagaggcagtgcgcagagaggcagtgcgcagactcattcattcccagagaggaacaaaggaaaatacaacaggcatttccagtctttgaaggagccgagggtgggcgtgtccacgctccggtagaatacttacaaattaaagaacttgccgagtcggtccgtaaatatggaaccaat	1349	108	8%	148	11%
7	32813551	32814900	gcttgtgcagcttcgtgccaaagcgctctccattccatatatttgcccatactagggagagcggcttttacaaccgtttgccagtcggcaggagttagtgccatgccggcaagcctgtctaactgcaccaaggtaaaattagcattggttccgtatttacggaccgactcggcaatttctttaatttgtaagtattctaccggagcgtggacacgcccaccctcggctccttcaaagaccggaaatgcctgttgtattttcctttgttcctctctgggaatgaatgagtctgcgcactgcctctctgcgcactgcctctctgcgcagggctgacgcactacgcagggcgggggctccgcatagggcggaccttgaagccgactgccctgaggccaatcagcaaactggccttcgccagccgcttttggcttccttaactgattagctagcactttacctggctggtacccttttttctcataatgagctgcttcttcctcccagtctgtttcttcagaggagaattcatcatctgattcagagctaccaagagctggctccccgagcccatccagcgatgagcacaggctccttttcctagagacctccgctaatcgatctcttttcttttcttttttcttttccttccttctaatctctccccaggtattcttacctgacctaaacttttcctcgggttcaagacccttggaaaggcctgtatacttattttgtgtaccatattttctctttgttcctactctctctccccgctttacttctgatagattgccctgaatttcctctagaatcctccctgccttaaccacttgataacatgtgaaaaggaacaaaagggcttctaacactagaaaaaattcaaggccaaacattttccactttacttctgatagactgtcttgaatttccttagaaagttcaaggccaggcttacctcgtaaagctatactcactggtactctcgttccccagctgaaaagttctgaattcatacagttgaatccttcttaacagtctgctttacgggaacctttattaccgcgacccgcagttctggttctggaatgagggatcttccttgcgccagtcccgagttttttctcgtcccggaattcggcaccaattgttattagacgcgttctcacgaccggccaggaaagacgcaacaaaccagaatcttctgcggcaaaactttattgcttacatcttcaggagcaagagtgtaagaagcaagagcgagagaaaacgaaaacccgtcccttttttaggagagttatatttcgcctaggacgtgtcactccctgattggctgcagcccatcggccgag	1349	112	8%	148	11%
7	33040501	33041700	agggagagcggcttttacaaccgtttgccagtcggcaggagttagtgccatgccggcaagcctgtctaactgcaccaaggtaaaattagcattggttccgtatttacggaccgactcggcaatttctttaatttgtaagtattctaccggagcgtggacacgcccaccctcggctccttcaaagaccggaaatgcctgttgtattttcctttgttcctctctgggaatgaatgagtctgcgcactgcctctctgcgcactgcctctctgcgcagggctgacgcactacgcagggcgggggctccgcatagggcggaccttgaagccgactgccctgaggccaatcagcaaactggccttcgccagccgcttttggcttccttaactgattagctagcactttacctggctggtacccttttttctcataatgagctgcttcttcctcccagtctgtttcttcagaggagaattcatcatctgattcagagctaccaagagctggctccccgagcccatccagcgatgagcacaggctccttttcctagagacctccgctaatcgatctcttttcttttcttttttcttttccttccttctaatctctccccaggtattcttacctgacctaaacttttcctcgggttcaagacccttggaaaggcctgtatacttattttgtgtaccatattttctctttgttcctactctctctccccgctttacttctgatagattgccctgaatttcctctagaatcctccctgccttaaccacttgataacatgtgaaaaggaacaaaagggcttctaacactagaaaaaattcaaggccaaacattttccactttacttctgatagactgtcttgaatttccttagaaagttcaaggccaggcttacctcgtaaagctatactcactggtactctcgttccccagctgaaaagttctgaattcatacagttgaatccttcttaacagtctgctttacgggaacctttattaccgcgacccgcagttctggttctggaatgagggatcttccttgcgccagtcccgagttttttctcgtcccggaattcggcaccaattgttattagacgcgttctcacgaccggccaggaaagacgcaacaaaccagaatcttctgcggcaaaactttattgcttacatcttcaggagcaagagtgtaagaagc	1199	94	8%	130	11%
7	35695951	35696400	gcacccactcagcatctcacaaccgacattccagaggggaggattgctcaagtaatgcctgcatacgatacatatatgcgtaccatgcatacatgcatacatgcacacacacgaacatacatgcagaaactcatacgcaaaaaagtaaaaaaaaTAAGATAAGCGAGGAGCCAGGAAAATGCAGTTGATCACGACTCAATTTCATGGGGTTAAAACAGCAAAACTATAAAAACAGTAAAACTGAGTATGACTTTAAATGATATTTAAAGGAGGAAGCCCTGACATGATTAACACGGAAGAAGCTTCCGAAGAGCAGTCCGTTACTAAGAGAGGACGCACGCTTCTTCCGACACAGAGACACTCTTCTGTCTCCTCAGACACAACACACAAAGCCAAGGCCTACGTGACATCATCCCATGAACTTATTTCCCATGGAGCACCAAGCTCTC	449	28	6%	106	24%
7	37163551	37163850	tcagaactgcatcacggggaaggagtggttaatgaagtgttcctgtaaaacagactgttgagaaggatctggcgtggattcagaactcttcagctggggaacggtactgatgaagagaaagaagaaagatgaagactgaataaactgctgttagaaggactggtggtcgtgtcgttcttgctggtcgagagcagacgcgacaattggtggcccatacggggaaccgactcccccaccgagttcagaactttcagcagtcagtggttgccggcagggtaagttcacggtgagtgaaactt	299	26	9%	32	11%
7	39778051	39779550	CATAAAAGAACAAGCCAGTCTTTtgttgggagccgcgcccacattcgccgttacaagatggcgctgacagctgtgttctaagtggtaaacaaataatctgcgcatgtgccaagggtattttgtgactacttgtactctgccttccccgtgacgtcaactcggccgatgggctgcagccaatcagggagtgacacgtccgaggcgaaggataattctccttaatagggacggggtttcgttttctctctctcttgcttcttgcactctggctcctgaagatgtaagcaataaagctttgccgcagaagattctggtttgttgcgtctttcctggccggtcgtgagaacgcgtctaataacaattggtgccgaattccgggacgagaaaaaactcgggactggcgcaaggaagatccctcattccagaaccagaactgcgggtcgcggtaataaaggttcccgtaaagcagactgttaagaaggattcaactgtatgaattcagaacttttcagctggggaacgagagtaccagtgaatacagctttacgaggtaagtctggtcttgaactttctaaggaaattcaagacagtctatcagaagtaaagtggaatatgtttggtcttgaattttttctagtgttagaagcccttttgttccttttcacatgttatcaagtggttaaggcagggcggattctagatgaaattcaggacaatctatcagaagtaaagtggggagagagagtaggaacaaagaggaaatatggtacacaaaataagtatacaggcctttccaagggtcttgaacccgaggaaaagttaaggttaggtaggaatacctggagagagattagaagaaaaagaggaaaaagggaaaagaagaaagatcaattagcagaggtctctaggaaaaggagcctgtgctcatcgctggatgggctcggggagccagctcttagtagctctgaagcagatgaagaatcctcctctgaggaaacagactgggaggaagaagcagctcattatgagaaaaaagggtaccagccaggtaaagtgctagctaatcagttaaggaagccaaaagcggctggcgaaggccagtttgctgattggcctcagggcagtcggcttcaaggtccgccctatgcggagtccccgccctgcgtagtgcgtcagccctgcgcagagaggcagtgcgcagagaggcagtgcgcagactcattcattcccagagaggaacaaaggaaaatacaacaggcatttccggtctttgaaggagccgagggtgggcgtgtccacgctccggtagaatacttacaaattaaagaaattgccgagtcggtccgtaaatacggaaccaatgctaattttaccttggtgcagttagacaggcttgccggcatggcactaactcctgccgactggcaaacggttgtaaaagccgctctccctagtatgggcaaatatatggaatggagagcgctttggcacgaagctgc	1499	124	8%	166	11%
7	40131451	40132350	gatgggctgcagccaatcagggagtaatacgtcctaggcggaggataattctccttaaaagggacggggttttgccattctctctctctctcttgctttcttgttcttgttctctctcttgttcttgctttttctctctcttgctttcttgttcttgttcttgttctttttcttgctttcttgctctctcttcctctggctctctggctcctgaagatgtaagcaataaagcttttgccgcagaagattccggtttgttgcgttcttcctggccggtcgcgagaacgcgtgtaagaGTtggtgctgagacccgagacgagaaaacccgggacgagaagacccgggacaagaagacctgggacaagaagacccgggacgagaaaacctgggacgagaagacctgggacgagaaatcccgggacgagaaaacctgggacggttaccatcacaggcgcaaggaagatccctcattccggaaccagaactgcgggtcatggtaatgaagtgttccagtaaaacagactgttgagaaggatccagcctggattcagaactcttcagctggggaacggtggtaataaagtgttcccgcaacacagactgttgagaaggattcaactgcgtggattcagaactcttcagctggggaacggtggtaatgatgtgttcccgtaaaacagactgttgagaaggattcaactgcgtgaattcagaactcttcagctggggaacagggtactcgtaagtatagctttacaaggtaagtctggtcttgaactttctaacgaaattcaagacagtctatcagaagtaaagtgggaaatagctttacaaggtaagtctggccttgaactttctaacgaaattcaagacagtctatcagaagtaaagtgggaaat	899	70	8%	78	9%
7	42889051	42889350	cttgctttcttgctcttgtgctcttgctctctagctcctgaagatgtaagcaataaagcttttgccgcagaagattccggtttgttgcgttcttcctggccggtcgcgagaacgcatgtaagaGttggtgctgagacccgggacgagaagacctgggacgagaaaacccgggacgagaaatcctgggatgagaaaacccgggacggttaccatcaccggcgcaaggaagatccctcattctggaaccagaactgcgggtcatggtaatgaagtgttcccgtaaaacagactgttgagaa	299	36	12%	20	7%
7	42891451	42891600	tctctcttgctcttgctttttctctttcttgttcttgttctttttcttgctttcttgctcttgtgctcttgctctctagctcctgaagatgtaagcaataaagcttttgccgcagaagattccggtttgttgcgttcttcctggccggt	149	8	5%	4	3%
7	43148851	43149450	aggaatGTATGttttttttttttACACATGACAAGCATGTATTGTTGGTTTGTGCTTCACTTACATCTCGAATAATAAAATTGGCCAGAGAGTATTATTCTAATTCCCAGAATGGCATGTAATTGTGACATTAATAGTGCCTGATCCTTCCAATTCATTTGTTATTAAGAGTGAGACACTCTTCCTACATGTTGTCTTTGTTTTGAAATATTTGAATGACTatgaatgcatatgcacctctctgtgcttggtcctctcttacacgcgttcgcgaccggccaggaaagacgcagcaaaccagaatcttctgcggcaaaactttattgcttacatcttcaggagcaagagtgcaagagagcaagagctctattgcttacatctttaggagccagagagcaagagcgcaagagccagagcaagagagagaaaagcgaaaccccgtcccctttaaggagaattatcctccgcctaggacgtgtcactccctgattggctgcagcccatcggccgagttgtcctcacggggaaggcagagcacacggcgtggagaactacccttggcacatgcgcagattatttgtttaccacttagaacacag	599	38	6%	92	15%
7	55409551	55409850	cttgccctcgctcttgctctcttgcactcttgctcctgaagatgtaagcaataaagttttgccgcagaagattccggtttgttgcgttcttcctggccggtcgtgagaatgcgtgtaagaGttggtgccgaaacctgggacgagaaaatccgggaagaaaaaacccgggacaagaaaactcgggacgggagttaaccatcaccggcgcaaggaagattcctcattccggaaccagaactgcgggtcacggtaatgaagtgttcccgtaaaacagactgttgagaaggattcaactgcgt	299	40	13%	24	8%
7	57116101	57116250	ttaaggaagccaaaagcggctggcgaaggccagtttgctgattggcctcagggcagtcggcttcaaggtccgccctatgcggagtccccgccctgcgtagtgcatcagccctgcgcagagaggcaatggacagagaggcaatgcacaga	149	16	11%	26	17%
7	59209351	59209800	aatctctctgctctggagtcaaagcagctgcgtttgctcgggcctgcgcttgtgcagcttcgtgccaaagcgctctccattccatatatttgcccatactagggagagcggcttttacaaccgtttgccagtcagcaggagttagtgccatgccggcgagcctgtctaactgcaccaaggtaaaattagcattggttccgtatttacggaccgactcggcaatttctttaatttgtaagtattctaccggagcgtggacacgcccaccctcggctccttcaaagaccggaaatgcctgttgtattttcctttgttcctctctgggaatgaatgagtctgcgcactgcctctctgcgcactgcctctctgcgcattgctgacgcactacgcagggcggggactccgcatagggcggaccttgaagccgactgccctgaggccaatcagca	449	54	12%	56	12%
7	59533951	59534400	GTTGAGCTGCCCAAGTTCTATGGATAGGACAAAAAAATAATTGAATAAAACAACTACAGATAGGTATTTCGAGGGTGATTAAAGTAACTGTGTGTTTTTGCTCAAAGTGCAAATGTGGCATCAGACCTCTGTAAGGTCTATGTTGTAAGACCCGACTCAACGTGAAAGGTGATTCCTGAAAATCTCCCGAGAATCCTGGACCGAGGCCACAGAACCCATGTCTATACATGTATCCATTTGTGTCAACGTGTTATGGGTTGCCCTGCTGTAAAACGTGAGTGTAAGCACTGTTGCTGGACTAAAGTCAGGCCTTGGTGTTATGAATCAAAGTGGAATTAGGTTCTTTAAACACCTGGCCTTACCGTGTATCAACCTAATGTGTAGAGCTTTTTTTCCTCAGTGATTCTGCAGTGAGGTTCAGTAAGTGCCCTAAATGATACCATGAAGGA	449	16	4%	48	11%
7	59691901	59692200	accggagcgtggacacgcccaccctcggctccttcaaagaccggaaatgcctgttgtattttcctttgttcctctctgggaatgaatgagtctgcgcactgcctctctgcgcactgcctctctgcgcattgctgacgcactacgcagggcggggactccgcatagggcggaccttgaagccgactgccctgaggccaatcagcaaactggccttcgccagccgcttttggcttttttcttgaccaattagctggctggtaatgggctgcttcttcctcccagtctgtttcctcagagga	299	32	11%	32	11%
7	63810601	63810750	ctctttaatagggacggggtttcgttttctctctctcttgcttctcgctctctcttgcttcttgcactctggctcctgaagatgtaagcaataaagctttgccgcagaagattctggtttgttgtgtctttcctggccggtcgtgagaa	149	12	8%	6	4%
7	67156201	67156350	aatacaacaggcatttccggtctttgaaggagccgagggtgggcgtgtccacgctccggtagaatacttacaaattaaagaaattgccgagtcggtccgtaaatacggaaccaatgctaattttaccttggtgcagttagacaggctcg	149	20	13%	16	11%
7	73180651	73180950	gggcctgcgcttgtgcagcttcgtgccaaagcgctctccattccatatatttgcccatactagggagagcggcttttacaaccgtttgccagtcggcaggagttagtgccatgccggcaagcctgtctaactgcaccaaggtaaaattagcattggttccgtatttacggaccgactcggcaatttctttaatttgtaagtattctaccggagcgtggacacgcccaccctcggctccttcaaagaccggaaatgcctgttgtattttcctttgttcctctctgggaatgaatgagtct	299	32	11%	34	11%
7	75811801	75811950	gggtgggcgtgtccacgctccggtagaatacttacaaattaaagaacttgccgagtcggtccgtaaatacggaaccaatgctaattttaccttggtgcagttagacaggcttgccggcatggcactaactcctgccgactggcaaacgg	149	20	13%	16	11%
7	82090351	82090500	cgtgctgcgagcaatcgcatgtgtgccgccagtaatctctgaggagagccgtgtgtgccgcgagcaatcgccattataagatggcgcgggcctccgctgtgcctaactagtaaacaagccttgtacgcaggtgcaagagtgaattcact	149	24	16%	18	12%
7	83923801	83923950	gagaaaagcaagagagcgaaaaagcaagagagagaaaaaacgaaaaccccgtccctcttaaggagcattctccttcgcctcggacgtgtcactccttgattggctgcagcccatcggccgagttgacgtcacggggaaggcagagcaca	149	20	13%	20	13%
7	83925601	83926050	agaactgttggaatttttgagacgtataagctggtccattatcagtcttaaggagtctgggtttcccccaagcactccatgcctcaagacaatgttgaatcacatgtgaggctttttctccagttaacggagaagcaaacatgatgccagaacatgtgtcaatggacacatggagatattgaagttttccaaaggaagaaacatgtgtaacatccatttgccagacctgtagaggtcgaataccgcgtgggttaattcccacatgaggaactggcaagaactcacagcagctttgacattgagtaacaatgtcacgggcttcttttcttgtcaaggagaaacgactgcgtaatgtttcagccgtcacatgaaaattgttatgaaaatttcttgcagcctctaccggggatgatagggcagcagccatcactttagtggccttatctgcc	449	20	4%	80	18%
7	83927551	83927850	ccaaggtaaaattagcattgattccatatttaatctgcacatattctaccggagcgtggacacgcccaccctcggctccttcaaagactggaaatgcctgttgtattttcctttgttcctctcggggaatgaatgagtctgcgcactgcctttctgcgcactgcctctctgcgcattgctgacgcactacgggctgacgcactacgcagggcggggactccgcatagggcgggagtgcacctggtagccgattgccctgaggccaattagcaaactggccttcgccagccgcttttggc	299	36	12%	38	13%
7	85373701	85374150	tctttaagtgagttatttaAGtcttaatagcgttctcacgcccggccaggaagaacacaacagaccagaatcttctgcggcaaaactttattgcttacatcttcaggagctaggagcgcaaacccccagccccaaaagcgaaagccccttcttacatctttaggagccagagctccggcgcgccaaagcgcagagcgcgctctattgtttacatctttaggcagcgagagagcgcagggcgcgcagagccagagagatgccagcgagagagaatggcggaaaccccgtcccctttaaggaggagttatccttcgcttaggacgcatcactccctgattggctgcagcccatggccgagctgacgttcacgggaaaggcagagtacaagtagtcgtaaaatacccttggcacatgcgcagattatttgtttaccacttagaacacaggat	449	52	12%	70	16%
7	86031901	86032350	catgtgctctgccttccccgtgacgtcaactcggccgatgggctgcagccaatcagggagtgacacgtcctaggcgaaggataattctccttaatagggacggggtttcgttttctctctctcttgcttcttacactcttgctcctgaagatgtaagcaataaagttttgccgcagaagattctggtttgctgtgttcttcctggccgggcgtgagaacgcgttaataacaattggtgccgaattccgggacgagaaaaaactcgggacgagagtttaccatcaccggtgcaaggaagatccctcattccggaaccagaactgcgggtcacggttatgaagtgttcccacaacacagactgttgagaaggattcaactgcatgaattcagaacttttcagctggggaacggcggtaacccgtaagtatagctttacgaggtacgcctgg	449	54	12%	48	11%
7	86032951	86033100	ccctgcgtagtgcgtcagccctgcgcagagagacaatgcgcagagaggcagtgcgcagactcattcattcccagagaggaacaaaggaaaatacaacaggcatttccggtctttgaaggagccgagggtgggcgtgtccacgctccggt	149	20	13%	28	19%
7	89273101	89273850	AATGTCCAAAAACTGTTCTTATTTTGTGTTTGTACTACAGtgttgggagccgcccccacattcgccgtcacaagatggcgctgacagctgtgttctaagtggtaaacaaataatctgcgcatgtgccaagggtatttctccaccccatgtactctgccttccccgtggcaacaactcggccatgggctgcagccaatcagggagtgatacgtcctaggcgaaggataactctcctaaagagggacggggtttcgctttcgttttgggggcttggggcttgcacgcttgcccctgaagatgtaagcaataaagttttgccgcagaagattctggtttgttgtgttcttcctggccggtcgtgagaaagcgtGCaagagttggtgccgaaatccgggacgagaaaacccgggacgagaagacctgagacgagaaatcctgggacgagaaaaccccgggacggaatttaccatcaccggcgcaaggaagatccctcattccggaaccagaactgcgggttatggtaatgaaggttcccgtaaaacagactgttgagaaggattcaactgcgtgaattcagaactcttcagctggggaacggtggtaataaagtgttcccacaacacagactgttgagaaggattcaactgcgtgaattcagaactcttcagctggggaacagggtacccgtaagtatagctttacaaggtaagtctggtcttgaactttctaacgaaattcaagacagtcta	749	72	10%	82	11%
7	89572201	89572650	ggtttagcagaataagctctctgacccgttaacaagtcaaaagtccaatctctctgctctggagtcaaagcagcagcgtttgctcgggcctgcgcctgtgccgcctcctgccacagagctcgccattccacacacttgcccataccagggagagcggcctccgcaatcatttgccagtcggcaggagtcagtgccacgccggcaagcctgtccaactgcaccaaggcaaaaccagcactgattccacatttacggaccgactcggcaagttccccaatctgcacatattctaccggagcgtggacacgcccaccctcggctccttcaaagactggaaatgcctgctgtattttcctttgttcctctcggggaatgaatgagtctgcgcactgcctttctgcgcactgctgacgcactacgggctgacgcactacgcagggcggggactc	449	52	12%	84	19%
7	89588401	89588550	ggacttgtgccccagatcaggcccgggtagcctgcttccctatgtaccgcagtctcaggttccacgtgattggattggggcaggcgctgtgttccactcaccagaggtcttaggatcccgtggggagtcccgtgtgggcccttgcgggt	149	14	9%	18	12%
7	89818951	89819250	cagggagtgacacgtccgaggcgaaggagaattctccttaaaaagggacggggtttcgttttctctctctcttgcttcttgctctcttgcttcttgctctcttgcttcctgcaccctggctcctgaagatgtaagaaataaagctttgccgcagaagattctggtctgtggtgttcttcctggccggtcgtgagaacgcgtctaataacaattggtgccgaattccgggacgagaaaaaaactcgggactggcgcaaggaggatccctcattccggaaccagaactgcggatcacgttt	299	36	12%	18	6%
7	89820001	89820300	cctatgcggagtccccgccctgcgtagtgcgtcagcaatgcgcagagaggcagtgcgcagagaggcagtgcgcagactcattcattcccagagaggaacaaaggaaaatacaacaggcatttccggtctttgaaggagccgagggtgggcgtgtccacgctccggtagaatacttacaaattaaggaaattgccgagtcggttcgtaaatacggaaccaatgctaattttaccttggtgcagttagacaggctcgctggcatggcactaactcctgccgactggcaaacggttgtaaaa	299	38	13%	44	15%
7	96323251	96324600	cccatactagggagagcggcttttacaaccgtttgccagtcggcaggagttagtgccatgccggcaagcctgtctaactgcaccaaggtaaaattagcattggttccgtatttacggaccgactcggcaatttctttaatttgtaagtattctaccggagcgtggacacgcccaccctcggctccttcaaagaccggaaatgcctgttgtattttcctttgttcctctctgggaatgaatgagtctgcgcactgcctctctgcgcactgcctctctgcgaagggctgacgcactacgcagggcggggactccgcatagggcggaccttgaagccgactgccctgaggccaatcagcaaactggccttcgccagccgcttttggcttccttaactgattagctagcactttacctggctggtacccttttttctcataatgagctgcttcttcctcccagtctgtttcttcagaggagaattcttcatctgcttcagagctactaagagctggctccccgagcccatccagcgatgagcacaggctccttttcctagagacctccgctaattgatctttcttcttttccctttttcctctttttcttctaatctctctccaggtattcctacctaaccttaacttttcctcaggttcaagacccgtggaaaggcctgtacgcttattttgtgtaccatattttctctttgctcctactctctctccccgctttacttctgatagcttgtcctgaatttcctctagaattttcagccctatcttaatcacttgataacatgtgaaaaggaacaaaagggctcctaacaccagaaaaaattcaaggccaaacatattccactttacttctgatagactgtcttgaatttccttagaaagttcaagatcagacttacctcgtaaagctgtactcactggtactctcgttccccagctgaaaagttctgaattcatacagttgaatccttcttaacagtctgctttacgggaacctttattaccgcgacccgcagttctggttctggaatgagggatcttccttgtgccggtgatggtaaactctcgtcccgagttttttctcgtcccggaattcggcaccaattgttattagacgcgttctcacgaccggccaggaagaacacggcaaaccagaatcttctgcggcaaaactttattgcttacatcttcaggagccagagtgcaagaagcaagagagagagaaaacgaaaccccgtcccttttttaggagagttatatttcgcctaggacgtgtcactccctgattggctgcagcccatcggccgagttgacgtcacggggaaggcagagcac	1349	112	8%	146	11%
7	97274101	97274400	aaaaaccccaaaccccaaaaacgaaagcccccttcttacatctttaggagccagagctccggcgcgccggggcgcagagcgcgctctattgtttacatctttaggcagcgagcgagcgcagggcgcgcagagccagagagatgccagcgagagagaatggcggaaaccccgtccccttttttaggagcgttatatttcgcctaggacgcatcactccctgattggctgcagcccatggccgagctgacgttcacgggaaaggcagagtacaagtagtcataaaatacccttggcacatg	299	44	15%	42	14%
7	97277701	97278300	gctgaaaagttctgaattcatgcagttgaatccttcttaacagtctgctttacgggaacctttattaccgcgacccgcagttctggttctggaatgagggatcttccttgtgccggtcccgagttttcttgtattttttcgtcccggattttttctcgtcccggatttcagcaccaattcttactagcgttctcacgcccggccaggaagaacacaacagaccagaatcttctgcggcaaaactttattgcttacatcttcaggagcaggagtgcaaaaaccccaaaccccaaaaacgaaagcccccttcttacatctttaggagccagagctccggcgcgccggggcgcagagcgcgctctattgtttacatctttaggcagcgagcgagcgcagggcgcgcagagccagagagatgccagcgagagagaatggcggaaaccccgtccccttttttaggagcgttatatttcgcctaggacgcatcactccctgattggctgcagcccatggccgagctgacgttcacgggaaaggcagagtacaagtagtcataaaatacccttggcacatgcgcagattatttgtttaccacttag	599	74	12%	82	14%
7	103293451	103295100	acggtctatctctctgacaaatccctctaaggtcttagtggtgatttttaggccacactgcttcaagaccaagcgtaaggctgggagcgtaagaatgggagattcccatactgccgctgttcaggcctgaccgcgactgaaattggtcactgtccaggcgctgtccaggcctgaccgcgactaagaaccagtcagcagttccagtggtggaaacaaaatgaaaccgaaaggaaaagtgtaatcgccgtgcaaacaatcaaaagggcttctaactctgaagaaatttcaagattgtacgtaccttgtagagccttttgtcccacggttctgattctgccccgcgaacgagggatcttccttgcgccggtgtgatgacagttcccgggttcttcggcgccacttattgcgtcccgctcaaccggcaagaaagacgcaacaaaccagaatcttccgcggcaagagctttattgcttgcttctcaggaagattccgaaccgggaaaatggcgctgcttttataacccgcagcgtgacgtttcagcacctgatatggcgtgacagctcccgattcgttgcttgcccatcaccccactattacaccccgagaatgggagtgactaggagtgaattcactcttgcacctgcgtacaaggcttgtttactagttaggcacagcggaggcccgcgccatcttataatggcgattgctcgctgcacacacggctctcctcagagattactggcggcacacatgcgattgctcgcagcacgtaccggctctccacagaaagaacccagatgcccctcaacagaggaatggatacagaaaatgtggtacatttacacaatggaatactactcaccaagaacatttttgagataagggcctcctggaacaacctcaaaatgaaccgggtacattgccaaatgataggacatgaccccttagttacgtagattcccttggcagaaccccttgtcccttggcagaaccccttagtgatgtaaacctgtactttccctgcccagctctcaccccttgagttttcctatataagcctgtaaaaaattctggctgatggtgcatgagtttcgaccccagagctctggtctatgttccatgtgctttcttgctgttgttctattaaatcttgccttccacattttgagtacggtctcagtgtcttcttgggtgcgcggctgtcccggggcttgagtgcttgagtgagggtctcccttcgggggtctttcaTtttggtgcattggccgggaatcagcgcgaccacccagaggtcctagacccacttagaggtaagattctttgtcccgttttggtctgatgtctgtgttctgtttctaagtttggtgcgatcgcagtttcggttttgtggacgctcagtgagaccgcgctccgagagggaacgcggggtggataaggatagacgtgtccaggtgtccaccgttcgttcaccctgggagacgtcccaggaggaacaggggaggaccagggacgcctggtggacccctttggaggccaagagaccatttggggttgcgagatcgtgggtttgagtcccacctcgtgcccagttgcgagatcgtgggttcgagtcccacctcgcgttttgttgcgagatcgtgggtttgagt	1649	172	10%	196	12%
7	103921651	103921800	ctgcctggcctgagaggtttgtggcacaggcgccggcgggagccttcttggctccgggactccgcggagggcaggctgcacgggtgaccgtgtggaatacagagtgccagccgtttctgggacgggcgagagagtcgcagagcttctgg	149	24	16%	14	9%
7	108429301	108429750	caagggtatcttatgactacttgtgctctgccttccccgtgacgtcaactcggccgatgggctgcagccaatcaaggagtgacacgtccgaggcgaaggagaatgctccttaagagggacggggttttcgttttctctctctcttgcttcttgctctcttgcttcttgctctcttgcttcttgctctcttttcctgaagatgtaagaataaagctttgccgcagaagattctggtctgtggtgttcttcctggccggtcgtgagaacgcgtctaataacaattggtgccgaattccgggacgagaaaatccgggacgagaaaaaactccggactggcgcaggagggatacttcattccagaaccagaactgcgaatcaaggttataaggttcccgtaacacagactgttgagaaggattcaactgccgaattcagaactcatcagctgg	449	48	11%	38	8%
7	108430351	108430650	gcgaaggccagtttgctaattggcctcagggcaatcggctaccaggtgcactcccgccctatgcggagtccccgccctgcgtagtgcgtcagcccgtagtgcgtcagcaatgcgcagagaggcagtgcgcagaaaggcagtgcgcagactcattcattccccgagagaaacaaaggaaaatacaacaggcatttccagtctttgaaggagccgagggtgggcgtgtccacgctccggtagaatatgtgcagattaaatatggaatcaatgctaattttaccttggtgcagttagacagg	299	34	11%	50	17%
7	109488301	109488600	tgagccgatgggctgcagccaatcagggagtaatacgtcctaggcggaggataattctccttaaaagggacggggttttgccattctttttcttgctttcttgttcttgttctttttcttgctcttgctctcttgctctctggctcctgaagatataagcaataaagcttttgccgcagaagattccggtttgttgcgttcttcctggccggtcgcgagaacgcgtgtaagaGGACTCTCCATCTCCACCCACTGAATCTGTGACTAGACCTCAGGAGCCTGCGCAGTTCTGCTCTTGC	299	26	9%	22	7%
7	111009301	111009600	tctgttttacgggaacacttcattaccgtgacccgcagttctggttccggaatgaggaatcttccttgcgccggtgatggttaactcccgtcccgagttttcttgtcccgggttttttcttcccggattttctcgtcccggatttcggcaccaaCtcttacacgcgttctcacgaccggccaggaagaacacaacaaaccagaatcttctgcggcaaaactttattgcttacatcttcaggagtaagagtgcaagcccccctttgcttacatctttaggagccagagcgccagagcgcc	299	40	13%	38	13%
7	113942401	113942700	ttcctcgtgacgtcaactcggccgatgggctgcagccaatcagggagtgacacgtcctaggcgaaggaaaattctccttaatagggacggggtttcgttttctctctctcttgcttcttacactcttgctcctgaagatgtaagcaataaagttttgccgcagaagattctggtctgtggtgttcttcctggccgggcgtgagaacgcgtctaataacaattggtgccgaattccgggacgagaaaaaactcgggactggcgcaaggaagatccctcattccagaaccagaactgcggg	299	38	13%	26	9%
7	113943301	113943750	agggtaccagccaggtaaagtgctagctaatcagttaaggaagccaaaagcggctggcgaaggccagtttgctgattggcctcagggcagtcggcttcaaggtccgccctatgcggagtccccgccctgcgtagtgcgtcagccctgcgcagagaggcaatgcgcagagaggcagtgcgcagactcattcattcccagagaggaacaaaggaaaatacaacaggcatttccggtctttgaaggagccgagggtgggcgtgtccacgctccggtagaatacttacaaattaaagaaattgccgagtcggtccgtaaatacggaaccaatgctaattttaccttggtgcagttagacaggcttgccggcatggcactaactcctgctgactggcaaacggttgtaaaagccgctctccctagtatgggcaaatatatggaatggagagctc	449	46	10%	60	13%
7	114404701	114405900	tttcgttttctccctctcttgcttcttgctctcttgcttcttgctctcttgcttcttacactcctgctcctgaagatgtaagcaataaagctttgccgcagaagattctggtttgttgcgtctttcctggccggtcgtgagaacgcgtctaataacaattggtgccgaattccgggacgagaaaaaactcgggactggcgcaaggaagatccctcattccagaaccagaactgcgggtcgcggtaataaaggttcccgtaaagcagactgttaagaaggattcaactgtatgaattcagaacttttcagctggggaacgagagtaccagtgagtacagctttacgaggtaagtctgatcttgaactttctaaggaaattcaagacagtctatcagaagtaaagtggaatatgtttggccttgaattttttctggtgttaggagcccttttgttccttttcacatgttatcaagtgattaagatagggctgaaaattctagaggaaattcaggacaagctatcagaagtaaagcggggagagagagtaggaacaaagaggaaatatggtacacaaaataagtatacaggcctttccaagggtcttgaacccgaggaaaagttaaggttaggtaggaatacctggagagagattagaagaaaaagaggaaaaagggaaaagaagaaagatcaattagcggaggtctctaggaaaaggagcctgtgctcatcgctggatgggctcggggagccagctcttagtagctctgaagcagatgaagaattctcctctgaagaaacagactgggaggaagaagcagctcattatgagaaaaaagggtaccagccaggtaaagtgctagctaatcagttaaggaagccaaaagcggctggcgaaggccagtttgctgattggcctcagggcagtcggcttcaaggtccgccctatgcggagtccccgccctgcgtagtgcgtcagccctgcgcagagaggcagtgcgcagactcattcattcccagagaggaacaaaggaaaatacaacaggcatttccggtctttgaaggagccgagggtgggcgtgtccacgctccggtagaatacttacaaattaaagaaattgctgagtcggtccgtaaatacggaaccaatgctaattttaccttggtgcagttagacaggctcgctggcatggcactaactc	1199	84	7%	122	10%
7	118285951	118287150	caactcggccgatgggctgcagccaatcagggagtgacacgtcctaggcgaaggagaattctctttaatagggacggggtttcgttctctctctctcttgcttcttgctctcttgcttcttacactcttgctcctgaagatgtaagaaataaagctttgccgcagaagattctggtctgtggtgttcttcctggccggtcgtgagaacgcgtctaataacaattggtgccgaattccgggacgagaaaaaaaaactcgggactggcgcaaggaagatccctcattccagaaccagaactgcgggtcgcggtaataaaggttcccgtaaagcagactgttaagaaggattcaactgtatgaattcagaacttttcagctggggaacgagagtaccagtgagtacagctttacgaggtaagtctgatcttgaactttctaaggaaattcaagacagtctatcagaagtaaagtggaatatgtttggccttgaattttttctggtgttagaagcccttttgttccttttcacatgttatcaagtggttaaggcagggaggattctagatgaaattcaggacaatctatcagaagtaaagcggggagagagagtaggagcaaagagaaaatatggtacacaaaataagtatacaggcctttccaagggtcttgaacccgaggaaaagtttaggtcaggtaagaatacctggggagagattagaaggaaggaaaagaaaaaagaaaagaaaaaagatcgattagcggaggtctctaggagatactcgtcactagatgagctcaggaagccagctcttagtagttctgaagcagatgaagaattctcctctgaggaaacagactgggaggaagaagcagcccattaccagccagctaattggtcaagaaaaaagccaaaagcggctggcgaaggccagtttgctgattggcctcagggcagtcggcttcaaggtccgccctatgcggagtccccgccctgcgtagtgcgtcagcaatgcgcagagagatgcgcagagaggcagtgcgcagactcattcattcccagagaggaacaaaggaaaatacaacaggcatttccggtctttgaaggagccgagggtgggcgtgtccacgctccggtagaatacttacaaattaaagaaattgccgagtcggtccgtaaatacggaaccaatgctaatttt	1199	94	8%	130	11%
7	118285951	118287150	caactcggccgatgggctgcagccaatcagggagtgacacgtcctaggcgaaggagaattctctttaatagggacggggtttcgttctctctctctcttgcttcttgctctcttgcttcttacactcttgctcctgaagatgtaagaaataaagctttgccgcagaagattctggtctgtggtgttcttcctggccggtcgtgagaacgcgtctaataacaattggtgccgaattccgggacgagaaaaaaaaactcgggactggcgcaaggaagatccctcattccagaaccagaactgcgggtcgcggtaataaaggttcccgtaaagcagactgttaagaaggattcaactgtatgaattcagaacttttcagctggggaacgagagtaccagtgagtacagctttacgaggtaagtctgatcttgaactttctaaggaaattcaagacagtctatcagaagtaaagtggaatatgtttggccttgaattttttctggtgttagaagcccttttgttccttttcacatgttatcaagtggttaaggcagggaggattctagatgaaattcaggacaatctatcagaagtaaagcggggagagagagtaggagcaaagagaaaatatggtacacaaaataagtatacaggcctttccaagggtcttgaacccgaggaaaagtttaggtcaggtaagaatacctggggagagattagaaggaaggaaaagaaaaaagaaaagaaaaaagatcgattagcggaggtctctaggagatactcgtcactagatgagctcaggaagccagctcttagtagttctgaagcagatgaagaattctcctctgaggaaacagactgggaggaagaagcagcccattaccagccagctaattggtcaagaaaaaagccaaaagcggctggcgaaggccagtttgctgattggcctcagggcagtcggcttcaaggtccgccctatgcggagtccccgccctgcgtagtgcgtcagcaatgcgcagagagatgcgcagagaggcagtgcgcagactcattcattcccagagaggaacaaaggaaaatacaacaggcatttccggtctttgaaggagccgagggtgggcgtgtccacgctccggtagaatacttacaaattaaagaaattgccgagtcggtccgtaaatacggaaccaatgctaatttt	1199	94	8%	130	11%
7	119027401	119027550	cactgaagcagtgagctccgggttcagcaagagacagtcttacggcaatgtggtgtagagcgatagaacaggacgtgatgctttctcccctggtctggacaggcgcacacacacacacaaacacagacacacacaccatacacatcaca	149	10	7%	52	35%
7	124808551	124808700	tccagtcaggtgggttacgtccatctgacggcagaactgctggaatttttgagacgtataagctggtccattatcagtcttaaggagtctgggtttcccccaagcactccatgcctcaagacaatgttgaatcacatgtgaggcttttt	149	6	4%	26	17%
7	124810651	124810800	ctgcctctctgcgcactgcctctctgcgcattgctgacgcactacgcagggcggggactccgcatagggcggaccttgaagccgactgccctgaggccaatcagcaaactggccttcgccagccgcttttggcttttttcttgaccaat	149	20	13%	20	13%
7	124900801	124902300	tcggcaggagttagtgccatgccggcaagcctgtctaactgcaccaaggtaaaattagcattggttccatatttacggaccgactcggcaagttctttaatctgcacatattctaccggagcgtggacacgcccaccctcggctccttcaaagaccggaaatgcctgttgtattttcctttgttcctctctgggaatgaatgagtctgcgcattgcctctctgcgcattgtctctctgcgcagggctgacgcactacgcagggcgggggctccgcatagggcggaccttgaagccgactgccctgaggccaatcagcaaactggccttcgccagccgcttttggcttccttaactgattagctagcactttacctggctggtacccttttttctcataatgagctgcttcttcctcccagtctgtttcttcagaggagaattcatcatctgattcagagctaccaagagctggctccccgagcccatccaacgatgagcacaggctccttttcctagagacctccgctaattgatctttcttcttttccctttttcctctttttcttctaatctctctccaggtattcctacctaaccttaacttttcctcgggttcaagacccttggaaaggcctgtatacttattttgtgtaccatatttcctctttgttcctactctctctccccactttacttctgatagcttgtcctgaatttcctctagaattttcagccctatcttaatcacttgataacatgtgaaaaggaacaaaagggctcctaacaccagaaaaaattcaaggccaaacataccttgtaaagccatttcccactttacttctgatagactgtcttgaatttcgttagaaagttcaagaccagacttaccttgtgaagctgtactcactggtactcccgttccccagctgaaaagttctgaattcatgcagttgaatccttctcaacagtctgtgttgtgggaacacttcataaccgtgacccgcagttctggttccggaatgagggatcttccttgcaccggtgatggtaaactctcgtcccgagttttttctcgtcccggaattcggcaccaattgttattaacgcgttctcacgcccggccaggaagaacacagcaaaccagaatcttctgcggcaaaactttattgcttacatcttcaggagcaagagtgtaagaagcaagagagagagaaaacgaaaccccgtccctattaaggagaattatcctttgcctaggacgtgtcactccctgattggctgcagcccatcggccgagttgacgtcacggggaaggcagagcacatggagtggagaaccaccctcggcacatgcgcagattatttgtttaccacttagaacacagctgtcagcgccatcttgtaacggcgaatgtgggcgcggctcccaacactacagctaatcattaggcagagcccagggagtcctttggaggactgaggggaagaactgaggagcc	1499	110	7%	194	13%
7	125532601	125532750	tctgccaatcaccaggagtcatagcgtgattcgcaagcctttccacttgtgctatagtgaaattagcactgactccatagttacggaccgactcggcaagctctttaatctgtatatacgctaccggagcgtggacacgcccaccctcg	149	20	13%	22	15%
7	126900001	126900450	ttcacccttgactgactacaacagccatattcctaggaagattattcacccctgactacgacacccgtattcctaggaagattattcacccctgactacgacacccgtattcctaggaagattattcacccctgactacgacacccgtattcctaggaagattattcacccctgactacgacacccgtattcctaggaagattattcacccctgactacgacacccgtattcctaggaagattattcacccctgactacgacacccgtattcctaggaagattattcacccctgactacgacacccgtattcctaggaagattattcacccctgactacgacacccgtattcctaggaagattattcacccctgactacgacacccgtattcctaggaagattattcacccctgactatgacacccgtattcctaggattattcacaag	449	38	8%	52	12%
7	127618801	127620450	acgtcagctcggccatgggctgcagccaatcagggagtgatgcgtcctaggcgaaatataacgctcctaaaaaaggggacggggtttccgccatttctctctcgctggcatctctctggctctgcgcgccctgcgctctctcgctgcctaaagatgtaaacaatagagcacgctctgcgccccggcgcgccagagctctggctcctaaaattattgaaggggcttttcgtttttggggctgggcgctgggcgcttgccctcctggctcccaaagatgtaagcaataaagttttgccgcagaagattctggtctgttgcgtctttcctggccgggcgtgagaacgcgtctaataagaattggtgccgaattccgggacgagaaaaaactcgggactggcgcagggaagatccctcattccagaaccagaactgcgggtcgcggtaataaaggttcccgtaaagcagactgttaagaaggattcaactgtatgaattcagaacttttcagctggggaacgagagtacccgtaagtatagctttacgaggtaagcctggccttgaactttctaaggaaattcaagacagtctatcagaagtaaagtggaaaatgtttggccttgaattttttctaatgttaggagcccttttgttccttttcacatgttatcaggtgattaagatagggctgaaaattctagaggaaattcagggcaatctatcagaagtaaagcggggagagagagtaggagcaaagagaaaatatggtacacaaaataagtatacaggcctttccaagggtcttgaacccgaggaaaagtttaggtcaggtaagaatacctggggagagattagaaggaaggaaaagaaaaaagaaaagaaaaaagatcgattagcggaggtctctaggagatactcgtcactagatgagctcaggaagccagctcttagtagttctgaagcagatgaagaattctcctctgaggaaacagactgggaggaagaagcagcccattaccagccagctaattggtcaagaaaaaagccaaaagcggctggcgaaagccagcgtactgttcaacctcccggcagtcggtttcaaggtccgccctatgcggagcccccgccctgcgtagtgcgtcagcaatgcgcagagaggcaatgcgcagagagatgcgcagagaggcaatgcgcagagagatgcgcagagaggcagtgcgcagagagatgcgcagagaggcagtgcgcagagagatgcgcagagaggcagtgcgcagagaggcagtgcgcagagaggcagtgcgcagactcattcattcccagagaggaacaaaggaaaatacaacaggcatttccagtctttgaaggagccgagggtgggcgtgtccacgctccggtagaatacttacaaattaaagaaattgccgagtcggtccgtaaatacggaaccaatgctaattttaccttggtgcagttagacaggcttgccggcatggcactaactcctgccgactggcaaacggttgtaaaagccgctctccctagtatgggcaaatatatggaatggagagcgctttggcacgaagctgcacaagcgcaggcccgagcaaacgcagctgctttgactccagagcagagagattggactttt	1649	164	10%	194	12%
7	128204251	128204550	tgcgtgcctgtgtgtgtATATATGAGTGCGcatatgtacatgtgtatatgactgtgtgtgtgcatgtgtgcgcacatgcatgcacatgtgtgtgtttgtgtgtattgtgtgcctgtgtgcatgagtgtttgtgtgcacatgtgtgtatatgagtgcgcatatgtgcatatgtatatgactgtgtgtgtgcgtgtgtgtgtgtttgtgtgtactgtgtgcctgtgtgtatgagtgtttgtgtgCATGTGTGAGAAGAATGAGCATTCACTGATTTTCAAATCAGGTGTCAACGATGCTAG	299	12	4%	38	13%
7	133275001	133275300	aaggtggctggttgtctggagctgaagatggcgccacccagaagctctgcgactctcgcccgtcccagaaacggctggcactctgtattccacacggtcacccgtgcagcctgccctccgcggagtcccggagccaagaaggctcccgccggcgcctgtgccacaaacctctcaggccgggcagacccccgtgctctcaccaggaaggtggccggctgtctggagctgaagatggcgccgcccagaagctctgcgactctcgcccgtcccagaaacggctggcactctgtattccacac	299	44	15%	40	13%
7	133592851	133593150	caagctgtcttctgaccttcacccactcctacacatgcccttacacacgtgtgtgcgcatgtgcacacacacacactaacacacacacactaaaacacatacacacacactaacacacacactaacacacacatacacacacactaacacacacactaacacaaacatgcacacacacatacacacacactaacacactaacacacatatactaacacacacactaacacacacatactaacacacacacaaacacgcacacacatacacacacactgacacacacacatacacacaca	299	6	2%	178	60%
7	135733351	135733950	aaattcaaggccaaatataccttgtaaagccattttccactttacttctgatagactgtcttgaatttccttagaaagttcaagatcagacttacctcgtaaagctgtactcactggtactctcgttccccagctgaaaagttctgaattcatacagttgaatccttcttaacagtctgctttacgggaacctttattaccgcgacccgcagttctggttctggaatgagggatcttccttgcgccagtcccgagttttttctcgtcccgggtttcggcaccaattgttattagacgcgttctcacgaccggccaggaaagacgcaacaaaccagaatcttctgcggcaaaactttattgcttacatcttcaggagcaagagtgtaagaagcaagagagagagaaaacgaaaccccgtccctattaaggagaattttccttcgcctaggacgtgtcactccctgattggctgcagcccatcggccgagttgacgtcacgaggaaggcagagcacatggagtgaagaaccaccctcggcacatgcgcagattatttgtttaccacttagaacacagctgtcagcgccatcttgtaacggc	599	58	10%	82	14%
7	137642101	137643150	atacttcattccagaaccagaactgcgaatcaaggttataaggttcccgtaacacagactgttgagaaggattcaactgccgaattcagaactcatcagctggggaacgacggtgataaaggttcccgtaaagcagactgttgagaaggattcaactgccgaattcagaactcatcagctggggaacgacggtgataaaggttcccgtaaagcagactgttgagaaggattcaactgccgaattcagaactcatcagctggggaacggaagtgagaaatggctttaccaggtatgtttggccttgaactttttctagtgttaggagcccttttgttccttttcacatgttatatagtgcttaaggcagggctaaaaattctagaggaaattcaggacagtctatcagaagtaaagcggagagagagagtaggaacaaggagaaacggtaagtatacaggcctttccaagggtcttgaacccgaggaaaagttaaggttaggtaggaatacctggagagagattagaagaaaaagaggaaaaagggagaagaaaaaagatcgattagcggaggtctctaggagatactcgtcactagatgagctcaggaagccagctcttagtagttctgaagcagatgaagaatcctcctctgaggaaacagactgggaggaagaagcagcccattaccagccagctaatcggtcaagaaaaaagccaaaagcggctggcgaaggccagtttgctaattggcctcagggcaatcggctaccaggtgcactcccgccctatgcggagtccccgccctgcgtagtgcgtcagcccgtagtgcgtcagcaatgcgcagagaggcagtgcgcagaaaggcagtgcgcagactcattcattccccgagaggaacaaaggaaaatacaacaggcatttccagtctttgaaggagccgagggtgggcgtgtccacgctccggtagaatatgtgcagattaaatatggaatcaatgctaattttaccttggtgcagttagacaggcttgccagcatggcactaactc	1049	74	7%	138	13%
7	138262951	138263400	cggctggcgaaggccagtttgctaattggcctcagggcaatcggctaccaggtgcactcccgccctatgcggagtccccgccctgcgtagtgcgtcagcccgtagtgcgtcagcaatgcgcagagaggcagtgcgcagagaggcagtgcgcagactcattcattccccgagaggaacaaaggaaaatacaacaggcatttccagtctttgaaggagccgagggtgggcgtgtccacgctccggtagaatatgtgcagattaaagaaattgctgagtcggttcgtaaatacggaaccaatgctaattttaccttggtgcagttagacaggcttgccggcatggcactaactcctgccgactggcaaatgattgcaaaagccgctctccctaatatgggcaaatatttggaatggagatctctgtggcgagaggctgcacaggcgcaggac	449	52	12%	66	15%
7	139426501	139426800	agaaagaaagcaagcaacaccaccctaacaacaattaccggacctactgcgtaagaaagcatacctctcagagactcacattaatttccttttacttacgggtacccctgttccccagctgaagagttctgaatccacgcagttgaatccttctcaacagtctgtgttgcgggaacacttcattaccaccgttccccagctgaagagttctgaatccacgccggatccttctcaacagtctgttttacgggaacctttatcaaccactccttccccgcgatgcagttctgaatcctccc	299	22	7%	50	17%
7	142219351	142219650	actgcaccaaggtaaaattagcattggttccgtatttacgaaccgactcggcaatttctttaatttgtaagtattctaccggagcgtggacacgcccaccctcggctccttcaaagaccggaaatgcctgttgtattttcctttgttcctctctgggaatgaatgagtctgcgcactgcctctctgcgcattgcctctctgcgcatctctctgcgcattgctgacgcactacgcagggcgggggctccgcatagggcggaccttgaagccgactgccctgaggccaatcagcaaactgg	299	38	13%	34	11%
7	144353851	144354450	aagttcaaggccaggcttacctcgtaaagctatacttacgggttaccgccgttccccagctgaaaagttctgaattcatgcagttgaatccttcttaacagtctgctttacgggaacctttattaccgcgacccgcagttctggttctggaatgagggatcttccttgtgccggtgaaactcccgtcccgagtttcctcccgggttttttcttcccggattttttctcgtcccggaatttctcgtcccgggtttCAGCACCAATtcttactagcgtgttctcacgcccggccaggaagaacacagcaaaccagaatcttctgcggcaaaactttattgcttacatctttgggagccaggagggcaagcgcccagcgcccagccccaaaaacgaaagccccttctatatttttaggagccagagctccggcgcgccaaagcgcagagcgtgctctattgtttacatctttaggcagcgagagagcgcagggcgcgcagagccagagagatgccagcgagagagaaatggcggaaaccccgtccccttttttaagagagttatatttcgcctaggacgcatcactccctgattggctgcag	599	76	13%	70	12%
8	3338401	3338850	ctgtttttcccgtgaacgtcagctcggccatgggctgcagccaatcagggagtgatgcgccctaggcaatggttgttctctttaaaatagaaggggtttcgtttttctctctctcttgcttctctctcttgcttcttacactctggccccaaaaagatgtaagcaataaagctttgccgtagaagattctggttgttgtgttcttcctggccggtcgtgagaacgcgacgaataacaattggtgccgaattccgggacgagaaaaaactccggactggcgcaggagggatacttcatttcagaaccagaactgcggatcacgtttataaaggttcccgtaacacagactgttgagaaggattcaactgccgaattcagaactcatcagctggggaacgacggtgataaaggttcccgtaaagcagactgttaagaaggattcaactgta	449	46	10%	46	10%
8	5640301	5640450	TGGGCATCTGGTACATCAACTGCTACGGTTGTGAGACCCACGCCTTGCTGCCCTATGACCAGTACATGTACCGCTTTGCTGCCTATTTCCAGCAGGGTGACATGGAGTCCAACGGAAAGTACATCACCAAGTCCGGGGCCCGCGTGGAC	149	14	9%	26	17%
8	7685851	7686150	cattcgccgttacaagatggcgctgacagctgtgttctaagtggtaaacaaataatctgcgcatgtgccaagggtatcttatgactacttgtactctgcttccccgtgacgtcaactcggccgatgggctgcagccaatcagggagtgacacgtcctaggcgaaatataactctcctaaaaaagggacggggtttcgttttctctcgctcttgcttcttgcactcctgctcctgaagatgtaagcaataaagctttgccgcagaagattctggtttgttgcgtctttcctggccggtcg	299	34	11%	28	9%
8	8319151	8320200	aggtaaaattagcattggttccgtatttacgaaccgactcagcaatttctttaatctgcacatattctaccggagcgtggacacgcccaccctcggctccttcaaagactggaaatgcctgttgtattttcctttgttcctctcggggaatgaatgagtctgcgcactgcctctctgcgcactgcctctctgcgcattgctgacgcactacgggctgacgcactacgcagggcggggactccgcatagggcgggagtgcacctggtagccgattgccctgaggccaattagcaaactggccttcgccagccgcttttggctttttccttaaatgactagttagcactttacttggcggctggtatccttttctttcataatgagccgcttttttctcccagtctgtttcttcagagcacaggctccttctcctagagacctccgctaattgatctttcttcttttccctttttcctctttttcttctaatctctctccaggtattcctacctaaccttaacttttcctcgggttcaagacccttggaaaggcctgtatacttattttgtgtaccatatttcctttttgttcctactctctctccccgctttacttctgatagcttgtcctgaatttcctctagaattttcagccctatcttaaccactatataacatgtgaaaaggaacaaaagggcttctaacactagaaaaaattcaaggccaaacataacttgtaaagccattttccactttacttctgatagactgtcttgaatttccttagaaagttcaagatcagacttacctcgttccccagctgaaaagttctgaattcatacagttgaatccttcttaacagtctgctttacgggaacctttatcaccgtcgttccccagctgatgagttctgaattcggcagttgaatccttctcaacagtctgctttacgggaacctttatcaccgtcgttccccagctgatgagttctgaattcggcagttgaatccttctcaacagtctgtgttacgggaacctttataaacgtga	1049	74	7%	108	10%
8	12159901	12160200	gtgtgtgagagtctatgcgtatagcatgtgtgtctctgagtgtgtatgtgtctgcatgtgtgtgtgagcatgtgtccacacatgtgtcaacacatggataagtggtatgtgtgtgcctgtgtgtattgtatgtgtgttcatgtatatatatgtgtgtgcatgtgtttgcacacaggtccacacatgtgtacatggtatgtgtgtgtctgtgtgtatagcatgtatgtgtgcatgcatgcatgcgtgtgtgttcacatgcatgtatgtgttcatgtgtgtgcacatgtgtccacacctgt	299	4	1%	60	20%
8	13715251	13715850	ccttctcaacagtctgtgttacgggaaccttataaccttgattcgcagttctggttctggaatgaagtatccctcctgcgccagtccggagttttttctcgtcccggattttctcgtcccggaattcggcaccaattgttattagacgcgttctcacgaccggccaggaagaacaccacagaccagaatcttctgcggcaaagctttattcttacatcttcaggaaaagagagcaagaagcaagagagagcgagaagcaagagagcgaaaaagcaagagaggagagagaacgaaaccccgtccctcttaaggagcattctccttcgcctcggacgtgtcactccctgattggctgcagcccatcggccgagttgacgtcacggggaaggcagagcacaagtagtcataagatacccttggcacatgcgcagattatttgtttaccacttagaacacaggatgtcagcgccatcttgtaacggcgaatgtgggggcggctcccaacaaccagatacacttgcagtatgcatacgcacatgcaggcaaaacattcatacacataaaataaaaTACATATTTTTAATctcaaataaagtgag	599	62	10%	104	17%
8	13719451	13719750	gctgcagccaatcagggagtgacacgtccgaggcgaaggagaatgctccttaagagggacggggttttcgttttctctctctcttgcttcttgctcttttttcctgaagatgtaagaataaagctttgccgcagaagattctggtctgtggtgttcttcctggccggtcgtgagaacgcgtctaataacaattggtgccgaattccgggacgagaaaatccgggacgagaaaaaactccggactggcgcaggagggatacttcattccagaaccagaactgcgaatcaaggttataagg	299	36	12%	22	7%
8	13722301	13722450	ctgctgtgagttcttgccagttcctcatgtgggaattaacccacgcggtattcgacctctacaggtctggcaaatggatgttacacatgtttcttcctttggaaaacttcaatatctccatgtgtccattgacacatgttctggcatca	149	6	4%	28	19%
8	13850701	13850850	tcactccattactacgccccgagatgggcagtgactaggcgtgagttcactctcgcacctgtgtacaaggcttgtttactagttaggcacagcggaagccagcaccatcttataatggtgattgcttgcgggtcgcgattgcttgcagc	149	16	11%	24	16%
8	14289451	14289750	gcggcaaaactttattgcttacatcttcaggagccaggagcgcaaacccccagccccaaaagcgaaagccaccccaataacgaaaccgaaaccccttccctatttaggagagttatctttcgcctaggacgcatcactccctgattggctgcagcccatggccgagctgacgttcacgggaaaggcagagtacaagtagtcgtaaaatacccttggcacatgcgcagattatttgtttaccacttagaacacaggatgtcagcgccatcttgtgacggcgaatgtgggggcggctccca	299	32	11%	50	17%
8	16794001	16794450	atttgccagtcggcaggagttagtgccatgccggcaagcctgtctaactgcaccaaggtaaaattagcattgattccgtatttacgaaccgactcagcaattcctttaatttgtaagtattctaccggagcgtggacacgcccaccctcggctccttcaaagaccggaaatgcctgttgtattttcctttgttcctctcggggaatgaatgagcctgcgcattgcctctctgcgcactgcctctctgcgcattgctgacgcactacgggctgacgcactacgcagggcggggactccgcatagggcgggagtgcacctggtagccgattgccctgaggccaattagcaaactggccttcgccagccgcttttggctttttccttaaatgactagttagcactttacttggcggctggtatccttttctttcataatgagccgctttttt	449	52	12%	50	11%
8	19674451	19675050	taccgcgacccgcagttctggttctggaatgagggatcttccttgcgccggtgatggtaaactctcgtcccgagtttttcttcccgggtttcctcttcccggattttctcgtcccggaatttctcgtcccggaattcggcaccaattcttatacgcgttctcacgaccggccaggaaagaacacaacaaaccagaatcttctgcggcaaaactttattgcttgcatcttcaggagcaggagcgcaaaaccccaagccccaaaaacgaaagcccccttctaaacatctttaggagccagagcgccagcgcgcagagcgcaaaagcgcaagcaagagctctattgtttacatctttaggagctagaagccagcgcgcgccagcgcgccagagcgaagagtgcaagtaagagagagaatggcggaaaccccgtcccctttaaggaggagttatccttcgcttaggacgcatcactccctgattggctgcagcccatgaccgagttgttgccacgggaaaggcagagtacatgtagtggtaaaatacccttggcacatgcgcagattatttgtttaccacttagaacacaggatgtcagcgcc	599	80	13%	84	14%
8	20016001	20016450	TTGTTGTGCAACCTCGTTTGAAAACTAtgtgaggaagaataaacaaccgtgaatgtggagtcaaggagacctgagggtgaagcccagcttggctgcctgcctgctgtggaccttggacaaattgcatggcaattctgggtccctgatctcctcttctgACACACCATGACCTGGTGTAAtgtgggacgcccgacttgcctgcaagtaagacgccacaacaggatccttctgcaacacgtttattgggagagcatggactgagtaggcgaaagaccccgagccccagaaatggcgctgcttatataggcccacgagtgacgtgtccatacctgattggttatgctaccagtacctcattaatatgcgtcgggccaggcagtgactcagcaaaaaactcttatgcacatgcttacattggttgtttatccattatcatgggtggtggccag	449	26	6%	64	14%
8	20118601	20118900	CTCTCTATTTTGTAATCCTGATTGTGACTTTTTTATAGTGCTCCTAGCTGGTGCTCTTCACAGGCAGCCACAGAGCCCACCATACTCAAgtgcgtgtgtgtgtgtgtgtgtgtgtgtgtgtgtgtgtgtgtgtgtatgtgtgtgtgtgtgtgtgtgtgtgtgtgtgcgtgcgcgtgtgtgtgtAggttcctctgtagatccctgactatcctggaactcactctgcagatcagagtggcttcagactcagagatccacttgtctgctttccaaatgttgaaattagagatacacaccac	299	8	3%	36	12%
8	20129401	20129550	TTTGAGAATGGAACGATATACATTATGATATTTTGTGTACTGCCCACTGTATATTCTGTACCCAAGAAAAAGTGAATCCAAACTTAAGTCTTGCACCAAATGCAGAAATCTGAGATAGAGAATTACGTTTCAACCATTCTTGTAATACT	149	4	3%	18	12%
8	20290051	20290500	cttgtcttttgtgatttgtatcctctgataattcgttgtaatataagtctgaagctcaaccagaacattacattcagattcaacacctctcttgcgtgtgtctgattgtcatttcatccgactcttttgcccatctgcttaagtaatcccgttcctcgcagaccagggacccagagggtctgcgacaAGGAAGTATTACAAGAATGGTTGAAACGTAATTCTCTATCTCAGATTTCTGCATTTGGTGCAAGACTTAAGTTTGGATTCACTTTTTCTTGGGTACAGAATATACAGTGGGCAGTACACAAAATATCATAATGTATATCGTTCCATTCTCAAATGCCAGACACAAATACTATAGTGAGTCATAGCAAAGAAACAAAAATGAAGATAATTTGAAACTTCAATAGAATTTTACAGGAGCTCAAAGATAAGTGTCACTTTTTGCC	449	16	4%	74	16%
8	20374951	20375100	AGTAACATAAATATTAtggagagatggcttggtagttaagcgatctagttttgtttgtagtgcattgagttttgagtgctattacccacatggcagctcacaactgtccataactccaattccagagcattccccactcaattctACCA	149	2	1%	28	19%
8	20569501	20569800	GgtgtgtgtgtgtgtgtgtgtgtgtgtgtgcgtgtgtgtgcctgtgtCCATATGTGCCTGCTCAGATCTGGCAAAATCTTCCTTTTGAAATGGAGCTAAGTAGGAGGAATAGTTGGCTTGTTCACTAACAGTCTGAATGGTGACGTTCAAGGTTGAATGCTTGAAAATTCCCTGAAAAGGTAGAATTTGGCAAAGCACAGAAGACTTAGAGTTTGCTTGTAGGACGTTCAGCCTGTGTCATGCTGTGCTGTGCAAAGCGAGAAGCAATCAGTCTTTGGAGTCAGGAACTGGCCCCTTGA	299	8	3%	30	10%
8	20593351	20593800	TGAaaacgatgtgaggaagaataaacaaccgtgaatgtggagtcaaggagacctgagggtgaagcccagcttggctgcctgcctgctgtggaccttggacaaattgcatggcaattctgggtccctggtctcctcttctgACACACCATGACCTGGTGTAAtgtgggacgcccgacttgcctagaagtaagacgccacaacaggatccttctgcaacacgtttattgggagagcatggactgagtaggcaaaagaccccgagccccagaaatggcgctgcttatataggcccacgagtgacgtgtccatacctgattggttatgctaccagtacctcattaatatgcgtcgggccaggcagtgactcagcaaaaaactcttatgcacatgcatacattggttgtttatccataatcatgggtggtggccagtggtagccagcgccatct	449	26	6%	68	15%
8	21874051	21874350	agccccgtgaaaacatacaaaaaggcctctaacactggagaaatttcaagaccgaacataccttacagagccttatgtgtcccgcagttctgaaccgccccgcgaacgggggatctcccttgtgccggtgatggtatgcagttcccgggtttctctgcgccacttgttccgagctatcattcttgccagtaagaagacactcagacaaccggattcttctgcggcaagctttattgcttcttaaggagggaagacccagaccccggaaaatggtgctgcttatatagcacttatatagc	299	28	9%	34	11%
8	22106851	22107000	tacacatgcacacacatacatacatacacacatatatatatatacacacgcacatacatacacacacatacatacaaacacgcgcacacacacatacagacagatatatatacatgtatatgtgtatatatatTGAAGCtaatttgatg	149	6	4%	62	42%
8	25878151	25879200	cgagtttttttctcgtcccggaattcggcaccaattgttattagacgcgttctcacgaccggccaggaagaacaccacagaccagaatcttctgcggcaaagctttattgcttacatcttcaggagccagagtgtaagaagccagagagagcgagaagcaagagagcgagaaaacgaaaccccgtccctcttaaggagcattctccttcgcctcggacgtgtcactccctgattggctgcagcccatcggccgagttgacgtcacggggaaggcagagcacaagtagtcataagatacccttggcacatgcgcagattatttgtttaccacttagaacacagctgtcagcgccatcttgtaacggcgaatgtgggcgcggctcccaacaGGATAATACTGATGTCTGTGTTGAGATATTACCAAAGATGGATTTTAGTTCAATGCACTCTCTCaaaatatgagagccaggtggtggcacacacctttaattccagtactcagctctgtgagttcgaggccagcctggtctacagaatgagttccaggacaaccaggtctataccgagaagccctttcttgaaaaaccaaatacacacacacacacacacacacacacacacacacacacacacatatgtaaattctatctgtggcttcctggttccactgtcttgatttattttattttccccagagcttaggatcaatcccagagcctttcccttctagacaagtgctccatcactgagctacgtgcacaactccTCAATCTGTGTGGTTTAAACTTATTTTTAGATGTACATAAGCCTTAAAAACTAGTGAAGACCCTgggctgttagctcagttgataagagtgcttgcctggcattcgtaaatctctgtgttcagttcccaccaccatacatacacatacacgtacacgtatacacacacacacatacacacatactcatatacacacatacatacatatacacacacatacacatatacacacatattcacacatacacacatatacatattcacacatacacatatacacaca	1049	64	6%	260	25%
8	27073951	27074550	gtgtgtgtgtgtatgttagtcatatgtgtgagtgtgtgagtgagtgtgtgtgtgttagtcatgtgtgtgagtgtgtgagtgtgtgtatgttagtcatgtgtgtgagtgtgtgagtgtgtgagtgtgtgtgtatgttagtcgtgtgtgtgtgtgtgagtgtgtgtgtatgttagtcatgtgtgtgagtgtgtgagtgtgtgtgtgtgtatgttagtcatgtgtgtgagtgtgtgagtgtgtgtgtatgttagtcgtgtatgtgagtgtgtgagtgtgtgtatgttagtcatgtgtgtgagtgtgtgagtgtgtgagtgtgtgagtgtgtgagtgtgtgtgtatgttagtcgtgtgtgtgtgtgtgagtgtgtgtgtatgttagtcatgtgtgtgagtgtgtgagtgtgtgtgtgtatgttagtcatgtgtgtgagtgtgtgagtgtgtgtgtatgttagtcgtgtatgtgagtgtgtgagtgtgtgtatgttagtcatgtgtgtgagtgtgtgagtgtgtgagtgtgtgtgtatgttagtcatgtgtgtgagtgtgtgagtgtgtgtgtgtatgttagtcgtatgtgagtgtgtgagtgt	599	10	2%	20	3%
8	27073951	27074550	gtgtgtgtgtgtatgttagtcatatgtgtgagtgtgtgagtgagtgtgtgtgtgttagtcatgtgtgtgagtgtgtgagtgtgtgtatgttagtcatgtgtgtgagtgtgtgagtgtgtgagtgtgtgtgtatgttagtcgtgtgtgtgtgtgtgagtgtgtgtgtatgttagtcatgtgtgtgagtgtgtgagtgtgtgtgtgtgtatgttagtcatgtgtgtgagtgtgtgagtgtgtgtgtatgttagtcgtgtatgtgagtgtgtgagtgtgtgtatgttagtcatgtgtgtgagtgtgtgagtgtgtgagtgtgtgagtgtgtgagtgtgtgtgtatgttagtcgtgtgtgtgtgtgtgagtgtgtgtgtatgttagtcatgtgtgtgagtgtgtgagtgtgtgtgtgtatgttagtcatgtgtgtgagtgtgtgagtgtgtgtgtatgttagtcgtgtatgtgagtgtgtgagtgtgtgtatgttagtcatgtgtgtgagtgtgtgagtgtgtgagtgtgtgtgtatgttagtcatgtgtgtgagtgtgtgagtgtgtgtgtgtatgttagtcgtatgtgagtgtgtgagtgt	599	10	2%	20	3%
8	27304201	27304950	ttttatgtatggtctcagtgtcttcttgggtacgcggctgtcccgggacttgagtgcctaagtgagggtctcccttcgggggtctttcaTTTGGTGCGTTGGCCGGGAATcagcgcgaccacccagaagtcctagacccacttagaggtaagattctttgttctgttttggtctgatgtctgtgttctgtttctaagtttggtgcaatcgcagtttcagttttgcggacgctcagtgagaccgcgctcgagagggagcgcggggtggataaggatagacgtgtccaggtgtccaccgtccgttcaccctgggagacgtcccaggaggaacaggggaggatcagggacgcctggtggacccctttgaaggccaagagaccatttggggttgcgagattgtgggtttgagtcccacctcatgcccagttgcgagatcgtgggttcgagtcccacctcgcgttttgttgtgagatcgtgggtttgagtcccacctcgcgccttgttgcgagaccgtgggttcgagtcccacctcgcgtttggtcacgggatcgtgggttcgagtcccacctcgtgcagagggtctcaatcggccggccttagagaggccatctgattctttgagttgcttgtggtcgacgcggagtcgccgccgtttctggtttcttttttgtcttagtctcgtgtccgctcttgttgtgactactgtttttctagaaatgggacaatctgtgtccactcccctttctctga	749	98	13%	62	8%
8	27464851	27465900	tttttctctctcttgcttcttgctctcttttcctgaagatgtaagaataaagctttgccgcagaagattctggtctgtggtgttcttcctggccggtcgtgagaacgcgtctaataacaattggtgccgaaacccgggacgagaaaaaactccggactggcgcaggagggatacctcattccggaaccaaaactgcggatcacgtttataaaggttcccgtaacacagactgttgagaaggattcaactgccgaattcagaactcatcagctggggaacgacggtgataaaggttcccgtaaagcagactgttaagaaggattcaactgtatgaattcagaacttttcagctggggaacgagagtaccagtgagtatgtttggccttaaattttttctagtgttaggagcccttttgttctttttcacatgctatcaagtgattaagatagggctaaaaattctaaaaaaaattcaggacaagctatcagaagtaaagcggaaagaaagagtaggaacaaagagaaaatatggttcacaaaataagtatacaggcctttccaagggtcttgaacccgaggaaaagttaaggttaggtaagaatacctagagagagattaaaagaaaaagaggaaaaagggaaaaaaaaaaagatcgattagcggaggtctctaggagatactcgtcactagatgagctcaggaagccagctcttagtagccctgaaacagatgaaaaatcctcctctgaggaaacagactgggaggaagaagcagcccattaccagccaactaatcggtcaagaaaaaagccaaaagcggctggcgaaggccagtttgctaattggcctcagggcaatcggctaccaggtacactcccgccctatgcggagtccccgccctgcgtagtgcgtcagcccgtagtgcgtcagcaatgcgcagagaggcagtgcgcagactcattcattccccgagaggaacaaagaaaaataaaacagacatttccagtctttgaaggagccgagggtgggcgtgtccacgctccgataga	1049	84	8%	114	11%
8	34246051	34246350	cttctaacagcagtttattcagtcttcctctttcttctttctcttcatcagtaccgttccccagctgaagagttctgaatccacgccggatccttctcaacagtctgttttacgggaacctttattaaccactccttccccgtgatgcagttctgaatcctccctgtagcagggggtcttcgctcgtgcctgaagatgtttcttgtcccgggtttcggcaccaaCTGTCGAgcgcgcccccaactcgccagcaagaacgacgctgctacaggatccttctgcacacgtttattcagtcc	299	32	11%	42	14%
8	44951701	44952150	GGCTACGTGACTTACAGTATTGCAAACTTAAATCACGTGCCGTTTGTCATTGACCACTTCACGGGAACCGTGAGTACCTCTGAGAATCTGGACTATGAACTGATGCCTCGCGTGTACACGCTGAGGATCCGTGCGTCTGACTGGGGCTTGCCATACCGCCGGGAAGTCGAAGTCCTCGCCACGATTACTCTCAATAACCTGAATGACAACACACCCCTGTTTGAGAGGATAAACTGTGAGGGGACCATTCCCCGAGACCTAGGTGTGGGGGAGCAGATAACCACCGTGTCTGCCATTGACGCCGACGAGCTGCAGCTGGTCCGGTACCAGATTGAAGCCGGAAATGAGTTGGATTTGTTTGGCTTAAACCCCAGCTCCGGTGTGCTGTCCTTAAAGCACTCCCTCACGGATGGCTTGGGCGCAAAGGTTTCCTTTCACAGTTTGAGAAT	449	50	11%	50	11%
8	46227301	46227600	tatgtgtatgtatgtgtatatgtgtatatgtgtgtatgtgtatgtatgtgtatatacatgtgtatctatgtgcatgtatgtgtacatgtgtatgtgtgtgcatgtatatggtgtgtatgtgtgtttgcgtatatgtgtgtatgtgtgcatacgtgtgtatgtatgtgtatgtgtgcatatgtgtttatgtatgtgtgtgtatatgtgcataagtgtgtattgtgtgtgtgctcacactcacctgcttgtgtcacatcacaagtgtggtggtcaaaggaggacaactttccggaattggt	299	6	2%	32	11%
8	46228951	46229250	ctttgtctctgtaactccttccatgggtgttttgttcccaattctaagaaggggcaaaCGCACTCGTCATTGACAATGGCTCCGGCATGTGCAAAGCCGGCTTTGCTGGTGACTACGCCCCCAGGGCCGTGTTCCCTTCCATCGTAGGGCGCCCCCGACACCAGGGCGTCATGGTGGGCATGGGCCAGAAAGACTCGTACGTGGGTGACGAGGCCCAGAGCAAGAGGGGTATCCTGACCCTGAAGTACCCTATCGAACACGGCATTGTCACCAACTGGGACGACATGGAGAAGATCTGG	299	32	11%	44	15%
8	47451901	47452200	AATGCAGCTTATCTTTCACGTCACATCTTACCTACtcttacacgcgttcgcgaccggccaggaaagacacaacaaactggaatcttctgcggcaaagctttattgcttacatcttcaggagccagagcgcaagagagcaagagctctattgcttacatctttaggagccagagtgcaagagccagagcaagagctcaagagcgcaagagagagaaagcaagagagagaatggcgaaaccccgtcccttttaaggagaattattctccgcctaggacgtattactccttgattggctgca	299	26	9%	48	16%
8	47454151	47454900	tattaccaccgttccccagctgaagagttctgaattcacgcagttgaatccttctcaacagtctgttttacgggaacacttcattaccaccgttccccagctgaggagttctgaatccaggctggatccttctcaacagtctgttttacgggaacacttcattaccatgacccgcagttctggttccggaatgagggatcttccttgcgccggtgatggtaaccgtcctgggttttcttgtctcgggttttctcgtctcgggtttcagcaccaaCtcttacacgcgttcgcgaccggccaggaaagacacaacaaactggaatcttctgcggcaaagctttattgcttacatcttcaggagccagagagcaagagagcaagagctctattgcttacatctttaggagccagagcgcaagagcgcaagagagcaagagctctattgcttacatctttaggagccagagcgcaagagccagagcaagagctcaagagcgcaagagagagaaagcaagagagagaatggcgaaaccccgtcccttttaaggagaattattctccgcctaggacgtattactccttgattggctgcagcccattggccgagttgtcgtcacggggaaggcagagcacatggggtggaaaactacctttggcacatgcgcagattatttgtttaccacttagaacacaggatgtcagcgccatcttgcaacggcgaatgtgagggcggcttcccacaACCTACG	749	72	10%	122	16%
8	48984301	48984750	ccccgtgacgtcaactcggccgatgggctgcagccaatcagggagtgacacgtcctaggcgaaatataactctcctaaaaaagggacggggtttcgttttctctctctcttgcttcttacactcttgctcctgaagatgtaagcaataaagttttgccgcagaagattctggtctgtggtgttcttcctggccgggcgtgagaacgcgtctaataacaattggtgccgaattccgggacgagaaaaaactcgggactggcgcaaggaagatccctcattccagaaccagaactgcgggtcgcggtaataaaggttcccgtaaagcagactgttaagaaggattcaactgtatgaattcagaacttttcagctggggaacgagagtaccagtgagtacagctttacgaggtaagtctgatcttgaactttctaaggaaattcaagacagt	449	48	11%	42	9%
8	50597401	50598600	ttcattattgaaggggctttcgtttttggggctgggcgctgggcgcttgccctcctggctcccaaagatgtaagcaataaagttttgccgcagaagattctggtttgttgcgtctttcctggccggtcgtgagaacgcgtctaataacaattggtgccgaattccgggacgagaaaaaaactcgggactggcgcaaggaagatccctcattccagaaccagaactgcgggtcgcggtaataaaggttcccgtaaagcagactgttaagaaggattcaactgtatgaattcagaacttttcagctggggaacgagagtaccagtgagtacagctttacgaggtaagcctggccttgaactttctaaggaaattcaagacagtctatcagaagtaaagtggaatatgtttggccttgaatattttctagtgttagaagcccttttgttccttttcacatgttatcaagtggttaagatagggcggattctagaggaaattcagggcaatctatcagaagtaaagcggggagagagagtaggagcaaagagaaaatatggtacacaaaataagtatacaggcctttccaagggtcttgaacccgaggaaaagtttaggtcaggtaagaatacctggggagagattagaaggaaggaaaagaaaaaagaaaagaaaaaagatcgattagcggaggtctctaggagatactcgtcactagatgagctcaggaagccagctcttagtagttctgaagcagatgaagaattctcctctgaggaaacagactgggaggaagaagcagcccattaccagccagctaattggtcaagaaaaaagccaaaagcggctggcgaaagccagcgtactgttcaacctcccggcagtcggtttcaaggtccgccctatgcggagcccccgccctgcgtagtgcgtcagcaatgcgcagagagatgcgcagagaggcaatgcgcagagagatgcgcagagaggcagtgcgcagagagatgcgcagagaggcagtgcgcagagagatgcgcagagaggcagtgcgcagagaggcagtgcgcagagaggcagtgcgcagactcattcattcccagagaggaacaaaggaaaatacaacaggcatttccagtctttgaaggagccgagggtgggcgtgtccacgctccggtagaatacttacaaattaaagaaattgc	1199	102	9%	148	12%
8	51569851	51570300	gaatctctgcgactctctcgcccgtcccagaaacggctggcactctgtattccacacggtcacccgtgcagcctgccctccgcggagtcccggagccaagaaggctcccgccggcgcctgtgccacaaacctctcaggccgggcagacccccgtgctctcaccaggaaggtggccggctgtctggagctaaagatggtgctgcccagaagctctgcgactctcgcccgtcccagaaacggctggcactctgtattccacatggtcacccatgcagcctgccctccgcggagtctcggagccaagaaggctcccgccggcgcctgtgccacaaacctctcaggccaggcagacccccgtgctctcaccaggaaggtggccggctgtctggagctgaagatggcgccgcccagaacctttttttcttttctttacttttctttATGTCAAA	449	58	13%	62	14%
8	55528651	55528800	cgggaacacttcattaccaccattccccagctgaagagttctgaattcacacagttgaatccttctcaacagtctgttttacgggaacacttcattaccatgacccgcagttctggttccggaatgagggatcttccttgcgccggtga	149	12	8%	28	19%
8	55547851	55548000	cattatgagaaaaaagagtaccaaccaagtaaagtgctaactagtcatttaaggaaaaagccaaaagcggctggcgaaggccagtttgctaattggcctcagggcaatcggctaccaggtgcactcccgccctatgcggagtccccgcc	149	12	8%	20	13%
8	60818701	60818850	tttccagtctttgaaggagccgagggtgggcgtgtccacgctccggtagaatacttacaaattaaagaactcgccgagtcggtccgtaaatacggaaccaatgctaattttaccttggtgcagttagacaggcttgccggcatggcact	149	20	13%	16	11%
8	60999001	60999150	agacgcaacagaccagaatcttctgcggcaaaactttattgcttacatctttgggagccaggagggcaagcgcccagcgcccagccccaaaaacgaaagccccttcaataatgaaaccgaaaccccttccctatttaggagagttatat	149	12	8%	22	15%
8	61004551	61005000	attggttccgtatttacggaccgactcggcgagttctttaatttgtaagtattctaccggagcgtggacacgcccaccctcggctccttcaaagactggaaatgcctgttgtattttcctttgttcctctctgggaatgaatgagtctgcgcactgcctctctgcgcactgcctctctgcgcactgcctctctgcgcatctctctgcgcattgcctctctgcgcatctctctgcgcattgcctctctgcgcatctctctgcgcattgcctctctgcgcatctctctgcgcattgcctctctgcgcatctctctgcgcattgcctctctgcgcattgctgacgcactacgcagggcgggggctccgcatagggcggaccttgaaaccgactgccgggaggttgaacagtacgctggctttcgccagccgcttttggcttttttcttgacc	449	66	15%	44	10%
8	62805001	62806650	GGTTTCTATCGATGAACAGAAGATGGTAATATAAGACTTTGAGTAGTGTTCATCAGGGTTAAGGTTGTCACAAGCTTTGTAGGAATGAGATTTCTATTTCCATTTCACATATCTATTTGGAAGACGATCAGTAATATGGTCAGATAGGAATATTATGATATACTCTGCTCCCAAATAGTGAAAAATCAGTTTTACAATTAATGAATTTGATTAGTTAGGtgttgggagccgcgcccacattcgccgttacaagatggcgctgacagctgtgttctaagtggtaaacaaataatctgcgcatgtgtcgagggtggttctccactccatgtgctctgccttccccgtgacgtcaactcggccgatgggctgcagccaatcagggagtgacacgtcctaggcgaaggagaattctccttaatagggacggggtttcgttttctctctctcttgcttcttacactctggctcctgaagatgtaagcaataaagttttgccgcagaagattctggtctgtggtgttcttcctggccgggcgtgagaacgcgtctaataacaattggtgccgaaacccgggacgagaaaaaactcgggactggcgcaaggaagatccctcattccagaaccagaactgcgggtcgcggtaataaaggttcccgtaaagcagactgttaagaaggattcaactgtatgaattcagaacttttcagctggagaacgagagtaccagtgagtacagctttacgaggtaagcctggtcttgaactttctaacgaaattcaagacagtctatcagaagtaaagtgggaaatggctttacaaggtatatttggccttgaattttttctggtgttaggagcccttttgttccttttcacatgttatcaagtggttaaggcagggcggattctagataaaattcaggacaatctatcagaagtaaagcggggagagagagtaggagcaaagagaaaatatggtacacaaaataagtatacaggcctttccaagggtcttgaacccgaggaaaagtttaggtcaggtaagaatacctggggagagattagaaggaaggaaaagaaaaaagaaaagaaaaaagatcgattagcggaggtctctaggagatactcgtcactagatgagctcaggaagccagctcttagtagctctgaagcagatgaagaattctcctctgaggaaacagactgggaggaagaagcagcccattaccagccagctaattggtcaagaaaaaagccaaaagcggctggcgaaagccagcgtactgttcaacctcagggcagtcagtttcaaggtccgccctatgcggagcccccgccctgcgtagtgcgtcagcaatgcgcagagaggcaatgcgcagagagatgcgcagagaggcagtgcgcagagaggcagtgcgcagagaggcagtgcgcagactcattcattcccagagaggaacaaagaaaaatacaacaggcatttccggtctttgaaggagccgagggtgggcgtgtccacgctccggtagaatacttacaaattaaagaacttgccgagtcggtccgtaaatatggaaccaatgctaattttaccttggtgcagttagacaggcttgccggcatggcactaactcctgccgactggcaaa	1649	128	8%	202	12%
8	63018301	63018900	gctattccccactttacttctgatagactgtcttgaatttcgttagaaagttcaagaccagacttaccttgtaaagctatacttacgggtaccctgttccccagctgaagagttctgaattcacgcagttgaatccttctcaacagtctgttttacgggaacacttcattaccaccattccccagctgaagagttctgaattcacgcagttgaatccttctcaacagtctgttttacgggaacacttcattaccatgacccgcagttctggttcctgaatgagggatcttccttgcgccggtgatggtaaccgtcccaggttttctcgtctcgggatttctcgtcccaggtcttctcgtcccgggtctcagcaccaaCtcttacacgcgttctcgaccggccaggaaagacgcagcaaaccagaatcttctgcggcaaaactttattgcttacatcttcaggagcaagagtgcaagagagcaagagctctattgcttacatctttaggagccagagcgcaagagcgcaagagcgcaagagcgcaagagccagagcaagagagcaaaaggagagaatggcgaaaccccgtcccttttaag	599	54	9%	92	15%
8	63909901	63910200	agaggcttctgcctcacgttccgtgggggccaccttggttccgggactccgcggcgggcggtctgcgggtgagagtgtggaacacagaggccagcagcttctggaacgggcgagagccacagagcctctgaggcggcgccattttcagctccagacaacctgccaccttcctggtcagagcacaggtgtccgcacagcccgtgaggcttctgcctcacgttccgcgggggccaccttgattctgggactccgcagcgggcagtctgcaggccaaagcaacacagcttctgggaaagatc	299	38	13%	54	18%
8	65030701	65030850	gacacacaggcacacagacacacacaggtacacacacagacacatacacactcacacacacagtcacacatacacacagacacatgctcacgcacacagacacacacacacagacacacactcacacacacagacacacacacacacac	149	2	1%	112	75%
8	65100751	65100900	tagtatgtgtgtagtatgtgtatagtatgtatgtgtgtgtgtgtttggtgtggtgcgtgtatgtagtgtgtgtatagtatgtatatgtatgtgtagtgtgtgtgtatatgtatgtgtgtgtgtgtagtatgtgtatagtttgtgtgtgt	149	2	1%	0	0%
8	67792651	67794450	CTTTCTACCAATCCCACTTCGAGTGTTCCACACTGACATGCCATATAAGAACTGTGACTTtgttgggagccgcccccacattcgccgtcacaagatggcgctgacatcctgtgttctaagtggtaaacaaataatctgcgcatgagccaagggtattttatgactacttgtactctacctttcccgtgaacgtcagctcggccatgggctgcagccaatcagggagtgatgcgtcctaggcgaaatataacgctcctaaaaaaggggacggggtttttccgccatgctctctcgctggcatctctctggctctgcgcgccctgcgctcgctcgctgcctaaagatgtaaacaatagagcacgctctgcgctttggcgcgccggagctctggctcctaaaaatattgaaggggctttcgtttttggggctgggcgctgggcgcttgccctcctggctcccaaagatgtaagcaataaagttttgccgcagaagattctggtctgttgcgtctttcctggccgggcgtgagaacgcgattaacaattggtgccgaattccgggacgagaaattccgggacgagaaaaaactcgggactggcgcaaggaagatccctcattccagaaccagaactgcgggtcgcggtaataaaggttcccgtaaagcagactgttaagaaggattcaactgtatgaattcagaacttttcagctggggaacgagagtacccgtaagtatagctttacgaggtaagcctggccttgaactttctaaggaaattcaagacagtctatcagaagtaaagtggaaaatgtttggccttgaattttttctaatgttaggagcccttttgttccttttcacatgttatcaggtgattaagatagggctgaaaattctggatgaaattcagggcaatctatcagaagtaaagcggggagagagagtaggagcaaagagaaaatatggtacacaaaataagtatacaggcctttccaagggtcttgaacccgaggaaaagtttaggtcaggtaagaatacctggggagagattagaaggaaggaaaagaaaaaagaaaagaaaaaagatcgattagcggaggtctctaggagatactcgtcactagatgagctcaggaagccagctcttagtagttctgaagcagatgaagaattctcctctgaggaaacagactgggaggaagaagcagcccattaccagccagctaattggtcaagaaaaaagccaaaagcggctggcgaaagccagcgtactgttcaacctcccggcagtcggtttcaaggtccgccctatgcggagcccccgccctgcgtagtgcgtcagcaatgcgcagagaggcaatgcgcagagagatgcgcagagaggcaatgcgcagagagatgcgcagagaggcaatgcgcagagagatgcgcagagaggcaatgcgcagagagatgcgcagagaggcagtgcgcagagagatgcgcagagaggcagtgcgcagagaggcagtgcgcagagaggcagtgcgcagactcattcattcccagagaggaacaaaggaaaatacaacaggcatttccagtctttgaaggagccgagggtgggcgtgtccacgctccggtagaatacttacaaattaaagaactcgccgagtcggtccgtaaatacggaaccaatgctaattttaccttggtgcagttagacaggcttgccggcatggcactaactcctgccgactggcaaacggttgtaaaagccgctctccctagtatgggcaaatatatggaatggagagct	1799	180	10%	212	12%
8	72863551	72864450	ctttcttgctgttgttctattaaatcttgccttctacattttgagtacggtctcagtgtcttcttgggtccgcggctgtcccggggcttgagtgcttgagtgagggtctcccttcgggggtctttcaTtttggtgcattggccgggaatcagcgcgaccacccagaggtcctagacccacttagaggtaagattctttgttctgttttggtctgatgtttgtgttctgtttctaagtttggtgcgattgcagtttcggttttgcggacgctcagtgagaccgcgctccgagagggaacgcggggtggataaggatagacgtgtccaggtgtccaccgtccgttcaccctgggagacgtcccaggaggaacaggggaggaccagggacgcctggtggacccctttggaggccaagagaccatttggggttgcgagatcgtgggtttgagtcccacctcgtgcccagttgcgagatcgtgggttcgagtcccacctcgcgttttgttgcgagatcgtgggtttgagtcccacctcgcgccttgttgcgagaccgtgggttcgagtcccgcctcgcgtttggtcacgggatcgtgggttcgagtcccacctcgtgcagagggtctcaatcggccggccttagaaaggccatctgattctttgagttgcttgtggtcgacgcagagtcgccgccgtttctggtttcttttttgtcttagtctcgtgtcccgctcttgttgtgtctactgtttttctagaaatgggacaatctgtgtccactcccctttctctgactctggagcattgggaggaggtgcgggtcagagcccacaaccagtcggtggaggtcagaaagggtccgtggcagaccttttgcgcctccgagtggccaacgtttggagt	899	118	13%	76	8%
8	72927001	72927450	cgggcagtcggcttcaaggtccgccctatgcggagcccccgccctgcgtagtgcgtcagccctgcgcagagagacaatgcgcagagaggcaatgcgcagagagacaatgcgcagagaggcaatgcgcagagagacaatgcgcagagaggcaatgcgcagagagacaatgcgcagagaggcaatgcgcagagagacaatgcgcagagaggcaatgcgcagagagacaatgcgcagagaggcaatgcacagagagacaatgcgcagagaggcaatgcgcagagagacaatgcgcagagaggcaatgcgcagactcattcattcccagagaggaacaaaggaaaatacaacaggcatttccggtctttgaaggagccgagggtgggcgtgtccacgctccggtagaatacgtgcagattaaagaactcgccgagtcggtccgtaaatacgga	449	68	15%	92	20%
8	74585851	74586150	cgcgttctcgcgaccggccaggaagaacgcaacaaaccggaatcttctgcggcaaagctttattgcttacatcttcaggagccagagagcaagagagcaagagctctattgcttacatctttaggagccagagcgcaagagagcaagagctttattgcttacatcttcaggagcaagaggcaagagccggagcaagagagagaatggcgaaaccccgtccctttttaaggagaattattctccgcctaggacgtattactccctgattggctgcagcccatcggccgagttgtcgtcac	299	34	11%	42	14%
8	78061051	78061350	attgcgtcccactggaccggcaagaaagacgcaacaaaccggaatcttccgtggcaaaagctttattgcttacttcttcaggaagaccccaaaccgggaaaatggcgctgcttttataacccgcagcgtgacgtttcagcacctgatatggcgtgacagctcctgattcgttgctcgcccatcacccccctattacaccccgagaatgggagtgactaggagtgagttcactctcgcacctgcgtacaaggcttgtttactagttaggcacagcggaggccagcgccatcttataatgg	299	36	12%	42	14%
8	87815401	87815550	ctacatatatacactctcacacatgcacatatacacacatgcatacatccttgcacccgcacacatacacatactcacacacatacacacatacacacacccacacatatagacacacgcatacacgatgcacacacacatacacacac	149	6	4%	86	58%
8	90087751	90088350	taagtggtaaacaaataatctgcgcatgtgccaagggtattttaccactacttgtactctgcctttcctgtgacgtcagctcggccatgggctgcagccaatcagggagtgatgcgtcctaagcaaaggataactctcctaaatagggatggggagtttcgctttcgtttagaagggggctttcgtttttggggtttggggttttgcgctcctgctcctgaagatgtaagcaataaagttttgccgcagaagattctggtttgttgtgttctttcctggccggtcgtgagaacgcgtataagagttggtgctgaaatccgggacgagaaaaaatccgggacgaaaaaatacaagaaaactcgggaccggcgcaaggaagatccctcattccagaaccagaactgcgggtcacggtaataaaggttcccgtaaaacagactgttgagaaggattcaactgcatgaattcagaacttttcagctggggaacagaagtaccagtgagtacagctttacaaggtaagtctggtcttgaactttctaaggaaattcaagacagtctatcagaagtaaagtggaaaatagctttacaaggtacgc	599	48	8%	62	10%
8	98179951	98181300	caaagcgctctccattccatatatttgcccatactagggagagcggcttttacaaccgtttgccagtcggcaggagttagtgccatgccggcaagcctgtctaactgcaccaaggtaaaattagcattggttccgtatttacggaccgactcggcaatttctttaatttgtaagtattctaccggagcgtggacacgcccaccctcggctccttcaaagaccggaaatgcctgttgtattttcctttgttcctctctgggaatgaatgagtctgcgcactgcctctctgcgcagggctgacgcactacgcagggcggggactccgcatagggcggaccttgaagccgactgccctgaggccaatcagcaaactggccttcgccagccgcttttggcttccttaactgattagctagcactttacctggctggtacccttttttctcataatgagctgcttcttcctcccagtctgtttcttcagaggagaattcttcatctgcttcagagctactaagagctggctccccgagcccatccagcgatgagcacaggctccttttcctagagacctccgctaattgatctttcttcttttccctttttcctctttttcttctaatctctctccaggtattcctacctaaccttaacttttcctcaggttcaagacccgtggaaaggcctgtacgcttattttgtgtaccatattttctctttgctcctactctctctccccgctttacttctgatagcttgtcctgaatttcctctagaattttcagccctatcttaatcacttgataacatgtgaaaaggaacaaaagggctcctaacaccagaaaaaattcaaggccaaacatattccactttacttctgatagactgtcttgaatttccttagaaagttcaagatcagacttacctcgtaaagctgtactcactggtactctcgttccccagctgaaaagttctgaattcatacagttgaatccttcttaacagtctgctttacgggaacctttattaccgcgacccgcagttctggttctggaatgagggatcttccttgcgccagtcccgagttttttctcgtcccggaattcggcaccaattgttattagacgcgttctcacgaccggccaggaaagacgcaacagaccagaatcttctgcggcaaagctttattgcttacatcttcaggagccagagtgcaagaagcaagagagagagaaaacgaaaccccgtccctattaaggagaattttccttcgcctaggacgtgtcactccctgattggctgcagcccatcggccgagttgacgtcacgaggaaggcagagcacatgga	1349	110	8%	156	12%
8	98179951	98181300	caaagcgctctccattccatatatttgcccatactagggagagcggcttttacaaccgtttgccagtcggcaggagttagtgccatgccggcaagcctgtctaactgcaccaaggtaaaattagcattggttccgtatttacggaccgactcggcaatttctttaatttgtaagtattctaccggagcgtggacacgcccaccctcggctccttcaaagaccggaaatgcctgttgtattttcctttgttcctctctgggaatgaatgagtctgcgcactgcctctctgcgcagggctgacgcactacgcagggcggggactccgcatagggcggaccttgaagccgactgccctgaggccaatcagcaaactggccttcgccagccgcttttggcttccttaactgattagctagcactttacctggctggtacccttttttctcataatgagctgcttcttcctcccagtctgtttcttcagaggagaattcttcatctgcttcagagctactaagagctggctccccgagcccatccagcgatgagcacaggctccttttcctagagacctccgctaattgatctttcttcttttccctttttcctctttttcttctaatctctctccaggtattcctacctaaccttaacttttcctcaggttcaagacccgtggaaaggcctgtacgcttattttgtgtaccatattttctctttgctcctactctctctccccgctttacttctgatagcttgtcctgaatttcctctagaattttcagccctatcttaatcacttgataacatgtgaaaaggaacaaaagggctcctaacaccagaaaaaattcaaggccaaacatattccactttacttctgatagactgtcttgaatttccttagaaagttcaagatcagacttacctcgtaaagctgtactcactggtactctcgttccccagctgaaaagttctgaattcatacagttgaatccttcttaacagtctgctttacgggaacctttattaccgcgacccgcagttctggttctggaatgagggatcttccttgcgccagtcccgagttttttctcgtcccggaattcggcaccaattgttattagacgcgttctcacgaccggccaggaaagacgcaacagaccagaatcttctgcggcaaagctttattgcttacatcttcaggagccagagtgcaagaagcaagagagagagaaaacgaaaccccgtccctattaaggagaattttccttcgcctaggacgtgtcactccctgattggctgcagcccatcggccgagttgacgtcacgaggaaggcagagcacatgga	1349	110	8%	156	12%
8	100249801	100249950	gccaaaagcggctggcgaaggccagtttgctgattggcctcagggcagtcggcttcaaggtccgccctatgcggagcccccgccctgcgtagtgcgtcagcaatgcgcagagaggcaatgcgcagagagatgcgcagagaggcagtgcg	149	24	16%	24	16%
8	100522651	100522950	ggccatgggctgcagccaatcagggagtgatgcgtcctaggcgaaatataacgctcctaaaaaaggggagggggtttccgccattctctctcgctggcatctctctggctctgcgcgccctgcgctcgctcgctgcctaaagatgtaaacaatagagcgcgctctgcgctttggcgcgccggagctctggctcctaaagatattatagaaggggttttcgtttttggggtttggggtttttgcactcctgctcctgaagatgtaagcaataaagttttgccgcagaagattctggtctg	299	36	12%	20	7%
8	101360551	101361150	ttagggaaatctggaaatgaaaaccataggaactgaaacaggaactacagtggctgttgggagccgcgcccacattcgccgttacaagatggcgctgacagctgtgttctaagtggtaaacaaataatctgcgcatgtgccaagggtatcttatgactacttgtgctctgccttccccgtgacgtcaactcggccgatgggctgcagccaatcagggagtgacacgtccgaggcgaaggagaatgctccttaagagggacggggtttcgttctctctctctcttgcttttctctctctcttgcttcttgctctcttgcttcttgcactctgttcctgaagatgtaagaataaagctttgccgcagaagattctggtctgtggtgttcttcctggccggtcgtgagaacgcgtctaataacaattggtgccgaattccgggacgagaaaaaaaactcgggactggcgcaaggaggatccctcattccggaaccagaactgcggatcacgtttataaaggttcccgtaacacagactgttgagaaggattcaactgccgaattcagaactcatcagctggggaacgacggtgataaaggtt	599	64	11%	56	9%
8	102009601	102010200	atcaccgtcgttccccagctgatgagttctgaattcggcagttgaatccttctcaacagtctgctttacgggaacctttatcaccgtcgttccccagctgatgagttctgaattcggcagttgaatccttctcaacagtctgctttacgggaacctttatcaccgtcgttccccagctgatgagttctgaattcggcagttgaatccttctcaacagtctgtgttacgggaaccttataaccttgattcgcagttctggttctggaatgaagtatccctcctgcgccagtccggagttttttctcgtcccggattttctcgtcccggaattcggcaccaattgttattcgacgcgttctcacgaccggccaggaagaacaccacagaccagaatcttctgcggcaaagctttattcttacatcttcaggaaaagagagcaagaagcaagagagagagaaaacgaaaaccccgtccctcttaaggagcattctccttcgcctcggacgtgtcactccttgattggctgcagcccatcggccgagttgacgtcacggggaaggcagagcacaagtagtcataagatacccttggcacatgc	599	70	12%	82	14%
8	104269651	104269800	tcttacacgcattcgcgaccggccaggaaagacgcagcaaaccagaatcttctgcggcaaaactttattgcttacatcttcaggagcaagagtgcaagagggcaagagagagaatggtgaaaccccgtcccctttaaggagaattatcc	149	14	9%	24	16%
8	104778451	104779050	AGGGAAACATCAGCTCATTAATAAAGTAGTTTGGAAAAAAACCCTACCAACATATTAAATGCTGTATtgttgggagccgcccccacattcgccgtcacaagatggcgctgacatcctgtgttctaagtggtaaacaaataatctgcgcatgtgccaagggtattttaccactacttgtactctgcctttcccgtgacgtcagctcggccatgggctgcagccaatcagggagtgatgcgtcctaagcgaaggataactcctccttaaaggggacggggtttccgccattctctctcttgctctggcgctctggcgcgctctggcgcgctctggctcctaaagatgttagaagggggctttcgtttttggggcttgggtttttgcgctcctgctcctgaagatgtaagcaataaagttttgccgcagaagattctggtttgttgtgttctttcctggccggtcgtgagaacgcgagtaagaGTTGGTGCTGaaatccgggacgaaaaaatacaagaaaactcgggaccggcgcaaggaagatccctcattccagaaccagaactgcgggtcacggtaataaaggttcccgtaaaacagac	599	64	11%	58	10%
8	105007051	105007350	tttaatttgtaagtattctaccggagcgtggacacgcccaccctcggctccttcaaagactggaaatgcctgttctattttcctttgttcctctcggggaatgaatgagtctgcgcactgcctctctgcgcactgcctctctgcgcattgctgacgcactacgggctgacgcactacgcagggcggggactccgcatagggcgggagtgcacctggtagccgattgccctgaggccaatcagcaaactggccttcgccagccgcttttggctttttccttaaatgactagttagcactt	299	36	12%	32	11%
8	105008101	105008550	ttttttctcgtcccgggtttcggcaccaattgttattagacgcgttctcacgaccggccaggaagaacaccacagaccagaatcttctgcggcaaagctttattcttacatcttcaggagccagagtgtaagcagcaagagagcaagaagcaagagagagcgaagcaagagagagaagcaagagagagagaaaacgaaaccccgtccctttttaaggagaattctccttcgcctcggacgtgtcactccttgattggctgcagcccatcggccgagttgacgtcacggggaaggcagagcacaagtagtcataagatacccttggcacatgcgcagattatttgtttaccacttagaacacagctgtcagcgccatcttgtaacggcgaatgtgggcgcggctcccaacaCCTATAGCTAAGCTACAGGCAAGTACTAAACAACATGAC	449	48	11%	80	18%
8	105212251	105212700	tgtgtggtctttacagtgcgctgggcagtgacggtgtggtctttacagtgcgctgggcagtgacggtgtggtctttacagtgcactgggcagtgacggtgtggtctttacagtgcgctgggcagtgacggtgtggtctttacagtgcgctgggcagtgacggtgtggtctttacagtgcgctgggcagtgacggtgtggtctttacagtgcgctgggcagtgacggtgtggtctttacagtgcgctgggcagtgacggtgtggtctttacagtgcgctgggcagtgacggtgtggtctttacagtgcgctgggcagtgacggtgtggtctttacagtgcgctgggcagtgacggtgtggtctttacagtgcgctgggcagtgacggtgtggtctttacagtgcgctgggcagtgacggtgtggtctttacagtgcgctgggcagtgacg	449	54	12%	58	13%
8	106479451	106480950	taccagttggaacttcttctgaggtattgctggatcttccGGTAATATGTtgttgggagccgcgcccacattcgccgcgctgacagctgtgttctaagtggtaaacaaataatctgcgcatatgccgagggtggttctccactccatgtgctctgccttccccgtgacgtcaactcggccgatgggctgcagccaatcagggagtgacacgtcctaggcgaaatataactctcctaaaaaagggacggggtttcgttttctctctctcttgcttcttgcactctggctcctgaagatgtaagcaataaagctttgccgcagaagattctggtctgtggtgttcttcctggccgggcgtgagaacgcgtctaataacaattggtgccgaattccgggacgagaaaaaactcgggactggcgcaaggaagatccctcattccagaaccagaactgcgggtcgcggtaataaaggttcccgtaaagcagactgttaagaaggattcaactgtatgaattcagaacttttcagctggggaacgagagtaccagtgagtatagctttacgaggtaagcctggccttgaactttctaaggaaattcaagacagtctatcagaagtaaagtggaaaatgtttggccttgaattttttctagtgttagaagcccttttgttccttttcacatgttatcaagtggttaaggcagggcggattctggatgaagttcaggacaagctatcagaagtaaagtggggagagagagtaggaacaaagaggaaatatggtacacaaaataagtatacaggcctttccaagggtcttgaacccgaggaaaagttaaggttaggtaggaatacctggagagagattagaagaaaaagaggaaaaaaagaaaagaaaaaagatcgattagcggaggtctctaggagatactcgtcactagatgagctcaggaagccagctcttagtagctctgaagcagatgaagaattctcctctgaagaaacagactgggaggaagaagcagctcattatgagaaaaaagggtaccagccaggtaaagtgctagctaatcagttaaggaagccaaaagcggctggcgaaggccagtttgctgattggcctcagggcagtcggcttcaaggtccgccctatgcggagtccccgccctgcgtagtgcgtcagccctgcgcagagagatgcgcagagaggcaatgcgcagagagatgcgcagagaggcaatgcgcagagagatgcgcagagaggcagtgcgcagagaggcagtgcgcagactcattcattcccagagaggaacaaaggaaaatacaacaggcatttccagtctttgaaggagccgagggtgggcgtgtccacgctccggtagaatacttacaaattaaagagcttgccgagtcggtccgtaaatacggaaccaatgctaattttaccttggtgcagttagacaggcttgccggcatggcactaactcctgccgactgg	1499	124	8%	168	11%
8	106486351	106486650	tggtaaacaaataatctgcgcatatgccgagggtggttctccactccatgtgctctgccttccccgtgacgtcaactcggccgatgggctgcagccaatcagggagtgacacgtcctaggcgaaatataactctcctaaaaaagggacggggtttcgttttctctctctcttgcttcttgcactctggctcctgaagatgtaagcaataaagctttgccgcagaagattctggtctgtggtgttcttcctggccgggcgtgagaacgcgtctaataacaattggtgccgaattccggga	299	34	11%	26	9%
8	106503151	106503300	aaaacgaaagccccttcaataatgaaaccgaaaccccttccctatttaggagagttatatttcgcctaggacgcatcactccctgattggctgcagcccatggccgagctgacgttcacgggaaaggcagagtacaagtagtcgtaaaa	149	16	11%	16	11%
8	107616601	107616900	ccttcccaaactcctggggtcccaagtttcactcaccatgaacttaccctgccggcaaccactgactgctgaaagttctgaactcggcgggggagttggttccccgtacgggccaccaattgtcgcgcccgctctcgaccagcaagaacgacacggccaccagtccttctaacagcagtttattcagtcttcatctttcttctttctcttcatcagtaccgttccccagctgaagagttctgaatccacgccagatccttctcaacagtctgttttacgggaacttttattaaccactc	299	28	9%	52	17%
8	109739251	109739400	aagagggacggggtttcgttttctctttctcttgcttcttgctctcttgcttcttgctctcttgcttcttgctctcttgcttcctgcaccctggctcctgaagatgtaagaaataaagctttgccgcagaagattctggtctgtggtgt	149	6	4%	4	3%
8	109740001	109740450	catcgctggatgggctcggggagccagctcttagtagctctgaagcaggtgaagaatcctcctctgaggaaacagactgggaggaagaagcagcccattaccagccagctaattggtcaagaaaaaagccaaaagcggctggcgaaggccagtttgctgattggcctcagggcagtcggcttcaaggtccgccctatgcggagtccccgccctgcgtagtgcgtcagcaatgcgcagagagatgcgcagagaggcagtgcgcagagaggcagtgcgcagactcattcattcccagagaggaacaaaggaaaatacaacaggcatttccggtctttgaaggagccgagggtgggcgtgtccacgctccggtagaatacttacaaattaaggaaattgccgagtcggttcgtaaatacggaaccaatgctaattttaccttggtgcagtta	449	46	10%	66	15%
8	113280601	113280900	tcttgctctcttgcttcttgcactctgttcctgaagatgtaagaataaagctttgccgcagaagattctggtctgtggtgttcttcctggccggtcgtgagaacgcgtctaataacaattggtgccgaattccgggacgagaaaaaaactcgggactggcgcaaggaggatccctcattccggaaccagaactgcggatcacgtttataaaggttcccgtaacacagactgttgagaaggattcaactgccgaattcagaactcatcagctggggaacgacggtgataaaggttcccgt	299	36	12%	26	9%
8	113281501	113281800	cggctggcgaaggccagtttgctgattggcctcagggcagtcggcttcaaggtccgccctatgcggagtccccgccctgcgtagtgcgtcagcaatgcgcagagaggcagtgcgcagagaggcagtgcgcagactcattcattcccagagaggaacaaaggaaaatacaacaggcatttccggtctttgaaggagccgagggtgggcgtgtccacgctccggtagaatacttacaaattaaagaaattgctgagtcggttcgtaaatacggaaccaatgctaattttaccttggtgcag	299	38	13%	44	15%
8	113575201	113575800	ggctctgacccgcacttccttccaatgctccagagtcagagaaaggggagtggacacagattgtcccatttctagaaaaacagtagtcacaacaagagcggacacgagactaagacaaaaaagaaaccagaaacggcggcgactctgcgtcgaccacaagcaactcaaagaatcagatggcctttctaaggccggccgattgagaccctctgcacgaggtgggactcgaacccacgatcccgtgaccaaacgcgaggtgggactcgaacccacggtctcgcaacaaggcgcgaggtgggactcaaacccacgatctcgcaacaaaacgcgaggtgggactcgaacccacgatctcgcaactgggcacgaggtgggactcaaacccacgatctcgcaaccccaaatggtctcttggcctccaaaggggtccaccaggcgtccctgggcctcccctgttcctcctgggacgtctcccagggtgaacggacggtggacacctggacacgtctatccttatccaccccgcgttccctctcggagcgcggtctcactgagcgtccgcaaaactgaaactgcgatcgtaccaaacttagaaacag	599	90	15%	94	16%
8	116768251	116768400	cacacacaaattcaatggcacacgtagactacataatcacatatacacaaacacacatacatttacacacagacatatacactcacacacacaaacagacacactcacagaggcacacacagagactcacacacacacaaactcacagg	149	2	1%	86	58%
8	116805001	116805300	tgccttccccgtgacgacaactcggccgatgggctgcagccaatcagggagtaacacgtcctaggcggaggataattctccttaaatgggacggggttttgccattctctctcttgctcttgcactcttgcgctcttgcgctctggctcctaaagatgtaagcaatagagctcttgcactcttgcgctctggctcctgaagatgtaagcaatagagctcttgctctcttgctctctggctcctgaagatgtaagcaataaagcttttgccgcagaagattccggtttgctgcgttcttc	299	26	9%	24	8%
8	116896201	116897700	AAACCTAAGATAAAAGCTAACGTTTGTCCTTTCACCTCCACGTCAGCTAAGCCCAAATGAGAGTtgttgggagccgcgcccacattcgccgttacaagatggcgctgacagctgtgttctaagtggtaaacaaataacctgcgcatgtgccgagggtggttctccactccatgtgctctgccttccccgtgacgtcaactcggccgatgggctgcagccaatcagggagtgacacgtcctaggcgaaggataattctccttaatagggacggggtttcgttttcgctcgctcttgcttcttacactcttgctcctgaagatgtaagcaataaagttttgccgcagaagattctggtctgtggtgttcttcctggccgggcgtgagaacgcgtttaataacaATTGGTGCTGaaatccgggacgagaaattccgggacgagaaaaaatccggaaagaaaaaacccgggaggaaactcgggacgggagtttcactggcgcaaggaagatccctcattccagaaccagaactgcgggtcgcggtaataaaggttcccgtaaagcagactgttaagaaggattcaactgtatgaattcagaacttttcagctggggaacgagagtaccagtgagtacagctttacgaggtaagcctggccttgaactttctaaggaaattcaagacagtctatcagaagtaaagtggaaaatgtttgcccttgaattttttctagtgttagaagcccttttgttccttttcacatgttatcaagtggttaaggcagggcggattctggatgaaattcagggcaatctatcagaagtaaagcggggagagagagtaggagcaaagagaaaatatggtacacaaaataagtatacaggcctttccaagggtcttgaacccgaggaaaagtttaggtcaggtaagaatacctggggagagattagaaggaaggaaaagaaaaaagaaaagaaaaaagatcgattagcggaggtctctaggagatactcgtcactagatgagctcaggaagccagctcttagtagctctgaagcagatgaagaattctcctctgaggaaacagactgggaggaagaagcagctcattatgagaaaaaagggtaccagccaggtaaagtgctagctaatcagttaaggaagccaaaagcggctggcgaaggccagtttgctgattggcctcagggcagtcggcttcaaggtccgccctatgcggagcccccgccctgcgtagtgcgtcagcaatgcgcagagaggcaatgcgcagagaggcaatgcgcagagaggcagtgcgcagagaggcagtgcgcagagaggcagtgcgcagactcattcattcccagagaggaacaaaggaaaatacaacaggcatttccagtctttgaaggagccgagggtgggcgtgtccacgctccggtagaatacttacaaattaaagaactcgccgagtcggtccgtaaatatggaaccaatgctaatt	1499	134	9%	174	12%
8	116903101	116903400	cgcccacattcgccgttacaagatggcgctgacagctgtgttctaagtggtaaacaaataacctgcgcatgtgccgagggtggttctccactccatgtgctctgccttccccgtgacgtcaactcggccgatgggctgcagccaatcagggagtgacacgtcctaggcgaaggataattctccttaatagggacggggtttcgttttcgctcgctcttgcttcttacactcttgctcctgaagatgtaagcaataaagttttgccgcagaagattctggtctgtggtgttcttcctggc	299	34	11%	32	11%
8	117007201	117007650	cactggtactctcgttccccagctgaaaagttctgaattcatacagttgaatccttcttaacagtctgctttacgggaacctttattaccgcgacccgcagttctggttctggaatgagggatcttccttgcgccagtcccgagttttttctcgtcccggaattcggcaccaattgttattagacgcgttctcacgcccggccaggaagaacaccacagaccagaatcttctgcggcaaaactttattgcttacatcttcaggagccagagtgcaagaagcaagagagagcgagaaaacgaaaccccgtccctattaaagagaattttccttcgcctaggacgtgtcactccctgattggctgcagcccatcggccgagttgacgtcacgaggaaggcagagcacatggagtgaagaaccaccctcggcacatgcgcagattatttgtt	449	52	12%	64	14%
8	117729301	117729750	gtgtatgaaagcatgtgtgtgtatgtgtctctgtgtatgagtgtgtatatatgtgagtgtgtataggtgtgtggttatatgtgtgtgagagagaccgtgtatgtgtttgtgtgtgtgagtgtatgtatgtgtgtgtggcatgtgtatgtgtgaacgtgtgtgtttgcgtgtgtggctgtgagagcatgtgtgtgtctgtgtgtgagcatgtgtatctgtgtgtataatgtgtgagtgtgtgtatatatgtgtggtgtatgtatatgtgatgtgtgtatgtgccctgtgtctgtgtgcgagggtgtatggtatgtgtgcttgatgtatgtgagtgtgaatgtgtatatatgtgtgcattcaagagcatgtgtgtgtggtgtatgtgggtgagtgcgtgtatatgtgtgtgatgtgtagtaaatgtgtgtgtgagcatgagtacgtgtgta	449	12	3%	16	4%
8	118438951	118439550	cacacatgcacacacatatactacatattcatgcacacatactacacatactatttacacacactacacatactgcatgcacactaccacactaaacacacatacacagatactgcacacaaataacacacatgcgcacacacatgcatacatgctacatatactacacatacaatatacacatactacatgcacacacatatactacatactcatgtacacgcatatactacatgcacatgtacataacacacatacacacatatgcacacgtactacatatactacacatactatacacacatactactcatattacacacacactacactacacacacatatactacacacatgcacataacacacatacacacatgtacacatactacatatactatatatactatacccacatactacacatacactaccatactacacacacatgcacacacatatagcacacatacatgtacacacatatatatactacatgcacatgtacacgacacacatatacacacatgcacacatactacatatactacacatatcatacacacatactactcattctatacacacactaccatact	599	8	1%	288	48%
8	119336701	119337900	gttagtgccatgccggcaagcctgtctaactgcaccaaggtaaaattagcattggttccatatttacggaccgactcggcaagttctttaatttgtaagtattctaccggagcgtggacacgcccaccctcggctccttcaaagaccggaaatgcctgttgtattttcctttgttcctctctgggaatgaatgagtctgcgcactgcctctctgcgcagggctgacgcactacgcagggcggggactccgcatagggcggaccttgaagccgactgccctgaggccaatcagcaaactggccttcgccagccgcttttggcttccttaactgattagctagcactttacctggctggtacccttttttctcataatgagctgcttcttcctcccagtctgtttcttcagaggagaattcttcatctgcttcagagctactaagagctggcttcctgagctcatctagtgacgagtatctcctagagacctccgctaattgatcttttttcttttccctttttcctctttttcttctaatctctctccaggtattcctacctaaccttaacttttcctcgggttcaagacccttggaaaggcctgtatacttattttgtgtaccatatttcctctttgttcctactctctctccccactttacttctgatagcttgtcctgaatttcctctagaatcctccctgccttaaccacttgataacatgtgaaaaggaacaaaagggcttctaacactagaaaaaattcaaggccaaacatattccactttacttctgatagactgtcttgaatttccttagaaagttcaagatcagacttacctcgtaaagctgtactcactggtactctcgttccccagctgaaaagttctgaattcatacagttgaatccttcttaacagtctgctttacgggaacctttattaccgcgacccgcagttctggttctggaatgagggatcttccttgcgccagtcccgagttttttctcgtcccggaattcggcaccaattgttattagacgcgttctcacgaccggccaggaaagacgcaacaaaccagaatcttctgcggcaaagctttattgcttacatcttcaggagccagagtgcaagaagcaagagagcaagaagcaagagagagagaaaacgaaaccccgtccctattaaggagaattttcctt	1199	82	7%	124	10%
8	119806201	119806500	acacatgcacagatacacacacacagatacacacaggcacacacacacatgtatacactacacactcacccccttagacacacacacagatatacacacacacatgcacagatacacacacacagatacacacaggcacacacacacgtgtatacactacacactcaccccctttagacacacatagatacacacacacacacacacacacacacggcacacacacCTAGATCGTGTTACTACTACTGTGCCTGAATGATACTGACTCTCCTGGGGTGCCCACCTTCGTGCCGGAGGAT	299	10	3%	142	47%
8	120000001	120000450	cgtagaaacacagacacacacacagatataaacacacagacacacacacatagacacatacaaagagactcaagcacacacagagactcacataccacatacacactgacacacacacatagacacagacacatgcacacataaacacacacagagacacaaagaacacagacacacaccacatacacattgacacacacagagacacacatagatacacacagacacacacagacacagagacacacacagacacacacacagacacacacacatagacacatacacacagacacacacacaaacacccacagacactcacacatagacacacatacagacacaacacgtagtcacacatacacacacacagacatacacatacagacacacacacacatggacacagacacatgcatacataaatacagagagacacaaagaacaca	449	4	1%	278	62%
8	120199201	120199500	cgttccccagctgaaaagttctgaattcatacagttgaatccttcttaacagtctgctttacgggaacctttattaccgcgacccgcagttctggttctggaatgagggatcttccttgcgccagtcccgagttttttctcgtcccgggtttcggcaccaattgttattagacgcgttctcacgaccggccaggaaagacgcaacaaaccagaatcttctgcggcaaagctttattgcttacatcttcaggagccagagtgcaagcagcaagagagcaagaagcaagagagagagaaaa	299	32	11%	44	15%
8	120822151	120822300	tatgtgcatgtgttcatgtgtgtgtgtatgcatgtgtgtatgtttatgtgtgtatgtgtatgtatgcatgtgtgcatgcacgtgtacatgtgtttgtgcgtgtatgtgtgtacatgtatgtatgcatgcatgcatgtgtgtgcatgcat	149	4	3%	26	17%
8	121241401	121241700	cacatatatactcacatgtgcatacactcacatgtacacatgcatgcatgcatgcatgtatacactcacatgcacacatccacacacacacatacactgacgtacacatggctacatgtatatacacgtgtgcatgtacatatatgcaaatgtatctgcatatacattcatgtgtgcatacagtcacatgttcacaagcatgcacgcacgcacacactcacaccatacacacatagacataCATGTAGACATGCGCTCACCCATGTGTACACAGGGCATTGCCTTCTTCCTTGTTTGAC	299	10	3%	126	42%
8	121833001	121833450	ttaaatgttacaggctgctgatgtttaaatggaccaatcatgtgaaaccgcgccaattcctcccccagccccactccttttctataaaaccccctagcttccaagcctcgtggtcgaatccactgtctcctgttgtgtgagatacgtttcgacccggagctccgccattaaaaaacctcttgttgttacatcaaggtgttgtgttctattcgtgattcttgggtgcacgccgaatcgggagctgagtgggggtttccccactgagttctttcatttggaggtcccaccgagatctgcgtgacacccaggaaccccgaaggaccccttggaggtgcgtttgtttgtgtgagtcttgttatgttgtctgttgtctaagtgtctaagtgtggcactgctgaatttgtgtcttagtttttcagttctgagattgtgggtttgagccccacctg	449	32	7%	40	9%
8	123420901	123421500	GCTAGTGGAGAACACAGACGAGACCTACTGCATCGACAATGAAGCCCTCTACGACATCTGCTTCCGCACCCTCAAGCTGGCCACACCCACCTATGGGGACCTCAACCACCTTGTGTCTGCCACCATGAGTGGAGTCACCACCTCCCTTCGATTCCCTGGTCAGCTCAATGCCGACCTCCGCAAGCTGGCTGTGAACATGGTGCCGTTCCCACGTCTCCACTTCTTCATGCCCGGCTTCGCCCCACTTACAGCCCGGGGCAGCCAGCAGTACCGTGCCCTGACGGTGCCTGAGCTCACGCAGCAGATGTTCGATGCCAAGAACATGATGGCTGCCTGTGACCCGCGCCACGGTCGCTACCTGACCGTGGCCACTGTCTTCCGTGGGCGCATGTCTATGAAGGAGGTGGACGAGCAGATGCTGGCCATCCAGAGTAAGAACAGCAGCTACTTCGTGGAGTGGATCCCCAACAACGTCAAGGTAGCCGTGTGTGACATCCCACCCCGTGGGCTCAAAATGTCATCCACCTTCATTGGCAACAGCACGGCCATCCAGGAGCTGTTCAAACGCATCTCGGAGCAGTTCACAGCCATGTTCCGGC	599	64	11%	122	20%
8	123543001	123543150	CATCGGCACAGGCTAGCCCAAGAGGCACGCACTGCACTGCCCTTGCCCTCCCTCCAGAGCGCAAGCACACACCACACCCGGACAGGCACACAAACTCGCCCCCTACCCACCCACGCACCCACGGAAACAGACACATGTCAGGGCACTGC	149	14	9%	54	36%
8	123544801	123544950	CCCACCCACGCACCCACGGAAACAGACACATGTCAGGGCACTGCAGCTTGCGCACCCGGACAAAAAAGGAGGACGGCTAGAAGGTGCAGGCAacacacagacacggccacgcacgcgcacacacactcacaccactcactcgcaggctg	149	20	13%	58	39%
8	123551551	123551850	CAAGCACACACCACACCCGGACAGGCACACAAACTCGCCCCCTACCCACCCACGCACCCACGGAAACAGACACATGTCAGGGCACTGCAGCTTGCGCACCCGGACAAAAAAGGAGGACGGCTAGAAGGTGCAGGCAacacacagacacggccacgcacgcgcacacacactcacaccactcacTCGCAGGCTGCCACACCTGCCCCTaccctcaggcacacacacacacacacacacacacacacacacacacacacttgtttttaCTGGCTGATTGAGCAAGCAAGCCCGGAGGGTCC	299	26	9%	128	43%
8	123553201	123553500	AGCCCAAGAGGCACGCACTGCACTGCCCTTGCCCTCCCTCCAGAGCGCAAGCACACACCACACCCGGACAGGCACACAAACTCGCCCCCTACCCACCCACGCACCCACGGAAACAGACACATGTCAGGGCACTGCAGCTTGCGCACCCGGACAAAAAAGGAGGACGGCTAGAAGGTGCAGGCAacacacagacacggccacgcacgcgcacacacactcacaccactcactcgcaggctgccacacCTGCCCCTACCCTCaggcacacacacacacacacacacacacacacacacaca	299	28	9%	128	43%
8	123560101	123560400	CCGGACAGGCACACAAACTCGCCCCCTACCCACCCACGCACCCACGGAAACAGACACATGTCAGGGCACTGCAGCTTGCGCACCCGGACAAAAAAGGAGGACGGCTAGACGGTGCAGGCaacacacagacacggccacgcacgcgcacacacactcacaccactcactcgcaggctgccacacCTGCCCCTaccctcaggcacacacacacacacacacacacacacacacacacacacacttgtttttaCTGGCTGATTGAGCAAGCAAGCCCGGAGGGTCCTCAGCTTCcacacaaa	299	28	9%	122	41%
8	123563401	123564000	TGGGACACGCACAGCCACACCCATCGGCACAGGCTAGCCCAAGAGGCACGCACTGCACTGCCCTTGCCCTCCCTCCAGAGCGCAAGCACACACCACACCCGGACAGGCACACAAACTCGCCCCCTACCCACCCACGCACCCACGGAAACAGACACATGTCAGGGCACTGCAGCTTGCGCACCCGGACAAAAAAGGAGGACGGCTAGAAGGTGCAGGCAacacacagacacggccacgcacgcgcacacacactcacaccactcactcgcaggctgccacacCTGCCCCTACCCTcaggcacacacacacacacacacacacacacacacacacacttgtttttaCTGGCTGATTGAGCAAGCAAGCCCGGAGGGTCCTCAGCTTCcacacaaacaaacacacacacacacacacaGGGACCCAGGTGAATTAGCAGAAGGCAGGAGGGGCAAGATACACAGAAtctctctctctccctgtgtctctccctctctctgtctctctgtctctctctctctctctctctctgtctctctctctTtcacacacacacacacacacacacacacacacacacacacggtggaaggcaagtgcgg	599	38	6%	230	38%
8	123568351	123568800	CTGtggatggatacatggatacatggatacatgaatggatgggtggatggatggatggatggatggatggatggCATCCCAGCCCACCTGGGACACGCACAGCCACACCCATCGGCACAGGCTAGCCCAAGAGGCACGCACTGCACTGCCCTTGCCCTCCCTCCAGAGCGCAAGCACACACCACACCCGGACAGGCACACAAACTCGCCCCCTACCCACCCACGCACCCACGGAAACAGACACATGTCAGGGCACTGCAGCTTGCGCACCCGGACAAAAAAGGAGGACGGCTAGAAGGTGCAGGCAAcacacagacacggccacgcacgcgcacacacactcacaccactcactcgcaggctgccacacCTGCCCCTACCCTCaggcacacacacacacacacacacacacacacacacacacacacacacttgtttttaCTGGCTGAT	449	32	7%	164	37%
8	123570151	123570600	GGCACAGGCTAGCCCAAGAGGCACGCACTGCACTGCCCTTGCCCTCCCTCCAGAGCGCAAGCACACACCACACCCGGACAGGCACACAAACTCGCCCCCTACCCACCCACGCACCCACGGAAACAGACACATGTCAGGGCACTGCAGCTTGCGCACCCGGACAAAAAAGGAGGACGGCTAGACGGTGCAGGCAacacacagacacggccacgcacgcgcacacacactcacaccactcacTCGCAGGCTGCCACACCTGCCCCTaccctcaggcacacacacacacacacacacacacacacacacacacacacttgtttttaCTGGCTGATTGAGCAAGCAAGCCCGGAGGGTCCTCAGCTTCcacacaaacaaacacacacacacacacacaGGGACCCAGGTGAATTAGCAGAAGGCAGGAGGGGCAAGATACACAGAAtctctct	449	32	7%	182	41%
8	123578551	123579000	CCCACCTGGGACACGCACAGCCACACCCATCGGCACAGGCTAGCCCAAGAGGCACGCACTGCACTGCCCTTGCCCTCCCTCCAGAGCGCAAGCACACACCACACCCGGACAGGCACACAAACTCGCCCCCTACCCACCCACGCACCCACGGAAACAGACACATGTCAGGGCACTGCAGCTTGCGCACCCGGACAAAAAAGGAGGACGGCTAGAAGGTGCAGGCAacacacagacacggccacgcacgcgcacacacactcacaccactcacTCGCAGGCTGCCACACCTGCCCCTACCCTCaggcacacacacacacacacacacacacacacacacacacacacacacacacttgtttttACTGGCTGATTGAGCAAGCAAGCCCGGAGGGTCCTCAGCTTCcacacaaacaaacacacacacacacacacaGGGACCCAGGTGAATT	449	34	8%	192	43%
8	123583651	123583950	CTGGGACACGCACAGCCACACCCATCGGCACAGGCTAGCCCAAGAGGCACGCACTGCACTGCCCTTGCCCTCCCTCCAGAGCGCAAGCACACACCACACCCGGACAGGCACACAAACTCGCCCCCTACCCACCCACGCACCCACGGAAACAGACACATGTCAGGGCACTGCAGCTTGCGCACCCGGACAAAAAAGGAGGACGGCTAGAAGGTGCAGGCAacacacagacacggccacgcacgcgcacacacactcacaccacTCACTCGCAGGCTGCCACACCTGCCCCTACCCTcagg	299	32	11%	110	37%
8	123585451	123585750	ACTCGCCCCCTACCCACCCACGCACCCACGGAAACAGACACATGTCAGGGCACTGCAGCTTGCGCACCCGGACAAAAAAGGAGGACGGCTAGACGGTGCAGGCAacacacagacacggccacgcacgcgcacacacactcacaccactcactcgcaggctgccacacCTGCCCCTACCCTCaggcacacacacacacacacacacacacacacacacacacacacacacacttgtttttaCTGGCTGATTGAGCAAGCAAGCCCGGAGGGTCCTCAGCTTCcacacaaacaaacacaca	299	26	9%	128	43%
8	123588751	123589200	CCAGCCCACCTGGGACACGCACAGCCACACCCATCGGCACAGGCTAGCCCAAGAGGCACGCACTGCACTGCCCTTGCCCTCCCTCCAGAGCGCAAGCACACACCACACCCGGACAGGCACACAAACTCGCCCCCTACCCACCCACGCACCCACGGAAACAGACACATGTCAGGGCACTGCAGCTTGCGCACCCGGACAAAAAAGGAGGACGGCTAGAAGGTGCAGGCAACAcacagacacggccacgcacgcgcacacacactcacaccactcactcgcaggctgccacacCTGCCCCTACCCTCaggcacacacacacacacacacacacacacacacacacacacacacacacacttgtttttACTGGCTGATTGAGCAAGCAAGCCCGGAGGGTCCTCAGCTTCcacacaaacaaacacacacacacacacacaGGGACCCAGGTG	449	34	8%	194	43%
8	123592201	123592500	CTAGCCCAAGAGGCACGCACTGCACTGCCCTTGCCCTCCCTCCAGAGCGCAAGCACACACCACACCCGGACAGGCACACAAACTCGCCCCCTACCCACCCACGCACCCACGGAAACAGACACATGTCAGGGCACTGCAGCTTGCGCACCCGGACAAAAAAGGAGGACGGCTAGAAGGTGCAGGCAacacacagacacggccacgcacgcgcacacacactcacaccactcactcgcaggctgccacacCTGCCCCTACCCTCaggcacacacacacacacacacacacacacacacaca	299	28	9%	126	42%
8	123597301	123597600	CCAAGAGGCACGCACTGCACTGCCCTTGCCCTCCCTCCAGAGCGCAAGCACACACCACACCCGGACAGGCACACAAACTCGCCCCCTACCCACCCACGCACCCACGGAAACAGACACATGTCAGGGCACTGCAGCTTGCGCACCCGGACAAAAAAGGAGGACGGCTAGACGGTGCAGGCAacacacagacacggccacgcacgcgcacacacactcacaccactcactcgcaggctgccacacCTGCCCCTaccctcaggcacacacacacacacacacacacacacacacacacacac	299	30	10%	132	44%
8	123599101	123599250	AAACAGACACATGTCAGGGCACTGCAGCTTGCGCACCCGGACAAAAAAGGAGGACGGCTAGAAGGTGCAGGCAacacacagacacggccacgcacgcgcacacacactcacaccactcacTCGCAGGCTGCCACACCTGCCCCTACCCT	149	16	11%	54	36%
8	123600601	123601050	ggatacatggatggatggatggatggatggatgggtggatggatggatggatggCATCCCAGCCCACCTGGGACACGCACAGCCACACCCATCGGCACAGGCTAGCCCAAGAGGCACGCACTGCACTGCCCTTGCCCTCCCTCCAGAGCGCAAGCACACACCACACCCGGACAGGCACACAAACTCGCCCCCTACCCACCCACGCACCCACGGAAACAGACACATGTCAGGGCACTGCGGCTTGCGCACCCGGACAAAAAAGGAGGACGGCTAGACGGTGCAGGCAacacacagacacggccacgcacgcgcacacacactcacaccactcacTCGCAGGCTGCCACACCTGCCCCTACCCTcaggcacacacacacacacacacacacacacacacacacacacttgtttttaCTGGCTGATTGAGCAAGCAAGCCCGGAGGGTCCTC	449	38	8%	158	35%
8	123605851	123606000	CACAAACTCGCCCCCTACCCACCCACGCACCCACGGAAACAGACACATGTCAGGGCACTGCAGCTTGCGCACCCGGACAAAAAAGGAGGACGGCTAGACGGTGCAGGCAacacacagacacggccacgcacgcgcacacacactcacac	149	22	15%	56	38%
8	123609151	123609600	GGCACAGGCTAGCCCAAGAGGCACGCACTGCACTGCCCTTGCCCTCCCTCCAGAGCGCAAGCACACACCACACCCGGACAGGCACACAAACTCGCCCCCTACCCACCCACGCACCCACGGAAACAGACACATGTCAGGGCACTGCAGCTTGCGCACCCGGACAAAAAAGGAGGACGGCTAGAAGGTGCAGGCAacacacagacacggccacgcacgcgcacacacactcacaccactcacTCGCAGGCTGCCACACCTGCCCCTaccctcaggcacacacacacacacacacacacacacacacacacacacacttgtttttaCTGGCTGATTGAGCAAGCAAGCCCGGAGGGTCCTCAGCTTCcacacaaacaaacacacacacacacacacaGGGACCCAGGTGAATTAGCAGAAGGCAGGAGGGGCAAGATACACAGAAtctctct	449	30	7%	182	41%
8	123612451	123612900	atggatacatgaatggatgggtggatggatggatggatggatggatggatggCATCCCAGCCCACCTGGGACACGCACAGCCACACCCATCGGCACAGGCTAGCCCAAGAGGCACGCACTGCACTGCCCTTGCCCTCCCTCCAGAGCGCAAGCACACACCACACCCGGACAGGCACACAAACTCGCCCCCTACCCACCCACGCACCCACGGAAACAGACACATGTCAGGGCACTGCAGCTTGCGCACCCGGACAAAAAAGGAGGACGGCTAGAAGGTGCAGGCAacacacagacacggccacgcacgcgcacacacactcacaccactcacTCGCAGGCTGCCACACCTGCCCCTACCCTCaggcacacacacacacacacacacacacacacacacacacacacacttgtttttaCTGGCTGATTGAGCAAGCAAGCCCGGAGGGTCC	449	34	8%	162	36%
8	123614251	123614400	GGCTAGCCCAAGAGGCACGCACTGCACTGCCCTTGCCCTCCCTCCAGAGCGCAAGCACACACCACACCCGGACAGGCACACAAACTCGCCCCCTACCCACCCACGCACCCACGGAAACAGACACATGTCAGGGCACTGCAGCTTGCGCA	149	14	9%	52	35%
8	123619501	123619650	GCTTGCGCACCCGGACAAAAAAGGAGGACGGCTAGACGGTGCAGGCaacacacagaaacggccacgcacgcgcacacacactcacaccactcacTCGCAGGCTGCCACACCTGCCCCTACCCTCaggcacacacacacacacacacaca	149	18	12%	60	40%
8	123622801	123623100	CCTTGCCCTCCCTCCAGAGCGCAAGCACACACCACACCCGGACAGGCACACAAACTCGCCCCCTACCCACCCACGCACCCACGGAAACAGACACATGTCAGGGCACTGCAGCTTGCGCACCCGGACAAAAAAGGAGGACGGCTAGACGGTGCAGGCAacacacagacacggccacgcacgcgcacacacactcacaccacTCACTCGCAGGCTGCCACACCTGCCCCTACCCTcaggcacacacacacacacacacacacacacacacacacacttgtttttaCTGGCTGATTGAGCAA	299	28	9%	124	41%
8	124507351	124507500	acacgtacatacacatacacacacataaacacacatacacatatacacacatacacacacgtacatacacatacacacatacatacacatacatatacacatgtaaacatacacacacatacatacacactcatacaaatacacTATAA	149	4	3%	84	56%
8	124582651	124583550	ttaacagtctgctttacgggaacctttattaccgcgacccgcagttctggttctggaatgagggatcctccttgcgccagtcccgagttttttctcgtcccggaattcggcaccaattgttattagacgcgttctcacgaccggccaggaagaacaccacagaccagaatcttctgcggcaaagctttatttcttacatcttcaggagccagggtgcaggaagcaagagagcaagaagcaagagagcaagaagcaagagagagagaaaacgaaaccccgtccctcttaaggagcattctccttcgcctcggacgtgtcactccctgattggctgcagcccatcggccgagttgacgtcacggggaaggcagagcacaagtagtcataagatacccttggcacatgcgcagattatttgtttaccacttagaacacagctgtcagcgccatcttgtaacggcgaatgtgggcgcggctcccaacaGggaacgctgctcactagcttgctagccatggcttgctcagctacctctcttacacaacccaagaccatttgcacagtggttttgtggtaggtgacacctgccacaatggactaggccctccacatcagtcaccaatcaaaaaaatgccccacacacttgcccatgggatgattcaatggagacttccgcaatgactccagcttgtatcacgttgaccaaaactcatcagTTCTTACTGCTATGTCTCATTCTGGACAGTCAGCGGTTGATAAGTATATATATACACACGTATATGTTTGTTTGCTCTAGATTATATGAATGTGTTGTATACACACACTGGTGCACTTCTGTGTGTACGTATGTATTCACGTGTATACTCGTGTATCTGTGTACACAGGTGGTACTAGCCTCCAT	899	74	8%	164	18%
8	125186251	125186550	tacattacacacacagacaccatacacatacacactcgcacacacatacacacctagagacacgtggacacacacacagacacacataggcacaccacacatacagacatacagacacaccacacatacagacacacagacacaccatacacatagacatacatatataatacacacaacacataagacacacacatacacacagagccacatacagacacacacagacatgcacacagatatccaaacacacacagagacgtacacacagagacacactcagacacatacacacaaac	299	6	2%	178	60%
8	125629501	125630850	gcgaaggataattctccttaatagggacggggtttcgttttctcgctctcttgcttcttacactcttgctcctgaagatgtaagcaataaagttttgccgcagaagattctggtctgtggtgttcttcctggccgggcgtgagaacgcgaataacaattggtgccgaattccgggtagagaaaaaactcgggactggcgcaaggaagatccctcattccagaaccagaactgcgggtcgcggtaataaaggttcccgtaaagcagactgttaagaaggattcaactgtatgaattcagaacttttcagctggggaacgagagtaccagtgagtacagctttacgaggtaagcctggccttgaactttctaaggaaattcaagacagtctatcagaagtaaagtggaaaatgtttggccttgaattttttctaatgttagaagcccttttgttccttttcacatgttatcaagtggttaaggcagggcggattctagatgaaattcaggacaagctatcagaagtaaagtggggagagagagtaggaacaaagaggaaatatggtacacaaaataagtatacaggcctttccaagggtcttgaacccgaggaaaagttaaggttaggtaggaatacctggagagagattagaagaaaaagaggaaaaagggaaaagaagaaagatcaattagcggaggtctctaggaaaaggagcctgtgctcatcgctggatgggctcggggagccagctcttggtagctctgaatcagatgatgaattctcctctgaagaaacagactgggaggaagaagcagctcattatgagaaaaaagggtaccagccaggtaaagtgctagctaatcagttaaggaagccaaaagcggctggcgaaggccagtttgctgattggcctcagggcagtcggcttcaaggtccgccctatgcggagtccccgccctgcgtagtgcgtcagcaatgcgcagagaggcaatgcgcagagaggcaatgcgcagagaggcaatgcgcagagaggcagtgcgcagactcattcattcccagagaggaacaaaggaaaatacaacaggcatttccggtctttgaaggagccgagggtgggcgtgtccacgctccggtagaatacttacaaattaaagaactcgccgagtcggtccgtaaatacggaaccaatgctaattttaccttggtgcagttagacaggcttgccggcatggcactaactcctgccgactggcaaacggttgtaaaagccgctctccctagtatgggcaaatatatggaatggagagctctttggcatgaaactgcacaagcgcaggcccgagcaaacgc	1349	108	8%	152	11%
8	126537751	126538050	gtgtgcacatgcgcatgtgcgagtgtgctcatatgcacatgtgtatatgtatatatggtgtgtatgtacacatacgtgcatgtggatgcatgtttgcatgtgtgtacatgtgggtatgtgcacatataagtattatacatgtgtgtacatgtgctcatatgtgcgtgtgtgcaagtatatgtatgtatacatgtgtgcacaaatgtatgcacatgtgtgcatgtgtgtatgcgtgtacatgtgtgtgtttatgtatacacgtgaatgtatatatgtgtgcatgtgtatatgcatgtgtg	299	12	4%	56	19%
8	126868501	126868800	acatacatatacacaaatacacacacatacacatatacacacacacaaatacacacatgcatacacatatacacttatactcacacacacatactcatatactcacacatacacacacatgcatgggcacacacacatacgcacacatacatacacaattacacacatactcatacatacacatacacatatgcatgcatacatgcacatacacacttaaattcaaacacacatacaCATtctctctctctctctctctGTcacacacacacacacgcacacacacaGGGAAGCTCAGG	299	4	1%	164	55%
8	128090401	128090850	cgtttgccagtcggcaggagttagtgccatgccggcaagcctgtctaactgcaccaaggtaaaattagcattggttccgtatttatggaccgactcggcaatttctttaatttgtaagtattctaccggagcgtggacacgcccaccctcggctccttcaaagaccggaaatgcctgttgtattttcctttgttcctctctgggaatgaatgagtctgcgcactgcctctctgcgcagggctgacgcactacgcagggcggggactccgcatagggcggaccttgaagccgactgccctgaggccaatcagcaaactggccttcgccagccgcttttggcttccttaactgattagctagcactttacctggctggtacccttttttctcataatgagctgcttcttcctcccagtctgtttcctcagaggagaattcttcatctgctt	449	42	9%	50	11%
8	128557351	128557800	ccccagctgatgagttctgaattcggcagttgaatccttctcaacagtctgctttacgggaacctttatcaccgtcgttccccagctgatgagttctgaattcggcagttgaatccttctcaacagtctgtgttacgggaacctttataaacgtgatccgcagttctggttccggaatgagggatcttccctgcgccagtcccgagtttttttctcgtctcgggttttCGGCACCAATtgttattcgacgcgttctcacgaccggccaggaagaacaccacagaccagaatcttctgcggcaaagctttattcttacatcttcaggaaaagagagcaagaagcaagagagagagaaaagcaagagagagagaaaagcaagagagcgaaaaagcaagagagagagcgcgagacaagagagagagagaacgaaaccccgtccctcttaagg	449	50	11%	56	12%
8	129211351	129211800	GCCATCTCTACCTCATAGGTGGAAAGAGATCTGTTTATAAAAAGATAGATAAAGAATATGTTCTATGGggtctgcgggtgagagtgtggaacacaaaggccagcagcttctggaacgggtgagagccacagagcctctgaggcggcgccatttccggctccagacaacctgccaccttcctggtgagagcacaggggtccacccggcccaagaggcttctgcctcacgttccgtgggggccaccttggttccgggactccgcggcgggcggtctgcgggtgagagtgtggaacacagaggccagcagcttctggaccagggaagaaccacagagcctctgaggcggcgccattttcagctccagacaacctgccaccttcctggtcagagcacaggtgtccacactgcccgtgaggcttatgcctcacgttccgtgggggccaccttga	449	38	8%	74	16%
9	3000001	3038400	Atcctacagtgtgcatttctcatttttcacgtttttcagtgatttcgtcatttttcaagtcatcaagtggctgtttctcattttccatgattttcagttttcttgccatattccttgtcctacagtggacatttctaaattttccacctttttcagttttccttgtcatatttcaggtcctacagtgtgtatttctcatttttcacgtttttcattgatttcgtcatttttcaagttgtcaagtgcatgtttctcattttccatgattttcagttttcttgccatattccatgtcctacaatggacatttctaaattttccaactttttcagttttcctcgccatatttcacgtcctaaagtgtgtatttctcattttccgtgattttcagttttctcgacatattccaggtcctacagtgtgcatttctcatttttcacgtttttcagtgatttcgtcatttttcacgtcgtcaagtggatgtttctcattttccatgattttcagttttcttgccatattccatgtcctacagtggacatttctaaattttccacctttttcagttttcctcgccatatttcacgtcctaaagtgtgtatttctcattttccgtgattttcagttttctcgacatattccaggtcttacagggtgcatttctcatttttcacgtttttcagtgatttcatcatttttcaagtcgtcaactgtatgtttctcattttcaatgattttcatttttcttgccatattccacgtcctatagtggacatttctaaattttccacctttttcagttttccttgccatatttcaggtcctacagtgtgcatttctcatttttcacgtttttcagtgatttcgtcatttttcaagtggtcaaatgcatgtttctcattttccatgattttcagttttcttgccatattccatgtcctacagtggacatttctaaattttccacctttttcagttttcctcgccatatttcacgtcctaaagtgtgtatttctcattttccgtgattttcagttttatcgccagattccaggtcctacggtgtgcatttttcatatttcacgtttttcagtgattttgtcatttttcaagttgtcaactgcatgtttctcattttccatgattttcagttttcttgccatattccatgtcctacagtggacatttctaaattttccacctttttcagttttcctcgccatatttcatgtcctaaagtgtgtatttctcattttcagtgattttctgttttctcgccatattccaggtcctacagtgtgcatttctcatttttcacgtttttcagtgatttcgtcatttttcaagttgtcaagtggatgtttctcattttccatgattttcagttttcttgccatattccatgtcctacaatggacatttctaaattttccacctttttcagttttcctcgccatatttcacgtcctaaagtgtgtatttctcattttccgtgattttcagttttctcgccatattccaggtcctatgtgtacatttctcatttttcacgtttttcagtgattttgtcatttttcaagttgtgaagtggatgtttctcatttttcttgattttcatttttcttgccatattccatgtcctagagtggaaatttttaaattttccacctttttcagttttcctcgccatatttcacgtcctaaagtgtgaatttctcattttccgtgattttcagttttctcgccatattccaagtcctacagtgtgcatttctcatttttcacgtttttcagtgatttcgtcatttttcaagttgtcaagtggatgtttctcattttccatgattttcagctttcttgccatattcaaagtcctacagtggacatttctaaattttcgacctttatcagttttcctcgccatatttcatgtcccaaagtgtgtacttctcattttccgtgattttcagtttcctcgccatattctaggtcctacagtgtgcatttctcatttttcaggtttttcagtgatttcgtcttttttcaagtcgtcaagtggatgtttctcattttccatgattttcagttttcttgccatattccatgtcctacagtggacatttctaaattttccaactttttcagttttcctcgccatatttcatgtcctaaagtgtgtatttctcattttcagtgattttcagttttctcgccatattccaggtcctacagtgtgcatttctcatttttcacgtttttcagtgatttcgtcatttttcaagttgtcaagtggatgtttctcatttttcatgattttcagttttcttgccatattccatgtcccacagtggacatttctaaatgttccacctttttctgttttccttgccatatttcatgtcctaaagtgtgtatttctcattttccgtgattttcagttttcttgctatattccaagtcctacagtgtgcatttctcatttttcacgtttttctgtgattttttcatttttcaatttgtcaactgcatgtttctcattttccatgattttcagttttcttgccatattccaggtcctacagtgtgcatttctcatttttcacgtttttcagtgattttgtcatttttcaagttgtcaactgcatgtttctcattttccatgattttcagttttcttgctatattccatgtcctacagtggaaatttctaaattttccacctttttcagttttcctcgccatatttcacgtcctaaagtgtgtatttctcattttccgtgattttcagttttctcgccatattccaggtcctatgtgtacatttctcatttttcacgtttttcagtgattttgtcatttttcaagttgtgaagtggatgtttctcatttttcttgattttcatttttcttgccatattccatgtcctagagtggaaatttttaaattttccacctttttcagttttcctcgccatatttcacgtcctaaattgtgaatttctcattttccgtgattttcagttttctcgccatattccaagtcctacagtgtgcatttctcatttttcacgtttttcagtgatttcgtcatttttcaagttgtcaagtggatgtttctcattttccatgattttcagctttcttgccatattcaaagtcctacagtggacatttctaaattttcgacctttatcagttttcctcgccatatttcatgtcccaaagtgtgtacttctcattttccgtgattttcagtttcctcgccatattctaggtcctacagtgtgcatttctcatttttcaggtttttcagtgatttcgtcttttttcaagtcgtcaagtggatgtttctcattttccatgattttcagttttcttgccatattccatgtcctacagtggacatttctaaattttccacctttttcagttttcctcgccatatttcatgtcctaaagtgtgtatttctcattttcagtgattttcagttttctcgccatattccaggtcctacagtgtgcatttctcatttttcacgtttttcagtgattttgtcatttttcaagttgtcaagtggatgtttctcattttccttgattttcagttttcttgccatattccatgtcctacagtggacatttctaaattttccacctttttcagttttccttgccatatttcatgtcctaaagtgtgtatttctcattttcagtgattttcagttttctcgccatattccaggtcctacagtgtgcatttctcattttttcaggtttttcagtgatttcgtcatttttcacgttgtcaagtggatgtttctcattttccatgattttcacttttcttgccatatttcatgtcctaaagtgtgtatttctcattttcagtgattttcagttttctcgccatattccaggtcctacagtgtgcatttctcattttttcacgtttttcagtgatttcgtcatttttcacgttgtcaagtggatgtttctcattttccattattttcacttttcttgccatatttcatgtcctacagtggacatttctaaattttccacctttttctgttttcctcgccatatttcacatcctaaagtgtgtatttctcattttccgtgattttcagttttcttgccatattccaggtcctacagtgtgcatttctcatttttcacgtttttcagtgatttcgtcatttttcaagtcgtcaagtggatgtttctcattttccatgattttcagttttctcgccatattccaggtcctacagttgacatttctaaattttccacattttttatgtttcctcgcgatatttcacatcctaaagtgtgtatttctcattttccgtgattttcagttttcttgccatattccaggtcctacagggtgcatttctcatttttcacgtttttcagtgatttcatcaatttcaagtcgtcaactgtatgtttctcattttcaatgattttcatttttcttgccatattccacgtcctatagtggacatttctacattttccacctttttcagttttcttcgccatatttcacgtcccaaagtgtgtatttctcattttccgtgattttcagtttcctcgccatattccaggtcctacagtgtgcatttctcatttttcacgtttttcagtgatttcgtcttttttcaagtcgtcaagtggatgtttctcattttccatgattttcagttttcttgccatattccatgtcctacagtggacatttctaaattttccacctttttctgttttcctcgccatatttcacgtcctaaagtgtgtatttctcatttaccgtgattttcagttttcttgctatattccaagtcctacagtgtgcatttctcatttttcacgtttttcactgattttgtcattgttcaagttgtcaactgcatgtttctcattttccatgattttcagttttcttgccatattccatgtcctacagtggaaatttctatattttccaactttttcagttttcctcgccatatttcacgtgctaaagtgtgtatttctcatttttcgtgtttttcaggtttctcgccatattccaggtcctacagtgtgcatttctcatttttcacgtttttcagtgattttgtaatttttcaagttgtcaagtggatgtttctcattttccttgattttcagttttcttgccatattccatgtcctactgtggacatttctaaattttccacctttttcagttttccttgccatatttcatgtcctaaagtgtgtatttctcattttcagtgattttcagttttctcgcaatattccaggtcctacagtgtgcatttctcattttttcaggtttttcagtgatttcgtcatttttcacgttgtcaagtggatgtttctcattttccatgattttcacttttcttgccatatttcatgtgctaaagtgtgtatttctcattttcagtgattttcagttttctgccatattccaggtcctacattgtgcatttctcattttttcacgtttttcagtgatttcgtcatttttcacgttgtcaagtggatgtttctcattttccatgattttcacttttcttgccatatttcatgttttacagtggacatttctaaattttccacctatttctgttttcctcgccatatttcacatcctaaagtgtgtatttctcattttccgtgattttcagttttctcgccatatgccaggtcatacagggtgcatttctcatttttcacgtttttcagtgatttcgtcatttttcacgtcgtcaagtggatgtttctcattttcaatgattttcatttttcttgccatattccacgtcctatagtggacatttctaaattttccacctttttcagttttccttgccatatttcaggtcctacagtgtgcatttctcttttttcacgtttttcagtgatttcgtcatttttcaagtggtcaagtgcatgtttctcattttccgtgattttcagttttcttgccatgttccaggtcctacagttgacgtttctaaaatttcactttttttaagttttcctcgccatatttcacttcctaaagtgtgtatttctcattttccgtgattttcagttttctcgccagattccaggtcctacagtgtgcatttttcatatttcacctttttcagtgattttgtcatttttcaagttgtcaactgcatgtttctcattttccatgattttcagttttcttgccatattccatgtcctactgtggacatttctaaattttccaactttttcagttttcctcgccatatttcatgtcctaaagtgtgtatttctcattttcagtgattttctgttttctcgccatattccaggtcctacagtgtgcatttctaatttttcacgtttttcagtgatttcgtcatttttcaagttgtcaagtggatgtttctcattttccatgattttcagttttcttgccatattccatgtcctacagtggacatttctaaattttccaactttttccattttcctcaccatatttcacgtcctaaagtgagtttttctcattttttgtgattttcagttttctcgacatattccaggtcctacagtgtgcatttctaattttttcttttttcagtgatttcgtcatttttcaagtggtcaagtgcatgtttctcattttccatgattttcagttttcttgccatattccatgtcctacaatggacatttctaaattttccaactttttcagttttcctcgccatatttcacgtcctaaagtgtgtatttctcattttccgtgattttcagttttctcgccatattccaggtcctacagtgtgcatttctcatttttcacgtttttcagtgatttcgtcatttttcaagttgtcaactgcatgtttctcattttccatgattttcagttttcttgccatattccatgtcttacagtggacatttttaaatttttcacatttttttaagttttcctccccatatttcacgttttaaagtgtgcatttctcattttcggtgattttcagttttctcgccagattccatgtcttacagtgtgcatttctcattttttcacgtttttcagtgatttcgtcatttttcaagtcgtcaagtggatgtttctcattttccatgattttcagttttcttgccatattccatgtcctacagtggaaatttctaaattttccacctttttcagttttccttgccatatttcaggtcctaaagtgtgtatttctcattttctgtgattttcagttttctcgccatattccaggtcctacagttgacatttctaaaatttccacattttttaagttttcctcgccatatttcacttcctaaagtgtgtatttctcattttccgtgattttcagttttctcgccatattccagatcctacagtgtacatttttcatttttcacgtttttcagtgattttgtcattttttagttgtcaactgcctgtttctcattttccatgattttcagttttcttgctatattccatgtcctacagtggaaatttctaaattttccacctttttcagttttcctcgccatatttcacgtcctaaagtgtgtatttctcattttccgtgattttcagttttctcgccatattccaggtcctatgtgtacatttctcatttttcacgtttttcagtgattttgtcatttttcaatttgtcaactgcatgtttctcattttccatgattttcagttttcttgccatattccatgtcctacagtggaaatttctatattttccaactttttcagttttcctcgccatatttcacgtgctaaagtgtgtatttctcatttttcgtgtttttcaggtttctcgccatattccaggtcctacagtgtgcatttctcatttttcacgtttttcagtgattttgtcatttttcaagttgtcaagtggatgtttctcattttccttgattttcagttttcttgccatattccatgtcctacagtggacatttctaaattttccacctttttcagttttccttgccatatttcatgtcctaaagtgtgtatttctcattttcagtgattttcagttttctcgccatattccaggtcctacagtgtgcatttctcattttttcaggtttttcagtgatttcgtcatttttcacgttgtcaagtggatgtttctcattttccatgattttcacttttcttgccatatttcatgtcctaaagtgtgtatttctcattttcagtgattttcagttttctcgctatattccaggtcctacagtgtgcatttctcattttttcacgtttttcagtgatttcgtcatttttcacgttgtcaagtggatgtttctcattttccatgattttcacttttcttgccatatttcatgtcctacaatggacatttctaaattttccacctttttctgttttcctcgccatatttcacatcctaaagtgtgtatttctcattttccgtgattttcagttttcttgccatattccaggtcctacagtgtgcatttctcatttttcacgtttttcagtgatttcgtcatttttcaagttgtcaagtggatgtttctcattttccttgattttcagttttcttgccatattccatgtcctactgtggacatttctaaattttccacctttttcagttttccttgccatatttcatgtcctaaagtgtgtatttctcattttcagtgattttcagttttctcgcaatattccaggtcctacagtgtgcatttctcattttttcaggtttttcagtgatttcgtcatttttcacgttgtcaagtggatgtttctcattttccatgattttcacttttcttgccatatttcatgtcctaaagtgtgtatttctcattttcagtgattttcagttttctgccatattccaggtcctacattgtgcatttctcattttttcacgtttttcagtgatttcgtcatttttcagttttctcgacatattccaggtcctacagtgtgcatttctaattttttcttttttcagtgatttcgtcatttttcaagttgtcaactgcatgtttctcattttccatgattttcagttttcttgccatattccatgtcttacagtggacatttttaaatttttcacatttttttaagttttcctccccatatttcacgttttaaagtgtgcatttctcattttcggtgattttcagttttctcgccagattccaggtcttacagtgtgcatttctcattttttcacgtttttcagtgatttcgtcatttttcaagtcgtcaagtggatgtttctcattttccatgattttcagttttcttgccatattccatgtcctacagtggaaatttctaaattttccacctttttcagttttccttgccatatttcaggtcctaaagtgtgtatttctcattttctgtgattttcagttttctcgccatattccaggtcctacagttgacatttctaaaatttccacattttttaagttttcctcgccatatttcacttcctaaagtgtgtatttctcattttccgtgattttcagttttctcgccatattccagatcctacagtgtgcatttttcatttttcacgtttttcagtgattttgtcattttttagttgtcaactgtctgtttctcattttccatgattttcagttttcttgccatattccatgtcctacactggacatttctaaattttccacctttttctgttttcctcgccatatttcacgtcctaaagtgtgtatttctcattttccgtgattttcagttttcttgccatattccaggtcctacagtgtgcatttctcatttttcacgtttttcagtgattttgtcatttttcaagttgtcaactgcatgtttctcattttctatgattttcagttttcttgctatattccatgtcctacagtggaaatttctaaattttccacctttttcagttttcctcgccatatttcacgtcctaaagtgtgtatttctcattttccgtgattttcagttttctcgccatattccaggtcctatgtgtacatttctcatttttcacgtttttcagtgattttgtcatttttcaagttgtgaagtggatgtttctcatttttcttgattttcatttttcttgccatattccatgtcctagagtggaaatttttaaattttccacctttttcagttttcctcgccatatttcacgtcctaaagtgtgaatttctcattttccgtgattttcagatttctcgccatattccaagtcctacagtgtgcatttctcatttttcacgtttttcagtgatttcgtcatttttcaagttgtcaagtggatgtttctcattttccatgattttcagctttcttgccatattcaaagtcctacagtggacatttctaaattttcgacctttatcagttttcctcgccatatttcatgtcccaaagtgtgtacttctcattttccgtgattttcagtttcctagccatattctaggtcctacagtgtgcatttctcatttttcaggtttttcagtgatttcgtcttttttcaagtcgtcaagtggatgtttctcattttccatgattttcacttttcttgccatatttcatgtcctaaagtgtgtatttctcattttcagtgattttcagttttctcgctatattccaggtcctacagtgtgcatttctcattttttcacgtttttcagtgatttcgtcatttttcacgttgtcaagtggatgtttctcattttccatgattttcacttttcttgccatatttcatgtcctacagtggacatttctaaattttccacctttttctgttttcctcgccatatttcacatcctaaagtgtgtatttctcattttccgtgattttcagttttcttgccatattccaggtcctacagtgtgcatttctcatttttcacgtttttcagtgatttcgtcatttttcaagttgtcaagtggatgtttctcattttccttgattttcagttttcttgccatattccatgtcctactgtggacatttctaaattttccacctttttcagttttccttgccatatttcatgtcctaaagtgtgtatttctcattttcagtgattttcagttttctcgcaatattccaggtcctacagtgtgcatttctcattttttcaggtttttcagtgatttcgtcatttttcacgttgtcaagtggatgtttctcattttccatgattttcacttttcttgccatatttcatgtcctaaagtgtgtatttctcattttcagtgattttcagttttctgccatattccaggtcctacattgtgcatttctcattttttcacgtttttcagtgatttcgtcatttttcacgttgtcaagtggatgtttctcattttccatgattttcacttttcttgccatatttcatgttttacagtggacatttctaaattttccacctttttctgttttcctcgccatatttcacatcctaaagtgtgtatttctcattttccgtgattttcagttttctcgccatatgccaggtcatacagggtgcatttctcatttttcacgtttttcagtgatttcgtcatttttcacgtcgtcaagtggatgtttctcattttcaatgattttcatttttcttgccatattccacgtcctatagtggacatttctaaattttccacctttttcagttttccttgccatatttcaggtcctacagtgtgcatttctcatttttcacgtttttcagtgatttcgtcatttttcaagtggtcaagtgcatgtttctcattttccgtgattttcagttttcttgccatgttccaggtcctacagttgacgtttctaaaatttcactttttttaagttttcctcgccatatttcacttcctaaagtgtgtatttctcattttccgtgattttcagttttctcgccagattccaggtcctacagtgtgcatttttcatatttcacctttttcagtgattttgtcatttttcaagttgtcaactgcatgtttctcattttccatgattttcagttttcttgccatattccatgtcctactgtggacatttctaaattttccaactttttcagttttcctcgccatatttcatgtcctaaagtgtgtatttctcattttcagtgattttctgttttctcgccatattccaggtcctacagtgtgcatttctaatttttcacgtttttcagtgatttcgtcatttttcaagttgtcaagtggatgtttctcattttccatgattttcagttttcttgccatattccatgtcctacagtggacatttctaaattttccaactttttccattttcctcaccatatttcacgtcctaaagtgtgtttttctcattttttgtgattttcagttttctcgacatattccaggtcctacagtgtgcatttctaattttttcttttttcagtgatttcgtcatttttcaagttgtcaactgcatgtttctcattttccatgattttcagttttcttgccatattccatgtcttacagtggacatttttaaatttttcacatttttttaagttttcctccccatatttcacgttttaaagtgtgcatttctcattttcggtgattttcagttttctcgccagattccaggtcttacagtgtgcatttctcattttttcacgtttttcagtgatttcgtcatttttcaagtcgtcaagtggatgtttctcattttccatgattttcagttttcttgccatattccatgtcctacagtggaaatttctaaattttccacctttttcagttttccttgccatatttcaggtcctaaagtgtgtatttctcattttctgtgattttcagttttctcgccatattccaggtcctacagttgacatttctaaaatttccacattttttaagttttcctcgccatatttcacttcctaaagtgtgtatttctcattttccgtgattttcagttttctcgccatattccagatcctacagtgtgcatttttcatttttcacgtttttcagtgattttgtcattttttagttgtcaactgtctgtttctcattttccatgattttcagttttcttgccatattccatgtcctacactggacatttctaaattttccacctttttctgttttcctcgccatatttcacgtcctaaagtgtgtatttctcattttccgtgattttcagttttcttgccatattccaggtcctacagtgtgcatttctcatttttcacgtttttcagtgattttgtcatttttcaagttgtcaactgcatgtttctcattttccatgattttcagttttcttgctatattccatgtcctacagtggaaatttctaaattttccacctttttcagttttcctcgccatatttcacgtcctaaagtgtgtatttctcattttccgtgattttcagttttctcgccatattccaggtcctatgtgtacatttctcatttttcacgtttttcagtgattttgtcatttttcaagttgtgaagtggatgtttctcatttttcttgattttcatttttcttgccatattccatgtcctagagtggaaatttttaaattttccacctttttcagttttcctcgccatatttcacgtcctaaagtgtgaatttctcattttccgtgattttcagatttctcgccatattccaagtcctacagtgtgcatttctcatttttcacgtttttcagtgatttcgtcatttttcaagttgtcaagtggatgtttctcattttccatgattttcagctttcttgccatattcaaagtcctacagtggacatttctaaattttcgacctttatcagttttcctcgccatatttcatgtcccaaagtgtgtacttctcattttccgtgattttcagtttcctcgccatattctaggtcctacagtgtgcatttctcatttttcaggtttttcagtgatttcgtcttttttcaagtcgtcaagtggatgtttctcattttccatgattttcagttttcttgccatattccatgtcctacagtggacatttctaaattttccacctttttcagttttcctcgccatatttcatgtcctaaagtgtgtatttctcattttcagtgattttcagttttctcgccatattccaggtcctacagtgtgcatttctcatttttcacgtttttcagtgatttcgtcatttttcaagttgtcaagtggatgtttctcattttccatgattttcagttttcttgccatattccatgtcccacagtggacatttctaaattttccacctttttctgttttccttgccatatttcatgtcctaaagtgtgtatttctcattttccgtgattttcagttttcttgctatattccaagtcctacagtgtgcatttctcatttttcacgtttttcagtgattttgtcatttttcaatttgtcaactgcatgtttctcattttccatgattttcagttttcttgccatattccatgtcctacagtggaaatttctatattttccaactttttcagttttcctcgccatatttcacgtgctaaagtgtgtatttctcatttttcgtgtttttcaggtttctcgccatattccaggtcctacagtgtgcatttctcatttttcacgtttttcagtgattttgtcatttttcaagttgtcaagtggatgtttctcattttccttgattttcagttttcttgccatattccatgtcctacagtggacatttctaaattttccacctttttcagttttccttgccatatttcatgtcctaaagtgtgtatttctcattttcagtgattttcagttttctcgccatattccaggtcctacagtgtgcatttctcattttttcaggtttttcagtgatttcgtcatttttcacgttgtcaagtggatgtttctcattttccatgattttcacttttcttgccatatttcatgtcctaaagtgtgtatttctcattttcagtgattttcagttttctcgctatattccaggtcctacagtgtgcatttctcattttttcacgtttttcagtgatttcgtcatttttcacgttgtcaagtggatgtttctcattttccatgattttcacttttcttgccatatttcatgtcctacagtggacatttctaaattttccacctttttctgttttcctcgccatatttcacatactaaagtgtgtatttctcattttccttgattttcagttttcttgccatattccaggtcctacagtgtgcatttctcatttttcacgtttttcagtgatttcgtcatttttcaagtcgtcaagtggatgtttctcattttccatgattttcagttttctcgccatattccaggtcctacagttgacatttctaaattttccacattttttaagtttcctcgcgatatttcacatcctaaagtgtgtatttctcattttccgtgattttcagttttcttgccatattccaggtcctacagggtgcatttctcatttttcacgtttttcagtgatttcatcaatttcaagtcgtcaactgtatgtttctcattttcaatgattttcatttttcttgccatattccatgtcctacagtggacatttctaaatttttcacctttttcagttttccttgccatatttcatgtcctaaagtgtgtatttctcattttcagtgattttcagttttctcgccatattccaggtcctacagtgtgcatttctcattttttcaggtttttcagtgatttcgtcatttttcacgttgtcaagtggatgtttctcattttccatgattttcacttttcttgccatatttcatgtcctaaagtgtgtatttctcattttcagtgattttcagttttctcgccatattccaggtcctacagtgtgcatttctcatttttcacgtttttcagtgatttcgtcatttttcaagttgtcaagtggatgtttctcattttccatgattttcacttttcttgccatattccatgtcccacagtggacatttctaaattttccacctttttctgttttcctcgccatatttcatgtcctaaagtgtgtatttctcattttccgtgattttcagttttcttgctatattccaagtcctacagtgtgcatttctcatttttcacgtttttcagtgattttgtcatttttcaatttgtcaactgcatgtttctcattttccatgattttcagttttcttgccatattccatgttctacagtggaaatttctatattttccaactttttcagttttcctcgccatatttcacgtgctaaagtgtgtatttctcatttttcgtgtttttcaggtttctcgccatattccaggtcctacagtgtgcatttctcatttttcacgtttttcagtgattttgtcatttttcaagttgtcaagtggatgtttctcattttccttgattttcagttttcttgccatattccatgtcctacagtggacatttctaaattttccacctttttcagttttccttgccatatttcatgtcctaaagtgtgtatttctcattttcagtgattttcagttttctcgccatattccaggtcctacagtgtgcatttctcattttttcaggtttttcagtgatttcgtcatttttcacgttgtcaagtggatgtttctcattttccatgattttcacttttcttgccatatttcatgtcctaaagtgtgtatttctcattttcagtgattttcagttttctcgctatattccaggtcctacagtgtgcatttctcattttttcacgttttgcagtgatttcgtcatttttcacgttgtcaagtggatgtttctcattttccatgattttcacttttcttgccatatttcatgtcctacagtggacatttctaaattttccacctttttctgttttcctcgccatatttcacatcctaaagtgtgtatttctcattttccgtgattttcagttttcttgccatattccaggtcctacagtgtgcatttctcatttttcacgtttttcagtgatttcgtcatttttcaagtcgtcaagtggatgtttctcattttccatgattttcagttttctcgccatattccaggtcctacagttgacatttctaaattttccacattttttaagtttcctcgcgatatttcacatcctaaagtgtgtatttctcattttccgtgattttcagttttcttgccatattccaggtcctacagggtgcatttctcatttttcacgtttttcagtgatttcatcaatttcaagtcgtcaactgtatgtttctcattttcaatgattttcatttttcttgccatattccatgtcctacagtggacatttctaaattttccacctttttcagttttccttgccatatttcatgtcctaaagtgtgtatttctcattttcagggattttcagttttctcgccatattccaggtcctacagtgtgcatttctcattttttcaggtttttcagtgatttcgtcatttttcacgttgtcaagtggatgtttctcattttccatgattttcacttttcttgccatatttcatgtcctaaagtgtgtatttctcattttcagtgattttcagttttctcgccatattccaggtcctacagtgtgcatttctcattttttcacgtttttcagtgatttcgtcatttttcacgttgtcaagtggatgtttctcattttccatgattttcacttttcttgccatatttcatgtcctacagtggacatttctaaattttccacctttttctgttttcctcgccatatttcacatcctaaagtgtgtatttctcattttccgtgattttcagttttcttgccatattccaggtcctacagtgtgcatttctcatttttcacgtttttcagtgatttcgtcatttttcaagtcgtcaagtggatgtttctcattttccatgattttcagttttctcgccatattccaggtcctacagttgacatttctaaattttccacattttttaagtttcctcgcgatatttcacatcctaaagtgtgtatttctcattttccgtgattttcagttttcttgccatattccaggtcctacagggtgcatttctcatttttcacgtttttcagtgatttcatcaatttcaagtcgtcaactgtatgtttctcattttcaatgattttcatttttcttgccatattccacgtcctatagtggacatttctaaattttccacctttttcagttttcttcgccatatttcacgtcccaaagtgtgtatttctcattttccgtgattttcagtttcctcgcaatattccaggtcctacagtgtgcatttctcatttttcacgtttttcagtgatttcgtcttttttcaagtcgtcaagtggatgtttctcattttccatgattttcagttttcttgccatattccatgtcctacagtggacatttctaaattttccacctttttctgttttcctcgccatatttcacgtcctaaagtgtgtatttctcattttccgtgattttcagttttcttgccatattccaggtcctacagtgtgcatttctcatttttcacgtttttcactgattttgtcattgttcaagttgtcaactgcatgtttctcattttccatgattttcaattttcttgccatattccatgtcctacagtggaaatttctatattttccaactttttcagttttcctcgccatatttcacgtgctaaagtgtgtatttctcatttttcgtgtttttcaggtttctcgccatattccaggtcctacagtgtgcatttctcatttttcacgtttttcagtgattttgtcatttttcaagttgtcaagtggttgtttctcattttccttgattttcagttttcttgccatattccatgtcctactgtggacatttctaaattttccacctttttcagttttccttgccatatttcatgtcctaaagtgtgtatttctcattttcagtgattttcagttttctcgcaatattccaggtcctacagtgtgcatttctcattttccgtgattttcagttttctcgccatatgccaggtcatacagggtgcatttctcatttttcacgtttttcagtgatttcgtcatttttcacgtcgtcaagtggatgtttctcattttcaatgattttcatttttcttgccatattccacgtcctatagtggacatttctaaattttccaactttttcagttttcttgccatatttcaggtcctacagtgtgcatttctcatttttcacgtttttcagtgatttcgtcatttttcaagtggtcaagtgcatgtttctgattttccgtgattttcagttttcttgccatgttccaggtcctacagttgacgtttctaaaatttcactttttttaagttttcctcgccatatttcacttcctaaagtgtgtatttctcattttccgtgattttcagttttctcgccagattccaggtcctacagtgtgcatttttcatatttcacctttttcagtgattttgtcatttttcaagttgtcaactgcatgtttctcattttccatgattttcagttttcttgccatattccatgtcctactgtggacatttctaaattttccaactttttcagttttcctcgccatatttcatgtcctaaagtgtgtatttctcattttcagtgtttttctgttttctcgccatattccaggtcctacagtgtgcatttctaatttttcacgtttttcagtgatttcgtcatttttcaagttgtcaagtggatgtttctcattttccatgattttcagttttcttgccatattccatgtcctacagtggacatttctaaattttccaactttttccattttcctcaccatatttcacgtcctaaagtgtgtttttctcattttttgtgattttcagttttctcgacatattccaggtcctacagtgtgcatttctaattttttcttttttcagtgatttcgtcatttttcaagtggtcaagtgcatgtttctcattttccatgattttcagttttcttgccatattccatgtcctacaatggacatttctaaattttccaactttttcagttttcctcgccatatttcacgtcctaaagtgtgtatttctcattttccgtgattttcagttttctcgccatattccaggtcctatgtgtacatttctcatttttcacgtttttcagtgattttgtcatttttcaagttgtgaagtggatgtttctcatttttcttgattttcatttttcttgccatattccatgtcctagagtggaaatttttaaattttccaactttttcagttttcctcgccatatttcacgtcctaaagtgtgtatttctcattttccgtgattttcagttttctcgccatattccaagtcctacagtgtgcatttctcatttttcacgtttttcagtgatttcgtcatttttcaagttgtcaagtggatgtttctcattttccatgattttcagctttcttgccatattcaaagtcctacagtggacatttctaaattttcgacctttatcagttttcctcgccatatttcatgtcccaaagtgtgtacttctcattttccgtgattttcagtttcctcgccatattctaggtcctacagtgtgcatttctcatttttcaggtttttcagtgatttcgtcttttttcaagtcgtcaagtggatgtttctcattttccatgattttcagttttcttgccatattccatgtcctacagtggacatttctaaattttccacctttttcagttttcctcgccatatttcatgtcctaaagtgtgtatttctcattttcagtgattttcagttttctcgccatattccaggtcctacagtgtgcatttctcatttttcacgtttttcagtgatttcgtcatttttcaagttgtcaagtggatgtttctcattttccatgattttcagttttcttgccatattccatgtcccacagtggacatttctaaattttccacctttttctgttttccttgccatatttcatgtcctaaagtgtgtatttctcattttccgtgattttcagttttcttgctatattccaagtcctacagtgtgcatttctcatttttcacgtttttaagtgattttgtcatttttcaatttgtcaactgcatgtttctcattttccatgattttcagttttcttgccatattccatgtcctacagtggaaatttctatattttccaactttttcagttttcctcgccatatttcacgtgctaaagtgtgtatttctcatttttcgtgtttttcaggtttctcgccatattccaggtcctacagtgtgcatttctcatttttcacgtttttcagtgattttgtcatttttcaagttgtcaagtggatgtttctcattttccttgattttcagttttcttgccatattccatgtcctacagtggacatttctaaattttccacctttttcagttttccttgccatatttcatgtcctaaagtgtgtatttctcattttcagtgattttcagttttctcgccatattccaggtcctacagtgtgcatttctcattttttcaggtttttcagtgatttcgtcatttttcacgttgtcaagtggatgtttctcattttccatgattttcacttttcttgccatatttcatgtcctaaagtgtgtatttctcattttcagtgattttcagttttctcgccatattccaggtcctacagtgtgcatttctcattttttcacgtttttcagtgatttcgtcatttttcacgttgtcaagtggatgtttctcattttccatgattttcacttttcttgccatatttcatgtcctacagtggacatttctaaattttccacctttttctgttttcctcgccatatttcacatcctaaagtgtgtatttctcattttccgtgattttcagttttcttgccatatttcaggtcctacagtgtgcatttctcatttttcacgtttttcagtgatttcgtcatttttcaagtcgtcaagaggatgtttctcattttccatgattttcagttttctcgccatattccaggtcctacagttgacatttctaaattttccacattttttaagtttcctcgcgatatttcacatcctaaagtgtgtatttctcattttccgtgattttcagttttcttgccatattccaggtcctacagggtgcatttctcatttttcacgtttttcagtgatttcatcaatttcaagtcgtcaactgtatgtttctcattttcaatgattttcatttttcttgccatattccacgtcctatagtggacatttctaaattttccacctttttctgttttcctcgccatatttcacgtcctaaagtgtgtatttctcattttccgtgattttcagttttcttgccatattccaggtcctacagtgtgcatttctcatttttcacgtttttcactgattttgtcattgttcaagttgtcaactgcatgtttctcattttccatgattttcagttttcttgccatattccatgtcctacagtggaaatttctatattttccacctttttcagttttcctcgccgtatttcatgtgctaaagtgtgtatttctcatttttcgtgtttttcaggtttctcgccatattccaggtcctacagtgtgcatttctcatttttcacgtttttcagtgattttgtcatttttcaagttgtcaactggatgtttctcattttccttgattttcagttttcttgccatattccatgtcctactgtggacatttctaaattttccacctttttcagttttccttgccatatttcatgtcctaaagtgtgtatttctcattttcagtgattttcagttttctcgcaatattccaggtcctacagtgtgcatttctcattttttcaggtttttcagtgatttcgtcatttttcacgttgtcaagtggatgtttctcattttccatgattttcacttttcttgccatatttcatgtcctaaagtgtgtatttctcattttcagtgattttcagttttctcgccatattccaggtcctacattgtgcatttctcattttttcacgtttttcagtgatttcgtcatttttcacgttgtcaagtggatgtttctcattttccatgattttcacttttcttgccatatttcatgttttacagtggacatttctaaattttccacctttttctgttttcctcgccatatttcacatcctaaagtgtgaatttctcattttccgtgattttcagttttcttgccatattccaggtcctacagtgtgcatttctcatttttcacgtttttcagtgatttcatcatttttcaagtcgtcaagtggatgtttctcattttccatgattttcagttttcttgccatattccatgtcctacagtggacatttctaaattttccacctttttctgttttcctcgccatatttcacgtcctaaagtgtgtatttctcattttccgtgattttcagttttcttgccatattccaggtcctacagtgtgcatttctcatttttcacgtttttcactgattttgtcatttttcaagttgtcaactgcatgtttctcattttccatgattttcagttttcttgctatattccatgtcctacagtggaaatttctaaattttccacctttttcagttttcctcgccatatttcacgtcctgaagtgtgtatttctcattttccgtgattttcagttttctcgccatattccaggtcctatgtgtacatttctcatttttcacgtttttcagtgattttgtcatttttcaagttgtgaagtggatgtttctcatttttcttgattttcatttttcttgccatattccatgtcctacagtggaaatttctaaattttccacctttttcagttttcctcgccatatttcacgtcctaaagtgtgtatttctcattttccgtgattttcagttttctcgccatattccaggtcctacagtgtgcatttctcatttttcacgtttttcagtgatttcgacatttttcaagttgtcaagtggatgtttctcattttccatgattttcagctttcttgccatattcaaagtcctacagtggacatttctaaattttcgacctttatcagttttcctcgccatatttcatgtcccaaagtgtgtacttctcattttccgtgattttcagtttcctcgccatattccaggtcctacagtgtgcatttctcatttttcacgtttttcagtgatttcgtcatttttcaagtcgtcaagtggatgtttctcattttccatgattttcagttttcttgccatattccatgtcctacagtggacatttctaaattttccacctttttctgttttcctcgccatatttcacgtcctaaagtgtgtatttctcattttccgtgattttcagttttcttgccatattccaggtcctacagtgtgcatttctcatttatcacgtttttcactgattttgtcatttttcaagttgtcaactgcatgtttctcattttccatgattttcagttttcttgctatattccatgtcctacagtggaatattctaaattttccacctttttcagttttcctcgccatatttcacgtcctgaagtgtgtatttctcattttccgtgattttcagttttctcgccatattccaggtcctatgtgtacatttctcatttttcacgtttttcagtgattttgtcatttttcaagttgtgaagtggatgtttctcatttttcttgattttcatttttcttgccatattccatgtcctacagtggaaatttctaaattttccacctttttcagttttcctcgccatatttcacgtcctaaagtgtgaatttctcattttccgtgattttcagttttctcgccatattccaggtcctacagtgtgcatttctcatttttcacgtttttcagtgatttcgacatttttcaagttgtcaagtggatgtttctcattttccatgattttcagctttcttgccatattcaaagtcctacagtggacatttctaaattttcgacctttatcagttttcctcgccatatttcatgtcccaaagtgtgtacttctcattttccgtgattttgagtttcctcgccatattccaggtcctacagtgtgcatttctcatttttcacgtttttcagtgatttcgtcttttttcaagttgtcaactgcatgtttctcattttccatgattttcagttttcttgccatattccatgtcctacagtggaaatttgtaaatttccacctttttcagttttcctcgccatatttcacgtcctaaagtatgtatttctcattttccgtgattttcagttttctcgccatattccaggtcctacagtgtgcatttctcatttttcacgtttttcagtgattttgtcattttttaagttttcaagtggatgtttctcattttccttgattttcagttttcttgccatattccatgtcctacagtggacatttctaaattttccacctttttcagttttcctcgccatatttcatgtcctaaagtgtgtatttctcattttcagtgattttcagttttctcgccatattccaggtcctacagtgtgcatttctcatttttcacgtttttcagtgatttcgtcatttttcaaggtgtcaagtggatgtttctcattttccatgattttcagttttcttgccatattccatgtcctacagtggacatttctaaattttccacctttttctgttttcctcgccatatttcatgtcctaaagtgtgtatttctcattttccgtgattttcagttttcttgctatattccaagtcctacagtgtgcatttctcatttttcacgtttttcagtgattttgtcatttttcaatttgtcaactgcatgtttctcattttccatgattttcagtttttttgccatattccatgtcctactgtggaaatttctatattttccacctttttcagttttcctcgccatatttcacgtgctaaagtgtgtatttctcatttttcgtgtttttcaggtttctcgccatattccaggtcctacagtgtgcatttctcatttttcacgtttttcagtgattttgtcatttttcaagttttcaagtggatgtttctcattttccttgattttcagttttcttgccatattccatgtcctacagtggacatttctaaattttccacctttttcagttttccttgccatatttcatgtcctaaagtgtgtatttctcattttcagtgattttcagtttccttgccatattccaggtcctacagtgtgcatttctcattttttcacgtttttcagtgatttcgtcatttttcacgttgtcaagtggatgtttctcattttccatgattttcacttttcttgccatatttcatgtcctacagtggacatttctaaattttccaactttttcaattttcctcgccatattttatgtcctaaagtgtgtatttctcatttttcgttattttcagttttcttgccatattccaggtcctacagtgtgcatttgtcatttttcacgtttttcagtgatttcgtcatttttcaagtcgtcaagtagatgtttctcatattccatgtttttcagttttctcgccatattccaggtcctacagttgacatttctaaattttctacatttttaaattttcctcgccatatttcacgtcctaaagtgtgtatttctcattttttgttattttcagttttctagccatattccaggtcctacaggatgcatttctcatttttcacgtttttcagtgatttcatcatttttcaagtcgtcaagtgtatgtttcttattttcaatgattttcatttttcttgccttattccacgtcctatagtggacatttctaaattttccacctttttcagtttttttcgccatatttcacgtcctaaagtgtgtatttctcattttctgtgattttcagttttctcaccatattccaggtcctacagtgtgcatttctcatttttcacgtttttcagtgatttcgtcatttttcaagttgtcaagtggaagtttctcattttccatgattttcagctttctagacatattccaggtcctacagtggacatttcctaattttcgacctttatcagttttcctcgtcatatttcacgtcccaaaatgtgtatttcttattttccatgattttcagtttcctcgccatattccaggtcctacagtgtgcaattctcatttttcacgtttttcagtgatttcgtcttttttcaagacgtcaagtggatgtttctcatttttcatgattttcagttttcttgccatattccatgtcctacagtggacatttctaaattttccacctttttctgttttcctcgccatatttcacgtcctaaagtgtgtatttctcattttccgtgattttcagttttcttgccatattcctggtcctacagtgtgcatttctcatttttcacgtttttcagtgattttgtcatttttcaatttgtcaactgcatgtttctcattttccattattttcagttttcttgccatattccatgtcctacagtggacatttctaaattttccacctttttctgttttcctcgccatatttcatgtcctaaagtgtgtatttctcattttccgtgattttcagttttcttgctatattccaagtcctacagtgtgcatttctcatttttcacgtttttcagtgattttgtcatttttcaatttgtcaactgcatgtttctcattttccatgattttcagtttttttgccatattccatgtcctacaggggaaatttctatattttccacctttttcagttttcctcgccatatttcatgtcctaaagtgtgtatttctcattttccgtgattttcagttttcttgccatattccaggtcctacagtgtgcatttctcatttttcacgtttttcagtgatttcgtcatttttcaagtcttcaagtagatgtttctcatattccatgtttttcagttttctcgccatattccaggtcctacagttgacatttctaaattttctacatttttaaattttcctcgccatatttcacgtcctaaagtgtgtatttctcatttttcgttattttcagttttctagccatattccaggtcctacaggatgcatttctcatttttcacgtttttcagtgatttcatcatttttcaagtcgtcaagtgtatgtttctcattttcaatgattttcatttttcttgccttattccacgtcctatagtggacatttctaaattttccacctttttcagtttttctcgccatatttcacgtcctaaagtgtgtatttctcattttctgtgattttcagttttctcaccatattccaggtcctacagtgtgcatttctcatttttcacgtttttcagtgatttcgtcatttttcaagttgtcaagtggaagtttctcattttccatgattttcagctttctagccatattccaggtcctacagtggacatttcctaattttcgacctttatcagttttcctcgccatatttcacgtcctaaagtgtgtatttctcattttccgtgattttcagttttcttgccatattccaggtcctacagtgtgcatttctcatttttcacgtttttcagtgattttgtcatttttcaatttgtcaactgcatgtttctcattttccatgatttttagttttcttgctatattccatgtcctacagtggaaatttctaaattttccacctttttcagttttcctcgccatatttcacgtcctaaagtgtgtatttctcattttccgtgattttcagttttcttgctatattccaagtcctacattgtgcatttctcatttttcacgtttttcagtgattttgtcatttttcaatttgtcaaaccacatgtttctcattttccatgattttcagtttttttgccatattccatgtcctacagtggaaatttctatattttccacctttttcagttttcctcgccatatttcacgtgctaaagtgtgtatttctcatttttcgtgtttttcaggtttctcgccatattccaggtcctacagtgtgcatttctcatttttcacgtttttcagtgattttgtcatttttcaagttgtcaagtggatgtttcccattttccttgattttcagttttcttaccatattccatgtcctacagtggacatttctaaattttccacctttttcagttttccttgccatatttcatgtcctaaagtgtgtatttctcattttcagtgattttcagtttcctcgccatattccaggtcctacagtgtgcatttctcattttttcacgtttttcagtgatttcgtcatttttcacgttgtcaagtggatgtttctcattttccatgattttcacttttcttgccatatttcatgtcctatagtggacatttctaaattttccacctttttcagtttttctcgccatatttcacgtcctaaagtgtgtatttctcattttctgtgattttcagttttctcaccatattccaggtcctacagtgtgcatttctcatttttcacgtttttcagtgatttcgtcatttttcaagtcgtcaagtagatgtttctcatattccatgtttttcagttttctcgccatattccaggtcctacagttgacatttctaaattttctacatttttaaattttcctcgccatatttcacgtcctaaagtgtgtatttctcatttttcgttattttcagttttctagccatattccaggtcctacaggatgcatttctcatttttcacgtttttcagtgatttcatcatttttcaagtcgtcaagtgtatgtttcttattttcaatgattttcatttttcttgccttattccacgtcctatagtggacatttctaaattttccaccttttttcagtttttctcgccatatttcacgtcctaaagtgtgtatttctcattttctgtgattatcagttttctcaccatattccaggtcctacagtgtgcatttctcatttttcacgtttttcagtgatttcgtcatttttcaagttgtcaagtggaagtttctcattttccatgattttcagctttctagccatattccaggtcctacagtggacatttcctaattttcgacctttatcagttttcctcgccatatttcacgtcccaaaatgtgtatttcttattttccatgattttcagtttcctcgccatattccaggtcctacagtgtgcatttctcatttttcacgtttttcagtgatttcgtcttttttcaagacgtcaagtggatgtttctcatttttcatgattttcagttttcttgccatattccatgtcctacagtggacatttctaaattttccacctttttctgttttcctcgccatatttcacgtcctaaagtgtgtatttctcattttccgtgattttcagttttcttgccatattcctggtcctacagtgtgcatttctcatttttcacgtttttcagtgattttgtcatttttcaatttgtcaactgcatgtttctcattttccatgattttcagttttcttgccatattccatgtcctacagtggacatttctaaattttccacctttttcagttttcctcgccatatttcacgtgctaaagtgtgtatttctcatttttcgtgtttttcaggtttctcgccatattccaggtcctacagtgtgcatttctcatttttcacgtttttcagtgattttgtcatttttcaagttgtcaagtggatgtttctcattttccttgattttcacttttcttgccatattccaagtcttacaggggcatttctcatttttcacgttttcagtgattttgtcattttcaatttgtcaactgcatgtttctcattttccatgattttcagtttttttgccatattccatgtcctacaggggaaatttctatattttccacctttttcagttttcctcgccatatttcatgtcctaaagtgtgtatttctcattttccgtgattttcagttttcttgccatattccaggtcctacagtgtgcatttctcatttttcacgtttttcagtgatttcgtcatttttcaagtcttcaagtagatgtttctcatattccatgtttttcagttttctcgccatattccaggtcctacagttgacatttctaaattttctacatttttaaattttcctcgccatatttcacgtcctaaagtgtgtatttctcatttttcgttattttcagttttctagccatattccaggtcctacaggatgcatttctcatttttcacgtttttcagtgatttcatcatttttcaagtcgtcaagtgtatgtttctcattttcaatgattttcatttttcttgccttattccacgtcctatagtggacatttctaaattttccacctttttcagtttttctcgccatatttcacgtcctaaagtgtgtatttctcattttctgtgattttcagttttctcaccatattccaggtcctacagtgtgcatttctcatttttcacgtttttcagtgatttcgtcatttttcaagttgtcaagtggaagtttctcattttccatgattttcagctttctagccatattccaagtcctacagtggacatttcctaattttcgacctttatcagttttcctcgccatatttcacgtcccaaaatgtgtattccttattttccatgattttcagtttcctcgccatattccaggtcctacagtgtgcatttatcatttttcacgtttttcagtgatttcgtcttttttcaagacgtcaagtggatgtttctcatttttcatgattttcagttttcttgccatattccatgtcctacagtggacatttctaaattttccacctttttctgttttcctcgccatatttcacgtcctaaagtgtgtatttctcattttccgtgattttcagttttcttgccatattcctggtcctacagtgtgcatttctcatttttcacgtttttcagtgattttgtcatttttcaagttgtcaagtggatgtttctcattttccttgattttcacttttcttgccatattccatgtcctacagtggacatttctatattttccacctttttccgttttccttgccatatttcacgtcctaaagtgtgtatttctcattttccgtgattttcaggtttctcgccatattccaggtcctacagtgtgcatttctcatttttcacgtttttcagtgattttgtcatttttcaagttgtcaagtggatgtttctcattttccttgattttcacttttcttgccatattccatgtcctacagtggacatttctaaattttccacctttttcagttttcctcgccatatttcatgtcctaaagtgtgtatttctcattttcagtgattttcagttttcttgccatattccaggtcctacagtgtgcatttctcatttttcacgtttttcagtgattttgtcatttttcaagttgtcaactgcatgtttctcattttctatgattttcagttttcttgctatattccatgtcctacagtggaaatttctaaattttccacctttttcagttttcctcgccatatttcacgtcctaaagtgtgtatttctcattttccgtgattttcagttttctcgccatattccaggtcctatgtgtacatttctcatttttcacgtttttcagtgattttgtcatttttcaagttgtgaagtggatgtttctcatttttcttgattttcatttttcttgccatattccatgtcctagagtggaaatttttaaattttccacctttttcagttttcctcgccatatttcacgtcctaaagtgtgaatttctcattttccgtgattttcagatttctcgccatattccaagtcctacagtgtgcatttctcatttttcacgtttttcagtgatttcgtcatttttcaagttgtcaagtggatgtttctcattttccatgattttcagctttcttgccatattcaaagtcctacagtggacatttctaaattttcgacctttatcagttttcctcgccatatttcatgtcccaaagtgtgtacttctcattttccgtgattttcagtttcctcgccatattctaggtcctacagtgtgcatttctcatttttcaggtttttcagtgatttcgtcttttttcaagtcgtcaagtggatgtttctcattttccatgattttcacttttcttgccatatttcatgtcctaaagtgtgtatttctcattttcagtgattttcagttttctcgctatattccaggtcctacagtgtgcatttctcattttttcacgtttttcagtgatttcgtcatttttcacgttgtcaagtggatgtttctcattttccatgattttcacttttcttgccatatttcatgtcctacagtggacatttctaaattttccacctttttctgttttcctcgccatatttcacatcctaaagtgtgtatttctcattttccgtgattttcagttttcttgccatattccaggtcctacagtgtgcatttctcatttttcacgtttttcagtgatttcgtcatttttcaagttgtcaagtggatgtttctcattttccttgattttcagttttcttgccatattccatgtcctactgtggacatttctaaattttccacctttttcagttttccttgccatatttcatgtcctaaagtgtgtatttctcattttcagtgattttcagttttctcgcaatattccaggtcctacagtgtgcatttctcattttttcaggtttttcagtgatttcgtcatttttcacgttgtcaagtggatgtttctcattttccatgattttcacttttcttgccatatttcatgtcctaaagtgtgtatttctcattttcagtgattttcagttttcctcgccatatttcacgtcccaaaatgtgtatttcttattttccatgattttcagtttcctcgccatattccaggtcctacagtgtgcatttctcatttttcacgtttttcagtgatttcgtcttttttcaagacgtcaagtggatgtttctcatttttcatgattttcagttttcttgccatattccatgtcctacagtggacatttctaaattttccacctttttctgttttcctcgccatatttcacgtcctaaagtgtgtatttctcattttccgtgattttcagttttcttgccatattcctggtcctacagtgtgcatttctcatttttcacgtttttcagtgattttgtcatttttcaatttgtcaactgcatgtttctcattttccatgattttcagttttcttgccatattccatgtcctacagtggacatttctaaattttccacctttttcagttttcctcgccatatttcacgtgctaaagtgtgtatttctcatttttcgtgtttttcaggtttctcgccatattccaggtcctacagtgtgcatttctcatttttcacgtttttcagtgattttgtcatttttcaagttgtcaagtggatgtttctcattttccttgattttcacttttcttgccatattccatgtcctacagtggacatttctaaattttccacctttttcagttttcctcgccatatttcatgtcctaaagtgtgtatttctcattttcagtgattttcagttttctcgccatattccaggtcctacagtgtgcatttctcatttttcacgtttttcagtgatttcgtcttttttcaagacgtcaagtggatgtttctcattttccatgattttcagttttcttgccatattccatgtcctacagtggacatttctaaattttccacctttttctgttttcctcgccatatttcacgtcctaaagtgtgtatttctcattttccgtgattttcagttttcttgccatattccaggtcctacagtgtgcatttctcatttttcacgtttttcagtgattttgtcatttttcaatttgtcaactgcatgtttctcattttccatgatttttagttttcttgctatattccatgtcctacagtggaaatttctaaattttccacctttttcagttttcctcgccatatttcacgtcctaaagtgtgtatttctcattttccgtgattttcagttttcttgctatattccaagtcctacattgtgcatttctcatttttcacgtttttcagtgattttgtcatttttcaatttgtcaaaccacatgtttctcattttccatgattttcagtttttttgccatattccatgtcctacagtggaaatttctatattttccacctttttcagttttcctcgccatatttcacgtgctaaagtgtgtatttctcatttttcgtgtttttcaggtttctcgccatattccaggtcctacagtgtgcatttctcatttttcacgtttttctgtgattttgtcatttttcaagttgtcaagtggatgtttctcattttccttgattttcagttttcttaccatattccatgtcctacagtggacatttctaaattttccaccttttctgttttcctcgccatatttcatgtcctaaagtgtgtatttctcattttccgtgattttcatttttcttgctatattccaagtcctacagtgtgcatttctcattttccatgattttcagttttcttgctatattccatgtcctacagtggaaatttctaaattttccacctttttcagttttcctcgccatatttcacgtcctaaagtgtgtatttctcattttccgtgattttcagttttttcgccatattacaggtcctatgtgtacatttctcatttttcacgtttttcagtgattttgtcatttttcaagttgtcaagtggatgtttctcatttttcttgattttcatttttcttgccatattccatgtcctacagtggaaatttctaaattttccacctttttcagttttcctcgccatatttcacgtcctaaagtgtgaatttctcattttccgtgattttcagttttctcgccatattccaggtctacagtgtgcatttctcatttttcacgttttcagtgattcgtcatttttcaagttgacaagtggatgtttctcattttccatgattttcagctttcttgccatattcaaagtcctacagtggacatttctaaattttcgacctttatcagttttcctcgccatatttcatgtcccaaagtgtgtacttctcattttccgtgattttcagttttcttgccatattccaagtcctacagtgtgcatttctcatttttcacgtttttcagtgattttgtcatttttcaatttgtcaactgcatgtttctcattttccatgattttcagttttcttgccatattccatgtcctacagtggaaatttctatattttccacctttttcagttttcctcgccatatttcacgtgctaaagtgtgtatttctcatttttcgtgtttttcaggtttctcgccatattccaggtcctacagtgtgcatttctcatttttcacgtttttcagtgattttgtcatttttcaagttgtcaagtggatgtttctcattttcaatgattttcatttttcttgccttattccacgtcctatagtggacatttctaaattttccacctttttcagtttttctcgccatatttcacgtcccaaaatgtgtattccttattttccatgattttcagtttcctcgccatattccaggtcctacagtgtgcatttctcatttttcacgtttttcagtgatttcgtcttttttcaagacgtcaagtggatgtttctcatttttcatgattttcagttttcttgccatattccctgtcctacagtggacatttctaaattttccacctttttctgttttcctcgccatatttcacgtcctaaagtgtgtatttctcattttccgtgattttcagttttctcgccagattccaggtcctacagtgtgcatttctcatttttcacgtttttcagtgattttgtcatttttcaatttgtcaactgcatgtttctctctttccatgattttcagttttcttgccatattccatgtcctacagtggacatttctaaattttccacctttttcagttttcctcgccatatttcacgtgctaaagtgtgtatttctcatttttcgtgtttttcaggtttctcgccatattccaggtcctacagtgtgcatttctcatttttcacgtttttcagtgattttgtcatttttcaagttgtcaagtggatgtttctcattttcaatgattttcatttttcttaccttattccacgtcctatagtggacatttctaaattttccacctttttcagtttttctcgccatatttcacgtcccaaaatgtgtattccttattttccatgattttcagtttcctcgccatattccaggtcctacagtgtgcatttctcatttttcacgtttttcagtgatttcgtcttttttcaagacgtcaagtggatgtttctcatttttcatgattttcagttttcttgccatattccctgtcctacagtggacatttctaaattttccacctttttctgttttcctcgccatatttcacgtcctaaagtgtgtatttctcattttccgtgattttcagttttctcgccagattccaggtcctacagtgtgcatttctcatttttcacgtttttcagtgatttcgtcatttttcaagtcttcaagtgtatgtttctcattttcaatgattttcatttttcttgccttattccacgtcctatagtggacatttctaaattttccacctttttcagtttttctcgccatatttcacgtcctaaagtgtgtatttctcattttctgtgattttcagttttcttaccatattccaggtcctacagtgtgcatttctcatttttcacgtttttcagtgatttcgtcatttttcaagttgtcaagtggaagtttctcattttccatgattttcagctttctagccatattccaggtattacagtggacatttccttattttcgacctttatcagttttcctcgccatatttcatgtcctaaagtgtgt	38399	1554	4%	7300	19%
9	3000001	3038400	Atcctacagtgtgcatttctcatttttcacgtttttcagtgatttcgtcatttttcaagtcatcaagtggctgtttctcattttccatgattttcagttttcttgccatattccttgtcctacagtggacatttctaaattttccacctttttcagttttccttgtcatatttcaggtcctacagtgtgtatttctcatttttcacgtttttcattgatttcgtcatttttcaagttgtcaagtgcatgtttctcattttccatgattttcagttttcttgccatattccatgtcctacaatggacatttctaaattttccaactttttcagttttcctcgccatatttcacgtcctaaagtgtgtatttctcattttccgtgattttcagttttctcgacatattccaggtcctacagtgtgcatttctcatttttcacgtttttcagtgatttcgtcatttttcacgtcgtcaagtggatgtttctcattttccatgattttcagttttcttgccatattccatgtcctacagtggacatttctaaattttccacctttttcagttttcctcgccatatttcacgtcctaaagtgtgtatttctcattttccgtgattttcagttttctcgacatattccaggtcttacagggtgcatttctcatttttcacgtttttcagtgatttcatcatttttcaagtcgtcaactgtatgtttctcattttcaatgattttcatttttcttgccatattccacgtcctatagtggacatttctaaattttccacctttttcagttttccttgccatatttcaggtcctacagtgtgcatttctcatttttcacgtttttcagtgatttcgtcatttttcaagtggtcaaatgcatgtttctcattttccatgattttcagttttcttgccatattccatgtcctacagtggacatttctaaattttccacctttttcagttttcctcgccatatttcacgtcctaaagtgtgtatttctcattttccgtgattttcagttttatcgccagattccaggtcctacggtgtgcatttttcatatttcacgtttttcagtgattttgtcatttttcaagttgtcaactgcatgtttctcattttccatgattttcagttttcttgccatattccatgtcctacagtggacatttctaaattttccacctttttcagttttcctcgccatatttcatgtcctaaagtgtgtatttctcattttcagtgattttctgttttctcgccatattccaggtcctacagtgtgcatttctcatttttcacgtttttcagtgatttcgtcatttttcaagttgtcaagtggatgtttctcattttccatgattttcagttttcttgccatattccatgtcctacaatggacatttctaaattttccacctttttcagttttcctcgccatatttcacgtcctaaagtgtgtatttctcattttccgtgattttcagttttctcgccatattccaggtcctatgtgtacatttctcatttttcacgtttttcagtgattttgtcatttttcaagttgtgaagtggatgtttctcatttttcttgattttcatttttcttgccatattccatgtcctagagtggaaatttttaaattttccacctttttcagttttcctcgccatatttcacgtcctaaagtgtgaatttctcattttccgtgattttcagttttctcgccatattccaagtcctacagtgtgcatttctcatttttcacgtttttcagtgatttcgtcatttttcaagttgtcaagtggatgtttctcattttccatgattttcagctttcttgccatattcaaagtcctacagtggacatttctaaattttcgacctttatcagttttcctcgccatatttcatgtcccaaagtgtgtacttctcattttccgtgattttcagtttcctcgccatattctaggtcctacagtgtgcatttctcatttttcaggtttttcagtgatttcgtcttttttcaagtcgtcaagtggatgtttctcattttccatgattttcagttttcttgccatattccatgtcctacagtggacatttctaaattttccaactttttcagttttcctcgccatatttcatgtcctaaagtgtgtatttctcattttcagtgattttcagttttctcgccatattccaggtcctacagtgtgcatttctcatttttcacgtttttcagtgatttcgtcatttttcaagttgtcaagtggatgtttctcatttttcatgattttcagttttcttgccatattccatgtcccacagtggacatttctaaatgttccacctttttctgttttccttgccatatttcatgtcctaaagtgtgtatttctcattttccgtgattttcagttttcttgctatattccaagtcctacagtgtgcatttctcatttttcacgtttttctgtgattttttcatttttcaatttgtcaactgcatgtttctcattttccatgattttcagttttcttgccatattccaggtcctacagtgtgcatttctcatttttcacgtttttcagtgattttgtcatttttcaagttgtcaactgcatgtttctcattttccatgattttcagttttcttgctatattccatgtcctacagtggaaatttctaaattttccacctttttcagttttcctcgccatatttcacgtcctaaagtgtgtatttctcattttccgtgattttcagttttctcgccatattccaggtcctatgtgtacatttctcatttttcacgtttttcagtgattttgtcatttttcaagttgtgaagtggatgtttctcatttttcttgattttcatttttcttgccatattccatgtcctagagtggaaatttttaaattttccacctttttcagttttcctcgccatatttcacgtcctaaattgtgaatttctcattttccgtgattttcagttttctcgccatattccaagtcctacagtgtgcatttctcatttttcacgtttttcagtgatttcgtcatttttcaagttgtcaagtggatgtttctcattttccatgattttcagctttcttgccatattcaaagtcctacagtggacatttctaaattttcgacctttatcagttttcctcgccatatttcatgtcccaaagtgtgtacttctcattttccgtgattttcagtttcctcgccatattctaggtcctacagtgtgcatttctcatttttcaggtttttcagtgatttcgtcttttttcaagtcgtcaagtggatgtttctcattttccatgattttcagttttcttgccatattccatgtcctacagtggacatttctaaattttccacctttttcagttttcctcgccatatttcatgtcctaaagtgtgtatttctcattttcagtgattttcagttttctcgccatattccaggtcctacagtgtgcatttctcatttttcacgtttttcagtgattttgtcatttttcaagttgtcaagtggatgtttctcattttccttgattttcagttttcttgccatattccatgtcctacagtggacatttctaaattttccacctttttcagttttccttgccatatttcatgtcctaaagtgtgtatttctcattttcagtgattttcagttttctcgccatattccaggtcctacagtgtgcatttctcattttttcaggtttttcagtgatttcgtcatttttcacgttgtcaagtggatgtttctcattttccatgattttcacttttcttgccatatttcatgtcctaaagtgtgtatttctcattttcagtgattttcagttttctcgccatattccaggtcctacagtgtgcatttctcattttttcacgtttttcagtgatttcgtcatttttcacgttgtcaagtggatgtttctcattttccattattttcacttttcttgccatatttcatgtcctacagtggacatttctaaattttccacctttttctgttttcctcgccatatttcacatcctaaagtgtgtatttctcattttccgtgattttcagttttcttgccatattccaggtcctacagtgtgcatttctcatttttcacgtttttcagtgatttcgtcatttttcaagtcgtcaagtggatgtttctcattttccatgattttcagttttctcgccatattccaggtcctacagttgacatttctaaattttccacattttttatgtttcctcgcgatatttcacatcctaaagtgtgtatttctcattttccgtgattttcagttttcttgccatattccaggtcctacagggtgcatttctcatttttcacgtttttcagtgatttcatcaatttcaagtcgtcaactgtatgtttctcattttcaatgattttcatttttcttgccatattccacgtcctatagtggacatttctacattttccacctttttcagttttcttcgccatatttcacgtcccaaagtgtgtatttctcattttccgtgattttcagtttcctcgccatattccaggtcctacagtgtgcatttctcatttttcacgtttttcagtgatttcgtcttttttcaagtcgtcaagtggatgtttctcattttccatgattttcagttttcttgccatattccatgtcctacagtggacatttctaaattttccacctttttctgttttcctcgccatatttcacgtcctaaagtgtgtatttctcatttaccgtgattttcagttttcttgctatattccaagtcctacagtgtgcatttctcatttttcacgtttttcactgattttgtcattgttcaagttgtcaactgcatgtttctcattttccatgattttcagttttcttgccatattccatgtcctacagtggaaatttctatattttccaactttttcagttttcctcgccatatttcacgtgctaaagtgtgtatttctcatttttcgtgtttttcaggtttctcgccatattccaggtcctacagtgtgcatttctcatttttcacgtttttcagtgattttgtaatttttcaagttgtcaagtggatgtttctcattttccttgattttcagttttcttgccatattccatgtcctactgtggacatttctaaattttccacctttttcagttttccttgccatatttcatgtcctaaagtgtgtatttctcattttcagtgattttcagttttctcgcaatattccaggtcctacagtgtgcatttctcattttttcaggtttttcagtgatttcgtcatttttcacgttgtcaagtggatgtttctcattttccatgattttcacttttcttgccatatttcatgtgctaaagtgtgtatttctcattttcagtgattttcagttttctgccatattccaggtcctacattgtgcatttctcattttttcacgtttttcagtgatttcgtcatttttcacgttgtcaagtggatgtttctcattttccatgattttcacttttcttgccatatttcatgttttacagtggacatttctaaattttccacctatttctgttttcctcgccatatttcacatcctaaagtgtgtatttctcattttccgtgattttcagttttctcgccatatgccaggtcatacagggtgcatttctcatttttcacgtttttcagtgatttcgtcatttttcacgtcgtcaagtggatgtttctcattttcaatgattttcatttttcttgccatattccacgtcctatagtggacatttctaaattttccacctttttcagttttccttgccatatttcaggtcctacagtgtgcatttctcttttttcacgtttttcagtgatttcgtcatttttcaagtggtcaagtgcatgtttctcattttccgtgattttcagttttcttgccatgttccaggtcctacagttgacgtttctaaaatttcactttttttaagttttcctcgccatatttcacttcctaaagtgtgtatttctcattttccgtgattttcagttttctcgccagattccaggtcctacagtgtgcatttttcatatttcacctttttcagtgattttgtcatttttcaagttgtcaactgcatgtttctcattttccatgattttcagttttcttgccatattccatgtcctactgtggacatttctaaattttccaactttttcagttttcctcgccatatttcatgtcctaaagtgtgtatttctcattttcagtgattttctgttttctcgccatattccaggtcctacagtgtgcatttctaatttttcacgtttttcagtgatttcgtcatttttcaagttgtcaagtggatgtttctcattttccatgattttcagttttcttgccatattccatgtcctacagtggacatttctaaattttccaactttttccattttcctcaccatatttcacgtcctaaagtgagtttttctcattttttgtgattttcagttttctcgacatattccaggtcctacagtgtgcatttctaattttttcttttttcagtgatttcgtcatttttcaagtggtcaagtgcatgtttctcattttccatgattttcagttttcttgccatattccatgtcctacaatggacatttctaaattttccaactttttcagttttcctcgccatatttcacgtcctaaagtgtgtatttctcattttccgtgattttcagttttctcgccatattccaggtcctacagtgtgcatttctcatttttcacgtttttcagtgatttcgtcatttttcaagttgtcaactgcatgtttctcattttccatgattttcagttttcttgccatattccatgtcttacagtggacatttttaaatttttcacatttttttaagttttcctccccatatttcacgttttaaagtgtgcatttctcattttcggtgattttcagttttctcgccagattccatgtcttacagtgtgcatttctcattttttcacgtttttcagtgatttcgtcatttttcaagtcgtcaagtggatgtttctcattttccatgattttcagttttcttgccatattccatgtcctacagtggaaatttctaaattttccacctttttcagttttccttgccatatttcaggtcctaaagtgtgtatttctcattttctgtgattttcagttttctcgccatattccaggtcctacagttgacatttctaaaatttccacattttttaagttttcctcgccatatttcacttcctaaagtgtgtatttctcattttccgtgattttcagttttctcgccatattccagatcctacagtgtacatttttcatttttcacgtttttcagtgattttgtcattttttagttgtcaactgcctgtttctcattttccatgattttcagttttcttgctatattccatgtcctacagtggaaatttctaaattttccacctttttcagttttcctcgccatatttcacgtcctaaagtgtgtatttctcattttccgtgattttcagttttctcgccatattccaggtcctatgtgtacatttctcatttttcacgtttttcagtgattttgtcatttttcaatttgtcaactgcatgtttctcattttccatgattttcagttttcttgccatattccatgtcctacagtggaaatttctatattttccaactttttcagttttcctcgccatatttcacgtgctaaagtgtgtatttctcatttttcgtgtttttcaggtttctcgccatattccaggtcctacagtgtgcatttctcatttttcacgtttttcagtgattttgtcatttttcaagttgtcaagtggatgtttctcattttccttgattttcagttttcttgccatattccatgtcctacagtggacatttctaaattttccacctttttcagttttccttgccatatttcatgtcctaaagtgtgtatttctcattttcagtgattttcagttttctcgccatattccaggtcctacagtgtgcatttctcattttttcaggtttttcagtgatttcgtcatttttcacgttgtcaagtggatgtttctcattttccatgattttcacttttcttgccatatttcatgtcctaaagtgtgtatttctcattttcagtgattttcagttttctcgctatattccaggtcctacagtgtgcatttctcattttttcacgtttttcagtgatttcgtcatttttcacgttgtcaagtggatgtttctcattttccatgattttcacttttcttgccatatttcatgtcctacaatggacatttctaaattttccacctttttctgttttcctcgccatatttcacatcctaaagtgtgtatttctcattttccgtgattttcagttttcttgccatattccaggtcctacagtgtgcatttctcatttttcacgtttttcagtgatttcgtcatttttcaagttgtcaagtggatgtttctcattttccttgattttcagttttcttgccatattccatgtcctactgtggacatttctaaattttccacctttttcagttttccttgccatatttcatgtcctaaagtgtgtatttctcattttcagtgattttcagttttctcgcaatattccaggtcctacagtgtgcatttctcattttttcaggtttttcagtgatttcgtcatttttcacgttgtcaagtggatgtttctcattttccatgattttcacttttcttgccatatttcatgtcctaaagtgtgtatttctcattttcagtgattttcagttttctgccatattccaggtcctacattgtgcatttctcattttttcacgtttttcagtgatttcgtcatttttcagttttctcgacatattccaggtcctacagtgtgcatttctaattttttcttttttcagtgatttcgtcatttttcaagttgtcaactgcatgtttctcattttccatgattttcagttttcttgccatattccatgtcttacagtggacatttttaaatttttcacatttttttaagttttcctccccatatttcacgttttaaagtgtgcatttctcattttcggtgattttcagttttctcgccagattccaggtcttacagtgtgcatttctcattttttcacgtttttcagtgatttcgtcatttttcaagtcgtcaagtggatgtttctcattttccatgattttcagttttcttgccatattccatgtcctacagtggaaatttctaaattttccacctttttcagttttccttgccatatttcaggtcctaaagtgtgtatttctcattttctgtgattttcagttttctcgccatattccaggtcctacagttgacatttctaaaatttccacattttttaagttttcctcgccatatttcacttcctaaagtgtgtatttctcattttccgtgattttcagttttctcgccatattccagatcctacagtgtgcatttttcatttttcacgtttttcagtgattttgtcattttttagttgtcaactgtctgtttctcattttccatgattttcagttttcttgccatattccatgtcctacactggacatttctaaattttccacctttttctgttttcctcgccatatttcacgtcctaaagtgtgtatttctcattttccgtgattttcagttttcttgccatattccaggtcctacagtgtgcatttctcatttttcacgtttttcagtgattttgtcatttttcaagttgtcaactgcatgtttctcattttctatgattttcagttttcttgctatattccatgtcctacagtggaaatttctaaattttccacctttttcagttttcctcgccatatttcacgtcctaaagtgtgtatttctcattttccgtgattttcagttttctcgccatattccaggtcctatgtgtacatttctcatttttcacgtttttcagtgattttgtcatttttcaagttgtgaagtggatgtttctcatttttcttgattttcatttttcttgccatattccatgtcctagagtggaaatttttaaattttccacctttttcagttttcctcgccatatttcacgtcctaaagtgtgaatttctcattttccgtgattttcagatttctcgccatattccaagtcctacagtgtgcatttctcatttttcacgtttttcagtgatttcgtcatttttcaagttgtcaagtggatgtttctcattttccatgattttcagctttcttgccatattcaaagtcctacagtggacatttctaaattttcgacctttatcagttttcctcgccatatttcatgtcccaaagtgtgtacttctcattttccgtgattttcagtttcctagccatattctaggtcctacagtgtgcatttctcatttttcaggtttttcagtgatttcgtcttttttcaagtcgtcaagtggatgtttctcattttccatgattttcacttttcttgccatatttcatgtcctaaagtgtgtatttctcattttcagtgattttcagttttctcgctatattccaggtcctacagtgtgcatttctcattttttcacgtttttcagtgatttcgtcatttttcacgttgtcaagtggatgtttctcattttccatgattttcacttttcttgccatatttcatgtcctacagtggacatttctaaattttccacctttttctgttttcctcgccatatttcacatcctaaagtgtgtatttctcattttccgtgattttcagttttcttgccatattccaggtcctacagtgtgcatttctcatttttcacgtttttcagtgatttcgtcatttttcaagttgtcaagtggatgtttctcattttccttgattttcagttttcttgccatattccatgtcctactgtggacatttctaaattttccacctttttcagttttccttgccatatttcatgtcctaaagtgtgtatttctcattttcagtgattttcagttttctcgcaatattccaggtcctacagtgtgcatttctcattttttcaggtttttcagtgatttcgtcatttttcacgttgtcaagtggatgtttctcattttccatgattttcacttttcttgccatatttcatgtcctaaagtgtgtatttctcattttcagtgattttcagttttctgccatattccaggtcctacattgtgcatttctcattttttcacgtttttcagtgatttcgtcatttttcacgttgtcaagtggatgtttctcattttccatgattttcacttttcttgccatatttcatgttttacagtggacatttctaaattttccacctttttctgttttcctcgccatatttcacatcctaaagtgtgtatttctcattttccgtgattttcagttttctcgccatatgccaggtcatacagggtgcatttctcatttttcacgtttttcagtgatttcgtcatttttcacgtcgtcaagtggatgtttctcattttcaatgattttcatttttcttgccatattccacgtcctatagtggacatttctaaattttccacctttttcagttttccttgccatatttcaggtcctacagtgtgcatttctcatttttcacgtttttcagtgatttcgtcatttttcaagtggtcaagtgcatgtttctcattttccgtgattttcagttttcttgccatgttccaggtcctacagttgacgtttctaaaatttcactttttttaagttttcctcgccatatttcacttcctaaagtgtgtatttctcattttccgtgattttcagttttctcgccagattccaggtcctacagtgtgcatttttcatatttcacctttttcagtgattttgtcatttttcaagttgtcaactgcatgtttctcattttccatgattttcagttttcttgccatattccatgtcctactgtggacatttctaaattttccaactttttcagttttcctcgccatatttcatgtcctaaagtgtgtatttctcattttcagtgattttctgttttctcgccatattccaggtcctacagtgtgcatttctaatttttcacgtttttcagtgatttcgtcatttttcaagttgtcaagtggatgtttctcattttccatgattttcagttttcttgccatattccatgtcctacagtggacatttctaaattttccaactttttccattttcctcaccatatttcacgtcctaaagtgtgtttttctcattttttgtgattttcagttttctcgacatattccaggtcctacagtgtgcatttctaattttttcttttttcagtgatttcgtcatttttcaagttgtcaactgcatgtttctcattttccatgattttcagttttcttgccatattccatgtcttacagtggacatttttaaatttttcacatttttttaagttttcctccccatatttcacgttttaaagtgtgcatttctcattttcggtgattttcagttttctcgccagattccaggtcttacagtgtgcatttctcattttttcacgtttttcagtgatttcgtcatttttcaagtcgtcaagtggatgtttctcattttccatgattttcagttttcttgccatattccatgtcctacagtggaaatttctaaattttccacctttttcagttttccttgccatatttcaggtcctaaagtgtgtatttctcattttctgtgattttcagttttctcgccatattccaggtcctacagttgacatttctaaaatttccacattttttaagttttcctcgccatatttcacttcctaaagtgtgtatttctcattttccgtgattttcagttttctcgccatattccagatcctacagtgtgcatttttcatttttcacgtttttcagtgattttgtcattttttagttgtcaactgtctgtttctcattttccatgattttcagttttcttgccatattccatgtcctacactggacatttctaaattttccacctttttctgttttcctcgccatatttcacgtcctaaagtgtgtatttctcattttccgtgattttcagttttcttgccatattccaggtcctacagtgtgcatttctcatttttcacgtttttcagtgattttgtcatttttcaagttgtcaactgcatgtttctcattttccatgattttcagttttcttgctatattccatgtcctacagtggaaatttctaaattttccacctttttcagttttcctcgccatatttcacgtcctaaagtgtgtatttctcattttccgtgattttcagttttctcgccatattccaggtcctatgtgtacatttctcatttttcacgtttttcagtgattttgtcatttttcaagttgtgaagtggatgtttctcatttttcttgattttcatttttcttgccatattccatgtcctagagtggaaatttttaaattttccacctttttcagttttcctcgccatatttcacgtcctaaagtgtgaatttctcattttccgtgattttcagatttctcgccatattccaagtcctacagtgtgcatttctcatttttcacgtttttcagtgatttcgtcatttttcaagttgtcaagtggatgtttctcattttccatgattttcagctttcttgccatattcaaagtcctacagtggacatttctaaattttcgacctttatcagttttcctcgccatatttcatgtcccaaagtgtgtacttctcattttccgtgattttcagtttcctcgccatattctaggtcctacagtgtgcatttctcatttttcaggtttttcagtgatttcgtcttttttcaagtcgtcaagtggatgtttctcattttccatgattttcagttttcttgccatattccatgtcctacagtggacatttctaaattttccacctttttcagttttcctcgccatatttcatgtcctaaagtgtgtatttctcattttcagtgattttcagttttctcgccatattccaggtcctacagtgtgcatttctcatttttcacgtttttcagtgatttcgtcatttttcaagttgtcaagtggatgtttctcattttccatgattttcagttttcttgccatattccatgtcccacagtggacatttctaaattttccacctttttctgttttccttgccatatttcatgtcctaaagtgtgtatttctcattttccgtgattttcagttttcttgctatattccaagtcctacagtgtgcatttctcatttttcacgtttttcagtgattttgtcatttttcaatttgtcaactgcatgtttctcattttccatgattttcagttttcttgccatattccatgtcctacagtggaaatttctatattttccaactttttcagttttcctcgccatatttcacgtgctaaagtgtgtatttctcatttttcgtgtttttcaggtttctcgccatattccaggtcctacagtgtgcatttctcatttttcacgtttttcagtgattttgtcatttttcaagttgtcaagtggatgtttctcattttccttgattttcagttttcttgccatattccatgtcctacagtggacatttctaaattttccacctttttcagttttccttgccatatttcatgtcctaaagtgtgtatttctcattttcagtgattttcagttttctcgccatattccaggtcctacagtgtgcatttctcattttttcaggtttttcagtgatttcgtcatttttcacgttgtcaagtggatgtttctcattttccatgattttcacttttcttgccatatttcatgtcctaaagtgtgtatttctcattttcagtgattttcagttttctcgctatattccaggtcctacagtgtgcatttctcattttttcacgtttttcagtgatttcgtcatttttcacgttgtcaagtggatgtttctcattttccatgattttcacttttcttgccatatttcatgtcctacagtggacatttctaaattttccacctttttctgttttcctcgccatatttcacatactaaagtgtgtatttctcattttccttgattttcagttttcttgccatattccaggtcctacagtgtgcatttctcatttttcacgtttttcagtgatttcgtcatttttcaagtcgtcaagtggatgtttctcattttccatgattttcagttttctcgccatattccaggtcctacagttgacatttctaaattttccacattttttaagtttcctcgcgatatttcacatcctaaagtgtgtatttctcattttccgtgattttcagttttcttgccatattccaggtcctacagggtgcatttctcatttttcacgtttttcagtgatttcatcaatttcaagtcgtcaactgtatgtttctcattttcaatgattttcatttttcttgccatattccatgtcctacagtggacatttctaaatttttcacctttttcagttttccttgccatatttcatgtcctaaagtgtgtatttctcattttcagtgattttcagttttctcgccatattccaggtcctacagtgtgcatttctcattttttcaggtttttcagtgatttcgtcatttttcacgttgtcaagtggatgtttctcattttccatgattttcacttttcttgccatatttcatgtcctaaagtgtgtatttctcattttcagtgattttcagttttctcgccatattccaggtcctacagtgtgcatttctcatttttcacgtttttcagtgatttcgtcatttttcaagttgtcaagtggatgtttctcattttccatgattttcacttttcttgccatattccatgtcccacagtggacatttctaaattttccacctttttctgttttcctcgccatatttcatgtcctaaagtgtgtatttctcattttccgtgattttcagttttcttgctatattccaagtcctacagtgtgcatttctcatttttcacgtttttcagtgattttgtcatttttcaatttgtcaactgcatgtttctcattttccatgattttcagttttcttgccatattccatgttctacagtggaaatttctatattttccaactttttcagttttcctcgccatatttcacgtgctaaagtgtgtatttctcatttttcgtgtttttcaggtttctcgccatattccaggtcctacagtgtgcatttctcatttttcacgtttttcagtgattttgtcatttttcaagttgtcaagtggatgtttctcattttccttgattttcagttttcttgccatattccatgtcctacagtggacatttctaaattttccacctttttcagttttccttgccatatttcatgtcctaaagtgtgtatttctcattttcagtgattttcagttttctcgccatattccaggtcctacagtgtgcatttctcattttttcaggtttttcagtgatttcgtcatttttcacgttgtcaagtggatgtttctcattttccatgattttcacttttcttgccatatttcatgtcctaaagtgtgtatttctcattttcagtgattttcagttttctcgctatattccaggtcctacagtgtgcatttctcattttttcacgttttgcagtgatttcgtcatttttcacgttgtcaagtggatgtttctcattttccatgattttcacttttcttgccatatttcatgtcctacagtggacatttctaaattttccacctttttctgttttcctcgccatatttcacatcctaaagtgtgtatttctcattttccgtgattttcagttttcttgccatattccaggtcctacagtgtgcatttctcatttttcacgtttttcagtgatttcgtcatttttcaagtcgtcaagtggatgtttctcattttccatgattttcagttttctcgccatattccaggtcctacagttgacatttctaaattttccacattttttaagtttcctcgcgatatttcacatcctaaagtgtgtatttctcattttccgtgattttcagttttcttgccatattccaggtcctacagggtgcatttctcatttttcacgtttttcagtgatttcatcaatttcaagtcgtcaactgtatgtttctcattttcaatgattttcatttttcttgccatattccatgtcctacagtggacatttctaaattttccacctttttcagttttccttgccatatttcatgtcctaaagtgtgtatttctcattttcagggattttcagttttctcgccatattccaggtcctacagtgtgcatttctcattttttcaggtttttcagtgatttcgtcatttttcacgttgtcaagtggatgtttctcattttccatgattttcacttttcttgccatatttcatgtcctaaagtgtgtatttctcattttcagtgattttcagttttctcgccatattccaggtcctacagtgtgcatttctcattttttcacgtttttcagtgatttcgtcatttttcacgttgtcaagtggatgtttctcattttccatgattttcacttttcttgccatatttcatgtcctacagtggacatttctaaattttccacctttttctgttttcctcgccatatttcacatcctaaagtgtgtatttctcattttccgtgattttcagttttcttgccatattccaggtcctacagtgtgcatttctcatttttcacgtttttcagtgatttcgtcatttttcaagtcgtcaagtggatgtttctcattttccatgattttcagttttctcgccatattccaggtcctacagttgacatttctaaattttccacattttttaagtttcctcgcgatatttcacatcctaaagtgtgtatttctcattttccgtgattttcagttttcttgccatattccaggtcctacagggtgcatttctcatttttcacgtttttcagtgatttcatcaatttcaagtcgtcaactgtatgtttctcattttcaatgattttcatttttcttgccatattccacgtcctatagtggacatttctaaattttccacctttttcagttttcttcgccatatttcacgtcccaaagtgtgtatttctcattttccgtgattttcagtttcctcgcaatattccaggtcctacagtgtgcatttctcatttttcacgtttttcagtgatttcgtcttttttcaagtcgtcaagtggatgtttctcattttccatgattttcagttttcttgccatattccatgtcctacagtggacatttctaaattttccacctttttctgttttcctcgccatatttcacgtcctaaagtgtgtatttctcattttccgtgattttcagttttcttgccatattccaggtcctacagtgtgcatttctcatttttcacgtttttcactgattttgtcattgttcaagttgtcaactgcatgtttctcattttccatgattttcaattttcttgccatattccatgtcctacagtggaaatttctatattttccaactttttcagttttcctcgccatatttcacgtgctaaagtgtgtatttctcatttttcgtgtttttcaggtttctcgccatattccaggtcctacagtgtgcatttctcatttttcacgtttttcagtgattttgtcatttttcaagttgtcaagtggttgtttctcattttccttgattttcagttttcttgccatattccatgtcctactgtggacatttctaaattttccacctttttcagttttccttgccatatttcatgtcctaaagtgtgtatttctcattttcagtgattttcagttttctcgcaatattccaggtcctacagtgtgcatttctcattttccgtgattttcagttttctcgccatatgccaggtcatacagggtgcatttctcatttttcacgtttttcagtgatttcgtcatttttcacgtcgtcaagtggatgtttctcattttcaatgattttcatttttcttgccatattccacgtcctatagtggacatttctaaattttccaactttttcagttttcttgccatatttcaggtcctacagtgtgcatttctcatttttcacgtttttcagtgatttcgtcatttttcaagtggtcaagtgcatgtttctgattttccgtgattttcagttttcttgccatgttccaggtcctacagttgacgtttctaaaatttcactttttttaagttttcctcgccatatttcacttcctaaagtgtgtatttctcattttccgtgattttcagttttctcgccagattccaggtcctacagtgtgcatttttcatatttcacctttttcagtgattttgtcatttttcaagttgtcaactgcatgtttctcattttccatgattttcagttttcttgccatattccatgtcctactgtggacatttctaaattttccaactttttcagttttcctcgccatatttcatgtcctaaagtgtgtatttctcattttcagtgtttttctgttttctcgccatattccaggtcctacagtgtgcatttctaatttttcacgtttttcagtgatttcgtcatttttcaagttgtcaagtggatgtttctcattttccatgattttcagttttcttgccatattccatgtcctacagtggacatttctaaattttccaactttttccattttcctcaccatatttcacgtcctaaagtgtgtttttctcattttttgtgattttcagttttctcgacatattccaggtcctacagtgtgcatttctaattttttcttttttcagtgatttcgtcatttttcaagtggtcaagtgcatgtttctcattttccatgattttcagttttcttgccatattccatgtcctacaatggacatttctaaattttccaactttttcagttttcctcgccatatttcacgtcctaaagtgtgtatttctcattttccgtgattttcagttttctcgccatattccaggtcctatgtgtacatttctcatttttcacgtttttcagtgattttgtcatttttcaagttgtgaagtggatgtttctcatttttcttgattttcatttttcttgccatattccatgtcctagagtggaaatttttaaattttccaactttttcagttttcctcgccatatttcacgtcctaaagtgtgtatttctcattttccgtgattttcagttttctcgccatattccaagtcctacagtgtgcatttctcatttttcacgtttttcagtgatttcgtcatttttcaagttgtcaagtggatgtttctcattttccatgattttcagctttcttgccatattcaaagtcctacagtggacatttctaaattttcgacctttatcagttttcctcgccatatttcatgtcccaaagtgtgtacttctcattttccgtgattttcagtttcctcgccatattctaggtcctacagtgtgcatttctcatttttcaggtttttcagtgatttcgtcttttttcaagtcgtcaagtggatgtttctcattttccatgattttcagttttcttgccatattccatgtcctacagtggacatttctaaattttccacctttttcagttttcctcgccatatttcatgtcctaaagtgtgtatttctcattttcagtgattttcagttttctcgccatattccaggtcctacagtgtgcatttctcatttttcacgtttttcagtgatttcgtcatttttcaagttgtcaagtggatgtttctcattttccatgattttcagttttcttgccatattccatgtcccacagtggacatttctaaattttccacctttttctgttttccttgccatatttcatgtcctaaagtgtgtatttctcattttccgtgattttcagttttcttgctatattccaagtcctacagtgtgcatttctcatttttcacgtttttaagtgattttgtcatttttcaatttgtcaactgcatgtttctcattttccatgattttcagttttcttgccatattccatgtcctacagtggaaatttctatattttccaactttttcagttttcctcgccatatttcacgtgctaaagtgtgtatttctcatttttcgtgtttttcaggtttctcgccatattccaggtcctacagtgtgcatttctcatttttcacgtttttcagtgattttgtcatttttcaagttgtcaagtggatgtttctcattttccttgattttcagttttcttgccatattccatgtcctacagtggacatttctaaattttccacctttttcagttttccttgccatatttcatgtcctaaagtgtgtatttctcattttcagtgattttcagttttctcgccatattccaggtcctacagtgtgcatttctcattttttcaggtttttcagtgatttcgtcatttttcacgttgtcaagtggatgtttctcattttccatgattttcacttttcttgccatatttcatgtcctaaagtgtgtatttctcattttcagtgattttcagttttctcgccatattccaggtcctacagtgtgcatttctcattttttcacgtttttcagtgatttcgtcatttttcacgttgtcaagtggatgtttctcattttccatgattttcacttttcttgccatatttcatgtcctacagtggacatttctaaattttccacctttttctgttttcctcgccatatttcacatcctaaagtgtgtatttctcattttccgtgattttcagttttcttgccatatttcaggtcctacagtgtgcatttctcatttttcacgtttttcagtgatttcgtcatttttcaagtcgtcaagaggatgtttctcattttccatgattttcagttttctcgccatattccaggtcctacagttgacatttctaaattttccacattttttaagtttcctcgcgatatttcacatcctaaagtgtgtatttctcattttccgtgattttcagttttcttgccatattccaggtcctacagggtgcatttctcatttttcacgtttttcagtgatttcatcaatttcaagtcgtcaactgtatgtttctcattttcaatgattttcatttttcttgccatattccacgtcctatagtggacatttctaaattttccacctttttctgttttcctcgccatatttcacgtcctaaagtgtgtatttctcattttccgtgattttcagttttcttgccatattccaggtcctacagtgtgcatttctcatttttcacgtttttcactgattttgtcattgttcaagttgtcaactgcatgtttctcattttccatgattttcagttttcttgccatattccatgtcctacagtggaaatttctatattttccacctttttcagttttcctcgccgtatttcatgtgctaaagtgtgtatttctcatttttcgtgtttttcaggtttctcgccatattccaggtcctacagtgtgcatttctcatttttcacgtttttcagtgattttgtcatttttcaagttgtcaactggatgtttctcattttccttgattttcagttttcttgccatattccatgtcctactgtggacatttctaaattttccacctttttcagttttccttgccatatttcatgtcctaaagtgtgtatttctcattttcagtgattttcagttttctcgcaatattccaggtcctacagtgtgcatttctcattttttcaggtttttcagtgatttcgtcatttttcacgttgtcaagtggatgtttctcattttccatgattttcacttttcttgccatatttcatgtcctaaagtgtgtatttctcattttcagtgattttcagttttctcgccatattccaggtcctacattgtgcatttctcattttttcacgtttttcagtgatttcgtcatttttcacgttgtcaagtggatgtttctcattttccatgattttcacttttcttgccatatttcatgttttacagtggacatttctaaattttccacctttttctgttttcctcgccatatttcacatcctaaagtgtgaatttctcattttccgtgattttcagttttcttgccatattccaggtcctacagtgtgcatttctcatttttcacgtttttcagtgatttcatcatttttcaagtcgtcaagtggatgtttctcattttccatgattttcagttttcttgccatattccatgtcctacagtggacatttctaaattttccacctttttctgttttcctcgccatatttcacgtcctaaagtgtgtatttctcattttccgtgattttcagttttcttgccatattccaggtcctacagtgtgcatttctcatttttcacgtttttcactgattttgtcatttttcaagttgtcaactgcatgtttctcattttccatgattttcagttttcttgctatattccatgtcctacagtggaaatttctaaattttccacctttttcagttttcctcgccatatttcacgtcctgaagtgtgtatttctcattttccgtgattttcagttttctcgccatattccaggtcctatgtgtacatttctcatttttcacgtttttcagtgattttgtcatttttcaagttgtgaagtggatgtttctcatttttcttgattttcatttttcttgccatattccatgtcctacagtggaaatttctaaattttccacctttttcagttttcctcgccatatttcacgtcctaaagtgtgtatttctcattttccgtgattttcagttttctcgccatattccaggtcctacagtgtgcatttctcatttttcacgtttttcagtgatttcgacatttttcaagttgtcaagtggatgtttctcattttccatgattttcagctttcttgccatattcaaagtcctacagtggacatttctaaattttcgacctttatcagttttcctcgccatatttcatgtcccaaagtgtgtacttctcattttccgtgattttcagtttcctcgccatattccaggtcctacagtgtgcatttctcatttttcacgtttttcagtgatttcgtcatttttcaagtcgtcaagtggatgtttctcattttccatgattttcagttttcttgccatattccatgtcctacagtggacatttctaaattttccacctttttctgttttcctcgccatatttcacgtcctaaagtgtgtatttctcattttccgtgattttcagttttcttgccatattccaggtcctacagtgtgcatttctcatttatcacgtttttcactgattttgtcatttttcaagttgtcaactgcatgtttctcattttccatgattttcagttttcttgctatattccatgtcctacagtggaatattctaaattttccacctttttcagttttcctcgccatatttcacgtcctgaagtgtgtatttctcattttccgtgattttcagttttctcgccatattccaggtcctatgtgtacatttctcatttttcacgtttttcagtgattttgtcatttttcaagttgtgaagtggatgtttctcatttttcttgattttcatttttcttgccatattccatgtcctacagtggaaatttctaaattttccacctttttcagttttcctcgccatatttcacgtcctaaagtgtgaatttctcattttccgtgattttcagttttctcgccatattccaggtcctacagtgtgcatttctcatttttcacgtttttcagtgatttcgacatttttcaagttgtcaagtggatgtttctcattttccatgattttcagctttcttgccatattcaaagtcctacagtggacatttctaaattttcgacctttatcagttttcctcgccatatttcatgtcccaaagtgtgtacttctcattttccgtgattttgagtttcctcgccatattccaggtcctacagtgtgcatttctcatttttcacgtttttcagtgatttcgtcttttttcaagttgtcaactgcatgtttctcattttccatgattttcagttttcttgccatattccatgtcctacagtggaaatttgtaaatttccacctttttcagttttcctcgccatatttcacgtcctaaagtatgtatttctcattttccgtgattttcagttttctcgccatattccaggtcctacagtgtgcatttctcatttttcacgtttttcagtgattttgtcattttttaagttttcaagtggatgtttctcattttccttgattttcagttttcttgccatattccatgtcctacagtggacatttctaaattttccacctttttcagttttcctcgccatatttcatgtcctaaagtgtgtatttctcattttcagtgattttcagttttctcgccatattccaggtcctacagtgtgcatttctcatttttcacgtttttcagtgatttcgtcatttttcaaggtgtcaagtggatgtttctcattttccatgattttcagttttcttgccatattccatgtcctacagtggacatttctaaattttccacctttttctgttttcctcgccatatttcatgtcctaaagtgtgtatttctcattttccgtgattttcagttttcttgctatattccaagtcctacagtgtgcatttctcatttttcacgtttttcagtgattttgtcatttttcaatttgtcaactgcatgtttctcattttccatgattttcagtttttttgccatattccatgtcctactgtggaaatttctatattttccacctttttcagttttcctcgccatatttcacgtgctaaagtgtgtatttctcatttttcgtgtttttcaggtttctcgccatattccaggtcctacagtgtgcatttctcatttttcacgtttttcagtgattttgtcatttttcaagttttcaagtggatgtttctcattttccttgattttcagttttcttgccatattccatgtcctacagtggacatttctaaattttccacctttttcagttttccttgccatatttcatgtcctaaagtgtgtatttctcattttcagtgattttcagtttccttgccatattccaggtcctacagtgtgcatttctcattttttcacgtttttcagtgatttcgtcatttttcacgttgtcaagtggatgtttctcattttccatgattttcacttttcttgccatatttcatgtcctacagtggacatttctaaattttccaactttttcaattttcctcgccatattttatgtcctaaagtgtgtatttctcatttttcgttattttcagttttcttgccatattccaggtcctacagtgtgcatttgtcatttttcacgtttttcagtgatttcgtcatttttcaagtcgtcaagtagatgtttctcatattccatgtttttcagttttctcgccatattccaggtcctacagttgacatttctaaattttctacatttttaaattttcctcgccatatttcacgtcctaaagtgtgtatttctcattttttgttattttcagttttctagccatattccaggtcctacaggatgcatttctcatttttcacgtttttcagtgatttcatcatttttcaagtcgtcaagtgtatgtttcttattttcaatgattttcatttttcttgccttattccacgtcctatagtggacatttctaaattttccacctttttcagtttttttcgccatatttcacgtcctaaagtgtgtatttctcattttctgtgattttcagttttctcaccatattccaggtcctacagtgtgcatttctcatttttcacgtttttcagtgatttcgtcatttttcaagttgtcaagtggaagtttctcattttccatgattttcagctttctagacatattccaggtcctacagtggacatttcctaattttcgacctttatcagttttcctcgtcatatttcacgtcccaaaatgtgtatttcttattttccatgattttcagtttcctcgccatattccaggtcctacagtgtgcaattctcatttttcacgtttttcagtgatttcgtcttttttcaagacgtcaagtggatgtttctcatttttcatgattttcagttttcttgccatattccatgtcctacagtggacatttctaaattttccacctttttctgttttcctcgccatatttcacgtcctaaagtgtgtatttctcattttccgtgattttcagttttcttgccatattcctggtcctacagtgtgcatttctcatttttcacgtttttcagtgattttgtcatttttcaatttgtcaactgcatgtttctcattttccattattttcagttttcttgccatattccatgtcctacagtggacatttctaaattttccacctttttctgttttcctcgccatatttcatgtcctaaagtgtgtatttctcattttccgtgattttcagttttcttgctatattccaagtcctacagtgtgcatttctcatttttcacgtttttcagtgattttgtcatttttcaatttgtcaactgcatgtttctcattttccatgattttcagtttttttgccatattccatgtcctacaggggaaatttctatattttccacctttttcagttttcctcgccatatttcatgtcctaaagtgtgtatttctcattttccgtgattttcagttttcttgccatattccaggtcctacagtgtgcatttctcatttttcacgtttttcagtgatttcgtcatttttcaagtcttcaagtagatgtttctcatattccatgtttttcagttttctcgccatattccaggtcctacagttgacatttctaaattttctacatttttaaattttcctcgccatatttcacgtcctaaagtgtgtatttctcatttttcgttattttcagttttctagccatattccaggtcctacaggatgcatttctcatttttcacgtttttcagtgatttcatcatttttcaagtcgtcaagtgtatgtttctcattttcaatgattttcatttttcttgccttattccacgtcctatagtggacatttctaaattttccacctttttcagtttttctcgccatatttcacgtcctaaagtgtgtatttctcattttctgtgattttcagttttctcaccatattccaggtcctacagtgtgcatttctcatttttcacgtttttcagtgatttcgtcatttttcaagttgtcaagtggaagtttctcattttccatgattttcagctttctagccatattccaggtcctacagtggacatttcctaattttcgacctttatcagttttcctcgccatatttcacgtcctaaagtgtgtatttctcattttccgtgattttcagttttcttgccatattccaggtcctacagtgtgcatttctcatttttcacgtttttcagtgattttgtcatttttcaatttgtcaactgcatgtttctcattttccatgatttttagttttcttgctatattccatgtcctacagtggaaatttctaaattttccacctttttcagttttcctcgccatatttcacgtcctaaagtgtgtatttctcattttccgtgattttcagttttcttgctatattccaagtcctacattgtgcatttctcatttttcacgtttttcagtgattttgtcatttttcaatttgtcaaaccacatgtttctcattttccatgattttcagtttttttgccatattccatgtcctacagtggaaatttctatattttccacctttttcagttttcctcgccatatttcacgtgctaaagtgtgtatttctcatttttcgtgtttttcaggtttctcgccatattccaggtcctacagtgtgcatttctcatttttcacgtttttcagtgattttgtcatttttcaagttgtcaagtggatgtttcccattttccttgattttcagttttcttaccatattccatgtcctacagtggacatttctaaattttccacctttttcagttttccttgccatatttcatgtcctaaagtgtgtatttctcattttcagtgattttcagtttcctcgccatattccaggtcctacagtgtgcatttctcattttttcacgtttttcagtgatttcgtcatttttcacgttgtcaagtggatgtttctcattttccatgattttcacttttcttgccatatttcatgtcctatagtggacatttctaaattttccacctttttcagtttttctcgccatatttcacgtcctaaagtgtgtatttctcattttctgtgattttcagttttctcaccatattccaggtcctacagtgtgcatttctcatttttcacgtttttcagtgatttcgtcatttttcaagtcgtcaagtagatgtttctcatattccatgtttttcagttttctcgccatattccaggtcctacagttgacatttctaaattttctacatttttaaattttcctcgccatatttcacgtcctaaagtgtgtatttctcatttttcgttattttcagttttctagccatattccaggtcctacaggatgcatttctcatttttcacgtttttcagtgatttcatcatttttcaagtcgtcaagtgtatgtttcttattttcaatgattttcatttttcttgccttattccacgtcctatagtggacatttctaaattttccaccttttttcagtttttctcgccatatttcacgtcctaaagtgtgtatttctcattttctgtgattatcagttttctcaccatattccaggtcctacagtgtgcatttctcatttttcacgtttttcagtgatttcgtcatttttcaagttgtcaagtggaagtttctcattttccatgattttcagctttctagccatattccaggtcctacagtggacatttcctaattttcgacctttatcagttttcctcgccatatttcacgtcccaaaatgtgtatttcttattttccatgattttcagtttcctcgccatattccaggtcctacagtgtgcatttctcatttttcacgtttttcagtgatttcgtcttttttcaagacgtcaagtggatgtttctcatttttcatgattttcagttttcttgccatattccatgtcctacagtggacatttctaaattttccacctttttctgttttcctcgccatatttcacgtcctaaagtgtgtatttctcattttccgtgattttcagttttcttgccatattcctggtcctacagtgtgcatttctcatttttcacgtttttcagtgattttgtcatttttcaatttgtcaactgcatgtttctcattttccatgattttcagttttcttgccatattccatgtcctacagtggacatttctaaattttccacctttttcagttttcctcgccatatttcacgtgctaaagtgtgtatttctcatttttcgtgtttttcaggtttctcgccatattccaggtcctacagtgtgcatttctcatttttcacgtttttcagtgattttgtcatttttcaagttgtcaagtggatgtttctcattttccttgattttcacttttcttgccatattccaagtcttacaggggcatttctcatttttcacgttttcagtgattttgtcattttcaatttgtcaactgcatgtttctcattttccatgattttcagtttttttgccatattccatgtcctacaggggaaatttctatattttccacctttttcagttttcctcgccatatttcatgtcctaaagtgtgtatttctcattttccgtgattttcagttttcttgccatattccaggtcctacagtgtgcatttctcatttttcacgtttttcagtgatttcgtcatttttcaagtcttcaagtagatgtttctcatattccatgtttttcagttttctcgccatattccaggtcctacagttgacatttctaaattttctacatttttaaattttcctcgccatatttcacgtcctaaagtgtgtatttctcatttttcgttattttcagttttctagccatattccaggtcctacaggatgcatttctcatttttcacgtttttcagtgatttcatcatttttcaagtcgtcaagtgtatgtttctcattttcaatgattttcatttttcttgccttattccacgtcctatagtggacatttctaaattttccacctttttcagtttttctcgccatatttcacgtcctaaagtgtgtatttctcattttctgtgattttcagttttctcaccatattccaggtcctacagtgtgcatttctcatttttcacgtttttcagtgatttcgtcatttttcaagttgtcaagtggaagtttctcattttccatgattttcagctttctagccatattccaagtcctacagtggacatttcctaattttcgacctttatcagttttcctcgccatatttcacgtcccaaaatgtgtattccttattttccatgattttcagtttcctcgccatattccaggtcctacagtgtgcatttatcatttttcacgtttttcagtgatttcgtcttttttcaagacgtcaagtggatgtttctcatttttcatgattttcagttttcttgccatattccatgtcctacagtggacatttctaaattttccacctttttctgttttcctcgccatatttcacgtcctaaagtgtgtatttctcattttccgtgattttcagttttcttgccatattcctggtcctacagtgtgcatttctcatttttcacgtttttcagtgattttgtcatttttcaagttgtcaagtggatgtttctcattttccttgattttcacttttcttgccatattccatgtcctacagtggacatttctatattttccacctttttccgttttccttgccatatttcacgtcctaaagtgtgtatttctcattttccgtgattttcaggtttctcgccatattccaggtcctacagtgtgcatttctcatttttcacgtttttcagtgattttgtcatttttcaagttgtcaagtggatgtttctcattttccttgattttcacttttcttgccatattccatgtcctacagtggacatttctaaattttccacctttttcagttttcctcgccatatttcatgtcctaaagtgtgtatttctcattttcagtgattttcagttttcttgccatattccaggtcctacagtgtgcatttctcatttttcacgtttttcagtgattttgtcatttttcaagttgtcaactgcatgtttctcattttctatgattttcagttttcttgctatattccatgtcctacagtggaaatttctaaattttccacctttttcagttttcctcgccatatttcacgtcctaaagtgtgtatttctcattttccgtgattttcagttttctcgccatattccaggtcctatgtgtacatttctcatttttcacgtttttcagtgattttgtcatttttcaagttgtgaagtggatgtttctcatttttcttgattttcatttttcttgccatattccatgtcctagagtggaaatttttaaattttccacctttttcagttttcctcgccatatttcacgtcctaaagtgtgaatttctcattttccgtgattttcagatttctcgccatattccaagtcctacagtgtgcatttctcatttttcacgtttttcagtgatttcgtcatttttcaagttgtcaagtggatgtttctcattttccatgattttcagctttcttgccatattcaaagtcctacagtggacatttctaaattttcgacctttatcagttttcctcgccatatttcatgtcccaaagtgtgtacttctcattttccgtgattttcagtttcctcgccatattctaggtcctacagtgtgcatttctcatttttcaggtttttcagtgatttcgtcttttttcaagtcgtcaagtggatgtttctcattttccatgattttcacttttcttgccatatttcatgtcctaaagtgtgtatttctcattttcagtgattttcagttttctcgctatattccaggtcctacagtgtgcatttctcattttttcacgtttttcagtgatttcgtcatttttcacgttgtcaagtggatgtttctcattttccatgattttcacttttcttgccatatttcatgtcctacagtggacatttctaaattttccacctttttctgttttcctcgccatatttcacatcctaaagtgtgtatttctcattttccgtgattttcagttttcttgccatattccaggtcctacagtgtgcatttctcatttttcacgtttttcagtgatttcgtcatttttcaagttgtcaagtggatgtttctcattttccttgattttcagttttcttgccatattccatgtcctactgtggacatttctaaattttccacctttttcagttttccttgccatatttcatgtcctaaagtgtgtatttctcattttcagtgattttcagttttctcgcaatattccaggtcctacagtgtgcatttctcattttttcaggtttttcagtgatttcgtcatttttcacgttgtcaagtggatgtttctcattttccatgattttcacttttcttgccatatttcatgtcctaaagtgtgtatttctcattttcagtgattttcagttttcctcgccatatttcacgtcccaaaatgtgtatttcttattttccatgattttcagtttcctcgccatattccaggtcctacagtgtgcatttctcatttttcacgtttttcagtgatttcgtcttttttcaagacgtcaagtggatgtttctcatttttcatgattttcagttttcttgccatattccatgtcctacagtggacatttctaaattttccacctttttctgttttcctcgccatatttcacgtcctaaagtgtgtatttctcattttccgtgattttcagttttcttgccatattcctggtcctacagtgtgcatttctcatttttcacgtttttcagtgattttgtcatttttcaatttgtcaactgcatgtttctcattttccatgattttcagttttcttgccatattccatgtcctacagtggacatttctaaattttccacctttttcagttttcctcgccatatttcacgtgctaaagtgtgtatttctcatttttcgtgtttttcaggtttctcgccatattccaggtcctacagtgtgcatttctcatttttcacgtttttcagtgattttgtcatttttcaagttgtcaagtggatgtttctcattttccttgattttcacttttcttgccatattccatgtcctacagtggacatttctaaattttccacctttttcagttttcctcgccatatttcatgtcctaaagtgtgtatttctcattttcagtgattttcagttttctcgccatattccaggtcctacagtgtgcatttctcatttttcacgtttttcagtgatttcgtcttttttcaagacgtcaagtggatgtttctcattttccatgattttcagttttcttgccatattccatgtcctacagtggacatttctaaattttccacctttttctgttttcctcgccatatttcacgtcctaaagtgtgtatttctcattttccgtgattttcagttttcttgccatattccaggtcctacagtgtgcatttctcatttttcacgtttttcagtgattttgtcatttttcaatttgtcaactgcatgtttctcattttccatgatttttagttttcttgctatattccatgtcctacagtggaaatttctaaattttccacctttttcagttttcctcgccatatttcacgtcctaaagtgtgtatttctcattttccgtgattttcagttttcttgctatattccaagtcctacattgtgcatttctcatttttcacgtttttcagtgattttgtcatttttcaatttgtcaaaccacatgtttctcattttccatgattttcagtttttttgccatattccatgtcctacagtggaaatttctatattttccacctttttcagttttcctcgccatatttcacgtgctaaagtgtgtatttctcatttttcgtgtttttcaggtttctcgccatattccaggtcctacagtgtgcatttctcatttttcacgtttttctgtgattttgtcatttttcaagttgtcaagtggatgtttctcattttccttgattttcagttttcttaccatattccatgtcctacagtggacatttctaaattttccaccttttctgttttcctcgccatatttcatgtcctaaagtgtgtatttctcattttccgtgattttcatttttcttgctatattccaagtcctacagtgtgcatttctcattttccatgattttcagttttcttgctatattccatgtcctacagtggaaatttctaaattttccacctttttcagttttcctcgccatatttcacgtcctaaagtgtgtatttctcattttccgtgattttcagttttttcgccatattacaggtcctatgtgtacatttctcatttttcacgtttttcagtgattttgtcatttttcaagttgtcaagtggatgtttctcatttttcttgattttcatttttcttgccatattccatgtcctacagtggaaatttctaaattttccacctttttcagttttcctcgccatatttcacgtcctaaagtgtgaatttctcattttccgtgattttcagttttctcgccatattccaggtctacagtgtgcatttctcatttttcacgttttcagtgattcgtcatttttcaagttgacaagtggatgtttctcattttccatgattttcagctttcttgccatattcaaagtcctacagtggacatttctaaattttcgacctttatcagttttcctcgccatatttcatgtcccaaagtgtgtacttctcattttccgtgattttcagttttcttgccatattccaagtcctacagtgtgcatttctcatttttcacgtttttcagtgattttgtcatttttcaatttgtcaactgcatgtttctcattttccatgattttcagttttcttgccatattccatgtcctacagtggaaatttctatattttccacctttttcagttttcctcgccatatttcacgtgctaaagtgtgtatttctcatttttcgtgtttttcaggtttctcgccatattccaggtcctacagtgtgcatttctcatttttcacgtttttcagtgattttgtcatttttcaagttgtcaagtggatgtttctcattttcaatgattttcatttttcttgccttattccacgtcctatagtggacatttctaaattttccacctttttcagtttttctcgccatatttcacgtcccaaaatgtgtattccttattttccatgattttcagtttcctcgccatattccaggtcctacagtgtgcatttctcatttttcacgtttttcagtgatttcgtcttttttcaagacgtcaagtggatgtttctcatttttcatgattttcagttttcttgccatattccctgtcctacagtggacatttctaaattttccacctttttctgttttcctcgccatatttcacgtcctaaagtgtgtatttctcattttccgtgattttcagttttctcgccagattccaggtcctacagtgtgcatttctcatttttcacgtttttcagtgattttgtcatttttcaatttgtcaactgcatgtttctctctttccatgattttcagttttcttgccatattccatgtcctacagtggacatttctaaattttccacctttttcagttttcctcgccatatttcacgtgctaaagtgtgtatttctcatttttcgtgtttttcaggtttctcgccatattccaggtcctacagtgtgcatttctcatttttcacgtttttcagtgattttgtcatttttcaagttgtcaagtggatgtttctcattttcaatgattttcatttttcttaccttattccacgtcctatagtggacatttctaaattttccacctttttcagtttttctcgccatatttcacgtcccaaaatgtgtattccttattttccatgattttcagtttcctcgccatattccaggtcctacagtgtgcatttctcatttttcacgtttttcagtgatttcgtcttttttcaagacgtcaagtggatgtttctcatttttcatgattttcagttttcttgccatattccctgtcctacagtggacatttctaaattttccacctttttctgttttcctcgccatatttcacgtcctaaagtgtgtatttctcattttccgtgattttcagttttctcgccagattccaggtcctacagtgtgcatttctcatttttcacgtttttcagtgatttcgtcatttttcaagtcttcaagtgtatgtttctcattttcaatgattttcatttttcttgccttattccacgtcctatagtggacatttctaaattttccacctttttcagtttttctcgccatatttcacgtcctaaagtgtgtatttctcattttctgtgattttcagttttcttaccatattccaggtcctacagtgtgcatttctcatttttcacgtttttcagtgatttcgtcatttttcaagttgtcaagtggaagtttctcattttccatgattttcagctttctagccatattccaggtattacagtggacatttccttattttcgacctttatcagttttcctcgccatatttcatgtcctaaagtgtgt	38399	1554	4%	7300	19%
9	3000001	3038400	Atcctacagtgtgcatttctcatttttcacgtttttcagtgatttcgtcatttttcaagtcatcaagtggctgtttctcattttccatgattttcagttttcttgccatattccttgtcctacagtggacatttctaaattttccacctttttcagttttccttgtcatatttcaggtcctacagtgtgtatttctcatttttcacgtttttcattgatttcgtcatttttcaagttgtcaagtgcatgtttctcattttccatgattttcagttttcttgccatattccatgtcctacaatggacatttctaaattttccaactttttcagttttcctcgccatatttcacgtcctaaagtgtgtatttctcattttccgtgattttcagttttctcgacatattccaggtcctacagtgtgcatttctcatttttcacgtttttcagtgatttcgtcatttttcacgtcgtcaagtggatgtttctcattttccatgattttcagttttcttgccatattccatgtcctacagtggacatttctaaattttccacctttttcagttttcctcgccatatttcacgtcctaaagtgtgtatttctcattttccgtgattttcagttttctcgacatattccaggtcttacagggtgcatttctcatttttcacgtttttcagtgatttcatcatttttcaagtcgtcaactgtatgtttctcattttcaatgattttcatttttcttgccatattccacgtcctatagtggacatttctaaattttccacctttttcagttttccttgccatatttcaggtcctacagtgtgcatttctcatttttcacgtttttcagtgatttcgtcatttttcaagtggtcaaatgcatgtttctcattttccatgattttcagttttcttgccatattccatgtcctacagtggacatttctaaattttccacctttttcagttttcctcgccatatttcacgtcctaaagtgtgtatttctcattttccgtgattttcagttttatcgccagattccaggtcctacggtgtgcatttttcatatttcacgtttttcagtgattttgtcatttttcaagttgtcaactgcatgtttctcattttccatgattttcagttttcttgccatattccatgtcctacagtggacatttctaaattttccacctttttcagttttcctcgccatatttcatgtcctaaagtgtgtatttctcattttcagtgattttctgttttctcgccatattccaggtcctacagtgtgcatttctcatttttcacgtttttcagtgatttcgtcatttttcaagttgtcaagtggatgtttctcattttccatgattttcagttttcttgccatattccatgtcctacaatggacatttctaaattttccacctttttcagttttcctcgccatatttcacgtcctaaagtgtgtatttctcattttccgtgattttcagttttctcgccatattccaggtcctatgtgtacatttctcatttttcacgtttttcagtgattttgtcatttttcaagttgtgaagtggatgtttctcatttttcttgattttcatttttcttgccatattccatgtcctagagtggaaatttttaaattttccacctttttcagttttcctcgccatatttcacgtcctaaagtgtgaatttctcattttccgtgattttcagttttctcgccatattccaagtcctacagtgtgcatttctcatttttcacgtttttcagtgatttcgtcatttttcaagttgtcaagtggatgtttctcattttccatgattttcagctttcttgccatattcaaagtcctacagtggacatttctaaattttcgacctttatcagttttcctcgccatatttcatgtcccaaagtgtgtacttctcattttccgtgattttcagtttcctcgccatattctaggtcctacagtgtgcatttctcatttttcaggtttttcagtgatttcgtcttttttcaagtcgtcaagtggatgtttctcattttccatgattttcagttttcttgccatattccatgtcctacagtggacatttctaaattttccaactttttcagttttcctcgccatatttcatgtcctaaagtgtgtatttctcattttcagtgattttcagttttctcgccatattccaggtcctacagtgtgcatttctcatttttcacgtttttcagtgatttcgtcatttttcaagttgtcaagtggatgtttctcatttttcatgattttcagttttcttgccatattccatgtcccacagtggacatttctaaatgttccacctttttctgttttccttgccatatttcatgtcctaaagtgtgtatttctcattttccgtgattttcagttttcttgctatattccaagtcctacagtgtgcatttctcatttttcacgtttttctgtgattttttcatttttcaatttgtcaactgcatgtttctcattttccatgattttcagttttcttgccatattccaggtcctacagtgtgcatttctcatttttcacgtttttcagtgattttgtcatttttcaagttgtcaactgcatgtttctcattttccatgattttcagttttcttgctatattccatgtcctacagtggaaatttctaaattttccacctttttcagttttcctcgccatatttcacgtcctaaagtgtgtatttctcattttccgtgattttcagttttctcgccatattccaggtcctatgtgtacatttctcatttttcacgtttttcagtgattttgtcatttttcaagttgtgaagtggatgtttctcatttttcttgattttcatttttcttgccatattccatgtcctagagtggaaatttttaaattttccacctttttcagttttcctcgccatatttcacgtcctaaattgtgaatttctcattttccgtgattttcagttttctcgccatattccaagtcctacagtgtgcatttctcatttttcacgtttttcagtgatttcgtcatttttcaagttgtcaagtggatgtttctcattttccatgattttcagctttcttgccatattcaaagtcctacagtggacatttctaaattttcgacctttatcagttttcctcgccatatttcatgtcccaaagtgtgtacttctcattttccgtgattttcagtttcctcgccatattctaggtcctacagtgtgcatttctcatttttcaggtttttcagtgatttcgtcttttttcaagtcgtcaagtggatgtttctcattttccatgattttcagttttcttgccatattccatgtcctacagtggacatttctaaattttccacctttttcagttttcctcgccatatttcatgtcctaaagtgtgtatttctcattttcagtgattttcagttttctcgccatattccaggtcctacagtgtgcatttctcatttttcacgtttttcagtgattttgtcatttttcaagttgtcaagtggatgtttctcattttccttgattttcagttttcttgccatattccatgtcctacagtggacatttctaaattttccacctttttcagttttccttgccatatttcatgtcctaaagtgtgtatttctcattttcagtgattttcagttttctcgccatattccaggtcctacagtgtgcatttctcattttttcaggtttttcagtgatttcgtcatttttcacgttgtcaagtggatgtttctcattttccatgattttcacttttcttgccatatttcatgtcctaaagtgtgtatttctcattttcagtgattttcagttttctcgccatattccaggtcctacagtgtgcatttctcattttttcacgtttttcagtgatttcgtcatttttcacgttgtcaagtggatgtttctcattttccattattttcacttttcttgccatatttcatgtcctacagtggacatttctaaattttccacctttttctgttttcctcgccatatttcacatcctaaagtgtgtatttctcattttccgtgattttcagttttcttgccatattccaggtcctacagtgtgcatttctcatttttcacgtttttcagtgatttcgtcatttttcaagtcgtcaagtggatgtttctcattttccatgattttcagttttctcgccatattccaggtcctacagttgacatttctaaattttccacattttttatgtttcctcgcgatatttcacatcctaaagtgtgtatttctcattttccgtgattttcagttttcttgccatattccaggtcctacagggtgcatttctcatttttcacgtttttcagtgatttcatcaatttcaagtcgtcaactgtatgtttctcattttcaatgattttcatttttcttgccatattccacgtcctatagtggacatttctacattttccacctttttcagttttcttcgccatatttcacgtcccaaagtgtgtatttctcattttccgtgattttcagtttcctcgccatattccaggtcctacagtgtgcatttctcatttttcacgtttttcagtgatttcgtcttttttcaagtcgtcaagtggatgtttctcattttccatgattttcagttttcttgccatattccatgtcctacagtggacatttctaaattttccacctttttctgttttcctcgccatatttcacgtcctaaagtgtgtatttctcatttaccgtgattttcagttttcttgctatattccaagtcctacagtgtgcatttctcatttttcacgtttttcactgattttgtcattgttcaagttgtcaactgcatgtttctcattttccatgattttcagttttcttgccatattccatgtcctacagtggaaatttctatattttccaactttttcagttttcctcgccatatttcacgtgctaaagtgtgtatttctcatttttcgtgtttttcaggtttctcgccatattccaggtcctacagtgtgcatttctcatttttcacgtttttcagtgattttgtaatttttcaagttgtcaagtggatgtttctcattttccttgattttcagttttcttgccatattccatgtcctactgtggacatttctaaattttccacctttttcagttttccttgccatatttcatgtcctaaagtgtgtatttctcattttcagtgattttcagttttctcgcaatattccaggtcctacagtgtgcatttctcattttttcaggtttttcagtgatttcgtcatttttcacgttgtcaagtggatgtttctcattttccatgattttcacttttcttgccatatttcatgtgctaaagtgtgtatttctcattttcagtgattttcagttttctgccatattccaggtcctacattgtgcatttctcattttttcacgtttttcagtgatttcgtcatttttcacgttgtcaagtggatgtttctcattttccatgattttcacttttcttgccatatttcatgttttacagtggacatttctaaattttccacctatttctgttttcctcgccatatttcacatcctaaagtgtgtatttctcattttccgtgattttcagttttctcgccatatgccaggtcatacagggtgcatttctcatttttcacgtttttcagtgatttcgtcatttttcacgtcgtcaagtggatgtttctcattttcaatgattttcatttttcttgccatattccacgtcctatagtggacatttctaaattttccacctttttcagttttccttgccatatttcaggtcctacagtgtgcatttctcttttttcacgtttttcagtgatttcgtcatttttcaagtggtcaagtgcatgtttctcattttccgtgattttcagttttcttgccatgttccaggtcctacagttgacgtttctaaaatttcactttttttaagttttcctcgccatatttcacttcctaaagtgtgtatttctcattttccgtgattttcagttttctcgccagattccaggtcctacagtgtgcatttttcatatttcacctttttcagtgattttgtcatttttcaagttgtcaactgcatgtttctcattttccatgattttcagttttcttgccatattccatgtcctactgtggacatttctaaattttccaactttttcagttttcctcgccatatttcatgtcctaaagtgtgtatttctcattttcagtgattttctgttttctcgccatattccaggtcctacagtgtgcatttctaatttttcacgtttttcagtgatttcgtcatttttcaagttgtcaagtggatgtttctcattttccatgattttcagttttcttgccatattccatgtcctacagtggacatttctaaattttccaactttttccattttcctcaccatatttcacgtcctaaagtgagtttttctcattttttgtgattttcagttttctcgacatattccaggtcctacagtgtgcatttctaattttttcttttttcagtgatttcgtcatttttcaagtggtcaagtgcatgtttctcattttccatgattttcagttttcttgccatattccatgtcctacaatggacatttctaaattttccaactttttcagttttcctcgccatatttcacgtcctaaagtgtgtatttctcattttccgtgattttcagttttctcgccatattccaggtcctacagtgtgcatttctcatttttcacgtttttcagtgatttcgtcatttttcaagttgtcaactgcatgtttctcattttccatgattttcagttttcttgccatattccatgtcttacagtggacatttttaaatttttcacatttttttaagttttcctccccatatttcacgttttaaagtgtgcatttctcattttcggtgattttcagttttctcgccagattccatgtcttacagtgtgcatttctcattttttcacgtttttcagtgatttcgtcatttttcaagtcgtcaagtggatgtttctcattttccatgattttcagttttcttgccatattccatgtcctacagtggaaatttctaaattttccacctttttcagttttccttgccatatttcaggtcctaaagtgtgtatttctcattttctgtgattttcagttttctcgccatattccaggtcctacagttgacatttctaaaatttccacattttttaagttttcctcgccatatttcacttcctaaagtgtgtatttctcattttccgtgattttcagttttctcgccatattccagatcctacagtgtacatttttcatttttcacgtttttcagtgattttgtcattttttagttgtcaactgcctgtttctcattttccatgattttcagttttcttgctatattccatgtcctacagtggaaatttctaaattttccacctttttcagttttcctcgccatatttcacgtcctaaagtgtgtatttctcattttccgtgattttcagttttctcgccatattccaggtcctatgtgtacatttctcatttttcacgtttttcagtgattttgtcatttttcaatttgtcaactgcatgtttctcattttccatgattttcagttttcttgccatattccatgtcctacagtggaaatttctatattttccaactttttcagttttcctcgccatatttcacgtgctaaagtgtgtatttctcatttttcgtgtttttcaggtttctcgccatattccaggtcctacagtgtgcatttctcatttttcacgtttttcagtgattttgtcatttttcaagttgtcaagtggatgtttctcattttccttgattttcagttttcttgccatattccatgtcctacagtggacatttctaaattttccacctttttcagttttccttgccatatttcatgtcctaaagtgtgtatttctcattttcagtgattttcagttttctcgccatattccaggtcctacagtgtgcatttctcattttttcaggtttttcagtgatttcgtcatttttcacgttgtcaagtggatgtttctcattttccatgattttcacttttcttgccatatttcatgtcctaaagtgtgtatttctcattttcagtgattttcagttttctcgctatattccaggtcctacagtgtgcatttctcattttttcacgtttttcagtgatttcgtcatttttcacgttgtcaagtggatgtttctcattttccatgattttcacttttcttgccatatttcatgtcctacaatggacatttctaaattttccacctttttctgttttcctcgccatatttcacatcctaaagtgtgtatttctcattttccgtgattttcagttttcttgccatattccaggtcctacagtgtgcatttctcatttttcacgtttttcagtgatttcgtcatttttcaagttgtcaagtggatgtttctcattttccttgattttcagttttcttgccatattccatgtcctactgtggacatttctaaattttccacctttttcagttttccttgccatatttcatgtcctaaagtgtgtatttctcattttcagtgattttcagttttctcgcaatattccaggtcctacagtgtgcatttctcattttttcaggtttttcagtgatttcgtcatttttcacgttgtcaagtggatgtttctcattttccatgattttcacttttcttgccatatttcatgtcctaaagtgtgtatttctcattttcagtgattttcagttttctgccatattccaggtcctacattgtgcatttctcattttttcacgtttttcagtgatttcgtcatttttcagttttctcgacatattccaggtcctacagtgtgcatttctaattttttcttttttcagtgatttcgtcatttttcaagttgtcaactgcatgtttctcattttccatgattttcagttttcttgccatattccatgtcttacagtggacatttttaaatttttcacatttttttaagttttcctccccatatttcacgttttaaagtgtgcatttctcattttcggtgattttcagttttctcgccagattccaggtcttacagtgtgcatttctcattttttcacgtttttcagtgatttcgtcatttttcaagtcgtcaagtggatgtttctcattttccatgattttcagttttcttgccatattccatgtcctacagtggaaatttctaaattttccacctttttcagttttccttgccatatttcaggtcctaaagtgtgtatttctcattttctgtgattttcagttttctcgccatattccaggtcctacagttgacatttctaaaatttccacattttttaagttttcctcgccatatttcacttcctaaagtgtgtatttctcattttccgtgattttcagttttctcgccatattccagatcctacagtgtgcatttttcatttttcacgtttttcagtgattttgtcattttttagttgtcaactgtctgtttctcattttccatgattttcagttttcttgccatattccatgtcctacactggacatttctaaattttccacctttttctgttttcctcgccatatttcacgtcctaaagtgtgtatttctcattttccgtgattttcagttttcttgccatattccaggtcctacagtgtgcatttctcatttttcacgtttttcagtgattttgtcatttttcaagttgtcaactgcatgtttctcattttctatgattttcagttttcttgctatattccatgtcctacagtggaaatttctaaattttccacctttttcagttttcctcgccatatttcacgtcctaaagtgtgtatttctcattttccgtgattttcagttttctcgccatattccaggtcctatgtgtacatttctcatttttcacgtttttcagtgattttgtcatttttcaagttgtgaagtggatgtttctcatttttcttgattttcatttttcttgccatattccatgtcctagagtggaaatttttaaattttccacctttttcagttttcctcgccatatttcacgtcctaaagtgtgaatttctcattttccgtgattttcagatttctcgccatattccaagtcctacagtgtgcatttctcatttttcacgtttttcagtgatttcgtcatttttcaagttgtcaagtggatgtttctcattttccatgattttcagctttcttgccatattcaaagtcctacagtggacatttctaaattttcgacctttatcagttttcctcgccatatttcatgtcccaaagtgtgtacttctcattttccgtgattttcagtttcctagccatattctaggtcctacagtgtgcatttctcatttttcaggtttttcagtgatttcgtcttttttcaagtcgtcaagtggatgtttctcattttccatgattttcacttttcttgccatatttcatgtcctaaagtgtgtatttctcattttcagtgattttcagttttctcgctatattccaggtcctacagtgtgcatttctcattttttcacgtttttcagtgatttcgtcatttttcacgttgtcaagtggatgtttctcattttccatgattttcacttttcttgccatatttcatgtcctacagtggacatttctaaattttccacctttttctgttttcctcgccatatttcacatcctaaagtgtgtatttctcattttccgtgattttcagttttcttgccatattccaggtcctacagtgtgcatttctcatttttcacgtttttcagtgatttcgtcatttttcaagttgtcaagtggatgtttctcattttccttgattttcagttttcttgccatattccatgtcctactgtggacatttctaaattttccacctttttcagttttccttgccatatttcatgtcctaaagtgtgtatttctcattttcagtgattttcagttttctcgcaatattccaggtcctacagtgtgcatttctcattttttcaggtttttcagtgatttcgtcatttttcacgttgtcaagtggatgtttctcattttccatgattttcacttttcttgccatatttcatgtcctaaagtgtgtatttctcattttcagtgattttcagttttctgccatattccaggtcctacattgtgcatttctcattttttcacgtttttcagtgatttcgtcatttttcacgttgtcaagtggatgtttctcattttccatgattttcacttttcttgccatatttcatgttttacagtggacatttctaaattttccacctttttctgttttcctcgccatatttcacatcctaaagtgtgtatttctcattttccgtgattttcagttttctcgccatatgccaggtcatacagggtgcatttctcatttttcacgtttttcagtgatttcgtcatttttcacgtcgtcaagtggatgtttctcattttcaatgattttcatttttcttgccatattccacgtcctatagtggacatttctaaattttccacctttttcagttttccttgccatatttcaggtcctacagtgtgcatttctcatttttcacgtttttcagtgatttcgtcatttttcaagtggtcaagtgcatgtttctcattttccgtgattttcagttttcttgccatgttccaggtcctacagttgacgtttctaaaatttcactttttttaagttttcctcgccatatttcacttcctaaagtgtgtatttctcattttccgtgattttcagttttctcgccagattccaggtcctacagtgtgcatttttcatatttcacctttttcagtgattttgtcatttttcaagttgtcaactgcatgtttctcattttccatgattttcagttttcttgccatattccatgtcctactgtggacatttctaaattttccaactttttcagttttcctcgccatatttcatgtcctaaagtgtgtatttctcattttcagtgattttctgttttctcgccatattccaggtcctacagtgtgcatttctaatttttcacgtttttcagtgatttcgtcatttttcaagttgtcaagtggatgtttctcattttccatgattttcagttttcttgccatattccatgtcctacagtggacatttctaaattttccaactttttccattttcctcaccatatttcacgtcctaaagtgtgtttttctcattttttgtgattttcagttttctcgacatattccaggtcctacagtgtgcatttctaattttttcttttttcagtgatttcgtcatttttcaagttgtcaactgcatgtttctcattttccatgattttcagttttcttgccatattccatgtcttacagtggacatttttaaatttttcacatttttttaagttttcctccccatatttcacgttttaaagtgtgcatttctcattttcggtgattttcagttttctcgccagattccaggtcttacagtgtgcatttctcattttttcacgtttttcagtgatttcgtcatttttcaagtcgtcaagtggatgtttctcattttccatgattttcagttttcttgccatattccatgtcctacagtggaaatttctaaattttccacctttttcagttttccttgccatatttcaggtcctaaagtgtgtatttctcattttctgtgattttcagttttctcgccatattccaggtcctacagttgacatttctaaaatttccacattttttaagttttcctcgccatatttcacttcctaaagtgtgtatttctcattttccgtgattttcagttttctcgccatattccagatcctacagtgtgcatttttcatttttcacgtttttcagtgattttgtcattttttagttgtcaactgtctgtttctcattttccatgattttcagttttcttgccatattccatgtcctacactggacatttctaaattttccacctttttctgttttcctcgccatatttcacgtcctaaagtgtgtatttctcattttccgtgattttcagttttcttgccatattccaggtcctacagtgtgcatttctcatttttcacgtttttcagtgattttgtcatttttcaagttgtcaactgcatgtttctcattttccatgattttcagttttcttgctatattccatgtcctacagtggaaatttctaaattttccacctttttcagttttcctcgccatatttcacgtcctaaagtgtgtatttctcattttccgtgattttcagttttctcgccatattccaggtcctatgtgtacatttctcatttttcacgtttttcagtgattttgtcatttttcaagttgtgaagtggatgtttctcatttttcttgattttcatttttcttgccatattccatgtcctagagtggaaatttttaaattttccacctttttcagttttcctcgccatatttcacgtcctaaagtgtgaatttctcattttccgtgattttcagatttctcgccatattccaagtcctacagtgtgcatttctcatttttcacgtttttcagtgatttcgtcatttttcaagttgtcaagtggatgtttctcattttccatgattttcagctttcttgccatattcaaagtcctacagtggacatttctaaattttcgacctttatcagttttcctcgccatatttcatgtcccaaagtgtgtacttctcattttccgtgattttcagtttcctcgccatattctaggtcctacagtgtgcatttctcatttttcaggtttttcagtgatttcgtcttttttcaagtcgtcaagtggatgtttctcattttccatgattttcagttttcttgccatattccatgtcctacagtggacatttctaaattttccacctttttcagttttcctcgccatatttcatgtcctaaagtgtgtatttctcattttcagtgattttcagttttctcgccatattccaggtcctacagtgtgcatttctcatttttcacgtttttcagtgatttcgtcatttttcaagttgtcaagtggatgtttctcattttccatgattttcagttttcttgccatattccatgtcccacagtggacatttctaaattttccacctttttctgttttccttgccatatttcatgtcctaaagtgtgtatttctcattttccgtgattttcagttttcttgctatattccaagtcctacagtgtgcatttctcatttttcacgtttttcagtgattttgtcatttttcaatttgtcaactgcatgtttctcattttccatgattttcagttttcttgccatattccatgtcctacagtggaaatttctatattttccaactttttcagttttcctcgccatatttcacgtgctaaagtgtgtatttctcatttttcgtgtttttcaggtttctcgccatattccaggtcctacagtgtgcatttctcatttttcacgtttttcagtgattttgtcatttttcaagttgtcaagtggatgtttctcattttccttgattttcagttttcttgccatattccatgtcctacagtggacatttctaaattttccacctttttcagttttccttgccatatttcatgtcctaaagtgtgtatttctcattttcagtgattttcagttttctcgccatattccaggtcctacagtgtgcatttctcattttttcaggtttttcagtgatttcgtcatttttcacgttgtcaagtggatgtttctcattttccatgattttcacttttcttgccatatttcatgtcctaaagtgtgtatttctcattttcagtgattttcagttttctcgctatattccaggtcctacagtgtgcatttctcattttttcacgtttttcagtgatttcgtcatttttcacgttgtcaagtggatgtttctcattttccatgattttcacttttcttgccatatttcatgtcctacagtggacatttctaaattttccacctttttctgttttcctcgccatatttcacatactaaagtgtgtatttctcattttccttgattttcagttttcttgccatattccaggtcctacagtgtgcatttctcatttttcacgtttttcagtgatttcgtcatttttcaagtcgtcaagtggatgtttctcattttccatgattttcagttttctcgccatattccaggtcctacagttgacatttctaaattttccacattttttaagtttcctcgcgatatttcacatcctaaagtgtgtatttctcattttccgtgattttcagttttcttgccatattccaggtcctacagggtgcatttctcatttttcacgtttttcagtgatttcatcaatttcaagtcgtcaactgtatgtttctcattttcaatgattttcatttttcttgccatattccatgtcctacagtggacatttctaaatttttcacctttttcagttttccttgccatatttcatgtcctaaagtgtgtatttctcattttcagtgattttcagttttctcgccatattccaggtcctacagtgtgcatttctcattttttcaggtttttcagtgatttcgtcatttttcacgttgtcaagtggatgtttctcattttccatgattttcacttttcttgccatatttcatgtcctaaagtgtgtatttctcattttcagtgattttcagttttctcgccatattccaggtcctacagtgtgcatttctcatttttcacgtttttcagtgatttcgtcatttttcaagttgtcaagtggatgtttctcattttccatgattttcacttttcttgccatattccatgtcccacagtggacatttctaaattttccacctttttctgttttcctcgccatatttcatgtcctaaagtgtgtatttctcattttccgtgattttcagttttcttgctatattccaagtcctacagtgtgcatttctcatttttcacgtttttcagtgattttgtcatttttcaatttgtcaactgcatgtttctcattttccatgattttcagttttcttgccatattccatgttctacagtggaaatttctatattttccaactttttcagttttcctcgccatatttcacgtgctaaagtgtgtatttctcatttttcgtgtttttcaggtttctcgccatattccaggtcctacagtgtgcatttctcatttttcacgtttttcagtgattttgtcatttttcaagttgtcaagtggatgtttctcattttccttgattttcagttttcttgccatattccatgtcctacagtggacatttctaaattttccacctttttcagttttccttgccatatttcatgtcctaaagtgtgtatttctcattttcagtgattttcagttttctcgccatattccaggtcctacagtgtgcatttctcattttttcaggtttttcagtgatttcgtcatttttcacgttgtcaagtggatgtttctcattttccatgattttcacttttcttgccatatttcatgtcctaaagtgtgtatttctcattttcagtgattttcagttttctcgctatattccaggtcctacagtgtgcatttctcattttttcacgttttgcagtgatttcgtcatttttcacgttgtcaagtggatgtttctcattttccatgattttcacttttcttgccatatttcatgtcctacagtggacatttctaaattttccacctttttctgttttcctcgccatatttcacatcctaaagtgtgtatttctcattttccgtgattttcagttttcttgccatattccaggtcctacagtgtgcatttctcatttttcacgtttttcagtgatttcgtcatttttcaagtcgtcaagtggatgtttctcattttccatgattttcagttttctcgccatattccaggtcctacagttgacatttctaaattttccacattttttaagtttcctcgcgatatttcacatcctaaagtgtgtatttctcattttccgtgattttcagttttcttgccatattccaggtcctacagggtgcatttctcatttttcacgtttttcagtgatttcatcaatttcaagtcgtcaactgtatgtttctcattttcaatgattttcatttttcttgccatattccatgtcctacagtggacatttctaaattttccacctttttcagttttccttgccatatttcatgtcctaaagtgtgtatttctcattttcagggattttcagttttctcgccatattccaggtcctacagtgtgcatttctcattttttcaggtttttcagtgatttcgtcatttttcacgttgtcaagtggatgtttctcattttccatgattttcacttttcttgccatatttcatgtcctaaagtgtgtatttctcattttcagtgattttcagttttctcgccatattccaggtcctacagtgtgcatttctcattttttcacgtttttcagtgatttcgtcatttttcacgttgtcaagtggatgtttctcattttccatgattttcacttttcttgccatatttcatgtcctacagtggacatttctaaattttccacctttttctgttttcctcgccatatttcacatcctaaagtgtgtatttctcattttccgtgattttcagttttcttgccatattccaggtcctacagtgtgcatttctcatttttcacgtttttcagtgatttcgtcatttttcaagtcgtcaagtggatgtttctcattttccatgattttcagttttctcgccatattccaggtcctacagttgacatttctaaattttccacattttttaagtttcctcgcgatatttcacatcctaaagtgtgtatttctcattttccgtgattttcagttttcttgccatattccaggtcctacagggtgcatttctcatttttcacgtttttcagtgatttcatcaatttcaagtcgtcaactgtatgtttctcattttcaatgattttcatttttcttgccatattccacgtcctatagtggacatttctaaattttccacctttttcagttttcttcgccatatttcacgtcccaaagtgtgtatttctcattttccgtgattttcagtttcctcgcaatattccaggtcctacagtgtgcatttctcatttttcacgtttttcagtgatttcgtcttttttcaagtcgtcaagtggatgtttctcattttccatgattttcagttttcttgccatattccatgtcctacagtggacatttctaaattttccacctttttctgttttcctcgccatatttcacgtcctaaagtgtgtatttctcattttccgtgattttcagttttcttgccatattccaggtcctacagtgtgcatttctcatttttcacgtttttcactgattttgtcattgttcaagttgtcaactgcatgtttctcattttccatgattttcaattttcttgccatattccatgtcctacagtggaaatttctatattttccaactttttcagttttcctcgccatatttcacgtgctaaagtgtgtatttctcatttttcgtgtttttcaggtttctcgccatattccaggtcctacagtgtgcatttctcatttttcacgtttttcagtgattttgtcatttttcaagttgtcaagtggttgtttctcattttccttgattttcagttttcttgccatattccatgtcctactgtggacatttctaaattttccacctttttcagttttccttgccatatttcatgtcctaaagtgtgtatttctcattttcagtgattttcagttttctcgcaatattccaggtcctacagtgtgcatttctcattttccgtgattttcagttttctcgccatatgccaggtcatacagggtgcatttctcatttttcacgtttttcagtgatttcgtcatttttcacgtcgtcaagtggatgtttctcattttcaatgattttcatttttcttgccatattccacgtcctatagtggacatttctaaattttccaactttttcagttttcttgccatatttcaggtcctacagtgtgcatttctcatttttcacgtttttcagtgatttcgtcatttttcaagtggtcaagtgcatgtttctgattttccgtgattttcagttttcttgccatgttccaggtcctacagttgacgtttctaaaatttcactttttttaagttttcctcgccatatttcacttcctaaagtgtgtatttctcattttccgtgattttcagttttctcgccagattccaggtcctacagtgtgcatttttcatatttcacctttttcagtgattttgtcatttttcaagttgtcaactgcatgtttctcattttccatgattttcagttttcttgccatattccatgtcctactgtggacatttctaaattttccaactttttcagttttcctcgccatatttcatgtcctaaagtgtgtatttctcattttcagtgtttttctgttttctcgccatattccaggtcctacagtgtgcatttctaatttttcacgtttttcagtgatttcgtcatttttcaagttgtcaagtggatgtttctcattttccatgattttcagttttcttgccatattccatgtcctacagtggacatttctaaattttccaactttttccattttcctcaccatatttcacgtcctaaagtgtgtttttctcattttttgtgattttcagttttctcgacatattccaggtcctacagtgtgcatttctaattttttcttttttcagtgatttcgtcatttttcaagtggtcaagtgcatgtttctcattttccatgattttcagttttcttgccatattccatgtcctacaatggacatttctaaattttccaactttttcagttttcctcgccatatttcacgtcctaaagtgtgtatttctcattttccgtgattttcagttttctcgccatattccaggtcctatgtgtacatttctcatttttcacgtttttcagtgattttgtcatttttcaagttgtgaagtggatgtttctcatttttcttgattttcatttttcttgccatattccatgtcctagagtggaaatttttaaattttccaactttttcagttttcctcgccatatttcacgtcctaaagtgtgtatttctcattttccgtgattttcagttttctcgccatattccaagtcctacagtgtgcatttctcatttttcacgtttttcagtgatttcgtcatttttcaagttgtcaagtggatgtttctcattttccatgattttcagctttcttgccatattcaaagtcctacagtggacatttctaaattttcgacctttatcagttttcctcgccatatttcatgtcccaaagtgtgtacttctcattttccgtgattttcagtttcctcgccatattctaggtcctacagtgtgcatttctcatttttcaggtttttcagtgatttcgtcttttttcaagtcgtcaagtggatgtttctcattttccatgattttcagttttcttgccatattccatgtcctacagtggacatttctaaattttccacctttttcagttttcctcgccatatttcatgtcctaaagtgtgtatttctcattttcagtgattttcagttttctcgccatattccaggtcctacagtgtgcatttctcatttttcacgtttttcagtgatttcgtcatttttcaagttgtcaagtggatgtttctcattttccatgattttcagttttcttgccatattccatgtcccacagtggacatttctaaattttccacctttttctgttttccttgccatatttcatgtcctaaagtgtgtatttctcattttccgtgattttcagttttcttgctatattccaagtcctacagtgtgcatttctcatttttcacgtttttaagtgattttgtcatttttcaatttgtcaactgcatgtttctcattttccatgattttcagttttcttgccatattccatgtcctacagtggaaatttctatattttccaactttttcagttttcctcgccatatttcacgtgctaaagtgtgtatttctcatttttcgtgtttttcaggtttctcgccatattccaggtcctacagtgtgcatttctcatttttcacgtttttcagtgattttgtcatttttcaagttgtcaagtggatgtttctcattttccttgattttcagttttcttgccatattccatgtcctacagtggacatttctaaattttccacctttttcagttttccttgccatatttcatgtcctaaagtgtgtatttctcattttcagtgattttcagttttctcgccatattccaggtcctacagtgtgcatttctcattttttcaggtttttcagtgatttcgtcatttttcacgttgtcaagtggatgtttctcattttccatgattttcacttttcttgccatatttcatgtcctaaagtgtgtatttctcattttcagtgattttcagttttctcgccatattccaggtcctacagtgtgcatttctcattttttcacgtttttcagtgatttcgtcatttttcacgttgtcaagtggatgtttctcattttccatgattttcacttttcttgccatatttcatgtcctacagtggacatttctaaattttccacctttttctgttttcctcgccatatttcacatcctaaagtgtgtatttctcattttccgtgattttcagttttcttgccatatttcaggtcctacagtgtgcatttctcatttttcacgtttttcagtgatttcgtcatttttcaagtcgtcaagaggatgtttctcattttccatgattttcagttttctcgccatattccaggtcctacagttgacatttctaaattttccacattttttaagtttcctcgcgatatttcacatcctaaagtgtgtatttctcattttccgtgattttcagttttcttgccatattccaggtcctacagggtgcatttctcatttttcacgtttttcagtgatttcatcaatttcaagtcgtcaactgtatgtttctcattttcaatgattttcatttttcttgccatattccacgtcctatagtggacatttctaaattttccacctttttctgttttcctcgccatatttcacgtcctaaagtgtgtatttctcattttccgtgattttcagttttcttgccatattccaggtcctacagtgtgcatttctcatttttcacgtttttcactgattttgtcattgttcaagttgtcaactgcatgtttctcattttccatgattttcagttttcttgccatattccatgtcctacagtggaaatttctatattttccacctttttcagttttcctcgccgtatttcatgtgctaaagtgtgtatttctcatttttcgtgtttttcaggtttctcgccatattccaggtcctacagtgtgcatttctcatttttcacgtttttcagtgattttgtcatttttcaagttgtcaactggatgtttctcattttccttgattttcagttttcttgccatattccatgtcctactgtggacatttctaaattttccacctttttcagttttccttgccatatttcatgtcctaaagtgtgtatttctcattttcagtgattttcagttttctcgcaatattccaggtcctacagtgtgcatttctcattttttcaggtttttcagtgatttcgtcatttttcacgttgtcaagtggatgtttctcattttccatgattttcacttttcttgccatatttcatgtcctaaagtgtgtatttctcattttcagtgattttcagttttctcgccatattccaggtcctacattgtgcatttctcattttttcacgtttttcagtgatttcgtcatttttcacgttgtcaagtggatgtttctcattttccatgattttcacttttcttgccatatttcatgttttacagtggacatttctaaattttccacctttttctgttttcctcgccatatttcacatcctaaagtgtgaatttctcattttccgtgattttcagttttcttgccatattccaggtcctacagtgtgcatttctcatttttcacgtttttcagtgatttcatcatttttcaagtcgtcaagtggatgtttctcattttccatgattttcagttttcttgccatattccatgtcctacagtggacatttctaaattttccacctttttctgttttcctcgccatatttcacgtcctaaagtgtgtatttctcattttccgtgattttcagttttcttgccatattccaggtcctacagtgtgcatttctcatttttcacgtttttcactgattttgtcatttttcaagttgtcaactgcatgtttctcattttccatgattttcagttttcttgctatattccatgtcctacagtggaaatttctaaattttccacctttttcagttttcctcgccatatttcacgtcctgaagtgtgtatttctcattttccgtgattttcagttttctcgccatattccaggtcctatgtgtacatttctcatttttcacgtttttcagtgattttgtcatttttcaagttgtgaagtggatgtttctcatttttcttgattttcatttttcttgccatattccatgtcctacagtggaaatttctaaattttccacctttttcagttttcctcgccatatttcacgtcctaaagtgtgtatttctcattttccgtgattttcagttttctcgccatattccaggtcctacagtgtgcatttctcatttttcacgtttttcagtgatttcgacatttttcaagttgtcaagtggatgtttctcattttccatgattttcagctttcttgccatattcaaagtcctacagtggacatttctaaattttcgacctttatcagttttcctcgccatatttcatgtcccaaagtgtgtacttctcattttccgtgattttcagtttcctcgccatattccaggtcctacagtgtgcatttctcatttttcacgtttttcagtgatttcgtcatttttcaagtcgtcaagtggatgtttctcattttccatgattttcagttttcttgccatattccatgtcctacagtggacatttctaaattttccacctttttctgttttcctcgccatatttcacgtcctaaagtgtgtatttctcattttccgtgattttcagttttcttgccatattccaggtcctacagtgtgcatttctcatttatcacgtttttcactgattttgtcatttttcaagttgtcaactgcatgtttctcattttccatgattttcagttttcttgctatattccatgtcctacagtggaatattctaaattttccacctttttcagttttcctcgccatatttcacgtcctgaagtgtgtatttctcattttccgtgattttcagttttctcgccatattccaggtcctatgtgtacatttctcatttttcacgtttttcagtgattttgtcatttttcaagttgtgaagtggatgtttctcatttttcttgattttcatttttcttgccatattccatgtcctacagtggaaatttctaaattttccacctttttcagttttcctcgccatatttcacgtcctaaagtgtgaatttctcattttccgtgattttcagttttctcgccatattccaggtcctacagtgtgcatttctcatttttcacgtttttcagtgatttcgacatttttcaagttgtcaagtggatgtttctcattttccatgattttcagctttcttgccatattcaaagtcctacagtggacatttctaaattttcgacctttatcagttttcctcgccatatttcatgtcccaaagtgtgtacttctcattttccgtgattttgagtttcctcgccatattccaggtcctacagtgtgcatttctcatttttcacgtttttcagtgatttcgtcttttttcaagttgtcaactgcatgtttctcattttccatgattttcagttttcttgccatattccatgtcctacagtggaaatttgtaaatttccacctttttcagttttcctcgccatatttcacgtcctaaagtatgtatttctcattttccgtgattttcagttttctcgccatattccaggtcctacagtgtgcatttctcatttttcacgtttttcagtgattttgtcattttttaagttttcaagtggatgtttctcattttccttgattttcagttttcttgccatattccatgtcctacagtggacatttctaaattttccacctttttcagttttcctcgccatatttcatgtcctaaagtgtgtatttctcattttcagtgattttcagttttctcgccatattccaggtcctacagtgtgcatttctcatttttcacgtttttcagtgatttcgtcatttttcaaggtgtcaagtggatgtttctcattttccatgattttcagttttcttgccatattccatgtcctacagtggacatttctaaattttccacctttttctgttttcctcgccatatttcatgtcctaaagtgtgtatttctcattttccgtgattttcagttttcttgctatattccaagtcctacagtgtgcatttctcatttttcacgtttttcagtgattttgtcatttttcaatttgtcaactgcatgtttctcattttccatgattttcagtttttttgccatattccatgtcctactgtggaaatttctatattttccacctttttcagttttcctcgccatatttcacgtgctaaagtgtgtatttctcatttttcgtgtttttcaggtttctcgccatattccaggtcctacagtgtgcatttctcatttttcacgtttttcagtgattttgtcatttttcaagttttcaagtggatgtttctcattttccttgattttcagttttcttgccatattccatgtcctacagtggacatttctaaattttccacctttttcagttttccttgccatatttcatgtcctaaagtgtgtatttctcattttcagtgattttcagtttccttgccatattccaggtcctacagtgtgcatttctcattttttcacgtttttcagtgatttcgtcatttttcacgttgtcaagtggatgtttctcattttccatgattttcacttttcttgccatatttcatgtcctacagtggacatttctaaattttccaactttttcaattttcctcgccatattttatgtcctaaagtgtgtatttctcatttttcgttattttcagttttcttgccatattccaggtcctacagtgtgcatttgtcatttttcacgtttttcagtgatttcgtcatttttcaagtcgtcaagtagatgtttctcatattccatgtttttcagttttctcgccatattccaggtcctacagttgacatttctaaattttctacatttttaaattttcctcgccatatttcacgtcctaaagtgtgtatttctcattttttgttattttcagttttctagccatattccaggtcctacaggatgcatttctcatttttcacgtttttcagtgatttcatcatttttcaagtcgtcaagtgtatgtttcttattttcaatgattttcatttttcttgccttattccacgtcctatagtggacatttctaaattttccacctttttcagtttttttcgccatatttcacgtcctaaagtgtgtatttctcattttctgtgattttcagttttctcaccatattccaggtcctacagtgtgcatttctcatttttcacgtttttcagtgatttcgtcatttttcaagttgtcaagtggaagtttctcattttccatgattttcagctttctagacatattccaggtcctacagtggacatttcctaattttcgacctttatcagttttcctcgtcatatttcacgtcccaaaatgtgtatttcttattttccatgattttcagtttcctcgccatattccaggtcctacagtgtgcaattctcatttttcacgtttttcagtgatttcgtcttttttcaagacgtcaagtggatgtttctcatttttcatgattttcagttttcttgccatattccatgtcctacagtggacatttctaaattttccacctttttctgttttcctcgccatatttcacgtcctaaagtgtgtatttctcattttccgtgattttcagttttcttgccatattcctggtcctacagtgtgcatttctcatttttcacgtttttcagtgattttgtcatttttcaatttgtcaactgcatgtttctcattttccattattttcagttttcttgccatattccatgtcctacagtggacatttctaaattttccacctttttctgttttcctcgccatatttcatgtcctaaagtgtgtatttctcattttccgtgattttcagttttcttgctatattccaagtcctacagtgtgcatttctcatttttcacgtttttcagtgattttgtcatttttcaatttgtcaactgcatgtttctcattttccatgattttcagtttttttgccatattccatgtcctacaggggaaatttctatattttccacctttttcagttttcctcgccatatttcatgtcctaaagtgtgtatttctcattttccgtgattttcagttttcttgccatattccaggtcctacagtgtgcatttctcatttttcacgtttttcagtgatttcgtcatttttcaagtcttcaagtagatgtttctcatattccatgtttttcagttttctcgccatattccaggtcctacagttgacatttctaaattttctacatttttaaattttcctcgccatatttcacgtcctaaagtgtgtatttctcatttttcgttattttcagttttctagccatattccaggtcctacaggatgcatttctcatttttcacgtttttcagtgatttcatcatttttcaagtcgtcaagtgtatgtttctcattttcaatgattttcatttttcttgccttattccacgtcctatagtggacatttctaaattttccacctttttcagtttttctcgccatatttcacgtcctaaagtgtgtatttctcattttctgtgattttcagttttctcaccatattccaggtcctacagtgtgcatttctcatttttcacgtttttcagtgatttcgtcatttttcaagttgtcaagtggaagtttctcattttccatgattttcagctttctagccatattccaggtcctacagtggacatttcctaattttcgacctttatcagttttcctcgccatatttcacgtcctaaagtgtgtatttctcattttccgtgattttcagttttcttgccatattccaggtcctacagtgtgcatttctcatttttcacgtttttcagtgattttgtcatttttcaatttgtcaactgcatgtttctcattttccatgatttttagttttcttgctatattccatgtcctacagtggaaatttctaaattttccacctttttcagttttcctcgccatatttcacgtcctaaagtgtgtatttctcattttccgtgattttcagttttcttgctatattccaagtcctacattgtgcatttctcatttttcacgtttttcagtgattttgtcatttttcaatttgtcaaaccacatgtttctcattttccatgattttcagtttttttgccatattccatgtcctacagtggaaatttctatattttccacctttttcagttttcctcgccatatttcacgtgctaaagtgtgtatttctcatttttcgtgtttttcaggtttctcgccatattccaggtcctacagtgtgcatttctcatttttcacgtttttcagtgattttgtcatttttcaagttgtcaagtggatgtttcccattttccttgattttcagttttcttaccatattccatgtcctacagtggacatttctaaattttccacctttttcagttttccttgccatatttcatgtcctaaagtgtgtatttctcattttcagtgattttcagtttcctcgccatattccaggtcctacagtgtgcatttctcattttttcacgtttttcagtgatttcgtcatttttcacgttgtcaagtggatgtttctcattttccatgattttcacttttcttgccatatttcatgtcctatagtggacatttctaaattttccacctttttcagtttttctcgccatatttcacgtcctaaagtgtgtatttctcattttctgtgattttcagttttctcaccatattccaggtcctacagtgtgcatttctcatttttcacgtttttcagtgatttcgtcatttttcaagtcgtcaagtagatgtttctcatattccatgtttttcagttttctcgccatattccaggtcctacagttgacatttctaaattttctacatttttaaattttcctcgccatatttcacgtcctaaagtgtgtatttctcatttttcgttattttcagttttctagccatattccaggtcctacaggatgcatttctcatttttcacgtttttcagtgatttcatcatttttcaagtcgtcaagtgtatgtttcttattttcaatgattttcatttttcttgccttattccacgtcctatagtggacatttctaaattttccaccttttttcagtttttctcgccatatttcacgtcctaaagtgtgtatttctcattttctgtgattatcagttttctcaccatattccaggtcctacagtgtgcatttctcatttttcacgtttttcagtgatttcgtcatttttcaagttgtcaagtggaagtttctcattttccatgattttcagctttctagccatattccaggtcctacagtggacatttcctaattttcgacctttatcagttttcctcgccatatttcacgtcccaaaatgtgtatttcttattttccatgattttcagtttcctcgccatattccaggtcctacagtgtgcatttctcatttttcacgtttttcagtgatttcgtcttttttcaagacgtcaagtggatgtttctcatttttcatgattttcagttttcttgccatattccatgtcctacagtggacatttctaaattttccacctttttctgttttcctcgccatatttcacgtcctaaagtgtgtatttctcattttccgtgattttcagttttcttgccatattcctggtcctacagtgtgcatttctcatttttcacgtttttcagtgattttgtcatttttcaatttgtcaactgcatgtttctcattttccatgattttcagttttcttgccatattccatgtcctacagtggacatttctaaattttccacctttttcagttttcctcgccatatttcacgtgctaaagtgtgtatttctcatttttcgtgtttttcaggtttctcgccatattccaggtcctacagtgtgcatttctcatttttcacgtttttcagtgattttgtcatttttcaagttgtcaagtggatgtttctcattttccttgattttcacttttcttgccatattccaagtcttacaggggcatttctcatttttcacgttttcagtgattttgtcattttcaatttgtcaactgcatgtttctcattttccatgattttcagtttttttgccatattccatgtcctacaggggaaatttctatattttccacctttttcagttttcctcgccatatttcatgtcctaaagtgtgtatttctcattttccgtgattttcagttttcttgccatattccaggtcctacagtgtgcatttctcatttttcacgtttttcagtgatttcgtcatttttcaagtcttcaagtagatgtttctcatattccatgtttttcagttttctcgccatattccaggtcctacagttgacatttctaaattttctacatttttaaattttcctcgccatatttcacgtcctaaagtgtgtatttctcatttttcgttattttcagttttctagccatattccaggtcctacaggatgcatttctcatttttcacgtttttcagtgatttcatcatttttcaagtcgtcaagtgtatgtttctcattttcaatgattttcatttttcttgccttattccacgtcctatagtggacatttctaaattttccacctttttcagtttttctcgccatatttcacgtcctaaagtgtgtatttctcattttctgtgattttcagttttctcaccatattccaggtcctacagtgtgcatttctcatttttcacgtttttcagtgatttcgtcatttttcaagttgtcaagtggaagtttctcattttccatgattttcagctttctagccatattccaagtcctacagtggacatttcctaattttcgacctttatcagttttcctcgccatatttcacgtcccaaaatgtgtattccttattttccatgattttcagtttcctcgccatattccaggtcctacagtgtgcatttatcatttttcacgtttttcagtgatttcgtcttttttcaagacgtcaagtggatgtttctcatttttcatgattttcagttttcttgccatattccatgtcctacagtggacatttctaaattttccacctttttctgttttcctcgccatatttcacgtcctaaagtgtgtatttctcattttccgtgattttcagttttcttgccatattcctggtcctacagtgtgcatttctcatttttcacgtttttcagtgattttgtcatttttcaagttgtcaagtggatgtttctcattttccttgattttcacttttcttgccatattccatgtcctacagtggacatttctatattttccacctttttccgttttccttgccatatttcacgtcctaaagtgtgtatttctcattttccgtgattttcaggtttctcgccatattccaggtcctacagtgtgcatttctcatttttcacgtttttcagtgattttgtcatttttcaagttgtcaagtggatgtttctcattttccttgattttcacttttcttgccatattccatgtcctacagtggacatttctaaattttccacctttttcagttttcctcgccatatttcatgtcctaaagtgtgtatttctcattttcagtgattttcagttttcttgccatattccaggtcctacagtgtgcatttctcatttttcacgtttttcagtgattttgtcatttttcaagttgtcaactgcatgtttctcattttctatgattttcagttttcttgctatattccatgtcctacagtggaaatttctaaattttccacctttttcagttttcctcgccatatttcacgtcctaaagtgtgtatttctcattttccgtgattttcagttttctcgccatattccaggtcctatgtgtacatttctcatttttcacgtttttcagtgattttgtcatttttcaagttgtgaagtggatgtttctcatttttcttgattttcatttttcttgccatattccatgtcctagagtggaaatttttaaattttccacctttttcagttttcctcgccatatttcacgtcctaaagtgtgaatttctcattttccgtgattttcagatttctcgccatattccaagtcctacagtgtgcatttctcatttttcacgtttttcagtgatttcgtcatttttcaagttgtcaagtggatgtttctcattttccatgattttcagctttcttgccatattcaaagtcctacagtggacatttctaaattttcgacctttatcagttttcctcgccatatttcatgtcccaaagtgtgtacttctcattttccgtgattttcagtttcctcgccatattctaggtcctacagtgtgcatttctcatttttcaggtttttcagtgatttcgtcttttttcaagtcgtcaagtggatgtttctcattttccatgattttcacttttcttgccatatttcatgtcctaaagtgtgtatttctcattttcagtgattttcagttttctcgctatattccaggtcctacagtgtgcatttctcattttttcacgtttttcagtgatttcgtcatttttcacgttgtcaagtggatgtttctcattttccatgattttcacttttcttgccatatttcatgtcctacagtggacatttctaaattttccacctttttctgttttcctcgccatatttcacatcctaaagtgtgtatttctcattttccgtgattttcagttttcttgccatattccaggtcctacagtgtgcatttctcatttttcacgtttttcagtgatttcgtcatttttcaagttgtcaagtggatgtttctcattttccttgattttcagttttcttgccatattccatgtcctactgtggacatttctaaattttccacctttttcagttttccttgccatatttcatgtcctaaagtgtgtatttctcattttcagtgattttcagttttctcgcaatattccaggtcctacagtgtgcatttctcattttttcaggtttttcagtgatttcgtcatttttcacgttgtcaagtggatgtttctcattttccatgattttcacttttcttgccatatttcatgtcctaaagtgtgtatttctcattttcagtgattttcagttttcctcgccatatttcacgtcccaaaatgtgtatttcttattttccatgattttcagtttcctcgccatattccaggtcctacagtgtgcatttctcatttttcacgtttttcagtgatttcgtcttttttcaagacgtcaagtggatgtttctcatttttcatgattttcagttttcttgccatattccatgtcctacagtggacatttctaaattttccacctttttctgttttcctcgccatatttcacgtcctaaagtgtgtatttctcattttccgtgattttcagttttcttgccatattcctggtcctacagtgtgcatttctcatttttcacgtttttcagtgattttgtcatttttcaatttgtcaactgcatgtttctcattttccatgattttcagttttcttgccatattccatgtcctacagtggacatttctaaattttccacctttttcagttttcctcgccatatttcacgtgctaaagtgtgtatttctcatttttcgtgtttttcaggtttctcgccatattccaggtcctacagtgtgcatttctcatttttcacgtttttcagtgattttgtcatttttcaagttgtcaagtggatgtttctcattttccttgattttcacttttcttgccatattccatgtcctacagtggacatttctaaattttccacctttttcagttttcctcgccatatttcatgtcctaaagtgtgtatttctcattttcagtgattttcagttttctcgccatattccaggtcctacagtgtgcatttctcatttttcacgtttttcagtgatttcgtcttttttcaagacgtcaagtggatgtttctcattttccatgattttcagttttcttgccatattccatgtcctacagtggacatttctaaattttccacctttttctgttttcctcgccatatttcacgtcctaaagtgtgtatttctcattttccgtgattttcagttttcttgccatattccaggtcctacagtgtgcatttctcatttttcacgtttttcagtgattttgtcatttttcaatttgtcaactgcatgtttctcattttccatgatttttagttttcttgctatattccatgtcctacagtggaaatttctaaattttccacctttttcagttttcctcgccatatttcacgtcctaaagtgtgtatttctcattttccgtgattttcagttttcttgctatattccaagtcctacattgtgcatttctcatttttcacgtttttcagtgattttgtcatttttcaatttgtcaaaccacatgtttctcattttccatgattttcagtttttttgccatattccatgtcctacagtggaaatttctatattttccacctttttcagttttcctcgccatatttcacgtgctaaagtgtgtatttctcatttttcgtgtttttcaggtttctcgccatattccaggtcctacagtgtgcatttctcatttttcacgtttttctgtgattttgtcatttttcaagttgtcaagtggatgtttctcattttccttgattttcagttttcttaccatattccatgtcctacagtggacatttctaaattttccaccttttctgttttcctcgccatatttcatgtcctaaagtgtgtatttctcattttccgtgattttcatttttcttgctatattccaagtcctacagtgtgcatttctcattttccatgattttcagttttcttgctatattccatgtcctacagtggaaatttctaaattttccacctttttcagttttcctcgccatatttcacgtcctaaagtgtgtatttctcattttccgtgattttcagttttttcgccatattacaggtcctatgtgtacatttctcatttttcacgtttttcagtgattttgtcatttttcaagttgtcaagtggatgtttctcatttttcttgattttcatttttcttgccatattccatgtcctacagtggaaatttctaaattttccacctttttcagttttcctcgccatatttcacgtcctaaagtgtgaatttctcattttccgtgattttcagttttctcgccatattccaggtctacagtgtgcatttctcatttttcacgttttcagtgattcgtcatttttcaagttgacaagtggatgtttctcattttccatgattttcagctttcttgccatattcaaagtcctacagtggacatttctaaattttcgacctttatcagttttcctcgccatatttcatgtcccaaagtgtgtacttctcattttccgtgattttcagttttcttgccatattccaagtcctacagtgtgcatttctcatttttcacgtttttcagtgattttgtcatttttcaatttgtcaactgcatgtttctcattttccatgattttcagttttcttgccatattccatgtcctacagtggaaatttctatattttccacctttttcagttttcctcgccatatttcacgtgctaaagtgtgtatttctcatttttcgtgtttttcaggtttctcgccatattccaggtcctacagtgtgcatttctcatttttcacgtttttcagtgattttgtcatttttcaagttgtcaagtggatgtttctcattttcaatgattttcatttttcttgccttattccacgtcctatagtggacatttctaaattttccacctttttcagtttttctcgccatatttcacgtcccaaaatgtgtattccttattttccatgattttcagtttcctcgccatattccaggtcctacagtgtgcatttctcatttttcacgtttttcagtgatttcgtcttttttcaagacgtcaagtggatgtttctcatttttcatgattttcagttttcttgccatattccctgtcctacagtggacatttctaaattttccacctttttctgttttcctcgccatatttcacgtcctaaagtgtgtatttctcattttccgtgattttcagttttctcgccagattccaggtcctacagtgtgcatttctcatttttcacgtttttcagtgattttgtcatttttcaatttgtcaactgcatgtttctctctttccatgattttcagttttcttgccatattccatgtcctacagtggacatttctaaattttccacctttttcagttttcctcgccatatttcacgtgctaaagtgtgtatttctcatttttcgtgtttttcaggtttctcgccatattccaggtcctacagtgtgcatttctcatttttcacgtttttcagtgattttgtcatttttcaagttgtcaagtggatgtttctcattttcaatgattttcatttttcttaccttattccacgtcctatagtggacatttctaaattttccacctttttcagtttttctcgccatatttcacgtcccaaaatgtgtattccttattttccatgattttcagtttcctcgccatattccaggtcctacagtgtgcatttctcatttttcacgtttttcagtgatttcgtcttttttcaagacgtcaagtggatgtttctcatttttcatgattttcagttttcttgccatattccctgtcctacagtggacatttctaaattttccacctttttctgttttcctcgccatatttcacgtcctaaagtgtgtatttctcattttccgtgattttcagttttctcgccagattccaggtcctacagtgtgcatttctcatttttcacgtttttcagtgatttcgtcatttttcaagtcttcaagtgtatgtttctcattttcaatgattttcatttttcttgccttattccacgtcctatagtggacatttctaaattttccacctttttcagtttttctcgccatatttcacgtcctaaagtgtgtatttctcattttctgtgattttcagttttcttaccatattccaggtcctacagtgtgcatttctcatttttcacgtttttcagtgatttcgtcatttttcaagttgtcaagtggaagtttctcattttccatgattttcagctttctagccatattccaggtattacagtggacatttccttattttcgacctttatcagttttcctcgccatatttcatgtcctaaagtgtgt	38399	1554	4%	7300	19%
9	3000001	3038400	Atcctacagtgtgcatttctcatttttcacgtttttcagtgatttcgtcatttttcaagtcatcaagtggctgtttctcattttccatgattttcagttttcttgccatattccttgtcctacagtggacatttctaaattttccacctttttcagttttccttgtcatatttcaggtcctacagtgtgtatttctcatttttcacgtttttcattgatttcgtcatttttcaagttgtcaagtgcatgtttctcattttccatgattttcagttttcttgccatattccatgtcctacaatggacatttctaaattttccaactttttcagttttcctcgccatatttcacgtcctaaagtgtgtatttctcattttccgtgattttcagttttctcgacatattccaggtcctacagtgtgcatttctcatttttcacgtttttcagtgatttcgtcatttttcacgtcgtcaagtggatgtttctcattttccatgattttcagttttcttgccatattccatgtcctacagtggacatttctaaattttccacctttttcagttttcctcgccatatttcacgtcctaaagtgtgtatttctcattttccgtgattttcagttttctcgacatattccaggtcttacagggtgcatttctcatttttcacgtttttcagtgatttcatcatttttcaagtcgtcaactgtatgtttctcattttcaatgattttcatttttcttgccatattccacgtcctatagtggacatttctaaattttccacctttttcagttttccttgccatatttcaggtcctacagtgtgcatttctcatttttcacgtttttcagtgatttcgtcatttttcaagtggtcaaatgcatgtttctcattttccatgattttcagttttcttgccatattccatgtcctacagtggacatttctaaattttccacctttttcagttttcctcgccatatttcacgtcctaaagtgtgtatttctcattttccgtgattttcagttttatcgccagattccaggtcctacggtgtgcatttttcatatttcacgtttttcagtgattttgtcatttttcaagttgtcaactgcatgtttctcattttccatgattttcagttttcttgccatattccatgtcctacagtggacatttctaaattttccacctttttcagttttcctcgccatatttcatgtcctaaagtgtgtatttctcattttcagtgattttctgttttctcgccatattccaggtcctacagtgtgcatttctcatttttcacgtttttcagtgatttcgtcatttttcaagttgtcaagtggatgtttctcattttccatgattttcagttttcttgccatattccatgtcctacaatggacatttctaaattttccacctttttcagttttcctcgccatatttcacgtcctaaagtgtgtatttctcattttccgtgattttcagttttctcgccatattccaggtcctatgtgtacatttctcatttttcacgtttttcagtgattttgtcatttttcaagttgtgaagtggatgtttctcatttttcttgattttcatttttcttgccatattccatgtcctagagtggaaatttttaaattttccacctttttcagttttcctcgccatatttcacgtcctaaagtgtgaatttctcattttccgtgattttcagttttctcgccatattccaagtcctacagtgtgcatttctcatttttcacgtttttcagtgatttcgtcatttttcaagttgtcaagtggatgtttctcattttccatgattttcagctttcttgccatattcaaagtcctacagtggacatttctaaattttcgacctttatcagttttcctcgccatatttcatgtcccaaagtgtgtacttctcattttccgtgattttcagtttcctcgccatattctaggtcctacagtgtgcatttctcatttttcaggtttttcagtgatttcgtcttttttcaagtcgtcaagtggatgtttctcattttccatgattttcagttttcttgccatattccatgtcctacagtggacatttctaaattttccaactttttcagttttcctcgccatatttcatgtcctaaagtgtgtatttctcattttcagtgattttcagttttctcgccatattccaggtcctacagtgtgcatttctcatttttcacgtttttcagtgatttcgtcatttttcaagttgtcaagtggatgtttctcatttttcatgattttcagttttcttgccatattccatgtcccacagtggacatttctaaatgttccacctttttctgttttccttgccatatttcatgtcctaaagtgtgtatttctcattttccgtgattttcagttttcttgctatattccaagtcctacagtgtgcatttctcatttttcacgtttttctgtgattttttcatttttcaatttgtcaactgcatgtttctcattttccatgattttcagttttcttgccatattccaggtcctacagtgtgcatttctcatttttcacgtttttcagtgattttgtcatttttcaagttgtcaactgcatgtttctcattttccatgattttcagttttcttgctatattccatgtcctacagtggaaatttctaaattttccacctttttcagttttcctcgccatatttcacgtcctaaagtgtgtatttctcattttccgtgattttcagttttctcgccatattccaggtcctatgtgtacatttctcatttttcacgtttttcagtgattttgtcatttttcaagttgtgaagtggatgtttctcatttttcttgattttcatttttcttgccatattccatgtcctagagtggaaatttttaaattttccacctttttcagttttcctcgccatatttcacgtcctaaattgtgaatttctcattttccgtgattttcagttttctcgccatattccaagtcctacagtgtgcatttctcatttttcacgtttttcagtgatttcgtcatttttcaagttgtcaagtggatgtttctcattttccatgattttcagctttcttgccatattcaaagtcctacagtggacatttctaaattttcgacctttatcagttttcctcgccatatttcatgtcccaaagtgtgtacttctcattttccgtgattttcagtttcctcgccatattctaggtcctacagtgtgcatttctcatttttcaggtttttcagtgatttcgtcttttttcaagtcgtcaagtggatgtttctcattttccatgattttcagttttcttgccatattccatgtcctacagtggacatttctaaattttccacctttttcagttttcctcgccatatttcatgtcctaaagtgtgtatttctcattttcagtgattttcagttttctcgccatattccaggtcctacagtgtgcatttctcatttttcacgtttttcagtgattttgtcatttttcaagttgtcaagtggatgtttctcattttccttgattttcagttttcttgccatattccatgtcctacagtggacatttctaaattttccacctttttcagttttccttgccatatttcatgtcctaaagtgtgtatttctcattttcagtgattttcagttttctcgccatattccaggtcctacagtgtgcatttctcattttttcaggtttttcagtgatttcgtcatttttcacgttgtcaagtggatgtttctcattttccatgattttcacttttcttgccatatttcatgtcctaaagtgtgtatttctcattttcagtgattttcagttttctcgccatattccaggtcctacagtgtgcatttctcattttttcacgtttttcagtgatttcgtcatttttcacgttgtcaagtggatgtttctcattttccattattttcacttttcttgccatatttcatgtcctacagtggacatttctaaattttccacctttttctgttttcctcgccatatttcacatcctaaagtgtgtatttctcattttccgtgattttcagttttcttgccatattccaggtcctacagtgtgcatttctcatttttcacgtttttcagtgatttcgtcatttttcaagtcgtcaagtggatgtttctcattttccatgattttcagttttctcgccatattccaggtcctacagttgacatttctaaattttccacattttttatgtttcctcgcgatatttcacatcctaaagtgtgtatttctcattttccgtgattttcagttttcttgccatattccaggtcctacagggtgcatttctcatttttcacgtttttcagtgatttcatcaatttcaagtcgtcaactgtatgtttctcattttcaatgattttcatttttcttgccatattccacgtcctatagtggacatttctacattttccacctttttcagttttcttcgccatatttcacgtcccaaagtgtgtatttctcattttccgtgattttcagtttcctcgccatattccaggtcctacagtgtgcatttctcatttttcacgtttttcagtgatttcgtcttttttcaagtcgtcaagtggatgtttctcattttccatgattttcagttttcttgccatattccatgtcctacagtggacatttctaaattttccacctttttctgttttcctcgccatatttcacgtcctaaagtgtgtatttctcatttaccgtgattttcagttttcttgctatattccaagtcctacagtgtgcatttctcatttttcacgtttttcactgattttgtcattgttcaagttgtcaactgcatgtttctcattttccatgattttcagttttcttgccatattccatgtcctacagtggaaatttctatattttccaactttttcagttttcctcgccatatttcacgtgctaaagtgtgtatttctcatttttcgtgtttttcaggtttctcgccatattccaggtcctacagtgtgcatttctcatttttcacgtttttcagtgattttgtaatttttcaagttgtcaagtggatgtttctcattttccttgattttcagttttcttgccatattccatgtcctactgtggacatttctaaattttccacctttttcagttttccttgccatatttcatgtcctaaagtgtgtatttctcattttcagtgattttcagttttctcgcaatattccaggtcctacagtgtgcatttctcattttttcaggtttttcagtgatttcgtcatttttcacgttgtcaagtggatgtttctcattttccatgattttcacttttcttgccatatttcatgtgctaaagtgtgtatttctcattttcagtgattttcagttttctgccatattccaggtcctacattgtgcatttctcattttttcacgtttttcagtgatttcgtcatttttcacgttgtcaagtggatgtttctcattttccatgattttcacttttcttgccatatttcatgttttacagtggacatttctaaattttccacctatttctgttttcctcgccatatttcacatcctaaagtgtgtatttctcattttccgtgattttcagttttctcgccatatgccaggtcatacagggtgcatttctcatttttcacgtttttcagtgatttcgtcatttttcacgtcgtcaagtggatgtttctcattttcaatgattttcatttttcttgccatattccacgtcctatagtggacatttctaaattttccacctttttcagttttccttgccatatttcaggtcctacagtgtgcatttctcttttttcacgtttttcagtgatttcgtcatttttcaagtggtcaagtgcatgtttctcattttccgtgattttcagttttcttgccatgttccaggtcctacagttgacgtttctaaaatttcactttttttaagttttcctcgccatatttcacttcctaaagtgtgtatttctcattttccgtgattttcagttttctcgccagattccaggtcctacagtgtgcatttttcatatttcacctttttcagtgattttgtcatttttcaagttgtcaactgcatgtttctcattttccatgattttcagttttcttgccatattccatgtcctactgtggacatttctaaattttccaactttttcagttttcctcgccatatttcatgtcctaaagtgtgtatttctcattttcagtgattttctgttttctcgccatattccaggtcctacagtgtgcatttctaatttttcacgtttttcagtgatttcgtcatttttcaagttgtcaagtggatgtttctcattttccatgattttcagttttcttgccatattccatgtcctacagtggacatttctaaattttccaactttttccattttcctcaccatatttcacgtcctaaagtgagtttttctcattttttgtgattttcagttttctcgacatattccaggtcctacagtgtgcatttctaattttttcttttttcagtgatttcgtcatttttcaagtggtcaagtgcatgtttctcattttccatgattttcagttttcttgccatattccatgtcctacaatggacatttctaaattttccaactttttcagttttcctcgccatatttcacgtcctaaagtgtgtatttctcattttccgtgattttcagttttctcgccatattccaggtcctacagtgtgcatttctcatttttcacgtttttcagtgatttcgtcatttttcaagttgtcaactgcatgtttctcattttccatgattttcagttttcttgccatattccatgtcttacagtggacatttttaaatttttcacatttttttaagttttcctccccatatttcacgttttaaagtgtgcatttctcattttcggtgattttcagttttctcgccagattccatgtcttacagtgtgcatttctcattttttcacgtttttcagtgatttcgtcatttttcaagtcgtcaagtggatgtttctcattttccatgattttcagttttcttgccatattccatgtcctacagtggaaatttctaaattttccacctttttcagttttccttgccatatttcaggtcctaaagtgtgtatttctcattttctgtgattttcagttttctcgccatattccaggtcctacagttgacatttctaaaatttccacattttttaagttttcctcgccatatttcacttcctaaagtgtgtatttctcattttccgtgattttcagttttctcgccatattccagatcctacagtgtacatttttcatttttcacgtttttcagtgattttgtcattttttagttgtcaactgcctgtttctcattttccatgattttcagttttcttgctatattccatgtcctacagtggaaatttctaaattttccacctttttcagttttcctcgccatatttcacgtcctaaagtgtgtatttctcattttccgtgattttcagttttctcgccatattccaggtcctatgtgtacatttctcatttttcacgtttttcagtgattttgtcatttttcaatttgtcaactgcatgtttctcattttccatgattttcagttttcttgccatattccatgtcctacagtggaaatttctatattttccaactttttcagttttcctcgccatatttcacgtgctaaagtgtgtatttctcatttttcgtgtttttcaggtttctcgccatattccaggtcctacagtgtgcatttctcatttttcacgtttttcagtgattttgtcatttttcaagttgtcaagtggatgtttctcattttccttgattttcagttttcttgccatattccatgtcctacagtggacatttctaaattttccacctttttcagttttccttgccatatttcatgtcctaaagtgtgtatttctcattttcagtgattttcagttttctcgccatattccaggtcctacagtgtgcatttctcattttttcaggtttttcagtgatttcgtcatttttcacgttgtcaagtggatgtttctcattttccatgattttcacttttcttgccatatttcatgtcctaaagtgtgtatttctcattttcagtgattttcagttttctcgctatattccaggtcctacagtgtgcatttctcattttttcacgtttttcagtgatttcgtcatttttcacgttgtcaagtggatgtttctcattttccatgattttcacttttcttgccatatttcatgtcctacaatggacatttctaaattttccacctttttctgttttcctcgccatatttcacatcctaaagtgtgtatttctcattttccgtgattttcagttttcttgccatattccaggtcctacagtgtgcatttctcatttttcacgtttttcagtgatttcgtcatttttcaagttgtcaagtggatgtttctcattttccttgattttcagttttcttgccatattccatgtcctactgtggacatttctaaattttccacctttttcagttttccttgccatatttcatgtcctaaagtgtgtatttctcattttcagtgattttcagttttctcgcaatattccaggtcctacagtgtgcatttctcattttttcaggtttttcagtgatttcgtcatttttcacgttgtcaagtggatgtttctcattttccatgattttcacttttcttgccatatttcatgtcctaaagtgtgtatttctcattttcagtgattttcagttttctgccatattccaggtcctacattgtgcatttctcattttttcacgtttttcagtgatttcgtcatttttcagttttctcgacatattccaggtcctacagtgtgcatttctaattttttcttttttcagtgatttcgtcatttttcaagttgtcaactgcatgtttctcattttccatgattttcagttttcttgccatattccatgtcttacagtggacatttttaaatttttcacatttttttaagttttcctccccatatttcacgttttaaagtgtgcatttctcattttcggtgattttcagttttctcgccagattccaggtcttacagtgtgcatttctcattttttcacgtttttcagtgatttcgtcatttttcaagtcgtcaagtggatgtttctcattttccatgattttcagttttcttgccatattccatgtcctacagtggaaatttctaaattttccacctttttcagttttccttgccatatttcaggtcctaaagtgtgtatttctcattttctgtgattttcagttttctcgccatattccaggtcctacagttgacatttctaaaatttccacattttttaagttttcctcgccatatttcacttcctaaagtgtgtatttctcattttccgtgattttcagttttctcgccatattccagatcctacagtgtgcatttttcatttttcacgtttttcagtgattttgtcattttttagttgtcaactgtctgtttctcattttccatgattttcagttttcttgccatattccatgtcctacactggacatttctaaattttccacctttttctgttttcctcgccatatttcacgtcctaaagtgtgtatttctcattttccgtgattttcagttttcttgccatattccaggtcctacagtgtgcatttctcatttttcacgtttttcagtgattttgtcatttttcaagttgtcaactgcatgtttctcattttctatgattttcagttttcttgctatattccatgtcctacagtggaaatttctaaattttccacctttttcagttttcctcgccatatttcacgtcctaaagtgtgtatttctcattttccgtgattttcagttttctcgccatattccaggtcctatgtgtacatttctcatttttcacgtttttcagtgattttgtcatttttcaagttgtgaagtggatgtttctcatttttcttgattttcatttttcttgccatattccatgtcctagagtggaaatttttaaattttccacctttttcagttttcctcgccatatttcacgtcctaaagtgtgaatttctcattttccgtgattttcagatttctcgccatattccaagtcctacagtgtgcatttctcatttttcacgtttttcagtgatttcgtcatttttcaagttgtcaagtggatgtttctcattttccatgattttcagctttcttgccatattcaaagtcctacagtggacatttctaaattttcgacctttatcagttttcctcgccatatttcatgtcccaaagtgtgtacttctcattttccgtgattttcagtttcctagccatattctaggtcctacagtgtgcatttctcatttttcaggtttttcagtgatttcgtcttttttcaagtcgtcaagtggatgtttctcattttccatgattttcacttttcttgccatatttcatgtcctaaagtgtgtatttctcattttcagtgattttcagttttctcgctatattccaggtcctacagtgtgcatttctcattttttcacgtttttcagtgatttcgtcatttttcacgttgtcaagtggatgtttctcattttccatgattttcacttttcttgccatatttcatgtcctacagtggacatttctaaattttccacctttttctgttttcctcgccatatttcacatcctaaagtgtgtatttctcattttccgtgattttcagttttcttgccatattccaggtcctacagtgtgcatttctcatttttcacgtttttcagtgatttcgtcatttttcaagttgtcaagtggatgtttctcattttccttgattttcagttttcttgccatattccatgtcctactgtggacatttctaaattttccacctttttcagttttccttgccatatttcatgtcctaaagtgtgtatttctcattttcagtgattttcagttttctcgcaatattccaggtcctacagtgtgcatttctcattttttcaggtttttcagtgatttcgtcatttttcacgttgtcaagtggatgtttctcattttccatgattttcacttttcttgccatatttcatgtcctaaagtgtgtatttctcattttcagtgattttcagttttctgccatattccaggtcctacattgtgcatttctcattttttcacgtttttcagtgatttcgtcatttttcacgttgtcaagtggatgtttctcattttccatgattttcacttttcttgccatatttcatgttttacagtggacatttctaaattttccacctttttctgttttcctcgccatatttcacatcctaaagtgtgtatttctcattttccgtgattttcagttttctcgccatatgccaggtcatacagggtgcatttctcatttttcacgtttttcagtgatttcgtcatttttcacgtcgtcaagtggatgtttctcattttcaatgattttcatttttcttgccatattccacgtcctatagtggacatttctaaattttccacctttttcagttttccttgccatatttcaggtcctacagtgtgcatttctcatttttcacgtttttcagtgatttcgtcatttttcaagtggtcaagtgcatgtttctcattttccgtgattttcagttttcttgccatgttccaggtcctacagttgacgtttctaaaatttcactttttttaagttttcctcgccatatttcacttcctaaagtgtgtatttctcattttccgtgattttcagttttctcgccagattccaggtcctacagtgtgcatttttcatatttcacctttttcagtgattttgtcatttttcaagttgtcaactgcatgtttctcattttccatgattttcagttttcttgccatattccatgtcctactgtggacatttctaaattttccaactttttcagttttcctcgccatatttcatgtcctaaagtgtgtatttctcattttcagtgattttctgttttctcgccatattccaggtcctacagtgtgcatttctaatttttcacgtttttcagtgatttcgtcatttttcaagttgtcaagtggatgtttctcattttccatgattttcagttttcttgccatattccatgtcctacagtggacatttctaaattttccaactttttccattttcctcaccatatttcacgtcctaaagtgtgtttttctcattttttgtgattttcagttttctcgacatattccaggtcctacagtgtgcatttctaattttttcttttttcagtgatttcgtcatttttcaagttgtcaactgcatgtttctcattttccatgattttcagttttcttgccatattccatgtcttacagtggacatttttaaatttttcacatttttttaagttttcctccccatatttcacgttttaaagtgtgcatttctcattttcggtgattttcagttttctcgccagattccaggtcttacagtgtgcatttctcattttttcacgtttttcagtgatttcgtcatttttcaagtcgtcaagtggatgtttctcattttccatgattttcagttttcttgccatattccatgtcctacagtggaaatttctaaattttccacctttttcagttttccttgccatatttcaggtcctaaagtgtgtatttctcattttctgtgattttcagttttctcgccatattccaggtcctacagttgacatttctaaaatttccacattttttaagttttcctcgccatatttcacttcctaaagtgtgtatttctcattttccgtgattttcagttttctcgccatattccagatcctacagtgtgcatttttcatttttcacgtttttcagtgattttgtcattttttagttgtcaactgtctgtttctcattttccatgattttcagttttcttgccatattccatgtcctacactggacatttctaaattttccacctttttctgttttcctcgccatatttcacgtcctaaagtgtgtatttctcattttccgtgattttcagttttcttgccatattccaggtcctacagtgtgcatttctcatttttcacgtttttcagtgattttgtcatttttcaagttgtcaactgcatgtttctcattttccatgattttcagttttcttgctatattccatgtcctacagtggaaatttctaaattttccacctttttcagttttcctcgccatatttcacgtcctaaagtgtgtatttctcattttccgtgattttcagttttctcgccatattccaggtcctatgtgtacatttctcatttttcacgtttttcagtgattttgtcatttttcaagttgtgaagtggatgtttctcatttttcttgattttcatttttcttgccatattccatgtcctagagtggaaatttttaaattttccacctttttcagttttcctcgccatatttcacgtcctaaagtgtgaatttctcattttccgtgattttcagatttctcgccatattccaagtcctacagtgtgcatttctcatttttcacgtttttcagtgatttcgtcatttttcaagttgtcaagtggatgtttctcattttccatgattttcagctttcttgccatattcaaagtcctacagtggacatttctaaattttcgacctttatcagttttcctcgccatatttcatgtcccaaagtgtgtacttctcattttccgtgattttcagtttcctcgccatattctaggtcctacagtgtgcatttctcatttttcaggtttttcagtgatttcgtcttttttcaagtcgtcaagtggatgtttctcattttccatgattttcagttttcttgccatattccatgtcctacagtggacatttctaaattttccacctttttcagttttcctcgccatatttcatgtcctaaagtgtgtatttctcattttcagtgattttcagttttctcgccatattccaggtcctacagtgtgcatttctcatttttcacgtttttcagtgatttcgtcatttttcaagttgtcaagtggatgtttctcattttccatgattttcagttttcttgccatattccatgtcccacagtggacatttctaaattttccacctttttctgttttccttgccatatttcatgtcctaaagtgtgtatttctcattttccgtgattttcagttttcttgctatattccaagtcctacagtgtgcatttctcatttttcacgtttttcagtgattttgtcatttttcaatttgtcaactgcatgtttctcattttccatgattttcagttttcttgccatattccatgtcctacagtggaaatttctatattttccaactttttcagttttcctcgccatatttcacgtgctaaagtgtgtatttctcatttttcgtgtttttcaggtttctcgccatattccaggtcctacagtgtgcatttctcatttttcacgtttttcagtgattttgtcatttttcaagttgtcaagtggatgtttctcattttccttgattttcagttttcttgccatattccatgtcctacagtggacatttctaaattttccacctttttcagttttccttgccatatttcatgtcctaaagtgtgtatttctcattttcagtgattttcagttttctcgccatattccaggtcctacagtgtgcatttctcattttttcaggtttttcagtgatttcgtcatttttcacgttgtcaagtggatgtttctcattttccatgattttcacttttcttgccatatttcatgtcctaaagtgtgtatttctcattttcagtgattttcagttttctcgctatattccaggtcctacagtgtgcatttctcattttttcacgtttttcagtgatttcgtcatttttcacgttgtcaagtggatgtttctcattttccatgattttcacttttcttgccatatttcatgtcctacagtggacatttctaaattttccacctttttctgttttcctcgccatatttcacatactaaagtgtgtatttctcattttccttgattttcagttttcttgccatattccaggtcctacagtgtgcatttctcatttttcacgtttttcagtgatttcgtcatttttcaagtcgtcaagtggatgtttctcattttccatgattttcagttttctcgccatattccaggtcctacagttgacatttctaaattttccacattttttaagtttcctcgcgatatttcacatcctaaagtgtgtatttctcattttccgtgattttcagttttcttgccatattccaggtcctacagggtgcatttctcatttttcacgtttttcagtgatttcatcaatttcaagtcgtcaactgtatgtttctcattttcaatgattttcatttttcttgccatattccatgtcctacagtggacatttctaaatttttcacctttttcagttttccttgccatatttcatgtcctaaagtgtgtatttctcattttcagtgattttcagttttctcgccatattccaggtcctacagtgtgcatttctcattttttcaggtttttcagtgatttcgtcatttttcacgttgtcaagtggatgtttctcattttccatgattttcacttttcttgccatatttcatgtcctaaagtgtgtatttctcattttcagtgattttcagttttctcgccatattccaggtcctacagtgtgcatttctcatttttcacgtttttcagtgatttcgtcatttttcaagttgtcaagtggatgtttctcattttccatgattttcacttttcttgccatattccatgtcccacagtggacatttctaaattttccacctttttctgttttcctcgccatatttcatgtcctaaagtgtgtatttctcattttccgtgattttcagttttcttgctatattccaagtcctacagtgtgcatttctcatttttcacgtttttcagtgattttgtcatttttcaatttgtcaactgcatgtttctcattttccatgattttcagttttcttgccatattccatgttctacagtggaaatttctatattttccaactttttcagttttcctcgccatatttcacgtgctaaagtgtgtatttctcatttttcgtgtttttcaggtttctcgccatattccaggtcctacagtgtgcatttctcatttttcacgtttttcagtgattttgtcatttttcaagttgtcaagtggatgtttctcattttccttgattttcagttttcttgccatattccatgtcctacagtggacatttctaaattttccacctttttcagttttccttgccatatttcatgtcctaaagtgtgtatttctcattttcagtgattttcagttttctcgccatattccaggtcctacagtgtgcatttctcattttttcaggtttttcagtgatttcgtcatttttcacgttgtcaagtggatgtttctcattttccatgattttcacttttcttgccatatttcatgtcctaaagtgtgtatttctcattttcagtgattttcagttttctcgctatattccaggtcctacagtgtgcatttctcattttttcacgttttgcagtgatttcgtcatttttcacgttgtcaagtggatgtttctcattttccatgattttcacttttcttgccatatttcatgtcctacagtggacatttctaaattttccacctttttctgttttcctcgccatatttcacatcctaaagtgtgtatttctcattttccgtgattttcagttttcttgccatattccaggtcctacagtgtgcatttctcatttttcacgtttttcagtgatttcgtcatttttcaagtcgtcaagtggatgtttctcattttccatgattttcagttttctcgccatattccaggtcctacagttgacatttctaaattttccacattttttaagtttcctcgcgatatttcacatcctaaagtgtgtatttctcattttccgtgattttcagttttcttgccatattccaggtcctacagggtgcatttctcatttttcacgtttttcagtgatttcatcaatttcaagtcgtcaactgtatgtttctcattttcaatgattttcatttttcttgccatattccatgtcctacagtggacatttctaaattttccacctttttcagttttccttgccatatttcatgtcctaaagtgtgtatttctcattttcagggattttcagttttctcgccatattccaggtcctacagtgtgcatttctcattttttcaggtttttcagtgatttcgtcatttttcacgttgtcaagtggatgtttctcattttccatgattttcacttttcttgccatatttcatgtcctaaagtgtgtatttctcattttcagtgattttcagttttctcgccatattccaggtcctacagtgtgcatttctcattttttcacgtttttcagtgatttcgtcatttttcacgttgtcaagtggatgtttctcattttccatgattttcacttttcttgccatatttcatgtcctacagtggacatttctaaattttccacctttttctgttttcctcgccatatttcacatcctaaagtgtgtatttctcattttccgtgattttcagttttcttgccatattccaggtcctacagtgtgcatttctcatttttcacgtttttcagtgatttcgtcatttttcaagtcgtcaagtggatgtttctcattttccatgattttcagttttctcgccatattccaggtcctacagttgacatttctaaattttccacattttttaagtttcctcgcgatatttcacatcctaaagtgtgtatttctcattttccgtgattttcagttttcttgccatattccaggtcctacagggtgcatttctcatttttcacgtttttcagtgatttcatcaatttcaagtcgtcaactgtatgtttctcattttcaatgattttcatttttcttgccatattccacgtcctatagtggacatttctaaattttccacctttttcagttttcttcgccatatttcacgtcccaaagtgtgtatttctcattttccgtgattttcagtttcctcgcaatattccaggtcctacagtgtgcatttctcatttttcacgtttttcagtgatttcgtcttttttcaagtcgtcaagtggatgtttctcattttccatgattttcagttttcttgccatattccatgtcctacagtggacatttctaaattttccacctttttctgttttcctcgccatatttcacgtcctaaagtgtgtatttctcattttccgtgattttcagttttcttgccatattccaggtcctacagtgtgcatttctcatttttcacgtttttcactgattttgtcattgttcaagttgtcaactgcatgtttctcattttccatgattttcaattttcttgccatattccatgtcctacagtggaaatttctatattttccaactttttcagttttcctcgccatatttcacgtgctaaagtgtgtatttctcatttttcgtgtttttcaggtttctcgccatattccaggtcctacagtgtgcatttctcatttttcacgtttttcagtgattttgtcatttttcaagttgtcaagtggttgtttctcattttccttgattttcagttttcttgccatattccatgtcctactgtggacatttctaaattttccacctttttcagttttccttgccatatttcatgtcctaaagtgtgtatttctcattttcagtgattttcagttttctcgcaatattccaggtcctacagtgtgcatttctcattttccgtgattttcagttttctcgccatatgccaggtcatacagggtgcatttctcatttttcacgtttttcagtgatttcgtcatttttcacgtcgtcaagtggatgtttctcattttcaatgattttcatttttcttgccatattccacgtcctatagtggacatttctaaattttccaactttttcagttttcttgccatatttcaggtcctacagtgtgcatttctcatttttcacgtttttcagtgatttcgtcatttttcaagtggtcaagtgcatgtttctgattttccgtgattttcagttttcttgccatgttccaggtcctacagttgacgtttctaaaatttcactttttttaagttttcctcgccatatttcacttcctaaagtgtgtatttctcattttccgtgattttcagttttctcgccagattccaggtcctacagtgtgcatttttcatatttcacctttttcagtgattttgtcatttttcaagttgtcaactgcatgtttctcattttccatgattttcagttttcttgccatattccatgtcctactgtggacatttctaaattttccaactttttcagttttcctcgccatatttcatgtcctaaagtgtgtatttctcattttcagtgtttttctgttttctcgccatattccaggtcctacagtgtgcatttctaatttttcacgtttttcagtgatttcgtcatttttcaagttgtcaagtggatgtttctcattttccatgattttcagttttcttgccatattccatgtcctacagtggacatttctaaattttccaactttttccattttcctcaccatatttcacgtcctaaagtgtgtttttctcattttttgtgattttcagttttctcgacatattccaggtcctacagtgtgcatttctaattttttcttttttcagtgatttcgtcatttttcaagtggtcaagtgcatgtttctcattttccatgattttcagttttcttgccatattccatgtcctacaatggacatttctaaattttccaactttttcagttttcctcgccatatttcacgtcctaaagtgtgtatttctcattttccgtgattttcagttttctcgccatattccaggtcctatgtgtacatttctcatttttcacgtttttcagtgattttgtcatttttcaagttgtgaagtggatgtttctcatttttcttgattttcatttttcttgccatattccatgtcctagagtggaaatttttaaattttccaactttttcagttttcctcgccatatttcacgtcctaaagtgtgtatttctcattttccgtgattttcagttttctcgccatattccaagtcctacagtgtgcatttctcatttttcacgtttttcagtgatttcgtcatttttcaagttgtcaagtggatgtttctcattttccatgattttcagctttcttgccatattcaaagtcctacagtggacatttctaaattttcgacctttatcagttttcctcgccatatttcatgtcccaaagtgtgtacttctcattttccgtgattttcagtttcctcgccatattctaggtcctacagtgtgcatttctcatttttcaggtttttcagtgatttcgtcttttttcaagtcgtcaagtggatgtttctcattttccatgattttcagttttcttgccatattccatgtcctacagtggacatttctaaattttccacctttttcagttttcctcgccatatttcatgtcctaaagtgtgtatttctcattttcagtgattttcagttttctcgccatattccaggtcctacagtgtgcatttctcatttttcacgtttttcagtgatttcgtcatttttcaagttgtcaagtggatgtttctcattttccatgattttcagttttcttgccatattccatgtcccacagtggacatttctaaattttccacctttttctgttttccttgccatatttcatgtcctaaagtgtgtatttctcattttccgtgattttcagttttcttgctatattccaagtcctacagtgtgcatttctcatttttcacgtttttaagtgattttgtcatttttcaatttgtcaactgcatgtttctcattttccatgattttcagttttcttgccatattccatgtcctacagtggaaatttctatattttccaactttttcagttttcctcgccatatttcacgtgctaaagtgtgtatttctcatttttcgtgtttttcaggtttctcgccatattccaggtcctacagtgtgcatttctcatttttcacgtttttcagtgattttgtcatttttcaagttgtcaagtggatgtttctcattttccttgattttcagttttcttgccatattccatgtcctacagtggacatttctaaattttccacctttttcagttttccttgccatatttcatgtcctaaagtgtgtatttctcattttcagtgattttcagttttctcgccatattccaggtcctacagtgtgcatttctcattttttcaggtttttcagtgatttcgtcatttttcacgttgtcaagtggatgtttctcattttccatgattttcacttttcttgccatatttcatgtcctaaagtgtgtatttctcattttcagtgattttcagttttctcgccatattccaggtcctacagtgtgcatttctcattttttcacgtttttcagtgatttcgtcatttttcacgttgtcaagtggatgtttctcattttccatgattttcacttttcttgccatatttcatgtcctacagtggacatttctaaattttccacctttttctgttttcctcgccatatttcacatcctaaagtgtgtatttctcattttccgtgattttcagttttcttgccatatttcaggtcctacagtgtgcatttctcatttttcacgtttttcagtgatttcgtcatttttcaagtcgtcaagaggatgtttctcattttccatgattttcagttttctcgccatattccaggtcctacagttgacatttctaaattttccacattttttaagtttcctcgcgatatttcacatcctaaagtgtgtatttctcattttccgtgattttcagttttcttgccatattccaggtcctacagggtgcatttctcatttttcacgtttttcagtgatttcatcaatttcaagtcgtcaactgtatgtttctcattttcaatgattttcatttttcttgccatattccacgtcctatagtggacatttctaaattttccacctttttctgttttcctcgccatatttcacgtcctaaagtgtgtatttctcattttccgtgattttcagttttcttgccatattccaggtcctacagtgtgcatttctcatttttcacgtttttcactgattttgtcattgttcaagttgtcaactgcatgtttctcattttccatgattttcagttttcttgccatattccatgtcctacagtggaaatttctatattttccacctttttcagttttcctcgccgtatttcatgtgctaaagtgtgtatttctcatttttcgtgtttttcaggtttctcgccatattccaggtcctacagtgtgcatttctcatttttcacgtttttcagtgattttgtcatttttcaagttgtcaactggatgtttctcattttccttgattttcagttttcttgccatattccatgtcctactgtggacatttctaaattttccacctttttcagttttccttgccatatttcatgtcctaaagtgtgtatttctcattttcagtgattttcagttttctcgcaatattccaggtcctacagtgtgcatttctcattttttcaggtttttcagtgatttcgtcatttttcacgttgtcaagtggatgtttctcattttccatgattttcacttttcttgccatatttcatgtcctaaagtgtgtatttctcattttcagtgattttcagttttctcgccatattccaggtcctacattgtgcatttctcattttttcacgtttttcagtgatttcgtcatttttcacgttgtcaagtggatgtttctcattttccatgattttcacttttcttgccatatttcatgttttacagtggacatttctaaattttccacctttttctgttttcctcgccatatttcacatcctaaagtgtgaatttctcattttccgtgattttcagttttcttgccatattccaggtcctacagtgtgcatttctcatttttcacgtttttcagtgatttcatcatttttcaagtcgtcaagtggatgtttctcattttccatgattttcagttttcttgccatattccatgtcctacagtggacatttctaaattttccacctttttctgttttcctcgccatatttcacgtcctaaagtgtgtatttctcattttccgtgattttcagttttcttgccatattccaggtcctacagtgtgcatttctcatttttcacgtttttcactgattttgtcatttttcaagttgtcaactgcatgtttctcattttccatgattttcagttttcttgctatattccatgtcctacagtggaaatttctaaattttccacctttttcagttttcctcgccatatttcacgtcctgaagtgtgtatttctcattttccgtgattttcagttttctcgccatattccaggtcctatgtgtacatttctcatttttcacgtttttcagtgattttgtcatttttcaagttgtgaagtggatgtttctcatttttcttgattttcatttttcttgccatattccatgtcctacagtggaaatttctaaattttccacctttttcagttttcctcgccatatttcacgtcctaaagtgtgtatttctcattttccgtgattttcagttttctcgccatattccaggtcctacagtgtgcatttctcatttttcacgtttttcagtgatttcgacatttttcaagttgtcaagtggatgtttctcattttccatgattttcagctttcttgccatattcaaagtcctacagtggacatttctaaattttcgacctttatcagttttcctcgccatatttcatgtcccaaagtgtgtacttctcattttccgtgattttcagtttcctcgccatattccaggtcctacagtgtgcatttctcatttttcacgtttttcagtgatttcgtcatttttcaagtcgtcaagtggatgtttctcattttccatgattttcagttttcttgccatattccatgtcctacagtggacatttctaaattttccacctttttctgttttcctcgccatatttcacgtcctaaagtgtgtatttctcattttccgtgattttcagttttcttgccatattccaggtcctacagtgtgcatttctcatttatcacgtttttcactgattttgtcatttttcaagttgtcaactgcatgtttctcattttccatgattttcagttttcttgctatattccatgtcctacagtggaatattctaaattttccacctttttcagttttcctcgccatatttcacgtcctgaagtgtgtatttctcattttccgtgattttcagttttctcgccatattccaggtcctatgtgtacatttctcatttttcacgtttttcagtgattttgtcatttttcaagttgtgaagtggatgtttctcatttttcttgattttcatttttcttgccatattccatgtcctacagtggaaatttctaaattttccacctttttcagttttcctcgccatatttcacgtcctaaagtgtgaatttctcattttccgtgattttcagttttctcgccatattccaggtcctacagtgtgcatttctcatttttcacgtttttcagtgatttcgacatttttcaagttgtcaagtggatgtttctcattttccatgattttcagctttcttgccatattcaaagtcctacagtggacatttctaaattttcgacctttatcagttttcctcgccatatttcatgtcccaaagtgtgtacttctcattttccgtgattttgagtttcctcgccatattccaggtcctacagtgtgcatttctcatttttcacgtttttcagtgatttcgtcttttttcaagttgtcaactgcatgtttctcattttccatgattttcagttttcttgccatattccatgtcctacagtggaaatttgtaaatttccacctttttcagttttcctcgccatatttcacgtcctaaagtatgtatttctcattttccgtgattttcagttttctcgccatattccaggtcctacagtgtgcatttctcatttttcacgtttttcagtgattttgtcattttttaagttttcaagtggatgtttctcattttccttgattttcagttttcttgccatattccatgtcctacagtggacatttctaaattttccacctttttcagttttcctcgccatatttcatgtcctaaagtgtgtatttctcattttcagtgattttcagttttctcgccatattccaggtcctacagtgtgcatttctcatttttcacgtttttcagtgatttcgtcatttttcaaggtgtcaagtggatgtttctcattttccatgattttcagttttcttgccatattccatgtcctacagtggacatttctaaattttccacctttttctgttttcctcgccatatttcatgtcctaaagtgtgtatttctcattttccgtgattttcagttttcttgctatattccaagtcctacagtgtgcatttctcatttttcacgtttttcagtgattttgtcatttttcaatttgtcaactgcatgtttctcattttccatgattttcagtttttttgccatattccatgtcctactgtggaaatttctatattttccacctttttcagttttcctcgccatatttcacgtgctaaagtgtgtatttctcatttttcgtgtttttcaggtttctcgccatattccaggtcctacagtgtgcatttctcatttttcacgtttttcagtgattttgtcatttttcaagttttcaagtggatgtttctcattttccttgattttcagttttcttgccatattccatgtcctacagtggacatttctaaattttccacctttttcagttttccttgccatatttcatgtcctaaagtgtgtatttctcattttcagtgattttcagtttccttgccatattccaggtcctacagtgtgcatttctcattttttcacgtttttcagtgatttcgtcatttttcacgttgtcaagtggatgtttctcattttccatgattttcacttttcttgccatatttcatgtcctacagtggacatttctaaattttccaactttttcaattttcctcgccatattttatgtcctaaagtgtgtatttctcatttttcgttattttcagttttcttgccatattccaggtcctacagtgtgcatttgtcatttttcacgtttttcagtgatttcgtcatttttcaagtcgtcaagtagatgtttctcatattccatgtttttcagttttctcgccatattccaggtcctacagttgacatttctaaattttctacatttttaaattttcctcgccatatttcacgtcctaaagtgtgtatttctcattttttgttattttcagttttctagccatattccaggtcctacaggatgcatttctcatttttcacgtttttcagtgatttcatcatttttcaagtcgtcaagtgtatgtttcttattttcaatgattttcatttttcttgccttattccacgtcctatagtggacatttctaaattttccacctttttcagtttttttcgccatatttcacgtcctaaagtgtgtatttctcattttctgtgattttcagttttctcaccatattccaggtcctacagtgtgcatttctcatttttcacgtttttcagtgatttcgtcatttttcaagttgtcaagtggaagtttctcattttccatgattttcagctttctagacatattccaggtcctacagtggacatttcctaattttcgacctttatcagttttcctcgtcatatttcacgtcccaaaatgtgtatttcttattttccatgattttcagtttcctcgccatattccaggtcctacagtgtgcaattctcatttttcacgtttttcagtgatttcgtcttttttcaagacgtcaagtggatgtttctcatttttcatgattttcagttttcttgccatattccatgtcctacagtggacatttctaaattttccacctttttctgttttcctcgccatatttcacgtcctaaagtgtgtatttctcattttccgtgattttcagttttcttgccatattcctggtcctacagtgtgcatttctcatttttcacgtttttcagtgattttgtcatttttcaatttgtcaactgcatgtttctcattttccattattttcagttttcttgccatattccatgtcctacagtggacatttctaaattttccacctttttctgttttcctcgccatatttcatgtcctaaagtgtgtatttctcattttccgtgattttcagttttcttgctatattccaagtcctacagtgtgcatttctcatttttcacgtttttcagtgattttgtcatttttcaatttgtcaactgcatgtttctcattttccatgattttcagtttttttgccatattccatgtcctacaggggaaatttctatattttccacctttttcagttttcctcgccatatttcatgtcctaaagtgtgtatttctcattttccgtgattttcagttttcttgccatattccaggtcctacagtgtgcatttctcatttttcacgtttttcagtgatttcgtcatttttcaagtcttcaagtagatgtttctcatattccatgtttttcagttttctcgccatattccaggtcctacagttgacatttctaaattttctacatttttaaattttcctcgccatatttcacgtcctaaagtgtgtatttctcatttttcgttattttcagttttctagccatattccaggtcctacaggatgcatttctcatttttcacgtttttcagtgatttcatcatttttcaagtcgtcaagtgtatgtttctcattttcaatgattttcatttttcttgccttattccacgtcctatagtggacatttctaaattttccacctttttcagtttttctcgccatatttcacgtcctaaagtgtgtatttctcattttctgtgattttcagttttctcaccatattccaggtcctacagtgtgcatttctcatttttcacgtttttcagtgatttcgtcatttttcaagttgtcaagtggaagtttctcattttccatgattttcagctttctagccatattccaggtcctacagtggacatttcctaattttcgacctttatcagttttcctcgccatatttcacgtcctaaagtgtgtatttctcattttccgtgattttcagttttcttgccatattccaggtcctacagtgtgcatttctcatttttcacgtttttcagtgattttgtcatttttcaatttgtcaactgcatgtttctcattttccatgatttttagttttcttgctatattccatgtcctacagtggaaatttctaaattttccacctttttcagttttcctcgccatatttcacgtcctaaagtgtgtatttctcattttccgtgattttcagttttcttgctatattccaagtcctacattgtgcatttctcatttttcacgtttttcagtgattttgtcatttttcaatttgtcaaaccacatgtttctcattttccatgattttcagtttttttgccatattccatgtcctacagtggaaatttctatattttccacctttttcagttttcctcgccatatttcacgtgctaaagtgtgtatttctcatttttcgtgtttttcaggtttctcgccatattccaggtcctacagtgtgcatttctcatttttcacgtttttcagtgattttgtcatttttcaagttgtcaagtggatgtttcccattttccttgattttcagttttcttaccatattccatgtcctacagtggacatttctaaattttccacctttttcagttttccttgccatatttcatgtcctaaagtgtgtatttctcattttcagtgattttcagtttcctcgccatattccaggtcctacagtgtgcatttctcattttttcacgtttttcagtgatttcgtcatttttcacgttgtcaagtggatgtttctcattttccatgattttcacttttcttgccatatttcatgtcctatagtggacatttctaaattttccacctttttcagtttttctcgccatatttcacgtcctaaagtgtgtatttctcattttctgtgattttcagttttctcaccatattccaggtcctacagtgtgcatttctcatttttcacgtttttcagtgatttcgtcatttttcaagtcgtcaagtagatgtttctcatattccatgtttttcagttttctcgccatattccaggtcctacagttgacatttctaaattttctacatttttaaattttcctcgccatatttcacgtcctaaagtgtgtatttctcatttttcgttattttcagttttctagccatattccaggtcctacaggatgcatttctcatttttcacgtttttcagtgatttcatcatttttcaagtcgtcaagtgtatgtttcttattttcaatgattttcatttttcttgccttattccacgtcctatagtggacatttctaaattttccaccttttttcagtttttctcgccatatttcacgtcctaaagtgtgtatttctcattttctgtgattatcagttttctcaccatattccaggtcctacagtgtgcatttctcatttttcacgtttttcagtgatttcgtcatttttcaagttgtcaagtggaagtttctcattttccatgattttcagctttctagccatattccaggtcctacagtggacatttcctaattttcgacctttatcagttttcctcgccatatttcacgtcccaaaatgtgtatttcttattttccatgattttcagtttcctcgccatattccaggtcctacagtgtgcatttctcatttttcacgtttttcagtgatttcgtcttttttcaagacgtcaagtggatgtttctcatttttcatgattttcagttttcttgccatattccatgtcctacagtggacatttctaaattttccacctttttctgttttcctcgccatatttcacgtcctaaagtgtgtatttctcattttccgtgattttcagttttcttgccatattcctggtcctacagtgtgcatttctcatttttcacgtttttcagtgattttgtcatttttcaatttgtcaactgcatgtttctcattttccatgattttcagttttcttgccatattccatgtcctacagtggacatttctaaattttccacctttttcagttttcctcgccatatttcacgtgctaaagtgtgtatttctcatttttcgtgtttttcaggtttctcgccatattccaggtcctacagtgtgcatttctcatttttcacgtttttcagtgattttgtcatttttcaagttgtcaagtggatgtttctcattttccttgattttcacttttcttgccatattccaagtcttacaggggcatttctcatttttcacgttttcagtgattttgtcattttcaatttgtcaactgcatgtttctcattttccatgattttcagtttttttgccatattccatgtcctacaggggaaatttctatattttccacctttttcagttttcctcgccatatttcatgtcctaaagtgtgtatttctcattttccgtgattttcagttttcttgccatattccaggtcctacagtgtgcatttctcatttttcacgtttttcagtgatttcgtcatttttcaagtcttcaagtagatgtttctcatattccatgtttttcagttttctcgccatattccaggtcctacagttgacatttctaaattttctacatttttaaattttcctcgccatatttcacgtcctaaagtgtgtatttctcatttttcgttattttcagttttctagccatattccaggtcctacaggatgcatttctcatttttcacgtttttcagtgatttcatcatttttcaagtcgtcaagtgtatgtttctcattttcaatgattttcatttttcttgccttattccacgtcctatagtggacatttctaaattttccacctttttcagtttttctcgccatatttcacgtcctaaagtgtgtatttctcattttctgtgattttcagttttctcaccatattccaggtcctacagtgtgcatttctcatttttcacgtttttcagtgatttcgtcatttttcaagttgtcaagtggaagtttctcattttccatgattttcagctttctagccatattccaagtcctacagtggacatttcctaattttcgacctttatcagttttcctcgccatatttcacgtcccaaaatgtgtattccttattttccatgattttcagtttcctcgccatattccaggtcctacagtgtgcatttatcatttttcacgtttttcagtgatttcgtcttttttcaagacgtcaagtggatgtttctcatttttcatgattttcagttttcttgccatattccatgtcctacagtggacatttctaaattttccacctttttctgttttcctcgccatatttcacgtcctaaagtgtgtatttctcattttccgtgattttcagttttcttgccatattcctggtcctacagtgtgcatttctcatttttcacgtttttcagtgattttgtcatttttcaagttgtcaagtggatgtttctcattttccttgattttcacttttcttgccatattccatgtcctacagtggacatttctatattttccacctttttccgttttccttgccatatttcacgtcctaaagtgtgtatttctcattttccgtgattttcaggtttctcgccatattccaggtcctacagtgtgcatttctcatttttcacgtttttcagtgattttgtcatttttcaagttgtcaagtggatgtttctcattttccttgattttcacttttcttgccatattccatgtcctacagtggacatttctaaattttccacctttttcagttttcctcgccatatttcatgtcctaaagtgtgtatttctcattttcagtgattttcagttttcttgccatattccaggtcctacagtgtgcatttctcatttttcacgtttttcagtgattttgtcatttttcaagttgtcaactgcatgtttctcattttctatgattttcagttttcttgctatattccatgtcctacagtggaaatttctaaattttccacctttttcagttttcctcgccatatttcacgtcctaaagtgtgtatttctcattttccgtgattttcagttttctcgccatattccaggtcctatgtgtacatttctcatttttcacgtttttcagtgattttgtcatttttcaagttgtgaagtggatgtttctcatttttcttgattttcatttttcttgccatattccatgtcctagagtggaaatttttaaattttccacctttttcagttttcctcgccatatttcacgtcctaaagtgtgaatttctcattttccgtgattttcagatttctcgccatattccaagtcctacagtgtgcatttctcatttttcacgtttttcagtgatttcgtcatttttcaagttgtcaagtggatgtttctcattttccatgattttcagctttcttgccatattcaaagtcctacagtggacatttctaaattttcgacctttatcagttttcctcgccatatttcatgtcccaaagtgtgtacttctcattttccgtgattttcagtttcctcgccatattctaggtcctacagtgtgcatttctcatttttcaggtttttcagtgatttcgtcttttttcaagtcgtcaagtggatgtttctcattttccatgattttcacttttcttgccatatttcatgtcctaaagtgtgtatttctcattttcagtgattttcagttttctcgctatattccaggtcctacagtgtgcatttctcattttttcacgtttttcagtgatttcgtcatttttcacgttgtcaagtggatgtttctcattttccatgattttcacttttcttgccatatttcatgtcctacagtggacatttctaaattttccacctttttctgttttcctcgccatatttcacatcctaaagtgtgtatttctcattttccgtgattttcagttttcttgccatattccaggtcctacagtgtgcatttctcatttttcacgtttttcagtgatttcgtcatttttcaagttgtcaagtggatgtttctcattttccttgattttcagttttcttgccatattccatgtcctactgtggacatttctaaattttccacctttttcagttttccttgccatatttcatgtcctaaagtgtgtatttctcattttcagtgattttcagttttctcgcaatattccaggtcctacagtgtgcatttctcattttttcaggtttttcagtgatttcgtcatttttcacgttgtcaagtggatgtttctcattttccatgattttcacttttcttgccatatttcatgtcctaaagtgtgtatttctcattttcagtgattttcagttttcctcgccatatttcacgtcccaaaatgtgtatttcttattttccatgattttcagtttcctcgccatattccaggtcctacagtgtgcatttctcatttttcacgtttttcagtgatttcgtcttttttcaagacgtcaagtggatgtttctcatttttcatgattttcagttttcttgccatattccatgtcctacagtggacatttctaaattttccacctttttctgttttcctcgccatatttcacgtcctaaagtgtgtatttctcattttccgtgattttcagttttcttgccatattcctggtcctacagtgtgcatttctcatttttcacgtttttcagtgattttgtcatttttcaatttgtcaactgcatgtttctcattttccatgattttcagttttcttgccatattccatgtcctacagtggacatttctaaattttccacctttttcagttttcctcgccatatttcacgtgctaaagtgtgtatttctcatttttcgtgtttttcaggtttctcgccatattccaggtcctacagtgtgcatttctcatttttcacgtttttcagtgattttgtcatttttcaagttgtcaagtggatgtttctcattttccttgattttcacttttcttgccatattccatgtcctacagtggacatttctaaattttccacctttttcagttttcctcgccatatttcatgtcctaaagtgtgtatttctcattttcagtgattttcagttttctcgccatattccaggtcctacagtgtgcatttctcatttttcacgtttttcagtgatttcgtcttttttcaagacgtcaagtggatgtttctcattttccatgattttcagttttcttgccatattccatgtcctacagtggacatttctaaattttccacctttttctgttttcctcgccatatttcacgtcctaaagtgtgtatttctcattttccgtgattttcagttttcttgccatattccaggtcctacagtgtgcatttctcatttttcacgtttttcagtgattttgtcatttttcaatttgtcaactgcatgtttctcattttccatgatttttagttttcttgctatattccatgtcctacagtggaaatttctaaattttccacctttttcagttttcctcgccatatttcacgtcctaaagtgtgtatttctcattttccgtgattttcagttttcttgctatattccaagtcctacattgtgcatttctcatttttcacgtttttcagtgattttgtcatttttcaatttgtcaaaccacatgtttctcattttccatgattttcagtttttttgccatattccatgtcctacagtggaaatttctatattttccacctttttcagttttcctcgccatatttcacgtgctaaagtgtgtatttctcatttttcgtgtttttcaggtttctcgccatattccaggtcctacagtgtgcatttctcatttttcacgtttttctgtgattttgtcatttttcaagttgtcaagtggatgtttctcattttccttgattttcagttttcttaccatattccatgtcctacagtggacatttctaaattttccaccttttctgttttcctcgccatatttcatgtcctaaagtgtgtatttctcattttccgtgattttcatttttcttgctatattccaagtcctacagtgtgcatttctcattttccatgattttcagttttcttgctatattccatgtcctacagtggaaatttctaaattttccacctttttcagttttcctcgccatatttcacgtcctaaagtgtgtatttctcattttccgtgattttcagttttttcgccatattacaggtcctatgtgtacatttctcatttttcacgtttttcagtgattttgtcatttttcaagttgtcaagtggatgtttctcatttttcttgattttcatttttcttgccatattccatgtcctacagtggaaatttctaaattttccacctttttcagttttcctcgccatatttcacgtcctaaagtgtgaatttctcattttccgtgattttcagttttctcgccatattccaggtctacagtgtgcatttctcatttttcacgttttcagtgattcgtcatttttcaagttgacaagtggatgtttctcattttccatgattttcagctttcttgccatattcaaagtcctacagtggacatttctaaattttcgacctttatcagttttcctcgccatatttcatgtcccaaagtgtgtacttctcattttccgtgattttcagttttcttgccatattccaagtcctacagtgtgcatttctcatttttcacgtttttcagtgattttgtcatttttcaatttgtcaactgcatgtttctcattttccatgattttcagttttcttgccatattccatgtcctacagtggaaatttctatattttccacctttttcagttttcctcgccatatttcacgtgctaaagtgtgtatttctcatttttcgtgtttttcaggtttctcgccatattccaggtcctacagtgtgcatttctcatttttcacgtttttcagtgattttgtcatttttcaagttgtcaagtggatgtttctcattttcaatgattttcatttttcttgccttattccacgtcctatagtggacatttctaaattttccacctttttcagtttttctcgccatatttcacgtcccaaaatgtgtattccttattttccatgattttcagtttcctcgccatattccaggtcctacagtgtgcatttctcatttttcacgtttttcagtgatttcgtcttttttcaagacgtcaagtggatgtttctcatttttcatgattttcagttttcttgccatattccctgtcctacagtggacatttctaaattttccacctttttctgttttcctcgccatatttcacgtcctaaagtgtgtatttctcattttccgtgattttcagttttctcgccagattccaggtcctacagtgtgcatttctcatttttcacgtttttcagtgattttgtcatttttcaatttgtcaactgcatgtttctctctttccatgattttcagttttcttgccatattccatgtcctacagtggacatttctaaattttccacctttttcagttttcctcgccatatttcacgtgctaaagtgtgtatttctcatttttcgtgtttttcaggtttctcgccatattccaggtcctacagtgtgcatttctcatttttcacgtttttcagtgattttgtcatttttcaagttgtcaagtggatgtttctcattttcaatgattttcatttttcttaccttattccacgtcctatagtggacatttctaaattttccacctttttcagtttttctcgccatatttcacgtcccaaaatgtgtattccttattttccatgattttcagtttcctcgccatattccaggtcctacagtgtgcatttctcatttttcacgtttttcagtgatttcgtcttttttcaagacgtcaagtggatgtttctcatttttcatgattttcagttttcttgccatattccctgtcctacagtggacatttctaaattttccacctttttctgttttcctcgccatatttcacgtcctaaagtgtgtatttctcattttccgtgattttcagttttctcgccagattccaggtcctacagtgtgcatttctcatttttcacgtttttcagtgatttcgtcatttttcaagtcttcaagtgtatgtttctcattttcaatgattttcatttttcttgccttattccacgtcctatagtggacatttctaaattttccacctttttcagtttttctcgccatatttcacgtcctaaagtgtgtatttctcattttctgtgattttcagttttcttaccatattccaggtcctacagtgtgcatttctcatttttcacgtttttcagtgatttcgtcatttttcaagttgtcaagtggaagtttctcattttccatgattttcagctttctagccatattccaggtattacagtggacatttccttattttcgacctttatcagttttcctcgccatatttcatgtcctaaagtgtgt	38399	1554	4%	7300	19%
9	3000001	3038400	Atcctacagtgtgcatttctcatttttcacgtttttcagtgatttcgtcatttttcaagtcatcaagtggctgtttctcattttccatgattttcagttttcttgccatattccttgtcctacagtggacatttctaaattttccacctttttcagttttccttgtcatatttcaggtcctacagtgtgtatttctcatttttcacgtttttcattgatttcgtcatttttcaagttgtcaagtgcatgtttctcattttccatgattttcagttttcttgccatattccatgtcctacaatggacatttctaaattttccaactttttcagttttcctcgccatatttcacgtcctaaagtgtgtatttctcattttccgtgattttcagttttctcgacatattccaggtcctacagtgtgcatttctcatttttcacgtttttcagtgatttcgtcatttttcacgtcgtcaagtggatgtttctcattttccatgattttcagttttcttgccatattccatgtcctacagtggacatttctaaattttccacctttttcagttttcctcgccatatttcacgtcctaaagtgtgtatttctcattttccgtgattttcagttttctcgacatattccaggtcttacagggtgcatttctcatttttcacgtttttcagtgatttcatcatttttcaagtcgtcaactgtatgtttctcattttcaatgattttcatttttcttgccatattccacgtcctatagtggacatttctaaattttccacctttttcagttttccttgccatatttcaggtcctacagtgtgcatttctcatttttcacgtttttcagtgatttcgtcatttttcaagtggtcaaatgcatgtttctcattttccatgattttcagttttcttgccatattccatgtcctacagtggacatttctaaattttccacctttttcagttttcctcgccatatttcacgtcctaaagtgtgtatttctcattttccgtgattttcagttttatcgccagattccaggtcctacggtgtgcatttttcatatttcacgtttttcagtgattttgtcatttttcaagttgtcaactgcatgtttctcattttccatgattttcagttttcttgccatattccatgtcctacagtggacatttctaaattttccacctttttcagttttcctcgccatatttcatgtcctaaagtgtgtatttctcattttcagtgattttctgttttctcgccatattccaggtcctacagtgtgcatttctcatttttcacgtttttcagtgatttcgtcatttttcaagttgtcaagtggatgtttctcattttccatgattttcagttttcttgccatattccatgtcctacaatggacatttctaaattttccacctttttcagttttcctcgccatatttcacgtcctaaagtgtgtatttctcattttccgtgattttcagttttctcgccatattccaggtcctatgtgtacatttctcatttttcacgtttttcagtgattttgtcatttttcaagttgtgaagtggatgtttctcatttttcttgattttcatttttcttgccatattccatgtcctagagtggaaatttttaaattttccacctttttcagttttcctcgccatatttcacgtcctaaagtgtgaatttctcattttccgtgattttcagttttctcgccatattccaagtcctacagtgtgcatttctcatttttcacgtttttcagtgatttcgtcatttttcaagttgtcaagtggatgtttctcattttccatgattttcagctttcttgccatattcaaagtcctacagtggacatttctaaattttcgacctttatcagttttcctcgccatatttcatgtcccaaagtgtgtacttctcattttccgtgattttcagtttcctcgccatattctaggtcctacagtgtgcatttctcatttttcaggtttttcagtgatttcgtcttttttcaagtcgtcaagtggatgtttctcattttccatgattttcagttttcttgccatattccatgtcctacagtggacatttctaaattttccaactttttcagttttcctcgccatatttcatgtcctaaagtgtgtatttctcattttcagtgattttcagttttctcgccatattccaggtcctacagtgtgcatttctcatttttcacgtttttcagtgatttcgtcatttttcaagttgtcaagtggatgtttctcatttttcatgattttcagttttcttgccatattccatgtcccacagtggacatttctaaatgttccacctttttctgttttccttgccatatttcatgtcctaaagtgtgtatttctcattttccgtgattttcagttttcttgctatattccaagtcctacagtgtgcatttctcatttttcacgtttttctgtgattttttcatttttcaatttgtcaactgcatgtttctcattttccatgattttcagttttcttgccatattccaggtcctacagtgtgcatttctcatttttcacgtttttcagtgattttgtcatttttcaagttgtcaactgcatgtttctcattttccatgattttcagttttcttgctatattccatgtcctacagtggaaatttctaaattttccacctttttcagttttcctcgccatatttcacgtcctaaagtgtgtatttctcattttccgtgattttcagttttctcgccatattccaggtcctatgtgtacatttctcatttttcacgtttttcagtgattttgtcatttttcaagttgtgaagtggatgtttctcatttttcttgattttcatttttcttgccatattccatgtcctagagtggaaatttttaaattttccacctttttcagttttcctcgccatatttcacgtcctaaattgtgaatttctcattttccgtgattttcagttttctcgccatattccaagtcctacagtgtgcatttctcatttttcacgtttttcagtgatttcgtcatttttcaagttgtcaagtggatgtttctcattttccatgattttcagctttcttgccatattcaaagtcctacagtggacatttctaaattttcgacctttatcagttttcctcgccatatttcatgtcccaaagtgtgtacttctcattttccgtgattttcagtttcctcgccatattctaggtcctacagtgtgcatttctcatttttcaggtttttcagtgatttcgtcttttttcaagtcgtcaagtggatgtttctcattttccatgattttcagttttcttgccatattccatgtcctacagtggacatttctaaattttccacctttttcagttttcctcgccatatttcatgtcctaaagtgtgtatttctcattttcagtgattttcagttttctcgccatattccaggtcctacagtgtgcatttctcatttttcacgtttttcagtgattttgtcatttttcaagttgtcaagtggatgtttctcattttccttgattttcagttttcttgccatattccatgtcctacagtggacatttctaaattttccacctttttcagttttccttgccatatttcatgtcctaaagtgtgtatttctcattttcagtgattttcagttttctcgccatattccaggtcctacagtgtgcatttctcattttttcaggtttttcagtgatttcgtcatttttcacgttgtcaagtggatgtttctcattttccatgattttcacttttcttgccatatttcatgtcctaaagtgtgtatttctcattttcagtgattttcagttttctcgccatattccaggtcctacagtgtgcatttctcattttttcacgtttttcagtgatttcgtcatttttcacgttgtcaagtggatgtttctcattttccattattttcacttttcttgccatatttcatgtcctacagtggacatttctaaattttccacctttttctgttttcctcgccatatttcacatcctaaagtgtgtatttctcattttccgtgattttcagttttcttgccatattccaggtcctacagtgtgcatttctcatttttcacgtttttcagtgatttcgtcatttttcaagtcgtcaagtggatgtttctcattttccatgattttcagttttctcgccatattccaggtcctacagttgacatttctaaattttccacattttttatgtttcctcgcgatatttcacatcctaaagtgtgtatttctcattttccgtgattttcagttttcttgccatattccaggtcctacagggtgcatttctcatttttcacgtttttcagtgatttcatcaatttcaagtcgtcaactgtatgtttctcattttcaatgattttcatttttcttgccatattccacgtcctatagtggacatttctacattttccacctttttcagttttcttcgccatatttcacgtcccaaagtgtgtatttctcattttccgtgattttcagtttcctcgccatattccaggtcctacagtgtgcatttctcatttttcacgtttttcagtgatttcgtcttttttcaagtcgtcaagtggatgtttctcattttccatgattttcagttttcttgccatattccatgtcctacagtggacatttctaaattttccacctttttctgttttcctcgccatatttcacgtcctaaagtgtgtatttctcatttaccgtgattttcagttttcttgctatattccaagtcctacagtgtgcatttctcatttttcacgtttttcactgattttgtcattgttcaagttgtcaactgcatgtttctcattttccatgattttcagttttcttgccatattccatgtcctacagtggaaatttctatattttccaactttttcagttttcctcgccatatttcacgtgctaaagtgtgtatttctcatttttcgtgtttttcaggtttctcgccatattccaggtcctacagtgtgcatttctcatttttcacgtttttcagtgattttgtaatttttcaagttgtcaagtggatgtttctcattttccttgattttcagttttcttgccatattccatgtcctactgtggacatttctaaattttccacctttttcagttttccttgccatatttcatgtcctaaagtgtgtatttctcattttcagtgattttcagttttctcgcaatattccaggtcctacagtgtgcatttctcattttttcaggtttttcagtgatttcgtcatttttcacgttgtcaagtggatgtttctcattttccatgattttcacttttcttgccatatttcatgtgctaaagtgtgtatttctcattttcagtgattttcagttttctgccatattccaggtcctacattgtgcatttctcattttttcacgtttttcagtgatttcgtcatttttcacgttgtcaagtggatgtttctcattttccatgattttcacttttcttgccatatttcatgttttacagtggacatttctaaattttccacctatttctgttttcctcgccatatttcacatcctaaagtgtgtatttctcattttccgtgattttcagttttctcgccatatgccaggtcatacagggtgcatttctcatttttcacgtttttcagtgatttcgtcatttttcacgtcgtcaagtggatgtttctcattttcaatgattttcatttttcttgccatattccacgtcctatagtggacatttctaaattttccacctttttcagttttccttgccatatttcaggtcctacagtgtgcatttctcttttttcacgtttttcagtgatttcgtcatttttcaagtggtcaagtgcatgtttctcattttccgtgattttcagttttcttgccatgttccaggtcctacagttgacgtttctaaaatttcactttttttaagttttcctcgccatatttcacttcctaaagtgtgtatttctcattttccgtgattttcagttttctcgccagattccaggtcctacagtgtgcatttttcatatttcacctttttcagtgattttgtcatttttcaagttgtcaactgcatgtttctcattttccatgattttcagttttcttgccatattccatgtcctactgtggacatttctaaattttccaactttttcagttttcctcgccatatttcatgtcctaaagtgtgtatttctcattttcagtgattttctgttttctcgccatattccaggtcctacagtgtgcatttctaatttttcacgtttttcagtgatttcgtcatttttcaagttgtcaagtggatgtttctcattttccatgattttcagttttcttgccatattccatgtcctacagtggacatttctaaattttccaactttttccattttcctcaccatatttcacgtcctaaagtgagtttttctcattttttgtgattttcagttttctcgacatattccaggtcctacagtgtgcatttctaattttttcttttttcagtgatttcgtcatttttcaagtggtcaagtgcatgtttctcattttccatgattttcagttttcttgccatattccatgtcctacaatggacatttctaaattttccaactttttcagttttcctcgccatatttcacgtcctaaagtgtgtatttctcattttccgtgattttcagttttctcgccatattccaggtcctacagtgtgcatttctcatttttcacgtttttcagtgatttcgtcatttttcaagttgtcaactgcatgtttctcattttccatgattttcagttttcttgccatattccatgtcttacagtggacatttttaaatttttcacatttttttaagttttcctccccatatttcacgttttaaagtgtgcatttctcattttcggtgattttcagttttctcgccagattccatgtcttacagtgtgcatttctcattttttcacgtttttcagtgatttcgtcatttttcaagtcgtcaagtggatgtttctcattttccatgattttcagttttcttgccatattccatgtcctacagtggaaatttctaaattttccacctttttcagttttccttgccatatttcaggtcctaaagtgtgtatttctcattttctgtgattttcagttttctcgccatattccaggtcctacagttgacatttctaaaatttccacattttttaagttttcctcgccatatttcacttcctaaagtgtgtatttctcattttccgtgattttcagttttctcgccatattccagatcctacagtgtacatttttcatttttcacgtttttcagtgattttgtcattttttagttgtcaactgcctgtttctcattttccatgattttcagttttcttgctatattccatgtcctacagtggaaatttctaaattttccacctttttcagttttcctcgccatatttcacgtcctaaagtgtgtatttctcattttccgtgattttcagttttctcgccatattccaggtcctatgtgtacatttctcatttttcacgtttttcagtgattttgtcatttttcaatttgtcaactgcatgtttctcattttccatgattttcagttttcttgccatattccatgtcctacagtggaaatttctatattttccaactttttcagttttcctcgccatatttcacgtgctaaagtgtgtatttctcatttttcgtgtttttcaggtttctcgccatattccaggtcctacagtgtgcatttctcatttttcacgtttttcagtgattttgtcatttttcaagttgtcaagtggatgtttctcattttccttgattttcagttttcttgccatattccatgtcctacagtggacatttctaaattttccacctttttcagttttccttgccatatttcatgtcctaaagtgtgtatttctcattttcagtgattttcagttttctcgccatattccaggtcctacagtgtgcatttctcattttttcaggtttttcagtgatttcgtcatttttcacgttgtcaagtggatgtttctcattttccatgattttcacttttcttgccatatttcatgtcctaaagtgtgtatttctcattttcagtgattttcagttttctcgctatattccaggtcctacagtgtgcatttctcattttttcacgtttttcagtgatttcgtcatttttcacgttgtcaagtggatgtttctcattttccatgattttcacttttcttgccatatttcatgtcctacaatggacatttctaaattttccacctttttctgttttcctcgccatatttcacatcctaaagtgtgtatttctcattttccgtgattttcagttttcttgccatattccaggtcctacagtgtgcatttctcatttttcacgtttttcagtgatttcgtcatttttcaagttgtcaagtggatgtttctcattttccttgattttcagttttcttgccatattccatgtcctactgtggacatttctaaattttccacctttttcagttttccttgccatatttcatgtcctaaagtgtgtatttctcattttcagtgattttcagttttctcgcaatattccaggtcctacagtgtgcatttctcattttttcaggtttttcagtgatttcgtcatttttcacgttgtcaagtggatgtttctcattttccatgattttcacttttcttgccatatttcatgtcctaaagtgtgtatttctcattttcagtgattttcagttttctgccatattccaggtcctacattgtgcatttctcattttttcacgtttttcagtgatttcgtcatttttcagttttctcgacatattccaggtcctacagtgtgcatttctaattttttcttttttcagtgatttcgtcatttttcaagttgtcaactgcatgtttctcattttccatgattttcagttttcttgccatattccatgtcttacagtggacatttttaaatttttcacatttttttaagttttcctccccatatttcacgttttaaagtgtgcatttctcattttcggtgattttcagttttctcgccagattccaggtcttacagtgtgcatttctcattttttcacgtttttcagtgatttcgtcatttttcaagtcgtcaagtggatgtttctcattttccatgattttcagttttcttgccatattccatgtcctacagtggaaatttctaaattttccacctttttcagttttccttgccatatttcaggtcctaaagtgtgtatttctcattttctgtgattttcagttttctcgccatattccaggtcctacagttgacatttctaaaatttccacattttttaagttttcctcgccatatttcacttcctaaagtgtgtatttctcattttccgtgattttcagttttctcgccatattccagatcctacagtgtgcatttttcatttttcacgtttttcagtgattttgtcattttttagttgtcaactgtctgtttctcattttccatgattttcagttttcttgccatattccatgtcctacactggacatttctaaattttccacctttttctgttttcctcgccatatttcacgtcctaaagtgtgtatttctcattttccgtgattttcagttttcttgccatattccaggtcctacagtgtgcatttctcatttttcacgtttttcagtgattttgtcatttttcaagttgtcaactgcatgtttctcattttctatgattttcagttttcttgctatattccatgtcctacagtggaaatttctaaattttccacctttttcagttttcctcgccatatttcacgtcctaaagtgtgtatttctcattttccgtgattttcagttttctcgccatattccaggtcctatgtgtacatttctcatttttcacgtttttcagtgattttgtcatttttcaagttgtgaagtggatgtttctcatttttcttgattttcatttttcttgccatattccatgtcctagagtggaaatttttaaattttccacctttttcagttttcctcgccatatttcacgtcctaaagtgtgaatttctcattttccgtgattttcagatttctcgccatattccaagtcctacagtgtgcatttctcatttttcacgtttttcagtgatttcgtcatttttcaagttgtcaagtggatgtttctcattttccatgattttcagctttcttgccatattcaaagtcctacagtggacatttctaaattttcgacctttatcagttttcctcgccatatttcatgtcccaaagtgtgtacttctcattttccgtgattttcagtttcctagccatattctaggtcctacagtgtgcatttctcatttttcaggtttttcagtgatttcgtcttttttcaagtcgtcaagtggatgtttctcattttccatgattttcacttttcttgccatatttcatgtcctaaagtgtgtatttctcattttcagtgattttcagttttctcgctatattccaggtcctacagtgtgcatttctcattttttcacgtttttcagtgatttcgtcatttttcacgttgtcaagtggatgtttctcattttccatgattttcacttttcttgccatatttcatgtcctacagtggacatttctaaattttccacctttttctgttttcctcgccatatttcacatcctaaagtgtgtatttctcattttccgtgattttcagttttcttgccatattccaggtcctacagtgtgcatttctcatttttcacgtttttcagtgatttcgtcatttttcaagttgtcaagtggatgtttctcattttccttgattttcagttttcttgccatattccatgtcctactgtggacatttctaaattttccacctttttcagttttccttgccatatttcatgtcctaaagtgtgtatttctcattttcagtgattttcagttttctcgcaatattccaggtcctacagtgtgcatttctcattttttcaggtttttcagtgatttcgtcatttttcacgttgtcaagtggatgtttctcattttccatgattttcacttttcttgccatatttcatgtcctaaagtgtgtatttctcattttcagtgattttcagttttctgccatattccaggtcctacattgtgcatttctcattttttcacgtttttcagtgatttcgtcatttttcacgttgtcaagtggatgtttctcattttccatgattttcacttttcttgccatatttcatgttttacagtggacatttctaaattttccacctttttctgttttcctcgccatatttcacatcctaaagtgtgtatttctcattttccgtgattttcagttttctcgccatatgccaggtcatacagggtgcatttctcatttttcacgtttttcagtgatttcgtcatttttcacgtcgtcaagtggatgtttctcattttcaatgattttcatttttcttgccatattccacgtcctatagtggacatttctaaattttccacctttttcagttttccttgccatatttcaggtcctacagtgtgcatttctcatttttcacgtttttcagtgatttcgtcatttttcaagtggtcaagtgcatgtttctcattttccgtgattttcagttttcttgccatgttccaggtcctacagttgacgtttctaaaatttcactttttttaagttttcctcgccatatttcacttcctaaagtgtgtatttctcattttccgtgattttcagttttctcgccagattccaggtcctacagtgtgcatttttcatatttcacctttttcagtgattttgtcatttttcaagttgtcaactgcatgtttctcattttccatgattttcagttttcttgccatattccatgtcctactgtggacatttctaaattttccaactttttcagttttcctcgccatatttcatgtcctaaagtgtgtatttctcattttcagtgattttctgttttctcgccatattccaggtcctacagtgtgcatttctaatttttcacgtttttcagtgatttcgtcatttttcaagttgtcaagtggatgtttctcattttccatgattttcagttttcttgccatattccatgtcctacagtggacatttctaaattttccaactttttccattttcctcaccatatttcacgtcctaaagtgtgtttttctcattttttgtgattttcagttttctcgacatattccaggtcctacagtgtgcatttctaattttttcttttttcagtgatttcgtcatttttcaagttgtcaactgcatgtttctcattttccatgattttcagttttcttgccatattccatgtcttacagtggacatttttaaatttttcacatttttttaagttttcctccccatatttcacgttttaaagtgtgcatttctcattttcggtgattttcagttttctcgccagattccaggtcttacagtgtgcatttctcattttttcacgtttttcagtgatttcgtcatttttcaagtcgtcaagtggatgtttctcattttccatgattttcagttttcttgccatattccatgtcctacagtggaaatttctaaattttccacctttttcagttttccttgccatatttcaggtcctaaagtgtgtatttctcattttctgtgattttcagttttctcgccatattccaggtcctacagttgacatttctaaaatttccacattttttaagttttcctcgccatatttcacttcctaaagtgtgtatttctcattttccgtgattttcagttttctcgccatattccagatcctacagtgtgcatttttcatttttcacgtttttcagtgattttgtcattttttagttgtcaactgtctgtttctcattttccatgattttcagttttcttgccatattccatgtcctacactggacatttctaaattttccacctttttctgttttcctcgccatatttcacgtcctaaagtgtgtatttctcattttccgtgattttcagttttcttgccatattccaggtcctacagtgtgcatttctcatttttcacgtttttcagtgattttgtcatttttcaagttgtcaactgcatgtttctcattttccatgattttcagttttcttgctatattccatgtcctacagtggaaatttctaaattttccacctttttcagttttcctcgccatatttcacgtcctaaagtgtgtatttctcattttccgtgattttcagttttctcgccatattccaggtcctatgtgtacatttctcatttttcacgtttttcagtgattttgtcatttttcaagttgtgaagtggatgtttctcatttttcttgattttcatttttcttgccatattccatgtcctagagtggaaatttttaaattttccacctttttcagttttcctcgccatatttcacgtcctaaagtgtgaatttctcattttccgtgattttcagatttctcgccatattccaagtcctacagtgtgcatttctcatttttcacgtttttcagtgatttcgtcatttttcaagttgtcaagtggatgtttctcattttccatgattttcagctttcttgccatattcaaagtcctacagtggacatttctaaattttcgacctttatcagttttcctcgccatatttcatgtcccaaagtgtgtacttctcattttccgtgattttcagtttcctcgccatattctaggtcctacagtgtgcatttctcatttttcaggtttttcagtgatttcgtcttttttcaagtcgtcaagtggatgtttctcattttccatgattttcagttttcttgccatattccatgtcctacagtggacatttctaaattttccacctttttcagttttcctcgccatatttcatgtcctaaagtgtgtatttctcattttcagtgattttcagttttctcgccatattccaggtcctacagtgtgcatttctcatttttcacgtttttcagtgatttcgtcatttttcaagttgtcaagtggatgtttctcattttccatgattttcagttttcttgccatattccatgtcccacagtggacatttctaaattttccacctttttctgttttccttgccatatttcatgtcctaaagtgtgtatttctcattttccgtgattttcagttttcttgctatattccaagtcctacagtgtgcatttctcatttttcacgtttttcagtgattttgtcatttttcaatttgtcaactgcatgtttctcattttccatgattttcagttttcttgccatattccatgtcctacagtggaaatttctatattttccaactttttcagttttcctcgccatatttcacgtgctaaagtgtgtatttctcatttttcgtgtttttcaggtttctcgccatattccaggtcctacagtgtgcatttctcatttttcacgtttttcagtgattttgtcatttttcaagttgtcaagtggatgtttctcattttccttgattttcagttttcttgccatattccatgtcctacagtggacatttctaaattttccacctttttcagttttccttgccatatttcatgtcctaaagtgtgtatttctcattttcagtgattttcagttttctcgccatattccaggtcctacagtgtgcatttctcattttttcaggtttttcagtgatttcgtcatttttcacgttgtcaagtggatgtttctcattttccatgattttcacttttcttgccatatttcatgtcctaaagtgtgtatttctcattttcagtgattttcagttttctcgctatattccaggtcctacagtgtgcatttctcattttttcacgtttttcagtgatttcgtcatttttcacgttgtcaagtggatgtttctcattttccatgattttcacttttcttgccatatttcatgtcctacagtggacatttctaaattttccacctttttctgttttcctcgccatatttcacatactaaagtgtgtatttctcattttccttgattttcagttttcttgccatattccaggtcctacagtgtgcatttctcatttttcacgtttttcagtgatttcgtcatttttcaagtcgtcaagtggatgtttctcattttccatgattttcagttttctcgccatattccaggtcctacagttgacatttctaaattttccacattttttaagtttcctcgcgatatttcacatcctaaagtgtgtatttctcattttccgtgattttcagttttcttgccatattccaggtcctacagggtgcatttctcatttttcacgtttttcagtgatttcatcaatttcaagtcgtcaactgtatgtttctcattttcaatgattttcatttttcttgccatattccatgtcctacagtggacatttctaaatttttcacctttttcagttttccttgccatatttcatgtcctaaagtgtgtatttctcattttcagtgattttcagttttctcgccatattccaggtcctacagtgtgcatttctcattttttcaggtttttcagtgatttcgtcatttttcacgttgtcaagtggatgtttctcattttccatgattttcacttttcttgccatatttcatgtcctaaagtgtgtatttctcattttcagtgattttcagttttctcgccatattccaggtcctacagtgtgcatttctcatttttcacgtttttcagtgatttcgtcatttttcaagttgtcaagtggatgtttctcattttccatgattttcacttttcttgccatattccatgtcccacagtggacatttctaaattttccacctttttctgttttcctcgccatatttcatgtcctaaagtgtgtatttctcattttccgtgattttcagttttcttgctatattccaagtcctacagtgtgcatttctcatttttcacgtttttcagtgattttgtcatttttcaatttgtcaactgcatgtttctcattttccatgattttcagttttcttgccatattccatgttctacagtggaaatttctatattttccaactttttcagttttcctcgccatatttcacgtgctaaagtgtgtatttctcatttttcgtgtttttcaggtttctcgccatattccaggtcctacagtgtgcatttctcatttttcacgtttttcagtgattttgtcatttttcaagttgtcaagtggatgtttctcattttccttgattttcagttttcttgccatattccatgtcctacagtggacatttctaaattttccacctttttcagttttccttgccatatttcatgtcctaaagtgtgtatttctcattttcagtgattttcagttttctcgccatattccaggtcctacagtgtgcatttctcattttttcaggtttttcagtgatttcgtcatttttcacgttgtcaagtggatgtttctcattttccatgattttcacttttcttgccatatttcatgtcctaaagtgtgtatttctcattttcagtgattttcagttttctcgctatattccaggtcctacagtgtgcatttctcattttttcacgttttgcagtgatttcgtcatttttcacgttgtcaagtggatgtttctcattttccatgattttcacttttcttgccatatttcatgtcctacagtggacatttctaaattttccacctttttctgttttcctcgccatatttcacatcctaaagtgtgtatttctcattttccgtgattttcagttttcttgccatattccaggtcctacagtgtgcatttctcatttttcacgtttttcagtgatttcgtcatttttcaagtcgtcaagtggatgtttctcattttccatgattttcagttttctcgccatattccaggtcctacagttgacatttctaaattttccacattttttaagtttcctcgcgatatttcacatcctaaagtgtgtatttctcattttccgtgattttcagttttcttgccatattccaggtcctacagggtgcatttctcatttttcacgtttttcagtgatttcatcaatttcaagtcgtcaactgtatgtttctcattttcaatgattttcatttttcttgccatattccatgtcctacagtggacatttctaaattttccacctttttcagttttccttgccatatttcatgtcctaaagtgtgtatttctcattttcagggattttcagttttctcgccatattccaggtcctacagtgtgcatttctcattttttcaggtttttcagtgatttcgtcatttttcacgttgtcaagtggatgtttctcattttccatgattttcacttttcttgccatatttcatgtcctaaagtgtgtatttctcattttcagtgattttcagttttctcgccatattccaggtcctacagtgtgcatttctcattttttcacgtttttcagtgatttcgtcatttttcacgttgtcaagtggatgtttctcattttccatgattttcacttttcttgccatatttcatgtcctacagtggacatttctaaattttccacctttttctgttttcctcgccatatttcacatcctaaagtgtgtatttctcattttccgtgattttcagttttcttgccatattccaggtcctacagtgtgcatttctcatttttcacgtttttcagtgatttcgtcatttttcaagtcgtcaagtggatgtttctcattttccatgattttcagttttctcgccatattccaggtcctacagttgacatttctaaattttccacattttttaagtttcctcgcgatatttcacatcctaaagtgtgtatttctcattttccgtgattttcagttttcttgccatattccaggtcctacagggtgcatttctcatttttcacgtttttcagtgatttcatcaatttcaagtcgtcaactgtatgtttctcattttcaatgattttcatttttcttgccatattccacgtcctatagtggacatttctaaattttccacctttttcagttttcttcgccatatttcacgtcccaaagtgtgtatttctcattttccgtgattttcagtttcctcgcaatattccaggtcctacagtgtgcatttctcatttttcacgtttttcagtgatttcgtcttttttcaagtcgtcaagtggatgtttctcattttccatgattttcagttttcttgccatattccatgtcctacagtggacatttctaaattttccacctttttctgttttcctcgccatatttcacgtcctaaagtgtgtatttctcattttccgtgattttcagttttcttgccatattccaggtcctacagtgtgcatttctcatttttcacgtttttcactgattttgtcattgttcaagttgtcaactgcatgtttctcattttccatgattttcaattttcttgccatattccatgtcctacagtggaaatttctatattttccaactttttcagttttcctcgccatatttcacgtgctaaagtgtgtatttctcatttttcgtgtttttcaggtttctcgccatattccaggtcctacagtgtgcatttctcatttttcacgtttttcagtgattttgtcatttttcaagttgtcaagtggttgtttctcattttccttgattttcagttttcttgccatattccatgtcctactgtggacatttctaaattttccacctttttcagttttccttgccatatttcatgtcctaaagtgtgtatttctcattttcagtgattttcagttttctcgcaatattccaggtcctacagtgtgcatttctcattttccgtgattttcagttttctcgccatatgccaggtcatacagggtgcatttctcatttttcacgtttttcagtgatttcgtcatttttcacgtcgtcaagtggatgtttctcattttcaatgattttcatttttcttgccatattccacgtcctatagtggacatttctaaattttccaactttttcagttttcttgccatatttcaggtcctacagtgtgcatttctcatttttcacgtttttcagtgatttcgtcatttttcaagtggtcaagtgcatgtttctgattttccgtgattttcagttttcttgccatgttccaggtcctacagttgacgtttctaaaatttcactttttttaagttttcctcgccatatttcacttcctaaagtgtgtatttctcattttccgtgattttcagttttctcgccagattccaggtcctacagtgtgcatttttcatatttcacctttttcagtgattttgtcatttttcaagttgtcaactgcatgtttctcattttccatgattttcagttttcttgccatattccatgtcctactgtggacatttctaaattttccaactttttcagttttcctcgccatatttcatgtcctaaagtgtgtatttctcattttcagtgtttttctgttttctcgccatattccaggtcctacagtgtgcatttctaatttttcacgtttttcagtgatttcgtcatttttcaagttgtcaagtggatgtttctcattttccatgattttcagttttcttgccatattccatgtcctacagtggacatttctaaattttccaactttttccattttcctcaccatatttcacgtcctaaagtgtgtttttctcattttttgtgattttcagttttctcgacatattccaggtcctacagtgtgcatttctaattttttcttttttcagtgatttcgtcatttttcaagtggtcaagtgcatgtttctcattttccatgattttcagttttcttgccatattccatgtcctacaatggacatttctaaattttccaactttttcagttttcctcgccatatttcacgtcctaaagtgtgtatttctcattttccgtgattttcagttttctcgccatattccaggtcctatgtgtacatttctcatttttcacgtttttcagtgattttgtcatttttcaagttgtgaagtggatgtttctcatttttcttgattttcatttttcttgccatattccatgtcctagagtggaaatttttaaattttccaactttttcagttttcctcgccatatttcacgtcctaaagtgtgtatttctcattttccgtgattttcagttttctcgccatattccaagtcctacagtgtgcatttctcatttttcacgtttttcagtgatttcgtcatttttcaagttgtcaagtggatgtttctcattttccatgattttcagctttcttgccatattcaaagtcctacagtggacatttctaaattttcgacctttatcagttttcctcgccatatttcatgtcccaaagtgtgtacttctcattttccgtgattttcagtttcctcgccatattctaggtcctacagtgtgcatttctcatttttcaggtttttcagtgatttcgtcttttttcaagtcgtcaagtggatgtttctcattttccatgattttcagttttcttgccatattccatgtcctacagtggacatttctaaattttccacctttttcagttttcctcgccatatttcatgtcctaaagtgtgtatttctcattttcagtgattttcagttttctcgccatattccaggtcctacagtgtgcatttctcatttttcacgtttttcagtgatttcgtcatttttcaagttgtcaagtggatgtttctcattttccatgattttcagttttcttgccatattccatgtcccacagtggacatttctaaattttccacctttttctgttttccttgccatatttcatgtcctaaagtgtgtatttctcattttccgtgattttcagttttcttgctatattccaagtcctacagtgtgcatttctcatttttcacgtttttaagtgattttgtcatttttcaatttgtcaactgcatgtttctcattttccatgattttcagttttcttgccatattccatgtcctacagtggaaatttctatattttccaactttttcagttttcctcgccatatttcacgtgctaaagtgtgtatttctcatttttcgtgtttttcaggtttctcgccatattccaggtcctacagtgtgcatttctcatttttcacgtttttcagtgattttgtcatttttcaagttgtcaagtggatgtttctcattttccttgattttcagttttcttgccatattccatgtcctacagtggacatttctaaattttccacctttttcagttttccttgccatatttcatgtcctaaagtgtgtatttctcattttcagtgattttcagttttctcgccatattccaggtcctacagtgtgcatttctcattttttcaggtttttcagtgatttcgtcatttttcacgttgtcaagtggatgtttctcattttccatgattttcacttttcttgccatatttcatgtcctaaagtgtgtatttctcattttcagtgattttcagttttctcgccatattccaggtcctacagtgtgcatttctcattttttcacgtttttcagtgatttcgtcatttttcacgttgtcaagtggatgtttctcattttccatgattttcacttttcttgccatatttcatgtcctacagtggacatttctaaattttccacctttttctgttttcctcgccatatttcacatcctaaagtgtgtatttctcattttccgtgattttcagttttcttgccatatttcaggtcctacagtgtgcatttctcatttttcacgtttttcagtgatttcgtcatttttcaagtcgtcaagaggatgtttctcattttccatgattttcagttttctcgccatattccaggtcctacagttgacatttctaaattttccacattttttaagtttcctcgcgatatttcacatcctaaagtgtgtatttctcattttccgtgattttcagttttcttgccatattccaggtcctacagggtgcatttctcatttttcacgtttttcagtgatttcatcaatttcaagtcgtcaactgtatgtttctcattttcaatgattttcatttttcttgccatattccacgtcctatagtggacatttctaaattttccacctttttctgttttcctcgccatatttcacgtcctaaagtgtgtatttctcattttccgtgattttcagttttcttgccatattccaggtcctacagtgtgcatttctcatttttcacgtttttcactgattttgtcattgttcaagttgtcaactgcatgtttctcattttccatgattttcagttttcttgccatattccatgtcctacagtggaaatttctatattttccacctttttcagttttcctcgccgtatttcatgtgctaaagtgtgtatttctcatttttcgtgtttttcaggtttctcgccatattccaggtcctacagtgtgcatttctcatttttcacgtttttcagtgattttgtcatttttcaagttgtcaactggatgtttctcattttccttgattttcagttttcttgccatattccatgtcctactgtggacatttctaaattttccacctttttcagttttccttgccatatttcatgtcctaaagtgtgtatttctcattttcagtgattttcagttttctcgcaatattccaggtcctacagtgtgcatttctcattttttcaggtttttcagtgatttcgtcatttttcacgttgtcaagtggatgtttctcattttccatgattttcacttttcttgccatatttcatgtcctaaagtgtgtatttctcattttcagtgattttcagttttctcgccatattccaggtcctacattgtgcatttctcattttttcacgtttttcagtgatttcgtcatttttcacgttgtcaagtggatgtttctcattttccatgattttcacttttcttgccatatttcatgttttacagtggacatttctaaattttccacctttttctgttttcctcgccatatttcacatcctaaagtgtgaatttctcattttccgtgattttcagttttcttgccatattccaggtcctacagtgtgcatttctcatttttcacgtttttcagtgatttcatcatttttcaagtcgtcaagtggatgtttctcattttccatgattttcagttttcttgccatattccatgtcctacagtggacatttctaaattttccacctttttctgttttcctcgccatatttcacgtcctaaagtgtgtatttctcattttccgtgattttcagttttcttgccatattccaggtcctacagtgtgcatttctcatttttcacgtttttcactgattttgtcatttttcaagttgtcaactgcatgtttctcattttccatgattttcagttttcttgctatattccatgtcctacagtggaaatttctaaattttccacctttttcagttttcctcgccatatttcacgtcctgaagtgtgtatttctcattttccgtgattttcagttttctcgccatattccaggtcctatgtgtacatttctcatttttcacgtttttcagtgattttgtcatttttcaagttgtgaagtggatgtttctcatttttcttgattttcatttttcttgccatattccatgtcctacagtggaaatttctaaattttccacctttttcagttttcctcgccatatttcacgtcctaaagtgtgtatttctcattttccgtgattttcagttttctcgccatattccaggtcctacagtgtgcatttctcatttttcacgtttttcagtgatttcgacatttttcaagttgtcaagtggatgtttctcattttccatgattttcagctttcttgccatattcaaagtcctacagtggacatttctaaattttcgacctttatcagttttcctcgccatatttcatgtcccaaagtgtgtacttctcattttccgtgattttcagtttcctcgccatattccaggtcctacagtgtgcatttctcatttttcacgtttttcagtgatttcgtcatttttcaagtcgtcaagtggatgtttctcattttccatgattttcagttttcttgccatattccatgtcctacagtggacatttctaaattttccacctttttctgttttcctcgccatatttcacgtcctaaagtgtgtatttctcattttccgtgattttcagttttcttgccatattccaggtcctacagtgtgcatttctcatttatcacgtttttcactgattttgtcatttttcaagttgtcaactgcatgtttctcattttccatgattttcagttttcttgctatattccatgtcctacagtggaatattctaaattttccacctttttcagttttcctcgccatatttcacgtcctgaagtgtgtatttctcattttccgtgattttcagttttctcgccatattccaggtcctatgtgtacatttctcatttttcacgtttttcagtgattttgtcatttttcaagttgtgaagtggatgtttctcatttttcttgattttcatttttcttgccatattccatgtcctacagtggaaatttctaaattttccacctttttcagttttcctcgccatatttcacgtcctaaagtgtgaatttctcattttccgtgattttcagttttctcgccatattccaggtcctacagtgtgcatttctcatttttcacgtttttcagtgatttcgacatttttcaagttgtcaagtggatgtttctcattttccatgattttcagctttcttgccatattcaaagtcctacagtggacatttctaaattttcgacctttatcagttttcctcgccatatttcatgtcccaaagtgtgtacttctcattttccgtgattttgagtttcctcgccatattccaggtcctacagtgtgcatttctcatttttcacgtttttcagtgatttcgtcttttttcaagttgtcaactgcatgtttctcattttccatgattttcagttttcttgccatattccatgtcctacagtggaaatttgtaaatttccacctttttcagttttcctcgccatatttcacgtcctaaagtatgtatttctcattttccgtgattttcagttttctcgccatattccaggtcctacagtgtgcatttctcatttttcacgtttttcagtgattttgtcattttttaagttttcaagtggatgtttctcattttccttgattttcagttttcttgccatattccatgtcctacagtggacatttctaaattttccacctttttcagttttcctcgccatatttcatgtcctaaagtgtgtatttctcattttcagtgattttcagttttctcgccatattccaggtcctacagtgtgcatttctcatttttcacgtttttcagtgatttcgtcatttttcaaggtgtcaagtggatgtttctcattttccatgattttcagttttcttgccatattccatgtcctacagtggacatttctaaattttccacctttttctgttttcctcgccatatttcatgtcctaaagtgtgtatttctcattttccgtgattttcagttttcttgctatattccaagtcctacagtgtgcatttctcatttttcacgtttttcagtgattttgtcatttttcaatttgtcaactgcatgtttctcattttccatgattttcagtttttttgccatattccatgtcctactgtggaaatttctatattttccacctttttcagttttcctcgccatatttcacgtgctaaagtgtgtatttctcatttttcgtgtttttcaggtttctcgccatattccaggtcctacagtgtgcatttctcatttttcacgtttttcagtgattttgtcatttttcaagttttcaagtggatgtttctcattttccttgattttcagttttcttgccatattccatgtcctacagtggacatttctaaattttccacctttttcagttttccttgccatatttcatgtcctaaagtgtgtatttctcattttcagtgattttcagtttccttgccatattccaggtcctacagtgtgcatttctcattttttcacgtttttcagtgatttcgtcatttttcacgttgtcaagtggatgtttctcattttccatgattttcacttttcttgccatatttcatgtcctacagtggacatttctaaattttccaactttttcaattttcctcgccatattttatgtcctaaagtgtgtatttctcatttttcgttattttcagttttcttgccatattccaggtcctacagtgtgcatttgtcatttttcacgtttttcagtgatttcgtcatttttcaagtcgtcaagtagatgtttctcatattccatgtttttcagttttctcgccatattccaggtcctacagttgacatttctaaattttctacatttttaaattttcctcgccatatttcacgtcctaaagtgtgtatttctcattttttgttattttcagttttctagccatattccaggtcctacaggatgcatttctcatttttcacgtttttcagtgatttcatcatttttcaagtcgtcaagtgtatgtttcttattttcaatgattttcatttttcttgccttattccacgtcctatagtggacatttctaaattttccacctttttcagtttttttcgccatatttcacgtcctaaagtgtgtatttctcattttctgtgattttcagttttctcaccatattccaggtcctacagtgtgcatttctcatttttcacgtttttcagtgatttcgtcatttttcaagttgtcaagtggaagtttctcattttccatgattttcagctttctagacatattccaggtcctacagtggacatttcctaattttcgacctttatcagttttcctcgtcatatttcacgtcccaaaatgtgtatttcttattttccatgattttcagtttcctcgccatattccaggtcctacagtgtgcaattctcatttttcacgtttttcagtgatttcgtcttttttcaagacgtcaagtggatgtttctcatttttcatgattttcagttttcttgccatattccatgtcctacagtggacatttctaaattttccacctttttctgttttcctcgccatatttcacgtcctaaagtgtgtatttctcattttccgtgattttcagttttcttgccatattcctggtcctacagtgtgcatttctcatttttcacgtttttcagtgattttgtcatttttcaatttgtcaactgcatgtttctcattttccattattttcagttttcttgccatattccatgtcctacagtggacatttctaaattttccacctttttctgttttcctcgccatatttcatgtcctaaagtgtgtatttctcattttccgtgattttcagttttcttgctatattccaagtcctacagtgtgcatttctcatttttcacgtttttcagtgattttgtcatttttcaatttgtcaactgcatgtttctcattttccatgattttcagtttttttgccatattccatgtcctacaggggaaatttctatattttccacctttttcagttttcctcgccatatttcatgtcctaaagtgtgtatttctcattttccgtgattttcagttttcttgccatattccaggtcctacagtgtgcatttctcatttttcacgtttttcagtgatttcgtcatttttcaagtcttcaagtagatgtttctcatattccatgtttttcagttttctcgccatattccaggtcctacagttgacatttctaaattttctacatttttaaattttcctcgccatatttcacgtcctaaagtgtgtatttctcatttttcgttattttcagttttctagccatattccaggtcctacaggatgcatttctcatttttcacgtttttcagtgatttcatcatttttcaagtcgtcaagtgtatgtttctcattttcaatgattttcatttttcttgccttattccacgtcctatagtggacatttctaaattttccacctttttcagtttttctcgccatatttcacgtcctaaagtgtgtatttctcattttctgtgattttcagttttctcaccatattccaggtcctacagtgtgcatttctcatttttcacgtttttcagtgatttcgtcatttttcaagttgtcaagtggaagtttctcattttccatgattttcagctttctagccatattccaggtcctacagtggacatttcctaattttcgacctttatcagttttcctcgccatatttcacgtcctaaagtgtgtatttctcattttccgtgattttcagttttcttgccatattccaggtcctacagtgtgcatttctcatttttcacgtttttcagtgattttgtcatttttcaatttgtcaactgcatgtttctcattttccatgatttttagttttcttgctatattccatgtcctacagtggaaatttctaaattttccacctttttcagttttcctcgccatatttcacgtcctaaagtgtgtatttctcattttccgtgattttcagttttcttgctatattccaagtcctacattgtgcatttctcatttttcacgtttttcagtgattttgtcatttttcaatttgtcaaaccacatgtttctcattttccatgattttcagtttttttgccatattccatgtcctacagtggaaatttctatattttccacctttttcagttttcctcgccatatttcacgtgctaaagtgtgtatttctcatttttcgtgtttttcaggtttctcgccatattccaggtcctacagtgtgcatttctcatttttcacgtttttcagtgattttgtcatttttcaagttgtcaagtggatgtttcccattttccttgattttcagttttcttaccatattccatgtcctacagtggacatttctaaattttccacctttttcagttttccttgccatatttcatgtcctaaagtgtgtatttctcattttcagtgattttcagtttcctcgccatattccaggtcctacagtgtgcatttctcattttttcacgtttttcagtgatttcgtcatttttcacgttgtcaagtggatgtttctcattttccatgattttcacttttcttgccatatttcatgtcctatagtggacatttctaaattttccacctttttcagtttttctcgccatatttcacgtcctaaagtgtgtatttctcattttctgtgattttcagttttctcaccatattccaggtcctacagtgtgcatttctcatttttcacgtttttcagtgatttcgtcatttttcaagtcgtcaagtagatgtttctcatattccatgtttttcagttttctcgccatattccaggtcctacagttgacatttctaaattttctacatttttaaattttcctcgccatatttcacgtcctaaagtgtgtatttctcatttttcgttattttcagttttctagccatattccaggtcctacaggatgcatttctcatttttcacgtttttcagtgatttcatcatttttcaagtcgtcaagtgtatgtttcttattttcaatgattttcatttttcttgccttattccacgtcctatagtggacatttctaaattttccaccttttttcagtttttctcgccatatttcacgtcctaaagtgtgtatttctcattttctgtgattatcagttttctcaccatattccaggtcctacagtgtgcatttctcatttttcacgtttttcagtgatttcgtcatttttcaagttgtcaagtggaagtttctcattttccatgattttcagctttctagccatattccaggtcctacagtggacatttcctaattttcgacctttatcagttttcctcgccatatttcacgtcccaaaatgtgtatttcttattttccatgattttcagtttcctcgccatattccaggtcctacagtgtgcatttctcatttttcacgtttttcagtgatttcgtcttttttcaagacgtcaagtggatgtttctcatttttcatgattttcagttttcttgccatattccatgtcctacagtggacatttctaaattttccacctttttctgttttcctcgccatatttcacgtcctaaagtgtgtatttctcattttccgtgattttcagttttcttgccatattcctggtcctacagtgtgcatttctcatttttcacgtttttcagtgattttgtcatttttcaatttgtcaactgcatgtttctcattttccatgattttcagttttcttgccatattccatgtcctacagtggacatttctaaattttccacctttttcagttttcctcgccatatttcacgtgctaaagtgtgtatttctcatttttcgtgtttttcaggtttctcgccatattccaggtcctacagtgtgcatttctcatttttcacgtttttcagtgattttgtcatttttcaagttgtcaagtggatgtttctcattttccttgattttcacttttcttgccatattccaagtcttacaggggcatttctcatttttcacgttttcagtgattttgtcattttcaatttgtcaactgcatgtttctcattttccatgattttcagtttttttgccatattccatgtcctacaggggaaatttctatattttccacctttttcagttttcctcgccatatttcatgtcctaaagtgtgtatttctcattttccgtgattttcagttttcttgccatattccaggtcctacagtgtgcatttctcatttttcacgtttttcagtgatttcgtcatttttcaagtcttcaagtagatgtttctcatattccatgtttttcagttttctcgccatattccaggtcctacagttgacatttctaaattttctacatttttaaattttcctcgccatatttcacgtcctaaagtgtgtatttctcatttttcgttattttcagttttctagccatattccaggtcctacaggatgcatttctcatttttcacgtttttcagtgatttcatcatttttcaagtcgtcaagtgtatgtttctcattttcaatgattttcatttttcttgccttattccacgtcctatagtggacatttctaaattttccacctttttcagtttttctcgccatatttcacgtcctaaagtgtgtatttctcattttctgtgattttcagttttctcaccatattccaggtcctacagtgtgcatttctcatttttcacgtttttcagtgatttcgtcatttttcaagttgtcaagtggaagtttctcattttccatgattttcagctttctagccatattccaagtcctacagtggacatttcctaattttcgacctttatcagttttcctcgccatatttcacgtcccaaaatgtgtattccttattttccatgattttcagtttcctcgccatattccaggtcctacagtgtgcatttatcatttttcacgtttttcagtgatttcgtcttttttcaagacgtcaagtggatgtttctcatttttcatgattttcagttttcttgccatattccatgtcctacagtggacatttctaaattttccacctttttctgttttcctcgccatatttcacgtcctaaagtgtgtatttctcattttccgtgattttcagttttcttgccatattcctggtcctacagtgtgcatttctcatttttcacgtttttcagtgattttgtcatttttcaagttgtcaagtggatgtttctcattttccttgattttcacttttcttgccatattccatgtcctacagtggacatttctatattttccacctttttccgttttccttgccatatttcacgtcctaaagtgtgtatttctcattttccgtgattttcaggtttctcgccatattccaggtcctacagtgtgcatttctcatttttcacgtttttcagtgattttgtcatttttcaagttgtcaagtggatgtttctcattttccttgattttcacttttcttgccatattccatgtcctacagtggacatttctaaattttccacctttttcagttttcctcgccatatttcatgtcctaaagtgtgtatttctcattttcagtgattttcagttttcttgccatattccaggtcctacagtgtgcatttctcatttttcacgtttttcagtgattttgtcatttttcaagttgtcaactgcatgtttctcattttctatgattttcagttttcttgctatattccatgtcctacagtggaaatttctaaattttccacctttttcagttttcctcgccatatttcacgtcctaaagtgtgtatttctcattttccgtgattttcagttttctcgccatattccaggtcctatgtgtacatttctcatttttcacgtttttcagtgattttgtcatttttcaagttgtgaagtggatgtttctcatttttcttgattttcatttttcttgccatattccatgtcctagagtggaaatttttaaattttccacctttttcagttttcctcgccatatttcacgtcctaaagtgtgaatttctcattttccgtgattttcagatttctcgccatattccaagtcctacagtgtgcatttctcatttttcacgtttttcagtgatttcgtcatttttcaagttgtcaagtggatgtttctcattttccatgattttcagctttcttgccatattcaaagtcctacagtggacatttctaaattttcgacctttatcagttttcctcgccatatttcatgtcccaaagtgtgtacttctcattttccgtgattttcagtttcctcgccatattctaggtcctacagtgtgcatttctcatttttcaggtttttcagtgatttcgtcttttttcaagtcgtcaagtggatgtttctcattttccatgattttcacttttcttgccatatttcatgtcctaaagtgtgtatttctcattttcagtgattttcagttttctcgctatattccaggtcctacagtgtgcatttctcattttttcacgtttttcagtgatttcgtcatttttcacgttgtcaagtggatgtttctcattttccatgattttcacttttcttgccatatttcatgtcctacagtggacatttctaaattttccacctttttctgttttcctcgccatatttcacatcctaaagtgtgtatttctcattttccgtgattttcagttttcttgccatattccaggtcctacagtgtgcatttctcatttttcacgtttttcagtgatttcgtcatttttcaagttgtcaagtggatgtttctcattttccttgattttcagttttcttgccatattccatgtcctactgtggacatttctaaattttccacctttttcagttttccttgccatatttcatgtcctaaagtgtgtatttctcattttcagtgattttcagttttctcgcaatattccaggtcctacagtgtgcatttctcattttttcaggtttttcagtgatttcgtcatttttcacgttgtcaagtggatgtttctcattttccatgattttcacttttcttgccatatttcatgtcctaaagtgtgtatttctcattttcagtgattttcagttttcctcgccatatttcacgtcccaaaatgtgtatttcttattttccatgattttcagtttcctcgccatattccaggtcctacagtgtgcatttctcatttttcacgtttttcagtgatttcgtcttttttcaagacgtcaagtggatgtttctcatttttcatgattttcagttttcttgccatattccatgtcctacagtggacatttctaaattttccacctttttctgttttcctcgccatatttcacgtcctaaagtgtgtatttctcattttccgtgattttcagttttcttgccatattcctggtcctacagtgtgcatttctcatttttcacgtttttcagtgattttgtcatttttcaatttgtcaactgcatgtttctcattttccatgattttcagttttcttgccatattccatgtcctacagtggacatttctaaattttccacctttttcagttttcctcgccatatttcacgtgctaaagtgtgtatttctcatttttcgtgtttttcaggtttctcgccatattccaggtcctacagtgtgcatttctcatttttcacgtttttcagtgattttgtcatttttcaagttgtcaagtggatgtttctcattttccttgattttcacttttcttgccatattccatgtcctacagtggacatttctaaattttccacctttttcagttttcctcgccatatttcatgtcctaaagtgtgtatttctcattttcagtgattttcagttttctcgccatattccaggtcctacagtgtgcatttctcatttttcacgtttttcagtgatttcgtcttttttcaagacgtcaagtggatgtttctcattttccatgattttcagttttcttgccatattccatgtcctacagtggacatttctaaattttccacctttttctgttttcctcgccatatttcacgtcctaaagtgtgtatttctcattttccgtgattttcagttttcttgccatattccaggtcctacagtgtgcatttctcatttttcacgtttttcagtgattttgtcatttttcaatttgtcaactgcatgtttctcattttccatgatttttagttttcttgctatattccatgtcctacagtggaaatttctaaattttccacctttttcagttttcctcgccatatttcacgtcctaaagtgtgtatttctcattttccgtgattttcagttttcttgctatattccaagtcctacattgtgcatttctcatttttcacgtttttcagtgattttgtcatttttcaatttgtcaaaccacatgtttctcattttccatgattttcagtttttttgccatattccatgtcctacagtggaaatttctatattttccacctttttcagttttcctcgccatatttcacgtgctaaagtgtgtatttctcatttttcgtgtttttcaggtttctcgccatattccaggtcctacagtgtgcatttctcatttttcacgtttttctgtgattttgtcatttttcaagttgtcaagtggatgtttctcattttccttgattttcagttttcttaccatattccatgtcctacagtggacatttctaaattttccaccttttctgttttcctcgccatatttcatgtcctaaagtgtgtatttctcattttccgtgattttcatttttcttgctatattccaagtcctacagtgtgcatttctcattttccatgattttcagttttcttgctatattccatgtcctacagtggaaatttctaaattttccacctttttcagttttcctcgccatatttcacgtcctaaagtgtgtatttctcattttccgtgattttcagttttttcgccatattacaggtcctatgtgtacatttctcatttttcacgtttttcagtgattttgtcatttttcaagttgtcaagtggatgtttctcatttttcttgattttcatttttcttgccatattccatgtcctacagtggaaatttctaaattttccacctttttcagttttcctcgccatatttcacgtcctaaagtgtgaatttctcattttccgtgattttcagttttctcgccatattccaggtctacagtgtgcatttctcatttttcacgttttcagtgattcgtcatttttcaagttgacaagtggatgtttctcattttccatgattttcagctttcttgccatattcaaagtcctacagtggacatttctaaattttcgacctttatcagttttcctcgccatatttcatgtcccaaagtgtgtacttctcattttccgtgattttcagttttcttgccatattccaagtcctacagtgtgcatttctcatttttcacgtttttcagtgattttgtcatttttcaatttgtcaactgcatgtttctcattttccatgattttcagttttcttgccatattccatgtcctacagtggaaatttctatattttccacctttttcagttttcctcgccatatttcacgtgctaaagtgtgtatttctcatttttcgtgtttttcaggtttctcgccatattccaggtcctacagtgtgcatttctcatttttcacgtttttcagtgattttgtcatttttcaagttgtcaagtggatgtttctcattttcaatgattttcatttttcttgccttattccacgtcctatagtggacatttctaaattttccacctttttcagtttttctcgccatatttcacgtcccaaaatgtgtattccttattttccatgattttcagtttcctcgccatattccaggtcctacagtgtgcatttctcatttttcacgtttttcagtgatttcgtcttttttcaagacgtcaagtggatgtttctcatttttcatgattttcagttttcttgccatattccctgtcctacagtggacatttctaaattttccacctttttctgttttcctcgccatatttcacgtcctaaagtgtgtatttctcattttccgtgattttcagttttctcgccagattccaggtcctacagtgtgcatttctcatttttcacgtttttcagtgattttgtcatttttcaatttgtcaactgcatgtttctctctttccatgattttcagttttcttgccatattccatgtcctacagtggacatttctaaattttccacctttttcagttttcctcgccatatttcacgtgctaaagtgtgtatttctcatttttcgtgtttttcaggtttctcgccatattccaggtcctacagtgtgcatttctcatttttcacgtttttcagtgattttgtcatttttcaagttgtcaagtggatgtttctcattttcaatgattttcatttttcttaccttattccacgtcctatagtggacatttctaaattttccacctttttcagtttttctcgccatatttcacgtcccaaaatgtgtattccttattttccatgattttcagtttcctcgccatattccaggtcctacagtgtgcatttctcatttttcacgtttttcagtgatttcgtcttttttcaagacgtcaagtggatgtttctcatttttcatgattttcagttttcttgccatattccctgtcctacagtggacatttctaaattttccacctttttctgttttcctcgccatatttcacgtcctaaagtgtgtatttctcattttccgtgattttcagttttctcgccagattccaggtcctacagtgtgcatttctcatttttcacgtttttcagtgatttcgtcatttttcaagtcttcaagtgtatgtttctcattttcaatgattttcatttttcttgccttattccacgtcctatagtggacatttctaaattttccacctttttcagtttttctcgccatatttcacgtcctaaagtgtgtatttctcattttctgtgattttcagttttcttaccatattccaggtcctacagtgtgcatttctcatttttcacgtttttcagtgatttcgtcatttttcaagttgtcaagtggaagtttctcattttccatgattttcagctttctagccatattccaggtattacagtggacatttccttattttcgacctttatcagttttcctcgccatatttcatgtcctaaagtgtgt	38399	1554	4%	7300	19%
9	3000001	3038400	Atcctacagtgtgcatttctcatttttcacgtttttcagtgatttcgtcatttttcaagtcatcaagtggctgtttctcattttccatgattttcagttttcttgccatattccttgtcctacagtggacatttctaaattttccacctttttcagttttccttgtcatatttcaggtcctacagtgtgtatttctcatttttcacgtttttcattgatttcgtcatttttcaagttgtcaagtgcatgtttctcattttccatgattttcagttttcttgccatattccatgtcctacaatggacatttctaaattttccaactttttcagttttcctcgccatatttcacgtcctaaagtgtgtatttctcattttccgtgattttcagttttctcgacatattccaggtcctacagtgtgcatttctcatttttcacgtttttcagtgatttcgtcatttttcacgtcgtcaagtggatgtttctcattttccatgattttcagttttcttgccatattccatgtcctacagtggacatttctaaattttccacctttttcagttttcctcgccatatttcacgtcctaaagtgtgtatttctcattttccgtgattttcagttttctcgacatattccaggtcttacagggtgcatttctcatttttcacgtttttcagtgatttcatcatttttcaagtcgtcaactgtatgtttctcattttcaatgattttcatttttcttgccatattccacgtcctatagtggacatttctaaattttccacctttttcagttttccttgccatatttcaggtcctacagtgtgcatttctcatttttcacgtttttcagtgatttcgtcatttttcaagtggtcaaatgcatgtttctcattttccatgattttcagttttcttgccatattccatgtcctacagtggacatttctaaattttccacctttttcagttttcctcgccatatttcacgtcctaaagtgtgtatttctcattttccgtgattttcagttttatcgccagattccaggtcctacggtgtgcatttttcatatttcacgtttttcagtgattttgtcatttttcaagttgtcaactgcatgtttctcattttccatgattttcagttttcttgccatattccatgtcctacagtggacatttctaaattttccacctttttcagttttcctcgccatatttcatgtcctaaagtgtgtatttctcattttcagtgattttctgttttctcgccatattccaggtcctacagtgtgcatttctcatttttcacgtttttcagtgatttcgtcatttttcaagttgtcaagtggatgtttctcattttccatgattttcagttttcttgccatattccatgtcctacaatggacatttctaaattttccacctttttcagttttcctcgccatatttcacgtcctaaagtgtgtatttctcattttccgtgattttcagttttctcgccatattccaggtcctatgtgtacatttctcatttttcacgtttttcagtgattttgtcatttttcaagttgtgaagtggatgtttctcatttttcttgattttcatttttcttgccatattccatgtcctagagtggaaatttttaaattttccacctttttcagttttcctcgccatatttcacgtcctaaagtgtgaatttctcattttccgtgattttcagttttctcgccatattccaagtcctacagtgtgcatttctcatttttcacgtttttcagtgatttcgtcatttttcaagttgtcaagtggatgtttctcattttccatgattttcagctttcttgccatattcaaagtcctacagtggacatttctaaattttcgacctttatcagttttcctcgccatatttcatgtcccaaagtgtgtacttctcattttccgtgattttcagtttcctcgccatattctaggtcctacagtgtgcatttctcatttttcaggtttttcagtgatttcgtcttttttcaagtcgtcaagtggatgtttctcattttccatgattttcagttttcttgccatattccatgtcctacagtggacatttctaaattttccaactttttcagttttcctcgccatatttcatgtcctaaagtgtgtatttctcattttcagtgattttcagttttctcgccatattccaggtcctacagtgtgcatttctcatttttcacgtttttcagtgatttcgtcatttttcaagttgtcaagtggatgtttctcatttttcatgattttcagttttcttgccatattccatgtcccacagtggacatttctaaatgttccacctttttctgttttccttgccatatttcatgtcctaaagtgtgtatttctcattttccgtgattttcagttttcttgctatattccaagtcctacagtgtgcatttctcatttttcacgtttttctgtgattttttcatttttcaatttgtcaactgcatgtttctcattttccatgattttcagttttcttgccatattccaggtcctacagtgtgcatttctcatttttcacgtttttcagtgattttgtcatttttcaagttgtcaactgcatgtttctcattttccatgattttcagttttcttgctatattccatgtcctacagtggaaatttctaaattttccacctttttcagttttcctcgccatatttcacgtcctaaagtgtgtatttctcattttccgtgattttcagttttctcgccatattccaggtcctatgtgtacatttctcatttttcacgtttttcagtgattttgtcatttttcaagttgtgaagtggatgtttctcatttttcttgattttcatttttcttgccatattccatgtcctagagtggaaatttttaaattttccacctttttcagttttcctcgccatatttcacgtcctaaattgtgaatttctcattttccgtgattttcagttttctcgccatattccaagtcctacagtgtgcatttctcatttttcacgtttttcagtgatttcgtcatttttcaagttgtcaagtggatgtttctcattttccatgattttcagctttcttgccatattcaaagtcctacagtggacatttctaaattttcgacctttatcagttttcctcgccatatttcatgtcccaaagtgtgtacttctcattttccgtgattttcagtttcctcgccatattctaggtcctacagtgtgcatttctcatttttcaggtttttcagtgatttcgtcttttttcaagtcgtcaagtggatgtttctcattttccatgattttcagttttcttgccatattccatgtcctacagtggacatttctaaattttccacctttttcagttttcctcgccatatttcatgtcctaaagtgtgtatttctcattttcagtgattttcagttttctcgccatattccaggtcctacagtgtgcatttctcatttttcacgtttttcagtgattttgtcatttttcaagttgtcaagtggatgtttctcattttccttgattttcagttttcttgccatattccatgtcctacagtggacatttctaaattttccacctttttcagttttccttgccatatttcatgtcctaaagtgtgtatttctcattttcagtgattttcagttttctcgccatattccaggtcctacagtgtgcatttctcattttttcaggtttttcagtgatttcgtcatttttcacgttgtcaagtggatgtttctcattttccatgattttcacttttcttgccatatttcatgtcctaaagtgtgtatttctcattttcagtgattttcagttttctcgccatattccaggtcctacagtgtgcatttctcattttttcacgtttttcagtgatttcgtcatttttcacgttgtcaagtggatgtttctcattttccattattttcacttttcttgccatatttcatgtcctacagtggacatttctaaattttccacctttttctgttttcctcgccatatttcacatcctaaagtgtgtatttctcattttccgtgattttcagttttcttgccatattccaggtcctacagtgtgcatttctcatttttcacgtttttcagtgatttcgtcatttttcaagtcgtcaagtggatgtttctcattttccatgattttcagttttctcgccatattccaggtcctacagttgacatttctaaattttccacattttttatgtttcctcgcgatatttcacatcctaaagtgtgtatttctcattttccgtgattttcagttttcttgccatattccaggtcctacagggtgcatttctcatttttcacgtttttcagtgatttcatcaatttcaagtcgtcaactgtatgtttctcattttcaatgattttcatttttcttgccatattccacgtcctatagtggacatttctacattttccacctttttcagttttcttcgccatatttcacgtcccaaagtgtgtatttctcattttccgtgattttcagtttcctcgccatattccaggtcctacagtgtgcatttctcatttttcacgtttttcagtgatttcgtcttttttcaagtcgtcaagtggatgtttctcattttccatgattttcagttttcttgccatattccatgtcctacagtggacatttctaaattttccacctttttctgttttcctcgccatatttcacgtcctaaagtgtgtatttctcatttaccgtgattttcagttttcttgctatattccaagtcctacagtgtgcatttctcatttttcacgtttttcactgattttgtcattgttcaagttgtcaactgcatgtttctcattttccatgattttcagttttcttgccatattccatgtcctacagtggaaatttctatattttccaactttttcagttttcctcgccatatttcacgtgctaaagtgtgtatttctcatttttcgtgtttttcaggtttctcgccatattccaggtcctacagtgtgcatttctcatttttcacgtttttcagtgattttgtaatttttcaagttgtcaagtggatgtttctcattttccttgattttcagttttcttgccatattccatgtcctactgtggacatttctaaattttccacctttttcagttttccttgccatatttcatgtcctaaagtgtgtatttctcattttcagtgattttcagttttctcgcaatattccaggtcctacagtgtgcatttctcattttttcaggtttttcagtgatttcgtcatttttcacgttgtcaagtggatgtttctcattttccatgattttcacttttcttgccatatttcatgtgctaaagtgtgtatttctcattttcagtgattttcagttttctgccatattccaggtcctacattgtgcatttctcattttttcacgtttttcagtgatttcgtcatttttcacgttgtcaagtggatgtttctcattttccatgattttcacttttcttgccatatttcatgttttacagtggacatttctaaattttccacctatttctgttttcctcgccatatttcacatcctaaagtgtgtatttctcattttccgtgattttcagttttctcgccatatgccaggtcatacagggtgcatttctcatttttcacgtttttcagtgatttcgtcatttttcacgtcgtcaagtggatgtttctcattttcaatgattttcatttttcttgccatattccacgtcctatagtggacatttctaaattttccacctttttcagttttccttgccatatttcaggtcctacagtgtgcatttctcttttttcacgtttttcagtgatttcgtcatttttcaagtggtcaagtgcatgtttctcattttccgtgattttcagttttcttgccatgttccaggtcctacagttgacgtttctaaaatttcactttttttaagttttcctcgccatatttcacttcctaaagtgtgtatttctcattttccgtgattttcagttttctcgccagattccaggtcctacagtgtgcatttttcatatttcacctttttcagtgattttgtcatttttcaagttgtcaactgcatgtttctcattttccatgattttcagttttcttgccatattccatgtcctactgtggacatttctaaattttccaactttttcagttttcctcgccatatttcatgtcctaaagtgtgtatttctcattttcagtgattttctgttttctcgccatattccaggtcctacagtgtgcatttctaatttttcacgtttttcagtgatttcgtcatttttcaagttgtcaagtggatgtttctcattttccatgattttcagttttcttgccatattccatgtcctacagtggacatttctaaattttccaactttttccattttcctcaccatatttcacgtcctaaagtgagtttttctcattttttgtgattttcagttttctcgacatattccaggtcctacagtgtgcatttctaattttttcttttttcagtgatttcgtcatttttcaagtggtcaagtgcatgtttctcattttccatgattttcagttttcttgccatattccatgtcctacaatggacatttctaaattttccaactttttcagttttcctcgccatatttcacgtcctaaagtgtgtatttctcattttccgtgattttcagttttctcgccatattccaggtcctacagtgtgcatttctcatttttcacgtttttcagtgatttcgtcatttttcaagttgtcaactgcatgtttctcattttccatgattttcagttttcttgccatattccatgtcttacagtggacatttttaaatttttcacatttttttaagttttcctccccatatttcacgttttaaagtgtgcatttctcattttcggtgattttcagttttctcgccagattccatgtcttacagtgtgcatttctcattttttcacgtttttcagtgatttcgtcatttttcaagtcgtcaagtggatgtttctcattttccatgattttcagttttcttgccatattccatgtcctacagtggaaatttctaaattttccacctttttcagttttccttgccatatttcaggtcctaaagtgtgtatttctcattttctgtgattttcagttttctcgccatattccaggtcctacagttgacatttctaaaatttccacattttttaagttttcctcgccatatttcacttcctaaagtgtgtatttctcattttccgtgattttcagttttctcgccatattccagatcctacagtgtacatttttcatttttcacgtttttcagtgattttgtcattttttagttgtcaactgcctgtttctcattttccatgattttcagttttcttgctatattccatgtcctacagtggaaatttctaaattttccacctttttcagttttcctcgccatatttcacgtcctaaagtgtgtatttctcattttccgtgattttcagttttctcgccatattccaggtcctatgtgtacatttctcatttttcacgtttttcagtgattttgtcatttttcaatttgtcaactgcatgtttctcattttccatgattttcagttttcttgccatattccatgtcctacagtggaaatttctatattttccaactttttcagttttcctcgccatatttcacgtgctaaagtgtgtatttctcatttttcgtgtttttcaggtttctcgccatattccaggtcctacagtgtgcatttctcatttttcacgtttttcagtgattttgtcatttttcaagttgtcaagtggatgtttctcattttccttgattttcagttttcttgccatattccatgtcctacagtggacatttctaaattttccacctttttcagttttccttgccatatttcatgtcctaaagtgtgtatttctcattttcagtgattttcagttttctcgccatattccaggtcctacagtgtgcatttctcattttttcaggtttttcagtgatttcgtcatttttcacgttgtcaagtggatgtttctcattttccatgattttcacttttcttgccatatttcatgtcctaaagtgtgtatttctcattttcagtgattttcagttttctcgctatattccaggtcctacagtgtgcatttctcattttttcacgtttttcagtgatttcgtcatttttcacgttgtcaagtggatgtttctcattttccatgattttcacttttcttgccatatttcatgtcctacaatggacatttctaaattttccacctttttctgttttcctcgccatatttcacatcctaaagtgtgtatttctcattttccgtgattttcagttttcttgccatattccaggtcctacagtgtgcatttctcatttttcacgtttttcagtgatttcgtcatttttcaagttgtcaagtggatgtttctcattttccttgattttcagttttcttgccatattccatgtcctactgtggacatttctaaattttccacctttttcagttttccttgccatatttcatgtcctaaagtgtgtatttctcattttcagtgattttcagttttctcgcaatattccaggtcctacagtgtgcatttctcattttttcaggtttttcagtgatttcgtcatttttcacgttgtcaagtggatgtttctcattttccatgattttcacttttcttgccatatttcatgtcctaaagtgtgtatttctcattttcagtgattttcagttttctgccatattccaggtcctacattgtgcatttctcattttttcacgtttttcagtgatttcgtcatttttcagttttctcgacatattccaggtcctacagtgtgcatttctaattttttcttttttcagtgatttcgtcatttttcaagttgtcaactgcatgtttctcattttccatgattttcagttttcttgccatattccatgtcttacagtggacatttttaaatttttcacatttttttaagttttcctccccatatttcacgttttaaagtgtgcatttctcattttcggtgattttcagttttctcgccagattccaggtcttacagtgtgcatttctcattttttcacgtttttcagtgatttcgtcatttttcaagtcgtcaagtggatgtttctcattttccatgattttcagttttcttgccatattccatgtcctacagtggaaatttctaaattttccacctttttcagttttccttgccatatttcaggtcctaaagtgtgtatttctcattttctgtgattttcagttttctcgccatattccaggtcctacagttgacatttctaaaatttccacattttttaagttttcctcgccatatttcacttcctaaagtgtgtatttctcattttccgtgattttcagttttctcgccatattccagatcctacagtgtgcatttttcatttttcacgtttttcagtgattttgtcattttttagttgtcaactgtctgtttctcattttccatgattttcagttttcttgccatattccatgtcctacactggacatttctaaattttccacctttttctgttttcctcgccatatttcacgtcctaaagtgtgtatttctcattttccgtgattttcagttttcttgccatattccaggtcctacagtgtgcatttctcatttttcacgtttttcagtgattttgtcatttttcaagttgtcaactgcatgtttctcattttctatgattttcagttttcttgctatattccatgtcctacagtggaaatttctaaattttccacctttttcagttttcctcgccatatttcacgtcctaaagtgtgtatttctcattttccgtgattttcagttttctcgccatattccaggtcctatgtgtacatttctcatttttcacgtttttcagtgattttgtcatttttcaagttgtgaagtggatgtttctcatttttcttgattttcatttttcttgccatattccatgtcctagagtggaaatttttaaattttccacctttttcagttttcctcgccatatttcacgtcctaaagtgtgaatttctcattttccgtgattttcagatttctcgccatattccaagtcctacagtgtgcatttctcatttttcacgtttttcagtgatttcgtcatttttcaagttgtcaagtggatgtttctcattttccatgattttcagctttcttgccatattcaaagtcctacagtggacatttctaaattttcgacctttatcagttttcctcgccatatttcatgtcccaaagtgtgtacttctcattttccgtgattttcagtttcctagccatattctaggtcctacagtgtgcatttctcatttttcaggtttttcagtgatttcgtcttttttcaagtcgtcaagtggatgtttctcattttccatgattttcacttttcttgccatatttcatgtcctaaagtgtgtatttctcattttcagtgattttcagttttctcgctatattccaggtcctacagtgtgcatttctcattttttcacgtttttcagtgatttcgtcatttttcacgttgtcaagtggatgtttctcattttccatgattttcacttttcttgccatatttcatgtcctacagtggacatttctaaattttccacctttttctgttttcctcgccatatttcacatcctaaagtgtgtatttctcattttccgtgattttcagttttcttgccatattccaggtcctacagtgtgcatttctcatttttcacgtttttcagtgatttcgtcatttttcaagttgtcaagtggatgtttctcattttccttgattttcagttttcttgccatattccatgtcctactgtggacatttctaaattttccacctttttcagttttccttgccatatttcatgtcctaaagtgtgtatttctcattttcagtgattttcagttttctcgcaatattccaggtcctacagtgtgcatttctcattttttcaggtttttcagtgatttcgtcatttttcacgttgtcaagtggatgtttctcattttccatgattttcacttttcttgccatatttcatgtcctaaagtgtgtatttctcattttcagtgattttcagttttctgccatattccaggtcctacattgtgcatttctcattttttcacgtttttcagtgatttcgtcatttttcacgttgtcaagtggatgtttctcattttccatgattttcacttttcttgccatatttcatgttttacagtggacatttctaaattttccacctttttctgttttcctcgccatatttcacatcctaaagtgtgtatttctcattttccgtgattttcagttttctcgccatatgccaggtcatacagggtgcatttctcatttttcacgtttttcagtgatttcgtcatttttcacgtcgtcaagtggatgtttctcattttcaatgattttcatttttcttgccatattccacgtcctatagtggacatttctaaattttccacctttttcagttttccttgccatatttcaggtcctacagtgtgcatttctcatttttcacgtttttcagtgatttcgtcatttttcaagtggtcaagtgcatgtttctcattttccgtgattttcagttttcttgccatgttccaggtcctacagttgacgtttctaaaatttcactttttttaagttttcctcgccatatttcacttcctaaagtgtgtatttctcattttccgtgattttcagttttctcgccagattccaggtcctacagtgtgcatttttcatatttcacctttttcagtgattttgtcatttttcaagttgtcaactgcatgtttctcattttccatgattttcagttttcttgccatattccatgtcctactgtggacatttctaaattttccaactttttcagttttcctcgccatatttcatgtcctaaagtgtgtatttctcattttcagtgattttctgttttctcgccatattccaggtcctacagtgtgcatttctaatttttcacgtttttcagtgatttcgtcatttttcaagttgtcaagtggatgtttctcattttccatgattttcagttttcttgccatattccatgtcctacagtggacatttctaaattttccaactttttccattttcctcaccatatttcacgtcctaaagtgtgtttttctcattttttgtgattttcagttttctcgacatattccaggtcctacagtgtgcatttctaattttttcttttttcagtgatttcgtcatttttcaagttgtcaactgcatgtttctcattttccatgattttcagttttcttgccatattccatgtcttacagtggacatttttaaatttttcacatttttttaagttttcctccccatatttcacgttttaaagtgtgcatttctcattttcggtgattttcagttttctcgccagattccaggtcttacagtgtgcatttctcattttttcacgtttttcagtgatttcgtcatttttcaagtcgtcaagtggatgtttctcattttccatgattttcagttttcttgccatattccatgtcctacagtggaaatttctaaattttccacctttttcagttttccttgccatatttcaggtcctaaagtgtgtatttctcattttctgtgattttcagttttctcgccatattccaggtcctacagttgacatttctaaaatttccacattttttaagttttcctcgccatatttcacttcctaaagtgtgtatttctcattttccgtgattttcagttttctcgccatattccagatcctacagtgtgcatttttcatttttcacgtttttcagtgattttgtcattttttagttgtcaactgtctgtttctcattttccatgattttcagttttcttgccatattccatgtcctacactggacatttctaaattttccacctttttctgttttcctcgccatatttcacgtcctaaagtgtgtatttctcattttccgtgattttcagttttcttgccatattccaggtcctacagtgtgcatttctcatttttcacgtttttcagtgattttgtcatttttcaagttgtcaactgcatgtttctcattttccatgattttcagttttcttgctatattccatgtcctacagtggaaatttctaaattttccacctttttcagttttcctcgccatatttcacgtcctaaagtgtgtatttctcattttccgtgattttcagttttctcgccatattccaggtcctatgtgtacatttctcatttttcacgtttttcagtgattttgtcatttttcaagttgtgaagtggatgtttctcatttttcttgattttcatttttcttgccatattccatgtcctagagtggaaatttttaaattttccacctttttcagttttcctcgccatatttcacgtcctaaagtgtgaatttctcattttccgtgattttcagatttctcgccatattccaagtcctacagtgtgcatttctcatttttcacgtttttcagtgatttcgtcatttttcaagttgtcaagtggatgtttctcattttccatgattttcagctttcttgccatattcaaagtcctacagtggacatttctaaattttcgacctttatcagttttcctcgccatatttcatgtcccaaagtgtgtacttctcattttccgtgattttcagtttcctcgccatattctaggtcctacagtgtgcatttctcatttttcaggtttttcagtgatttcgtcttttttcaagtcgtcaagtggatgtttctcattttccatgattttcagttttcttgccatattccatgtcctacagtggacatttctaaattttccacctttttcagttttcctcgccatatttcatgtcctaaagtgtgtatttctcattttcagtgattttcagttttctcgccatattccaggtcctacagtgtgcatttctcatttttcacgtttttcagtgatttcgtcatttttcaagttgtcaagtggatgtttctcattttccatgattttcagttttcttgccatattccatgtcccacagtggacatttctaaattttccacctttttctgttttccttgccatatttcatgtcctaaagtgtgtatttctcattttccgtgattttcagttttcttgctatattccaagtcctacagtgtgcatttctcatttttcacgtttttcagtgattttgtcatttttcaatttgtcaactgcatgtttctcattttccatgattttcagttttcttgccatattccatgtcctacagtggaaatttctatattttccaactttttcagttttcctcgccatatttcacgtgctaaagtgtgtatttctcatttttcgtgtttttcaggtttctcgccatattccaggtcctacagtgtgcatttctcatttttcacgtttttcagtgattttgtcatttttcaagttgtcaagtggatgtttctcattttccttgattttcagttttcttgccatattccatgtcctacagtggacatttctaaattttccacctttttcagttttccttgccatatttcatgtcctaaagtgtgtatttctcattttcagtgattttcagttttctcgccatattccaggtcctacagtgtgcatttctcattttttcaggtttttcagtgatttcgtcatttttcacgttgtcaagtggatgtttctcattttccatgattttcacttttcttgccatatttcatgtcctaaagtgtgtatttctcattttcagtgattttcagttttctcgctatattccaggtcctacagtgtgcatttctcattttttcacgtttttcagtgatttcgtcatttttcacgttgtcaagtggatgtttctcattttccatgattttcacttttcttgccatatttcatgtcctacagtggacatttctaaattttccacctttttctgttttcctcgccatatttcacatactaaagtgtgtatttctcattttccttgattttcagttttcttgccatattccaggtcctacagtgtgcatttctcatttttcacgtttttcagtgatttcgtcatttttcaagtcgtcaagtggatgtttctcattttccatgattttcagttttctcgccatattccaggtcctacagttgacatttctaaattttccacattttttaagtttcctcgcgatatttcacatcctaaagtgtgtatttctcattttccgtgattttcagttttcttgccatattccaggtcctacagggtgcatttctcatttttcacgtttttcagtgatttcatcaatttcaagtcgtcaactgtatgtttctcattttcaatgattttcatttttcttgccatattccatgtcctacagtggacatttctaaatttttcacctttttcagttttccttgccatatttcatgtcctaaagtgtgtatttctcattttcagtgattttcagttttctcgccatattccaggtcctacagtgtgcatttctcattttttcaggtttttcagtgatttcgtcatttttcacgttgtcaagtggatgtttctcattttccatgattttcacttttcttgccatatttcatgtcctaaagtgtgtatttctcattttcagtgattttcagttttctcgccatattccaggtcctacagtgtgcatttctcatttttcacgtttttcagtgatttcgtcatttttcaagttgtcaagtggatgtttctcattttccatgattttcacttttcttgccatattccatgtcccacagtggacatttctaaattttccacctttttctgttttcctcgccatatttcatgtcctaaagtgtgtatttctcattttccgtgattttcagttttcttgctatattccaagtcctacagtgtgcatttctcatttttcacgtttttcagtgattttgtcatttttcaatttgtcaactgcatgtttctcattttccatgattttcagttttcttgccatattccatgttctacagtggaaatttctatattttccaactttttcagttttcctcgccatatttcacgtgctaaagtgtgtatttctcatttttcgtgtttttcaggtttctcgccatattccaggtcctacagtgtgcatttctcatttttcacgtttttcagtgattttgtcatttttcaagttgtcaagtggatgtttctcattttccttgattttcagttttcttgccatattccatgtcctacagtggacatttctaaattttccacctttttcagttttccttgccatatttcatgtcctaaagtgtgtatttctcattttcagtgattttcagttttctcgccatattccaggtcctacagtgtgcatttctcattttttcaggtttttcagtgatttcgtcatttttcacgttgtcaagtggatgtttctcattttccatgattttcacttttcttgccatatttcatgtcctaaagtgtgtatttctcattttcagtgattttcagttttctcgctatattccaggtcctacagtgtgcatttctcattttttcacgttttgcagtgatttcgtcatttttcacgttgtcaagtggatgtttctcattttccatgattttcacttttcttgccatatttcatgtcctacagtggacatttctaaattttccacctttttctgttttcctcgccatatttcacatcctaaagtgtgtatttctcattttccgtgattttcagttttcttgccatattccaggtcctacagtgtgcatttctcatttttcacgtttttcagtgatttcgtcatttttcaagtcgtcaagtggatgtttctcattttccatgattttcagttttctcgccatattccaggtcctacagttgacatttctaaattttccacattttttaagtttcctcgcgatatttcacatcctaaagtgtgtatttctcattttccgtgattttcagttttcttgccatattccaggtcctacagggtgcatttctcatttttcacgtttttcagtgatttcatcaatttcaagtcgtcaactgtatgtttctcattttcaatgattttcatttttcttgccatattccatgtcctacagtggacatttctaaattttccacctttttcagttttccttgccatatttcatgtcctaaagtgtgtatttctcattttcagggattttcagttttctcgccatattccaggtcctacagtgtgcatttctcattttttcaggtttttcagtgatttcgtcatttttcacgttgtcaagtggatgtttctcattttccatgattttcacttttcttgccatatttcatgtcctaaagtgtgtatttctcattttcagtgattttcagttttctcgccatattccaggtcctacagtgtgcatttctcattttttcacgtttttcagtgatttcgtcatttttcacgttgtcaagtggatgtttctcattttccatgattttcacttttcttgccatatttcatgtcctacagtggacatttctaaattttccacctttttctgttttcctcgccatatttcacatcctaaagtgtgtatttctcattttccgtgattttcagttttcttgccatattccaggtcctacagtgtgcatttctcatttttcacgtttttcagtgatttcgtcatttttcaagtcgtcaagtggatgtttctcattttccatgattttcagttttctcgccatattccaggtcctacagttgacatttctaaattttccacattttttaagtttcctcgcgatatttcacatcctaaagtgtgtatttctcattttccgtgattttcagttttcttgccatattccaggtcctacagggtgcatttctcatttttcacgtttttcagtgatttcatcaatttcaagtcgtcaactgtatgtttctcattttcaatgattttcatttttcttgccatattccacgtcctatagtggacatttctaaattttccacctttttcagttttcttcgccatatttcacgtcccaaagtgtgtatttctcattttccgtgattttcagtttcctcgcaatattccaggtcctacagtgtgcatttctcatttttcacgtttttcagtgatttcgtcttttttcaagtcgtcaagtggatgtttctcattttccatgattttcagttttcttgccatattccatgtcctacagtggacatttctaaattttccacctttttctgttttcctcgccatatttcacgtcctaaagtgtgtatttctcattttccgtgattttcagttttcttgccatattccaggtcctacagtgtgcatttctcatttttcacgtttttcactgattttgtcattgttcaagttgtcaactgcatgtttctcattttccatgattttcaattttcttgccatattccatgtcctacagtggaaatttctatattttccaactttttcagttttcctcgccatatttcacgtgctaaagtgtgtatttctcatttttcgtgtttttcaggtttctcgccatattccaggtcctacagtgtgcatttctcatttttcacgtttttcagtgattttgtcatttttcaagttgtcaagtggttgtttctcattttccttgattttcagttttcttgccatattccatgtcctactgtggacatttctaaattttccacctttttcagttttccttgccatatttcatgtcctaaagtgtgtatttctcattttcagtgattttcagttttctcgcaatattccaggtcctacagtgtgcatttctcattttccgtgattttcagttttctcgccatatgccaggtcatacagggtgcatttctcatttttcacgtttttcagtgatttcgtcatttttcacgtcgtcaagtggatgtttctcattttcaatgattttcatttttcttgccatattccacgtcctatagtggacatttctaaattttccaactttttcagttttcttgccatatttcaggtcctacagtgtgcatttctcatttttcacgtttttcagtgatttcgtcatttttcaagtggtcaagtgcatgtttctgattttccgtgattttcagttttcttgccatgttccaggtcctacagttgacgtttctaaaatttcactttttttaagttttcctcgccatatttcacttcctaaagtgtgtatttctcattttccgtgattttcagttttctcgccagattccaggtcctacagtgtgcatttttcatatttcacctttttcagtgattttgtcatttttcaagttgtcaactgcatgtttctcattttccatgattttcagttttcttgccatattccatgtcctactgtggacatttctaaattttccaactttttcagttttcctcgccatatttcatgtcctaaagtgtgtatttctcattttcagtgtttttctgttttctcgccatattccaggtcctacagtgtgcatttctaatttttcacgtttttcagtgatttcgtcatttttcaagttgtcaagtggatgtttctcattttccatgattttcagttttcttgccatattccatgtcctacagtggacatttctaaattttccaactttttccattttcctcaccatatttcacgtcctaaagtgtgtttttctcattttttgtgattttcagttttctcgacatattccaggtcctacagtgtgcatttctaattttttcttttttcagtgatttcgtcatttttcaagtggtcaagtgcatgtttctcattttccatgattttcagttttcttgccatattccatgtcctacaatggacatttctaaattttccaactttttcagttttcctcgccatatttcacgtcctaaagtgtgtatttctcattttccgtgattttcagttttctcgccatattccaggtcctatgtgtacatttctcatttttcacgtttttcagtgattttgtcatttttcaagttgtgaagtggatgtttctcatttttcttgattttcatttttcttgccatattccatgtcctagagtggaaatttttaaattttccaactttttcagttttcctcgccatatttcacgtcctaaagtgtgtatttctcattttccgtgattttcagttttctcgccatattccaagtcctacagtgtgcatttctcatttttcacgtttttcagtgatttcgtcatttttcaagttgtcaagtggatgtttctcattttccatgattttcagctttcttgccatattcaaagtcctacagtggacatttctaaattttcgacctttatcagttttcctcgccatatttcatgtcccaaagtgtgtacttctcattttccgtgattttcagtttcctcgccatattctaggtcctacagtgtgcatttctcatttttcaggtttttcagtgatttcgtcttttttcaagtcgtcaagtggatgtttctcattttccatgattttcagttttcttgccatattccatgtcctacagtggacatttctaaattttccacctttttcagttttcctcgccatatttcatgtcctaaagtgtgtatttctcattttcagtgattttcagttttctcgccatattccaggtcctacagtgtgcatttctcatttttcacgtttttcagtgatttcgtcatttttcaagttgtcaagtggatgtttctcattttccatgattttcagttttcttgccatattccatgtcccacagtggacatttctaaattttccacctttttctgttttccttgccatatttcatgtcctaaagtgtgtatttctcattttccgtgattttcagttttcttgctatattccaagtcctacagtgtgcatttctcatttttcacgtttttaagtgattttgtcatttttcaatttgtcaactgcatgtttctcattttccatgattttcagttttcttgccatattccatgtcctacagtggaaatttctatattttccaactttttcagttttcctcgccatatttcacgtgctaaagtgtgtatttctcatttttcgtgtttttcaggtttctcgccatattccaggtcctacagtgtgcatttctcatttttcacgtttttcagtgattttgtcatttttcaagttgtcaagtggatgtttctcattttccttgattttcagttttcttgccatattccatgtcctacagtggacatttctaaattttccacctttttcagttttccttgccatatttcatgtcctaaagtgtgtatttctcattttcagtgattttcagttttctcgccatattccaggtcctacagtgtgcatttctcattttttcaggtttttcagtgatttcgtcatttttcacgttgtcaagtggatgtttctcattttccatgattttcacttttcttgccatatttcatgtcctaaagtgtgtatttctcattttcagtgattttcagttttctcgccatattccaggtcctacagtgtgcatttctcattttttcacgtttttcagtgatttcgtcatttttcacgttgtcaagtggatgtttctcattttccatgattttcacttttcttgccatatttcatgtcctacagtggacatttctaaattttccacctttttctgttttcctcgccatatttcacatcctaaagtgtgtatttctcattttccgtgattttcagttttcttgccatatttcaggtcctacagtgtgcatttctcatttttcacgtttttcagtgatttcgtcatttttcaagtcgtcaagaggatgtttctcattttccatgattttcagttttctcgccatattccaggtcctacagttgacatttctaaattttccacattttttaagtttcctcgcgatatttcacatcctaaagtgtgtatttctcattttccgtgattttcagttttcttgccatattccaggtcctacagggtgcatttctcatttttcacgtttttcagtgatttcatcaatttcaagtcgtcaactgtatgtttctcattttcaatgattttcatttttcttgccatattccacgtcctatagtggacatttctaaattttccacctttttctgttttcctcgccatatttcacgtcctaaagtgtgtatttctcattttccgtgattttcagttttcttgccatattccaggtcctacagtgtgcatttctcatttttcacgtttttcactgattttgtcattgttcaagttgtcaactgcatgtttctcattttccatgattttcagttttcttgccatattccatgtcctacagtggaaatttctatattttccacctttttcagttttcctcgccgtatttcatgtgctaaagtgtgtatttctcatttttcgtgtttttcaggtttctcgccatattccaggtcctacagtgtgcatttctcatttttcacgtttttcagtgattttgtcatttttcaagttgtcaactggatgtttctcattttccttgattttcagttttcttgccatattccatgtcctactgtggacatttctaaattttccacctttttcagttttccttgccatatttcatgtcctaaagtgtgtatttctcattttcagtgattttcagttttctcgcaatattccaggtcctacagtgtgcatttctcattttttcaggtttttcagtgatttcgtcatttttcacgttgtcaagtggatgtttctcattttccatgattttcacttttcttgccatatttcatgtcctaaagtgtgtatttctcattttcagtgattttcagttttctcgccatattccaggtcctacattgtgcatttctcattttttcacgtttttcagtgatttcgtcatttttcacgttgtcaagtggatgtttctcattttccatgattttcacttttcttgccatatttcatgttttacagtggacatttctaaattttccacctttttctgttttcctcgccatatttcacatcctaaagtgtgaatttctcattttccgtgattttcagttttcttgccatattccaggtcctacagtgtgcatttctcatttttcacgtttttcagtgatttcatcatttttcaagtcgtcaagtggatgtttctcattttccatgattttcagttttcttgccatattccatgtcctacagtggacatttctaaattttccacctttttctgttttcctcgccatatttcacgtcctaaagtgtgtatttctcattttccgtgattttcagttttcttgccatattccaggtcctacagtgtgcatttctcatttttcacgtttttcactgattttgtcatttttcaagttgtcaactgcatgtttctcattttccatgattttcagttttcttgctatattccatgtcctacagtggaaatttctaaattttccacctttttcagttttcctcgccatatttcacgtcctgaagtgtgtatttctcattttccgtgattttcagttttctcgccatattccaggtcctatgtgtacatttctcatttttcacgtttttcagtgattttgtcatttttcaagttgtgaagtggatgtttctcatttttcttgattttcatttttcttgccatattccatgtcctacagtggaaatttctaaattttccacctttttcagttttcctcgccatatttcacgtcctaaagtgtgtatttctcattttccgtgattttcagttttctcgccatattccaggtcctacagtgtgcatttctcatttttcacgtttttcagtgatttcgacatttttcaagttgtcaagtggatgtttctcattttccatgattttcagctttcttgccatattcaaagtcctacagtggacatttctaaattttcgacctttatcagttttcctcgccatatttcatgtcccaaagtgtgtacttctcattttccgtgattttcagtttcctcgccatattccaggtcctacagtgtgcatttctcatttttcacgtttttcagtgatttcgtcatttttcaagtcgtcaagtggatgtttctcattttccatgattttcagttttcttgccatattccatgtcctacagtggacatttctaaattttccacctttttctgttttcctcgccatatttcacgtcctaaagtgtgtatttctcattttccgtgattttcagttttcttgccatattccaggtcctacagtgtgcatttctcatttatcacgtttttcactgattttgtcatttttcaagttgtcaactgcatgtttctcattttccatgattttcagttttcttgctatattccatgtcctacagtggaatattctaaattttccacctttttcagttttcctcgccatatttcacgtcctgaagtgtgtatttctcattttccgtgattttcagttttctcgccatattccaggtcctatgtgtacatttctcatttttcacgtttttcagtgattttgtcatttttcaagttgtgaagtggatgtttctcatttttcttgattttcatttttcttgccatattccatgtcctacagtggaaatttctaaattttccacctttttcagttttcctcgccatatttcacgtcctaaagtgtgaatttctcattttccgtgattttcagttttctcgccatattccaggtcctacagtgtgcatttctcatttttcacgtttttcagtgatttcgacatttttcaagttgtcaagtggatgtttctcattttccatgattttcagctttcttgccatattcaaagtcctacagtggacatttctaaattttcgacctttatcagttttcctcgccatatttcatgtcccaaagtgtgtacttctcattttccgtgattttgagtttcctcgccatattccaggtcctacagtgtgcatttctcatttttcacgtttttcagtgatttcgtcttttttcaagttgtcaactgcatgtttctcattttccatgattttcagttttcttgccatattccatgtcctacagtggaaatttgtaaatttccacctttttcagttttcctcgccatatttcacgtcctaaagtatgtatttctcattttccgtgattttcagttttctcgccatattccaggtcctacagtgtgcatttctcatttttcacgtttttcagtgattttgtcattttttaagttttcaagtggatgtttctcattttccttgattttcagttttcttgccatattccatgtcctacagtggacatttctaaattttccacctttttcagttttcctcgccatatttcatgtcctaaagtgtgtatttctcattttcagtgattttcagttttctcgccatattccaggtcctacagtgtgcatttctcatttttcacgtttttcagtgatttcgtcatttttcaaggtgtcaagtggatgtttctcattttccatgattttcagttttcttgccatattccatgtcctacagtggacatttctaaattttccacctttttctgttttcctcgccatatttcatgtcctaaagtgtgtatttctcattttccgtgattttcagttttcttgctatattccaagtcctacagtgtgcatttctcatttttcacgtttttcagtgattttgtcatttttcaatttgtcaactgcatgtttctcattttccatgattttcagtttttttgccatattccatgtcctactgtggaaatttctatattttccacctttttcagttttcctcgccatatttcacgtgctaaagtgtgtatttctcatttttcgtgtttttcaggtttctcgccatattccaggtcctacagtgtgcatttctcatttttcacgtttttcagtgattttgtcatttttcaagttttcaagtggatgtttctcattttccttgattttcagttttcttgccatattccatgtcctacagtggacatttctaaattttccacctttttcagttttccttgccatatttcatgtcctaaagtgtgtatttctcattttcagtgattttcagtttccttgccatattccaggtcctacagtgtgcatttctcattttttcacgtttttcagtgatttcgtcatttttcacgttgtcaagtggatgtttctcattttccatgattttcacttttcttgccatatttcatgtcctacagtggacatttctaaattttccaactttttcaattttcctcgccatattttatgtcctaaagtgtgtatttctcatttttcgttattttcagttttcttgccatattccaggtcctacagtgtgcatttgtcatttttcacgtttttcagtgatttcgtcatttttcaagtcgtcaagtagatgtttctcatattccatgtttttcagttttctcgccatattccaggtcctacagttgacatttctaaattttctacatttttaaattttcctcgccatatttcacgtcctaaagtgtgtatttctcattttttgttattttcagttttctagccatattccaggtcctacaggatgcatttctcatttttcacgtttttcagtgatttcatcatttttcaagtcgtcaagtgtatgtttcttattttcaatgattttcatttttcttgccttattccacgtcctatagtggacatttctaaattttccacctttttcagtttttttcgccatatttcacgtcctaaagtgtgtatttctcattttctgtgattttcagttttctcaccatattccaggtcctacagtgtgcatttctcatttttcacgtttttcagtgatttcgtcatttttcaagttgtcaagtggaagtttctcattttccatgattttcagctttctagacatattccaggtcctacagtggacatttcctaattttcgacctttatcagttttcctcgtcatatttcacgtcccaaaatgtgtatttcttattttccatgattttcagtttcctcgccatattccaggtcctacagtgtgcaattctcatttttcacgtttttcagtgatttcgtcttttttcaagacgtcaagtggatgtttctcatttttcatgattttcagttttcttgccatattccatgtcctacagtggacatttctaaattttccacctttttctgttttcctcgccatatttcacgtcctaaagtgtgtatttctcattttccgtgattttcagttttcttgccatattcctggtcctacagtgtgcatttctcatttttcacgtttttcagtgattttgtcatttttcaatttgtcaactgcatgtttctcattttccattattttcagttttcttgccatattccatgtcctacagtggacatttctaaattttccacctttttctgttttcctcgccatatttcatgtcctaaagtgtgtatttctcattttccgtgattttcagttttcttgctatattccaagtcctacagtgtgcatttctcatttttcacgtttttcagtgattttgtcatttttcaatttgtcaactgcatgtttctcattttccatgattttcagtttttttgccatattccatgtcctacaggggaaatttctatattttccacctttttcagttttcctcgccatatttcatgtcctaaagtgtgtatttctcattttccgtgattttcagttttcttgccatattccaggtcctacagtgtgcatttctcatttttcacgtttttcagtgatttcgtcatttttcaagtcttcaagtagatgtttctcatattccatgtttttcagttttctcgccatattccaggtcctacagttgacatttctaaattttctacatttttaaattttcctcgccatatttcacgtcctaaagtgtgtatttctcatttttcgttattttcagttttctagccatattccaggtcctacaggatgcatttctcatttttcacgtttttcagtgatttcatcatttttcaagtcgtcaagtgtatgtttctcattttcaatgattttcatttttcttgccttattccacgtcctatagtggacatttctaaattttccacctttttcagtttttctcgccatatttcacgtcctaaagtgtgtatttctcattttctgtgattttcagttttctcaccatattccaggtcctacagtgtgcatttctcatttttcacgtttttcagtgatttcgtcatttttcaagttgtcaagtggaagtttctcattttccatgattttcagctttctagccatattccaggtcctacagtggacatttcctaattttcgacctttatcagttttcctcgccatatttcacgtcctaaagtgtgtatttctcattttccgtgattttcagttttcttgccatattccaggtcctacagtgtgcatttctcatttttcacgtttttcagtgattttgtcatttttcaatttgtcaactgcatgtttctcattttccatgatttttagttttcttgctatattccatgtcctacagtggaaatttctaaattttccacctttttcagttttcctcgccatatttcacgtcctaaagtgtgtatttctcattttccgtgattttcagttttcttgctatattccaagtcctacattgtgcatttctcatttttcacgtttttcagtgattttgtcatttttcaatttgtcaaaccacatgtttctcattttccatgattttcagtttttttgccatattccatgtcctacagtggaaatttctatattttccacctttttcagttttcctcgccatatttcacgtgctaaagtgtgtatttctcatttttcgtgtttttcaggtttctcgccatattccaggtcctacagtgtgcatttctcatttttcacgtttttcagtgattttgtcatttttcaagttgtcaagtggatgtttcccattttccttgattttcagttttcttaccatattccatgtcctacagtggacatttctaaattttccacctttttcagttttccttgccatatttcatgtcctaaagtgtgtatttctcattttcagtgattttcagtttcctcgccatattccaggtcctacagtgtgcatttctcattttttcacgtttttcagtgatttcgtcatttttcacgttgtcaagtggatgtttctcattttccatgattttcacttttcttgccatatttcatgtcctatagtggacatttctaaattttccacctttttcagtttttctcgccatatttcacgtcctaaagtgtgtatttctcattttctgtgattttcagttttctcaccatattccaggtcctacagtgtgcatttctcatttttcacgtttttcagtgatttcgtcatttttcaagtcgtcaagtagatgtttctcatattccatgtttttcagttttctcgccatattccaggtcctacagttgacatttctaaattttctacatttttaaattttcctcgccatatttcacgtcctaaagtgtgtatttctcatttttcgttattttcagttttctagccatattccaggtcctacaggatgcatttctcatttttcacgtttttcagtgatttcatcatttttcaagtcgtcaagtgtatgtttcttattttcaatgattttcatttttcttgccttattccacgtcctatagtggacatttctaaattttccaccttttttcagtttttctcgccatatttcacgtcctaaagtgtgtatttctcattttctgtgattatcagttttctcaccatattccaggtcctacagtgtgcatttctcatttttcacgtttttcagtgatttcgtcatttttcaagttgtcaagtggaagtttctcattttccatgattttcagctttctagccatattccaggtcctacagtggacatttcctaattttcgacctttatcagttttcctcgccatatttcacgtcccaaaatgtgtatttcttattttccatgattttcagtttcctcgccatattccaggtcctacagtgtgcatttctcatttttcacgtttttcagtgatttcgtcttttttcaagacgtcaagtggatgtttctcatttttcatgattttcagttttcttgccatattccatgtcctacagtggacatttctaaattttccacctttttctgttttcctcgccatatttcacgtcctaaagtgtgtatttctcattttccgtgattttcagttttcttgccatattcctggtcctacagtgtgcatttctcatttttcacgtttttcagtgattttgtcatttttcaatttgtcaactgcatgtttctcattttccatgattttcagttttcttgccatattccatgtcctacagtggacatttctaaattttccacctttttcagttttcctcgccatatttcacgtgctaaagtgtgtatttctcatttttcgtgtttttcaggtttctcgccatattccaggtcctacagtgtgcatttctcatttttcacgtttttcagtgattttgtcatttttcaagttgtcaagtggatgtttctcattttccttgattttcacttttcttgccatattccaagtcttacaggggcatttctcatttttcacgttttcagtgattttgtcattttcaatttgtcaactgcatgtttctcattttccatgattttcagtttttttgccatattccatgtcctacaggggaaatttctatattttccacctttttcagttttcctcgccatatttcatgtcctaaagtgtgtatttctcattttccgtgattttcagttttcttgccatattccaggtcctacagtgtgcatttctcatttttcacgtttttcagtgatttcgtcatttttcaagtcttcaagtagatgtttctcatattccatgtttttcagttttctcgccatattccaggtcctacagttgacatttctaaattttctacatttttaaattttcctcgccatatttcacgtcctaaagtgtgtatttctcatttttcgttattttcagttttctagccatattccaggtcctacaggatgcatttctcatttttcacgtttttcagtgatttcatcatttttcaagtcgtcaagtgtatgtttctcattttcaatgattttcatttttcttgccttattccacgtcctatagtggacatttctaaattttccacctttttcagtttttctcgccatatttcacgtcctaaagtgtgtatttctcattttctgtgattttcagttttctcaccatattccaggtcctacagtgtgcatttctcatttttcacgtttttcagtgatttcgtcatttttcaagttgtcaagtggaagtttctcattttccatgattttcagctttctagccatattccaagtcctacagtggacatttcctaattttcgacctttatcagttttcctcgccatatttcacgtcccaaaatgtgtattccttattttccatgattttcagtttcctcgccatattccaggtcctacagtgtgcatttatcatttttcacgtttttcagtgatttcgtcttttttcaagacgtcaagtggatgtttctcatttttcatgattttcagttttcttgccatattccatgtcctacagtggacatttctaaattttccacctttttctgttttcctcgccatatttcacgtcctaaagtgtgtatttctcattttccgtgattttcagttttcttgccatattcctggtcctacagtgtgcatttctcatttttcacgtttttcagtgattttgtcatttttcaagttgtcaagtggatgtttctcattttccttgattttcacttttcttgccatattccatgtcctacagtggacatttctatattttccacctttttccgttttccttgccatatttcacgtcctaaagtgtgtatttctcattttccgtgattttcaggtttctcgccatattccaggtcctacagtgtgcatttctcatttttcacgtttttcagtgattttgtcatttttcaagttgtcaagtggatgtttctcattttccttgattttcacttttcttgccatattccatgtcctacagtggacatttctaaattttccacctttttcagttttcctcgccatatttcatgtcctaaagtgtgtatttctcattttcagtgattttcagttttcttgccatattccaggtcctacagtgtgcatttctcatttttcacgtttttcagtgattttgtcatttttcaagttgtcaactgcatgtttctcattttctatgattttcagttttcttgctatattccatgtcctacagtggaaatttctaaattttccacctttttcagttttcctcgccatatttcacgtcctaaagtgtgtatttctcattttccgtgattttcagttttctcgccatattccaggtcctatgtgtacatttctcatttttcacgtttttcagtgattttgtcatttttcaagttgtgaagtggatgtttctcatttttcttgattttcatttttcttgccatattccatgtcctagagtggaaatttttaaattttccacctttttcagttttcctcgccatatttcacgtcctaaagtgtgaatttctcattttccgtgattttcagatttctcgccatattccaagtcctacagtgtgcatttctcatttttcacgtttttcagtgatttcgtcatttttcaagttgtcaagtggatgtttctcattttccatgattttcagctttcttgccatattcaaagtcctacagtggacatttctaaattttcgacctttatcagttttcctcgccatatttcatgtcccaaagtgtgtacttctcattttccgtgattttcagtttcctcgccatattctaggtcctacagtgtgcatttctcatttttcaggtttttcagtgatttcgtcttttttcaagtcgtcaagtggatgtttctcattttccatgattttcacttttcttgccatatttcatgtcctaaagtgtgtatttctcattttcagtgattttcagttttctcgctatattccaggtcctacagtgtgcatttctcattttttcacgtttttcagtgatttcgtcatttttcacgttgtcaagtggatgtttctcattttccatgattttcacttttcttgccatatttcatgtcctacagtggacatttctaaattttccacctttttctgttttcctcgccatatttcacatcctaaagtgtgtatttctcattttccgtgattttcagttttcttgccatattccaggtcctacagtgtgcatttctcatttttcacgtttttcagtgatttcgtcatttttcaagttgtcaagtggatgtttctcattttccttgattttcagttttcttgccatattccatgtcctactgtggacatttctaaattttccacctttttcagttttccttgccatatttcatgtcctaaagtgtgtatttctcattttcagtgattttcagttttctcgcaatattccaggtcctacagtgtgcatttctcattttttcaggtttttcagtgatttcgtcatttttcacgttgtcaagtggatgtttctcattttccatgattttcacttttcttgccatatttcatgtcctaaagtgtgtatttctcattttcagtgattttcagttttcctcgccatatttcacgtcccaaaatgtgtatttcttattttccatgattttcagtttcctcgccatattccaggtcctacagtgtgcatttctcatttttcacgtttttcagtgatttcgtcttttttcaagacgtcaagtggatgtttctcatttttcatgattttcagttttcttgccatattccatgtcctacagtggacatttctaaattttccacctttttctgttttcctcgccatatttcacgtcctaaagtgtgtatttctcattttccgtgattttcagttttcttgccatattcctggtcctacagtgtgcatttctcatttttcacgtttttcagtgattttgtcatttttcaatttgtcaactgcatgtttctcattttccatgattttcagttttcttgccatattccatgtcctacagtggacatttctaaattttccacctttttcagttttcctcgccatatttcacgtgctaaagtgtgtatttctcatttttcgtgtttttcaggtttctcgccatattccaggtcctacagtgtgcatttctcatttttcacgtttttcagtgattttgtcatttttcaagttgtcaagtggatgtttctcattttccttgattttcacttttcttgccatattccatgtcctacagtggacatttctaaattttccacctttttcagttttcctcgccatatttcatgtcctaaagtgtgtatttctcattttcagtgattttcagttttctcgccatattccaggtcctacagtgtgcatttctcatttttcacgtttttcagtgatttcgtcttttttcaagacgtcaagtggatgtttctcattttccatgattttcagttttcttgccatattccatgtcctacagtggacatttctaaattttccacctttttctgttttcctcgccatatttcacgtcctaaagtgtgtatttctcattttccgtgattttcagttttcttgccatattccaggtcctacagtgtgcatttctcatttttcacgtttttcagtgattttgtcatttttcaatttgtcaactgcatgtttctcattttccatgatttttagttttcttgctatattccatgtcctacagtggaaatttctaaattttccacctttttcagttttcctcgccatatttcacgtcctaaagtgtgtatttctcattttccgtgattttcagttttcttgctatattccaagtcctacattgtgcatttctcatttttcacgtttttcagtgattttgtcatttttcaatttgtcaaaccacatgtttctcattttccatgattttcagtttttttgccatattccatgtcctacagtggaaatttctatattttccacctttttcagttttcctcgccatatttcacgtgctaaagtgtgtatttctcatttttcgtgtttttcaggtttctcgccatattccaggtcctacagtgtgcatttctcatttttcacgtttttctgtgattttgtcatttttcaagttgtcaagtggatgtttctcattttccttgattttcagttttcttaccatattccatgtcctacagtggacatttctaaattttccaccttttctgttttcctcgccatatttcatgtcctaaagtgtgtatttctcattttccgtgattttcatttttcttgctatattccaagtcctacagtgtgcatttctcattttccatgattttcagttttcttgctatattccatgtcctacagtggaaatttctaaattttccacctttttcagttttcctcgccatatttcacgtcctaaagtgtgtatttctcattttccgtgattttcagttttttcgccatattacaggtcctatgtgtacatttctcatttttcacgtttttcagtgattttgtcatttttcaagttgtcaagtggatgtttctcatttttcttgattttcatttttcttgccatattccatgtcctacagtggaaatttctaaattttccacctttttcagttttcctcgccatatttcacgtcctaaagtgtgaatttctcattttccgtgattttcagttttctcgccatattccaggtctacagtgtgcatttctcatttttcacgttttcagtgattcgtcatttttcaagttgacaagtggatgtttctcattttccatgattttcagctttcttgccatattcaaagtcctacagtggacatttctaaattttcgacctttatcagttttcctcgccatatttcatgtcccaaagtgtgtacttctcattttccgtgattttcagttttcttgccatattccaagtcctacagtgtgcatttctcatttttcacgtttttcagtgattttgtcatttttcaatttgtcaactgcatgtttctcattttccatgattttcagttttcttgccatattccatgtcctacagtggaaatttctatattttccacctttttcagttttcctcgccatatttcacgtgctaaagtgtgtatttctcatttttcgtgtttttcaggtttctcgccatattccaggtcctacagtgtgcatttctcatttttcacgtttttcagtgattttgtcatttttcaagttgtcaagtggatgtttctcattttcaatgattttcatttttcttgccttattccacgtcctatagtggacatttctaaattttccacctttttcagtttttctcgccatatttcacgtcccaaaatgtgtattccttattttccatgattttcagtttcctcgccatattccaggtcctacagtgtgcatttctcatttttcacgtttttcagtgatttcgtcttttttcaagacgtcaagtggatgtttctcatttttcatgattttcagttttcttgccatattccctgtcctacagtggacatttctaaattttccacctttttctgttttcctcgccatatttcacgtcctaaagtgtgtatttctcattttccgtgattttcagttttctcgccagattccaggtcctacagtgtgcatttctcatttttcacgtttttcagtgattttgtcatttttcaatttgtcaactgcatgtttctctctttccatgattttcagttttcttgccatattccatgtcctacagtggacatttctaaattttccacctttttcagttttcctcgccatatttcacgtgctaaagtgtgtatttctcatttttcgtgtttttcaggtttctcgccatattccaggtcctacagtgtgcatttctcatttttcacgtttttcagtgattttgtcatttttcaagttgtcaagtggatgtttctcattttcaatgattttcatttttcttaccttattccacgtcctatagtggacatttctaaattttccacctttttcagtttttctcgccatatttcacgtcccaaaatgtgtattccttattttccatgattttcagtttcctcgccatattccaggtcctacagtgtgcatttctcatttttcacgtttttcagtgatttcgtcttttttcaagacgtcaagtggatgtttctcatttttcatgattttcagttttcttgccatattccctgtcctacagtggacatttctaaattttccacctttttctgttttcctcgccatatttcacgtcctaaagtgtgtatttctcattttccgtgattttcagttttctcgccagattccaggtcctacagtgtgcatttctcatttttcacgtttttcagtgatttcgtcatttttcaagtcttcaagtgtatgtttctcattttcaatgattttcatttttcttgccttattccacgtcctatagtggacatttctaaattttccacctttttcagtttttctcgccatatttcacgtcctaaagtgtgtatttctcattttctgtgattttcagttttcttaccatattccaggtcctacagtgtgcatttctcatttttcacgtttttcagtgatttcgtcatttttcaagttgtcaagtggaagtttctcattttccatgattttcagctttctagccatattccaggtattacagtggacatttccttattttcgacctttatcagttttcctcgccatatttcatgtcctaaagtgtgt	38399	1554	4%	7300	19%
9	3000001	3038400	Atcctacagtgtgcatttctcatttttcacgtttttcagtgatttcgtcatttttcaagtcatcaagtggctgtttctcattttccatgattttcagttttcttgccatattccttgtcctacagtggacatttctaaattttccacctttttcagttttccttgtcatatttcaggtcctacagtgtgtatttctcatttttcacgtttttcattgatttcgtcatttttcaagttgtcaagtgcatgtttctcattttccatgattttcagttttcttgccatattccatgtcctacaatggacatttctaaattttccaactttttcagttttcctcgccatatttcacgtcctaaagtgtgtatttctcattttccgtgattttcagttttctcgacatattccaggtcctacagtgtgcatttctcatttttcacgtttttcagtgatttcgtcatttttcacgtcgtcaagtggatgtttctcattttccatgattttcagttttcttgccatattccatgtcctacagtggacatttctaaattttccacctttttcagttttcctcgccatatttcacgtcctaaagtgtgtatttctcattttccgtgattttcagttttctcgacatattccaggtcttacagggtgcatttctcatttttcacgtttttcagtgatttcatcatttttcaagtcgtcaactgtatgtttctcattttcaatgattttcatttttcttgccatattccacgtcctatagtggacatttctaaattttccacctttttcagttttccttgccatatttcaggtcctacagtgtgcatttctcatttttcacgtttttcagtgatttcgtcatttttcaagtggtcaaatgcatgtttctcattttccatgattttcagttttcttgccatattccatgtcctacagtggacatttctaaattttccacctttttcagttttcctcgccatatttcacgtcctaaagtgtgtatttctcattttccgtgattttcagttttatcgccagattccaggtcctacggtgtgcatttttcatatttcacgtttttcagtgattttgtcatttttcaagttgtcaactgcatgtttctcattttccatgattttcagttttcttgccatattccatgtcctacagtggacatttctaaattttccacctttttcagttttcctcgccatatttcatgtcctaaagtgtgtatttctcattttcagtgattttctgttttctcgccatattccaggtcctacagtgtgcatttctcatttttcacgtttttcagtgatttcgtcatttttcaagttgtcaagtggatgtttctcattttccatgattttcagttttcttgccatattccatgtcctacaatggacatttctaaattttccacctttttcagttttcctcgccatatttcacgtcctaaagtgtgtatttctcattttccgtgattttcagttttctcgccatattccaggtcctatgtgtacatttctcatttttcacgtttttcagtgattttgtcatttttcaagttgtgaagtggatgtttctcatttttcttgattttcatttttcttgccatattccatgtcctagagtggaaatttttaaattttccacctttttcagttttcctcgccatatttcacgtcctaaagtgtgaatttctcattttccgtgattttcagttttctcgccatattccaagtcctacagtgtgcatttctcatttttcacgtttttcagtgatttcgtcatttttcaagttgtcaagtggatgtttctcattttccatgattttcagctttcttgccatattcaaagtcctacagtggacatttctaaattttcgacctttatcagttttcctcgccatatttcatgtcccaaagtgtgtacttctcattttccgtgattttcagtttcctcgccatattctaggtcctacagtgtgcatttctcatttttcaggtttttcagtgatttcgtcttttttcaagtcgtcaagtggatgtttctcattttccatgattttcagttttcttgccatattccatgtcctacagtggacatttctaaattttccaactttttcagttttcctcgccatatttcatgtcctaaagtgtgtatttctcattttcagtgattttcagttttctcgccatattccaggtcctacagtgtgcatttctcatttttcacgtttttcagtgatttcgtcatttttcaagttgtcaagtggatgtttctcatttttcatgattttcagttttcttgccatattccatgtcccacagtggacatttctaaatgttccacctttttctgttttccttgccatatttcatgtcctaaagtgtgtatttctcattttccgtgattttcagttttcttgctatattccaagtcctacagtgtgcatttctcatttttcacgtttttctgtgattttttcatttttcaatttgtcaactgcatgtttctcattttccatgattttcagttttcttgccatattccaggtcctacagtgtgcatttctcatttttcacgtttttcagtgattttgtcatttttcaagttgtcaactgcatgtttctcattttccatgattttcagttttcttgctatattccatgtcctacagtggaaatttctaaattttccacctttttcagttttcctcgccatatttcacgtcctaaagtgtgtatttctcattttccgtgattttcagttttctcgccatattccaggtcctatgtgtacatttctcatttttcacgtttttcagtgattttgtcatttttcaagttgtgaagtggatgtttctcatttttcttgattttcatttttcttgccatattccatgtcctagagtggaaatttttaaattttccacctttttcagttttcctcgccatatttcacgtcctaaattgtgaatttctcattttccgtgattttcagttttctcgccatattccaagtcctacagtgtgcatttctcatttttcacgtttttcagtgatttcgtcatttttcaagttgtcaagtggatgtttctcattttccatgattttcagctttcttgccatattcaaagtcctacagtggacatttctaaattttcgacctttatcagttttcctcgccatatttcatgtcccaaagtgtgtacttctcattttccgtgattttcagtttcctcgccatattctaggtcctacagtgtgcatttctcatttttcaggtttttcagtgatttcgtcttttttcaagtcgtcaagtggatgtttctcattttccatgattttcagttttcttgccatattccatgtcctacagtggacatttctaaattttccacctttttcagttttcctcgccatatttcatgtcctaaagtgtgtatttctcattttcagtgattttcagttttctcgccatattccaggtcctacagtgtgcatttctcatttttcacgtttttcagtgattttgtcatttttcaagttgtcaagtggatgtttctcattttccttgattttcagttttcttgccatattccatgtcctacagtggacatttctaaattttccacctttttcagttttccttgccatatttcatgtcctaaagtgtgtatttctcattttcagtgattttcagttttctcgccatattccaggtcctacagtgtgcatttctcattttttcaggtttttcagtgatttcgtcatttttcacgttgtcaagtggatgtttctcattttccatgattttcacttttcttgccatatttcatgtcctaaagtgtgtatttctcattttcagtgattttcagttttctcgccatattccaggtcctacagtgtgcatttctcattttttcacgtttttcagtgatttcgtcatttttcacgttgtcaagtggatgtttctcattttccattattttcacttttcttgccatatttcatgtcctacagtggacatttctaaattttccacctttttctgttttcctcgccatatttcacatcctaaagtgtgtatttctcattttccgtgattttcagttttcttgccatattccaggtcctacagtgtgcatttctcatttttcacgtttttcagtgatttcgtcatttttcaagtcgtcaagtggatgtttctcattttccatgattttcagttttctcgccatattccaggtcctacagttgacatttctaaattttccacattttttatgtttcctcgcgatatttcacatcctaaagtgtgtatttctcattttccgtgattttcagttttcttgccatattccaggtcctacagggtgcatttctcatttttcacgtttttcagtgatttcatcaatttcaagtcgtcaactgtatgtttctcattttcaatgattttcatttttcttgccatattccacgtcctatagtggacatttctacattttccacctttttcagttttcttcgccatatttcacgtcccaaagtgtgtatttctcattttccgtgattttcagtttcctcgccatattccaggtcctacagtgtgcatttctcatttttcacgtttttcagtgatttcgtcttttttcaagtcgtcaagtggatgtttctcattttccatgattttcagttttcttgccatattccatgtcctacagtggacatttctaaattttccacctttttctgttttcctcgccatatttcacgtcctaaagtgtgtatttctcatttaccgtgattttcagttttcttgctatattccaagtcctacagtgtgcatttctcatttttcacgtttttcactgattttgtcattgttcaagttgtcaactgcatgtttctcattttccatgattttcagttttcttgccatattccatgtcctacagtggaaatttctatattttccaactttttcagttttcctcgccatatttcacgtgctaaagtgtgtatttctcatttttcgtgtttttcaggtttctcgccatattccaggtcctacagtgtgcatttctcatttttcacgtttttcagtgattttgtaatttttcaagttgtcaagtggatgtttctcattttccttgattttcagttttcttgccatattccatgtcctactgtggacatttctaaattttccacctttttcagttttccttgccatatttcatgtcctaaagtgtgtatttctcattttcagtgattttcagttttctcgcaatattccaggtcctacagtgtgcatttctcattttttcaggtttttcagtgatttcgtcatttttcacgttgtcaagtggatgtttctcattttccatgattttcacttttcttgccatatttcatgtgctaaagtgtgtatttctcattttcagtgattttcagttttctgccatattccaggtcctacattgtgcatttctcattttttcacgtttttcagtgatttcgtcatttttcacgttgtcaagtggatgtttctcattttccatgattttcacttttcttgccatatttcatgttttacagtggacatttctaaattttccacctatttctgttttcctcgccatatttcacatcctaaagtgtgtatttctcattttccgtgattttcagttttctcgccatatgccaggtcatacagggtgcatttctcatttttcacgtttttcagtgatttcgtcatttttcacgtcgtcaagtggatgtttctcattttcaatgattttcatttttcttgccatattccacgtcctatagtggacatttctaaattttccacctttttcagttttccttgccatatttcaggtcctacagtgtgcatttctcttttttcacgtttttcagtgatttcgtcatttttcaagtggtcaagtgcatgtttctcattttccgtgattttcagttttcttgccatgttccaggtcctacagttgacgtttctaaaatttcactttttttaagttttcctcgccatatttcacttcctaaagtgtgtatttctcattttccgtgattttcagttttctcgccagattccaggtcctacagtgtgcatttttcatatttcacctttttcagtgattttgtcatttttcaagttgtcaactgcatgtttctcattttccatgattttcagttttcttgccatattccatgtcctactgtggacatttctaaattttccaactttttcagttttcctcgccatatttcatgtcctaaagtgtgtatttctcattttcagtgattttctgttttctcgccatattccaggtcctacagtgtgcatttctaatttttcacgtttttcagtgatttcgtcatttttcaagttgtcaagtggatgtttctcattttccatgattttcagttttcttgccatattccatgtcctacagtggacatttctaaattttccaactttttccattttcctcaccatatttcacgtcctaaagtgagtttttctcattttttgtgattttcagttttctcgacatattccaggtcctacagtgtgcatttctaattttttcttttttcagtgatttcgtcatttttcaagtggtcaagtgcatgtttctcattttccatgattttcagttttcttgccatattccatgtcctacaatggacatttctaaattttccaactttttcagttttcctcgccatatttcacgtcctaaagtgtgtatttctcattttccgtgattttcagttttctcgccatattccaggtcctacagtgtgcatttctcatttttcacgtttttcagtgatttcgtcatttttcaagttgtcaactgcatgtttctcattttccatgattttcagttttcttgccatattccatgtcttacagtggacatttttaaatttttcacatttttttaagttttcctccccatatttcacgttttaaagtgtgcatttctcattttcggtgattttcagttttctcgccagattccatgtcttacagtgtgcatttctcattttttcacgtttttcagtgatttcgtcatttttcaagtcgtcaagtggatgtttctcattttccatgattttcagttttcttgccatattccatgtcctacagtggaaatttctaaattttccacctttttcagttttccttgccatatttcaggtcctaaagtgtgtatttctcattttctgtgattttcagttttctcgccatattccaggtcctacagttgacatttctaaaatttccacattttttaagttttcctcgccatatttcacttcctaaagtgtgtatttctcattttccgtgattttcagttttctcgccatattccagatcctacagtgtacatttttcatttttcacgtttttcagtgattttgtcattttttagttgtcaactgcctgtttctcattttccatgattttcagttttcttgctatattccatgtcctacagtggaaatttctaaattttccacctttttcagttttcctcgccatatttcacgtcctaaagtgtgtatttctcattttccgtgattttcagttttctcgccatattccaggtcctatgtgtacatttctcatttttcacgtttttcagtgattttgtcatttttcaatttgtcaactgcatgtttctcattttccatgattttcagttttcttgccatattccatgtcctacagtggaaatttctatattttccaactttttcagttttcctcgccatatttcacgtgctaaagtgtgtatttctcatttttcgtgtttttcaggtttctcgccatattccaggtcctacagtgtgcatttctcatttttcacgtttttcagtgattttgtcatttttcaagttgtcaagtggatgtttctcattttccttgattttcagttttcttgccatattccatgtcctacagtggacatttctaaattttccacctttttcagttttccttgccatatttcatgtcctaaagtgtgtatttctcattttcagtgattttcagttttctcgccatattccaggtcctacagtgtgcatttctcattttttcaggtttttcagtgatttcgtcatttttcacgttgtcaagtggatgtttctcattttccatgattttcacttttcttgccatatttcatgtcctaaagtgtgtatttctcattttcagtgattttcagttttctcgctatattccaggtcctacagtgtgcatttctcattttttcacgtttttcagtgatttcgtcatttttcacgttgtcaagtggatgtttctcattttccatgattttcacttttcttgccatatttcatgtcctacaatggacatttctaaattttccacctttttctgttttcctcgccatatttcacatcctaaagtgtgtatttctcattttccgtgattttcagttttcttgccatattccaggtcctacagtgtgcatttctcatttttcacgtttttcagtgatttcgtcatttttcaagttgtcaagtggatgtttctcattttccttgattttcagttttcttgccatattccatgtcctactgtggacatttctaaattttccacctttttcagttttccttgccatatttcatgtcctaaagtgtgtatttctcattttcagtgattttcagttttctcgcaatattccaggtcctacagtgtgcatttctcattttttcaggtttttcagtgatttcgtcatttttcacgttgtcaagtggatgtttctcattttccatgattttcacttttcttgccatatttcatgtcctaaagtgtgtatttctcattttcagtgattttcagttttctgccatattccaggtcctacattgtgcatttctcattttttcacgtttttcagtgatttcgtcatttttcagttttctcgacatattccaggtcctacagtgtgcatttctaattttttcttttttcagtgatttcgtcatttttcaagttgtcaactgcatgtttctcattttccatgattttcagttttcttgccatattccatgtcttacagtggacatttttaaatttttcacatttttttaagttttcctccccatatttcacgttttaaagtgtgcatttctcattttcggtgattttcagttttctcgccagattccaggtcttacagtgtgcatttctcattttttcacgtttttcagtgatttcgtcatttttcaagtcgtcaagtggatgtttctcattttccatgattttcagttttcttgccatattccatgtcctacagtggaaatttctaaattttccacctttttcagttttccttgccatatttcaggtcctaaagtgtgtatttctcattttctgtgattttcagttttctcgccatattccaggtcctacagttgacatttctaaaatttccacattttttaagttttcctcgccatatttcacttcctaaagtgtgtatttctcattttccgtgattttcagttttctcgccatattccagatcctacagtgtgcatttttcatttttcacgtttttcagtgattttgtcattttttagttgtcaactgtctgtttctcattttccatgattttcagttttcttgccatattccatgtcctacactggacatttctaaattttccacctttttctgttttcctcgccatatttcacgtcctaaagtgtgtatttctcattttccgtgattttcagttttcttgccatattccaggtcctacagtgtgcatttctcatttttcacgtttttcagtgattttgtcatttttcaagttgtcaactgcatgtttctcattttctatgattttcagttttcttgctatattccatgtcctacagtggaaatttctaaattttccacctttttcagttttcctcgccatatttcacgtcctaaagtgtgtatttctcattttccgtgattttcagttttctcgccatattccaggtcctatgtgtacatttctcatttttcacgtttttcagtgattttgtcatttttcaagttgtgaagtggatgtttctcatttttcttgattttcatttttcttgccatattccatgtcctagagtggaaatttttaaattttccacctttttcagttttcctcgccatatttcacgtcctaaagtgtgaatttctcattttccgtgattttcagatttctcgccatattccaagtcctacagtgtgcatttctcatttttcacgtttttcagtgatttcgtcatttttcaagttgtcaagtggatgtttctcattttccatgattttcagctttcttgccatattcaaagtcctacagtggacatttctaaattttcgacctttatcagttttcctcgccatatttcatgtcccaaagtgtgtacttctcattttccgtgattttcagtttcctagccatattctaggtcctacagtgtgcatttctcatttttcaggtttttcagtgatttcgtcttttttcaagtcgtcaagtggatgtttctcattttccatgattttcacttttcttgccatatttcatgtcctaaagtgtgtatttctcattttcagtgattttcagttttctcgctatattccaggtcctacagtgtgcatttctcattttttcacgtttttcagtgatttcgtcatttttcacgttgtcaagtggatgtttctcattttccatgattttcacttttcttgccatatttcatgtcctacagtggacatttctaaattttccacctttttctgttttcctcgccatatttcacatcctaaagtgtgtatttctcattttccgtgattttcagttttcttgccatattccaggtcctacagtgtgcatttctcatttttcacgtttttcagtgatttcgtcatttttcaagttgtcaagtggatgtttctcattttccttgattttcagttttcttgccatattccatgtcctactgtggacatttctaaattttccacctttttcagttttccttgccatatttcatgtcctaaagtgtgtatttctcattttcagtgattttcagttttctcgcaatattccaggtcctacagtgtgcatttctcattttttcaggtttttcagtgatttcgtcatttttcacgttgtcaagtggatgtttctcattttccatgattttcacttttcttgccatatttcatgtcctaaagtgtgtatttctcattttcagtgattttcagttttctgccatattccaggtcctacattgtgcatttctcattttttcacgtttttcagtgatttcgtcatttttcacgttgtcaagtggatgtttctcattttccatgattttcacttttcttgccatatttcatgttttacagtggacatttctaaattttccacctttttctgttttcctcgccatatttcacatcctaaagtgtgtatttctcattttccgtgattttcagttttctcgccatatgccaggtcatacagggtgcatttctcatttttcacgtttttcagtgatttcgtcatttttcacgtcgtcaagtggatgtttctcattttcaatgattttcatttttcttgccatattccacgtcctatagtggacatttctaaattttccacctttttcagttttccttgccatatttcaggtcctacagtgtgcatttctcatttttcacgtttttcagtgatttcgtcatttttcaagtggtcaagtgcatgtttctcattttccgtgattttcagttttcttgccatgttccaggtcctacagttgacgtttctaaaatttcactttttttaagttttcctcgccatatttcacttcctaaagtgtgtatttctcattttccgtgattttcagttttctcgccagattccaggtcctacagtgtgcatttttcatatttcacctttttcagtgattttgtcatttttcaagttgtcaactgcatgtttctcattttccatgattttcagttttcttgccatattccatgtcctactgtggacatttctaaattttccaactttttcagttttcctcgccatatttcatgtcctaaagtgtgtatttctcattttcagtgattttctgttttctcgccatattccaggtcctacagtgtgcatttctaatttttcacgtttttcagtgatttcgtcatttttcaagttgtcaagtggatgtttctcattttccatgattttcagttttcttgccatattccatgtcctacagtggacatttctaaattttccaactttttccattttcctcaccatatttcacgtcctaaagtgtgtttttctcattttttgtgattttcagttttctcgacatattccaggtcctacagtgtgcatttctaattttttcttttttcagtgatttcgtcatttttcaagttgtcaactgcatgtttctcattttccatgattttcagttttcttgccatattccatgtcttacagtggacatttttaaatttttcacatttttttaagttttcctccccatatttcacgttttaaagtgtgcatttctcattttcggtgattttcagttttctcgccagattccaggtcttacagtgtgcatttctcattttttcacgtttttcagtgatttcgtcatttttcaagtcgtcaagtggatgtttctcattttccatgattttcagttttcttgccatattccatgtcctacagtggaaatttctaaattttccacctttttcagttttccttgccatatttcaggtcctaaagtgtgtatttctcattttctgtgattttcagttttctcgccatattccaggtcctacagttgacatttctaaaatttccacattttttaagttttcctcgccatatttcacttcctaaagtgtgtatttctcattttccgtgattttcagttttctcgccatattccagatcctacagtgtgcatttttcatttttcacgtttttcagtgattttgtcattttttagttgtcaactgtctgtttctcattttccatgattttcagttttcttgccatattccatgtcctacactggacatttctaaattttccacctttttctgttttcctcgccatatttcacgtcctaaagtgtgtatttctcattttccgtgattttcagttttcttgccatattccaggtcctacagtgtgcatttctcatttttcacgtttttcagtgattttgtcatttttcaagttgtcaactgcatgtttctcattttccatgattttcagttttcttgctatattccatgtcctacagtggaaatttctaaattttccacctttttcagttttcctcgccatatttcacgtcctaaagtgtgtatttctcattttccgtgattttcagttttctcgccatattccaggtcctatgtgtacatttctcatttttcacgtttttcagtgattttgtcatttttcaagttgtgaagtggatgtttctcatttttcttgattttcatttttcttgccatattccatgtcctagagtggaaatttttaaattttccacctttttcagttttcctcgccatatttcacgtcctaaagtgtgaatttctcattttccgtgattttcagatttctcgccatattccaagtcctacagtgtgcatttctcatttttcacgtttttcagtgatttcgtcatttttcaagttgtcaagtggatgtttctcattttccatgattttcagctttcttgccatattcaaagtcctacagtggacatttctaaattttcgacctttatcagttttcctcgccatatttcatgtcccaaagtgtgtacttctcattttccgtgattttcagtttcctcgccatattctaggtcctacagtgtgcatttctcatttttcaggtttttcagtgatttcgtcttttttcaagtcgtcaagtggatgtttctcattttccatgattttcagttttcttgccatattccatgtcctacagtggacatttctaaattttccacctttttcagttttcctcgccatatttcatgtcctaaagtgtgtatttctcattttcagtgattttcagttttctcgccatattccaggtcctacagtgtgcatttctcatttttcacgtttttcagtgatttcgtcatttttcaagttgtcaagtggatgtttctcattttccatgattttcagttttcttgccatattccatgtcccacagtggacatttctaaattttccacctttttctgttttccttgccatatttcatgtcctaaagtgtgtatttctcattttccgtgattttcagttttcttgctatattccaagtcctacagtgtgcatttctcatttttcacgtttttcagtgattttgtcatttttcaatttgtcaactgcatgtttctcattttccatgattttcagttttcttgccatattccatgtcctacagtggaaatttctatattttccaactttttcagttttcctcgccatatttcacgtgctaaagtgtgtatttctcatttttcgtgtttttcaggtttctcgccatattccaggtcctacagtgtgcatttctcatttttcacgtttttcagtgattttgtcatttttcaagttgtcaagtggatgtttctcattttccttgattttcagttttcttgccatattccatgtcctacagtggacatttctaaattttccacctttttcagttttccttgccatatttcatgtcctaaagtgtgtatttctcattttcagtgattttcagttttctcgccatattccaggtcctacagtgtgcatttctcattttttcaggtttttcagtgatttcgtcatttttcacgttgtcaagtggatgtttctcattttccatgattttcacttttcttgccatatttcatgtcctaaagtgtgtatttctcattttcagtgattttcagttttctcgctatattccaggtcctacagtgtgcatttctcattttttcacgtttttcagtgatttcgtcatttttcacgttgtcaagtggatgtttctcattttccatgattttcacttttcttgccatatttcatgtcctacagtggacatttctaaattttccacctttttctgttttcctcgccatatttcacatactaaagtgtgtatttctcattttccttgattttcagttttcttgccatattccaggtcctacagtgtgcatttctcatttttcacgtttttcagtgatttcgtcatttttcaagtcgtcaagtggatgtttctcattttccatgattttcagttttctcgccatattccaggtcctacagttgacatttctaaattttccacattttttaagtttcctcgcgatatttcacatcctaaagtgtgtatttctcattttccgtgattttcagttttcttgccatattccaggtcctacagggtgcatttctcatttttcacgtttttcagtgatttcatcaatttcaagtcgtcaactgtatgtttctcattttcaatgattttcatttttcttgccatattccatgtcctacagtggacatttctaaatttttcacctttttcagttttccttgccatatttcatgtcctaaagtgtgtatttctcattttcagtgattttcagttttctcgccatattccaggtcctacagtgtgcatttctcattttttcaggtttttcagtgatttcgtcatttttcacgttgtcaagtggatgtttctcattttccatgattttcacttttcttgccatatttcatgtcctaaagtgtgtatttctcattttcagtgattttcagttttctcgccatattccaggtcctacagtgtgcatttctcatttttcacgtttttcagtgatttcgtcatttttcaagttgtcaagtggatgtttctcattttccatgattttcacttttcttgccatattccatgtcccacagtggacatttctaaattttccacctttttctgttttcctcgccatatttcatgtcctaaagtgtgtatttctcattttccgtgattttcagttttcttgctatattccaagtcctacagtgtgcatttctcatttttcacgtttttcagtgattttgtcatttttcaatttgtcaactgcatgtttctcattttccatgattttcagttttcttgccatattccatgttctacagtggaaatttctatattttccaactttttcagttttcctcgccatatttcacgtgctaaagtgtgtatttctcatttttcgtgtttttcaggtttctcgccatattccaggtcctacagtgtgcatttctcatttttcacgtttttcagtgattttgtcatttttcaagttgtcaagtggatgtttctcattttccttgattttcagttttcttgccatattccatgtcctacagtggacatttctaaattttccacctttttcagttttccttgccatatttcatgtcctaaagtgtgtatttctcattttcagtgattttcagttttctcgccatattccaggtcctacagtgtgcatttctcattttttcaggtttttcagtgatttcgtcatttttcacgttgtcaagtggatgtttctcattttccatgattttcacttttcttgccatatttcatgtcctaaagtgtgtatttctcattttcagtgattttcagttttctcgctatattccaggtcctacagtgtgcatttctcattttttcacgttttgcagtgatttcgtcatttttcacgttgtcaagtggatgtttctcattttccatgattttcacttttcttgccatatttcatgtcctacagtggacatttctaaattttccacctttttctgttttcctcgccatatttcacatcctaaagtgtgtatttctcattttccgtgattttcagttttcttgccatattccaggtcctacagtgtgcatttctcatttttcacgtttttcagtgatttcgtcatttttcaagtcgtcaagtggatgtttctcattttccatgattttcagttttctcgccatattccaggtcctacagttgacatttctaaattttccacattttttaagtttcctcgcgatatttcacatcctaaagtgtgtatttctcattttccgtgattttcagttttcttgccatattccaggtcctacagggtgcatttctcatttttcacgtttttcagtgatttcatcaatttcaagtcgtcaactgtatgtttctcattttcaatgattttcatttttcttgccatattccatgtcctacagtggacatttctaaattttccacctttttcagttttccttgccatatttcatgtcctaaagtgtgtatttctcattttcagggattttcagttttctcgccatattccaggtcctacagtgtgcatttctcattttttcaggtttttcagtgatttcgtcatttttcacgttgtcaagtggatgtttctcattttccatgattttcacttttcttgccatatttcatgtcctaaagtgtgtatttctcattttcagtgattttcagttttctcgccatattccaggtcctacagtgtgcatttctcattttttcacgtttttcagtgatttcgtcatttttcacgttgtcaagtggatgtttctcattttccatgattttcacttttcttgccatatttcatgtcctacagtggacatttctaaattttccacctttttctgttttcctcgccatatttcacatcctaaagtgtgtatttctcattttccgtgattttcagttttcttgccatattccaggtcctacagtgtgcatttctcatttttcacgtttttcagtgatttcgtcatttttcaagtcgtcaagtggatgtttctcattttccatgattttcagttttctcgccatattccaggtcctacagttgacatttctaaattttccacattttttaagtttcctcgcgatatttcacatcctaaagtgtgtatttctcattttccgtgattttcagttttcttgccatattccaggtcctacagggtgcatttctcatttttcacgtttttcagtgatttcatcaatttcaagtcgtcaactgtatgtttctcattttcaatgattttcatttttcttgccatattccacgtcctatagtggacatttctaaattttccacctttttcagttttcttcgccatatttcacgtcccaaagtgtgtatttctcattttccgtgattttcagtttcctcgcaatattccaggtcctacagtgtgcatttctcatttttcacgtttttcagtgatttcgtcttttttcaagtcgtcaagtggatgtttctcattttccatgattttcagttttcttgccatattccatgtcctacagtggacatttctaaattttccacctttttctgttttcctcgccatatttcacgtcctaaagtgtgtatttctcattttccgtgattttcagttttcttgccatattccaggtcctacagtgtgcatttctcatttttcacgtttttcactgattttgtcattgttcaagttgtcaactgcatgtttctcattttccatgattttcaattttcttgccatattccatgtcctacagtggaaatttctatattttccaactttttcagttttcctcgccatatttcacgtgctaaagtgtgtatttctcatttttcgtgtttttcaggtttctcgccatattccaggtcctacagtgtgcatttctcatttttcacgtttttcagtgattttgtcatttttcaagttgtcaagtggttgtttctcattttccttgattttcagttttcttgccatattccatgtcctactgtggacatttctaaattttccacctttttcagttttccttgccatatttcatgtcctaaagtgtgtatttctcattttcagtgattttcagttttctcgcaatattccaggtcctacagtgtgcatttctcattttccgtgattttcagttttctcgccatatgccaggtcatacagggtgcatttctcatttttcacgtttttcagtgatttcgtcatttttcacgtcgtcaagtggatgtttctcattttcaatgattttcatttttcttgccatattccacgtcctatagtggacatttctaaattttccaactttttcagttttcttgccatatttcaggtcctacagtgtgcatttctcatttttcacgtttttcagtgatttcgtcatttttcaagtggtcaagtgcatgtttctgattttccgtgattttcagttttcttgccatgttccaggtcctacagttgacgtttctaaaatttcactttttttaagttttcctcgccatatttcacttcctaaagtgtgtatttctcattttccgtgattttcagttttctcgccagattccaggtcctacagtgtgcatttttcatatttcacctttttcagtgattttgtcatttttcaagttgtcaactgcatgtttctcattttccatgattttcagttttcttgccatattccatgtcctactgtggacatttctaaattttccaactttttcagttttcctcgccatatttcatgtcctaaagtgtgtatttctcattttcagtgtttttctgttttctcgccatattccaggtcctacagtgtgcatttctaatttttcacgtttttcagtgatttcgtcatttttcaagttgtcaagtggatgtttctcattttccatgattttcagttttcttgccatattccatgtcctacagtggacatttctaaattttccaactttttccattttcctcaccatatttcacgtcctaaagtgtgtttttctcattttttgtgattttcagttttctcgacatattccaggtcctacagtgtgcatttctaattttttcttttttcagtgatttcgtcatttttcaagtggtcaagtgcatgtttctcattttccatgattttcagttttcttgccatattccatgtcctacaatggacatttctaaattttccaactttttcagttttcctcgccatatttcacgtcctaaagtgtgtatttctcattttccgtgattttcagttttctcgccatattccaggtcctatgtgtacatttctcatttttcacgtttttcagtgattttgtcatttttcaagttgtgaagtggatgtttctcatttttcttgattttcatttttcttgccatattccatgtcctagagtggaaatttttaaattttccaactttttcagttttcctcgccatatttcacgtcctaaagtgtgtatttctcattttccgtgattttcagttttctcgccatattccaagtcctacagtgtgcatttctcatttttcacgtttttcagtgatttcgtcatttttcaagttgtcaagtggatgtttctcattttccatgattttcagctttcttgccatattcaaagtcctacagtggacatttctaaattttcgacctttatcagttttcctcgccatatttcatgtcccaaagtgtgtacttctcattttccgtgattttcagtttcctcgccatattctaggtcctacagtgtgcatttctcatttttcaggtttttcagtgatttcgtcttttttcaagtcgtcaagtggatgtttctcattttccatgattttcagttttcttgccatattccatgtcctacagtggacatttctaaattttccacctttttcagttttcctcgccatatttcatgtcctaaagtgtgtatttctcattttcagtgattttcagttttctcgccatattccaggtcctacagtgtgcatttctcatttttcacgtttttcagtgatttcgtcatttttcaagttgtcaagtggatgtttctcattttccatgattttcagttttcttgccatattccatgtcccacagtggacatttctaaattttccacctttttctgttttccttgccatatttcatgtcctaaagtgtgtatttctcattttccgtgattttcagttttcttgctatattccaagtcctacagtgtgcatttctcatttttcacgtttttaagtgattttgtcatttttcaatttgtcaactgcatgtttctcattttccatgattttcagttttcttgccatattccatgtcctacagtggaaatttctatattttccaactttttcagttttcctcgccatatttcacgtgctaaagtgtgtatttctcatttttcgtgtttttcaggtttctcgccatattccaggtcctacagtgtgcatttctcatttttcacgtttttcagtgattttgtcatttttcaagttgtcaagtggatgtttctcattttccttgattttcagttttcttgccatattccatgtcctacagtggacatttctaaattttccacctttttcagttttccttgccatatttcatgtcctaaagtgtgtatttctcattttcagtgattttcagttttctcgccatattccaggtcctacagtgtgcatttctcattttttcaggtttttcagtgatttcgtcatttttcacgttgtcaagtggatgtttctcattttccatgattttcacttttcttgccatatttcatgtcctaaagtgtgtatttctcattttcagtgattttcagttttctcgccatattccaggtcctacagtgtgcatttctcattttttcacgtttttcagtgatttcgtcatttttcacgttgtcaagtggatgtttctcattttccatgattttcacttttcttgccatatttcatgtcctacagtggacatttctaaattttccacctttttctgttttcctcgccatatttcacatcctaaagtgtgtatttctcattttccgtgattttcagttttcttgccatatttcaggtcctacagtgtgcatttctcatttttcacgtttttcagtgatttcgtcatttttcaagtcgtcaagaggatgtttctcattttccatgattttcagttttctcgccatattccaggtcctacagttgacatttctaaattttccacattttttaagtttcctcgcgatatttcacatcctaaagtgtgtatttctcattttccgtgattttcagttttcttgccatattccaggtcctacagggtgcatttctcatttttcacgtttttcagtgatttcatcaatttcaagtcgtcaactgtatgtttctcattttcaatgattttcatttttcttgccatattccacgtcctatagtggacatttctaaattttccacctttttctgttttcctcgccatatttcacgtcctaaagtgtgtatttctcattttccgtgattttcagttttcttgccatattccaggtcctacagtgtgcatttctcatttttcacgtttttcactgattttgtcattgttcaagttgtcaactgcatgtttctcattttccatgattttcagttttcttgccatattccatgtcctacagtggaaatttctatattttccacctttttcagttttcctcgccgtatttcatgtgctaaagtgtgtatttctcatttttcgtgtttttcaggtttctcgccatattccaggtcctacagtgtgcatttctcatttttcacgtttttcagtgattttgtcatttttcaagttgtcaactggatgtttctcattttccttgattttcagttttcttgccatattccatgtcctactgtggacatttctaaattttccacctttttcagttttccttgccatatttcatgtcctaaagtgtgtatttctcattttcagtgattttcagttttctcgcaatattccaggtcctacagtgtgcatttctcattttttcaggtttttcagtgatttcgtcatttttcacgttgtcaagtggatgtttctcattttccatgattttcacttttcttgccatatttcatgtcctaaagtgtgtatttctcattttcagtgattttcagttttctcgccatattccaggtcctacattgtgcatttctcattttttcacgtttttcagtgatttcgtcatttttcacgttgtcaagtggatgtttctcattttccatgattttcacttttcttgccatatttcatgttttacagtggacatttctaaattttccacctttttctgttttcctcgccatatttcacatcctaaagtgtgaatttctcattttccgtgattttcagttttcttgccatattccaggtcctacagtgtgcatttctcatttttcacgtttttcagtgatttcatcatttttcaagtcgtcaagtggatgtttctcattttccatgattttcagttttcttgccatattccatgtcctacagtggacatttctaaattttccacctttttctgttttcctcgccatatttcacgtcctaaagtgtgtatttctcattttccgtgattttcagttttcttgccatattccaggtcctacagtgtgcatttctcatttttcacgtttttcactgattttgtcatttttcaagttgtcaactgcatgtttctcattttccatgattttcagttttcttgctatattccatgtcctacagtggaaatttctaaattttccacctttttcagttttcctcgccatatttcacgtcctgaagtgtgtatttctcattttccgtgattttcagttttctcgccatattccaggtcctatgtgtacatttctcatttttcacgtttttcagtgattttgtcatttttcaagttgtgaagtggatgtttctcatttttcttgattttcatttttcttgccatattccatgtcctacagtggaaatttctaaattttccacctttttcagttttcctcgccatatttcacgtcctaaagtgtgtatttctcattttccgtgattttcagttttctcgccatattccaggtcctacagtgtgcatttctcatttttcacgtttttcagtgatttcgacatttttcaagttgtcaagtggatgtttctcattttccatgattttcagctttcttgccatattcaaagtcctacagtggacatttctaaattttcgacctttatcagttttcctcgccatatttcatgtcccaaagtgtgtacttctcattttccgtgattttcagtttcctcgccatattccaggtcctacagtgtgcatttctcatttttcacgtttttcagtgatttcgtcatttttcaagtcgtcaagtggatgtttctcattttccatgattttcagttttcttgccatattccatgtcctacagtggacatttctaaattttccacctttttctgttttcctcgccatatttcacgtcctaaagtgtgtatttctcattttccgtgattttcagttttcttgccatattccaggtcctacagtgtgcatttctcatttatcacgtttttcactgattttgtcatttttcaagttgtcaactgcatgtttctcattttccatgattttcagttttcttgctatattccatgtcctacagtggaatattctaaattttccacctttttcagttttcctcgccatatttcacgtcctgaagtgtgtatttctcattttccgtgattttcagttttctcgccatattccaggtcctatgtgtacatttctcatttttcacgtttttcagtgattttgtcatttttcaagttgtgaagtggatgtttctcatttttcttgattttcatttttcttgccatattccatgtcctacagtggaaatttctaaattttccacctttttcagttttcctcgccatatttcacgtcctaaagtgtgaatttctcattttccgtgattttcagttttctcgccatattccaggtcctacagtgtgcatttctcatttttcacgtttttcagtgatttcgacatttttcaagttgtcaagtggatgtttctcattttccatgattttcagctttcttgccatattcaaagtcctacagtggacatttctaaattttcgacctttatcagttttcctcgccatatttcatgtcccaaagtgtgtacttctcattttccgtgattttgagtttcctcgccatattccaggtcctacagtgtgcatttctcatttttcacgtttttcagtgatttcgtcttttttcaagttgtcaactgcatgtttctcattttccatgattttcagttttcttgccatattccatgtcctacagtggaaatttgtaaatttccacctttttcagttttcctcgccatatttcacgtcctaaagtatgtatttctcattttccgtgattttcagttttctcgccatattccaggtcctacagtgtgcatttctcatttttcacgtttttcagtgattttgtcattttttaagttttcaagtggatgtttctcattttccttgattttcagttttcttgccatattccatgtcctacagtggacatttctaaattttccacctttttcagttttcctcgccatatttcatgtcctaaagtgtgtatttctcattttcagtgattttcagttttctcgccatattccaggtcctacagtgtgcatttctcatttttcacgtttttcagtgatttcgtcatttttcaaggtgtcaagtggatgtttctcattttccatgattttcagttttcttgccatattccatgtcctacagtggacatttctaaattttccacctttttctgttttcctcgccatatttcatgtcctaaagtgtgtatttctcattttccgtgattttcagttttcttgctatattccaagtcctacagtgtgcatttctcatttttcacgtttttcagtgattttgtcatttttcaatttgtcaactgcatgtttctcattttccatgattttcagtttttttgccatattccatgtcctactgtggaaatttctatattttccacctttttcagttttcctcgccatatttcacgtgctaaagtgtgtatttctcatttttcgtgtttttcaggtttctcgccatattccaggtcctacagtgtgcatttctcatttttcacgtttttcagtgattttgtcatttttcaagttttcaagtggatgtttctcattttccttgattttcagttttcttgccatattccatgtcctacagtggacatttctaaattttccacctttttcagttttccttgccatatttcatgtcctaaagtgtgtatttctcattttcagtgattttcagtttccttgccatattccaggtcctacagtgtgcatttctcattttttcacgtttttcagtgatttcgtcatttttcacgttgtcaagtggatgtttctcattttccatgattttcacttttcttgccatatttcatgtcctacagtggacatttctaaattttccaactttttcaattttcctcgccatattttatgtcctaaagtgtgtatttctcatttttcgttattttcagttttcttgccatattccaggtcctacagtgtgcatttgtcatttttcacgtttttcagtgatttcgtcatttttcaagtcgtcaagtagatgtttctcatattccatgtttttcagttttctcgccatattccaggtcctacagttgacatttctaaattttctacatttttaaattttcctcgccatatttcacgtcctaaagtgtgtatttctcattttttgttattttcagttttctagccatattccaggtcctacaggatgcatttctcatttttcacgtttttcagtgatttcatcatttttcaagtcgtcaagtgtatgtttcttattttcaatgattttcatttttcttgccttattccacgtcctatagtggacatttctaaattttccacctttttcagtttttttcgccatatttcacgtcctaaagtgtgtatttctcattttctgtgattttcagttttctcaccatattccaggtcctacagtgtgcatttctcatttttcacgtttttcagtgatttcgtcatttttcaagttgtcaagtggaagtttctcattttccatgattttcagctttctagacatattccaggtcctacagtggacatttcctaattttcgacctttatcagttttcctcgtcatatttcacgtcccaaaatgtgtatttcttattttccatgattttcagtttcctcgccatattccaggtcctacagtgtgcaattctcatttttcacgtttttcagtgatttcgtcttttttcaagacgtcaagtggatgtttctcatttttcatgattttcagttttcttgccatattccatgtcctacagtggacatttctaaattttccacctttttctgttttcctcgccatatttcacgtcctaaagtgtgtatttctcattttccgtgattttcagttttcttgccatattcctggtcctacagtgtgcatttctcatttttcacgtttttcagtgattttgtcatttttcaatttgtcaactgcatgtttctcattttccattattttcagttttcttgccatattccatgtcctacagtggacatttctaaattttccacctttttctgttttcctcgccatatttcatgtcctaaagtgtgtatttctcattttccgtgattttcagttttcttgctatattccaagtcctacagtgtgcatttctcatttttcacgtttttcagtgattttgtcatttttcaatttgtcaactgcatgtttctcattttccatgattttcagtttttttgccatattccatgtcctacaggggaaatttctatattttccacctttttcagttttcctcgccatatttcatgtcctaaagtgtgtatttctcattttccgtgattttcagttttcttgccatattccaggtcctacagtgtgcatttctcatttttcacgtttttcagtgatttcgtcatttttcaagtcttcaagtagatgtttctcatattccatgtttttcagttttctcgccatattccaggtcctacagttgacatttctaaattttctacatttttaaattttcctcgccatatttcacgtcctaaagtgtgtatttctcatttttcgttattttcagttttctagccatattccaggtcctacaggatgcatttctcatttttcacgtttttcagtgatttcatcatttttcaagtcgtcaagtgtatgtttctcattttcaatgattttcatttttcttgccttattccacgtcctatagtggacatttctaaattttccacctttttcagtttttctcgccatatttcacgtcctaaagtgtgtatttctcattttctgtgattttcagttttctcaccatattccaggtcctacagtgtgcatttctcatttttcacgtttttcagtgatttcgtcatttttcaagttgtcaagtggaagtttctcattttccatgattttcagctttctagccatattccaggtcctacagtggacatttcctaattttcgacctttatcagttttcctcgccatatttcacgtcctaaagtgtgtatttctcattttccgtgattttcagttttcttgccatattccaggtcctacagtgtgcatttctcatttttcacgtttttcagtgattttgtcatttttcaatttgtcaactgcatgtttctcattttccatgatttttagttttcttgctatattccatgtcctacagtggaaatttctaaattttccacctttttcagttttcctcgccatatttcacgtcctaaagtgtgtatttctcattttccgtgattttcagttttcttgctatattccaagtcctacattgtgcatttctcatttttcacgtttttcagtgattttgtcatttttcaatttgtcaaaccacatgtttctcattttccatgattttcagtttttttgccatattccatgtcctacagtggaaatttctatattttccacctttttcagttttcctcgccatatttcacgtgctaaagtgtgtatttctcatttttcgtgtttttcaggtttctcgccatattccaggtcctacagtgtgcatttctcatttttcacgtttttcagtgattttgtcatttttcaagttgtcaagtggatgtttcccattttccttgattttcagttttcttaccatattccatgtcctacagtggacatttctaaattttccacctttttcagttttccttgccatatttcatgtcctaaagtgtgtatttctcattttcagtgattttcagtttcctcgccatattccaggtcctacagtgtgcatttctcattttttcacgtttttcagtgatttcgtcatttttcacgttgtcaagtggatgtttctcattttccatgattttcacttttcttgccatatttcatgtcctatagtggacatttctaaattttccacctttttcagtttttctcgccatatttcacgtcctaaagtgtgtatttctcattttctgtgattttcagttttctcaccatattccaggtcctacagtgtgcatttctcatttttcacgtttttcagtgatttcgtcatttttcaagtcgtcaagtagatgtttctcatattccatgtttttcagttttctcgccatattccaggtcctacagttgacatttctaaattttctacatttttaaattttcctcgccatatttcacgtcctaaagtgtgtatttctcatttttcgttattttcagttttctagccatattccaggtcctacaggatgcatttctcatttttcacgtttttcagtgatttcatcatttttcaagtcgtcaagtgtatgtttcttattttcaatgattttcatttttcttgccttattccacgtcctatagtggacatttctaaattttccaccttttttcagtttttctcgccatatttcacgtcctaaagtgtgtatttctcattttctgtgattatcagttttctcaccatattccaggtcctacagtgtgcatttctcatttttcacgtttttcagtgatttcgtcatttttcaagttgtcaagtggaagtttctcattttccatgattttcagctttctagccatattccaggtcctacagtggacatttcctaattttcgacctttatcagttttcctcgccatatttcacgtcccaaaatgtgtatttcttattttccatgattttcagtttcctcgccatattccaggtcctacagtgtgcatttctcatttttcacgtttttcagtgatttcgtcttttttcaagacgtcaagtggatgtttctcatttttcatgattttcagttttcttgccatattccatgtcctacagtggacatttctaaattttccacctttttctgttttcctcgccatatttcacgtcctaaagtgtgtatttctcattttccgtgattttcagttttcttgccatattcctggtcctacagtgtgcatttctcatttttcacgtttttcagtgattttgtcatttttcaatttgtcaactgcatgtttctcattttccatgattttcagttttcttgccatattccatgtcctacagtggacatttctaaattttccacctttttcagttttcctcgccatatttcacgtgctaaagtgtgtatttctcatttttcgtgtttttcaggtttctcgccatattccaggtcctacagtgtgcatttctcatttttcacgtttttcagtgattttgtcatttttcaagttgtcaagtggatgtttctcattttccttgattttcacttttcttgccatattccaagtcttacaggggcatttctcatttttcacgttttcagtgattttgtcattttcaatttgtcaactgcatgtttctcattttccatgattttcagtttttttgccatattccatgtcctacaggggaaatttctatattttccacctttttcagttttcctcgccatatttcatgtcctaaagtgtgtatttctcattttccgtgattttcagttttcttgccatattccaggtcctacagtgtgcatttctcatttttcacgtttttcagtgatttcgtcatttttcaagtcttcaagtagatgtttctcatattccatgtttttcagttttctcgccatattccaggtcctacagttgacatttctaaattttctacatttttaaattttcctcgccatatttcacgtcctaaagtgtgtatttctcatttttcgttattttcagttttctagccatattccaggtcctacaggatgcatttctcatttttcacgtttttcagtgatttcatcatttttcaagtcgtcaagtgtatgtttctcattttcaatgattttcatttttcttgccttattccacgtcctatagtggacatttctaaattttccacctttttcagtttttctcgccatatttcacgtcctaaagtgtgtatttctcattttctgtgattttcagttttctcaccatattccaggtcctacagtgtgcatttctcatttttcacgtttttcagtgatttcgtcatttttcaagttgtcaagtggaagtttctcattttccatgattttcagctttctagccatattccaagtcctacagtggacatttcctaattttcgacctttatcagttttcctcgccatatttcacgtcccaaaatgtgtattccttattttccatgattttcagtttcctcgccatattccaggtcctacagtgtgcatttatcatttttcacgtttttcagtgatttcgtcttttttcaagacgtcaagtggatgtttctcatttttcatgattttcagttttcttgccatattccatgtcctacagtggacatttctaaattttccacctttttctgttttcctcgccatatttcacgtcctaaagtgtgtatttctcattttccgtgattttcagttttcttgccatattcctggtcctacagtgtgcatttctcatttttcacgtttttcagtgattttgtcatttttcaagttgtcaagtggatgtttctcattttccttgattttcacttttcttgccatattccatgtcctacagtggacatttctatattttccacctttttccgttttccttgccatatttcacgtcctaaagtgtgtatttctcattttccgtgattttcaggtttctcgccatattccaggtcctacagtgtgcatttctcatttttcacgtttttcagtgattttgtcatttttcaagttgtcaagtggatgtttctcattttccttgattttcacttttcttgccatattccatgtcctacagtggacatttctaaattttccacctttttcagttttcctcgccatatttcatgtcctaaagtgtgtatttctcattttcagtgattttcagttttcttgccatattccaggtcctacagtgtgcatttctcatttttcacgtttttcagtgattttgtcatttttcaagttgtcaactgcatgtttctcattttctatgattttcagttttcttgctatattccatgtcctacagtggaaatttctaaattttccacctttttcagttttcctcgccatatttcacgtcctaaagtgtgtatttctcattttccgtgattttcagttttctcgccatattccaggtcctatgtgtacatttctcatttttcacgtttttcagtgattttgtcatttttcaagttgtgaagtggatgtttctcatttttcttgattttcatttttcttgccatattccatgtcctagagtggaaatttttaaattttccacctttttcagttttcctcgccatatttcacgtcctaaagtgtgaatttctcattttccgtgattttcagatttctcgccatattccaagtcctacagtgtgcatttctcatttttcacgtttttcagtgatttcgtcatttttcaagttgtcaagtggatgtttctcattttccatgattttcagctttcttgccatattcaaagtcctacagtggacatttctaaattttcgacctttatcagttttcctcgccatatttcatgtcccaaagtgtgtacttctcattttccgtgattttcagtttcctcgccatattctaggtcctacagtgtgcatttctcatttttcaggtttttcagtgatttcgtcttttttcaagtcgtcaagtggatgtttctcattttccatgattttcacttttcttgccatatttcatgtcctaaagtgtgtatttctcattttcagtgattttcagttttctcgctatattccaggtcctacagtgtgcatttctcattttttcacgtttttcagtgatttcgtcatttttcacgttgtcaagtggatgtttctcattttccatgattttcacttttcttgccatatttcatgtcctacagtggacatttctaaattttccacctttttctgttttcctcgccatatttcacatcctaaagtgtgtatttctcattttccgtgattttcagttttcttgccatattccaggtcctacagtgtgcatttctcatttttcacgtttttcagtgatttcgtcatttttcaagttgtcaagtggatgtttctcattttccttgattttcagttttcttgccatattccatgtcctactgtggacatttctaaattttccacctttttcagttttccttgccatatttcatgtcctaaagtgtgtatttctcattttcagtgattttcagttttctcgcaatattccaggtcctacagtgtgcatttctcattttttcaggtttttcagtgatttcgtcatttttcacgttgtcaagtggatgtttctcattttccatgattttcacttttcttgccatatttcatgtcctaaagtgtgtatttctcattttcagtgattttcagttttcctcgccatatttcacgtcccaaaatgtgtatttcttattttccatgattttcagtttcctcgccatattccaggtcctacagtgtgcatttctcatttttcacgtttttcagtgatttcgtcttttttcaagacgtcaagtggatgtttctcatttttcatgattttcagttttcttgccatattccatgtcctacagtggacatttctaaattttccacctttttctgttttcctcgccatatttcacgtcctaaagtgtgtatttctcattttccgtgattttcagttttcttgccatattcctggtcctacagtgtgcatttctcatttttcacgtttttcagtgattttgtcatttttcaatttgtcaactgcatgtttctcattttccatgattttcagttttcttgccatattccatgtcctacagtggacatttctaaattttccacctttttcagttttcctcgccatatttcacgtgctaaagtgtgtatttctcatttttcgtgtttttcaggtttctcgccatattccaggtcctacagtgtgcatttctcatttttcacgtttttcagtgattttgtcatttttcaagttgtcaagtggatgtttctcattttccttgattttcacttttcttgccatattccatgtcctacagtggacatttctaaattttccacctttttcagttttcctcgccatatttcatgtcctaaagtgtgtatttctcattttcagtgattttcagttttctcgccatattccaggtcctacagtgtgcatttctcatttttcacgtttttcagtgatttcgtcttttttcaagacgtcaagtggatgtttctcattttccatgattttcagttttcttgccatattccatgtcctacagtggacatttctaaattttccacctttttctgttttcctcgccatatttcacgtcctaaagtgtgtatttctcattttccgtgattttcagttttcttgccatattccaggtcctacagtgtgcatttctcatttttcacgtttttcagtgattttgtcatttttcaatttgtcaactgcatgtttctcattttccatgatttttagttttcttgctatattccatgtcctacagtggaaatttctaaattttccacctttttcagttttcctcgccatatttcacgtcctaaagtgtgtatttctcattttccgtgattttcagttttcttgctatattccaagtcctacattgtgcatttctcatttttcacgtttttcagtgattttgtcatttttcaatttgtcaaaccacatgtttctcattttccatgattttcagtttttttgccatattccatgtcctacagtggaaatttctatattttccacctttttcagttttcctcgccatatttcacgtgctaaagtgtgtatttctcatttttcgtgtttttcaggtttctcgccatattccaggtcctacagtgtgcatttctcatttttcacgtttttctgtgattttgtcatttttcaagttgtcaagtggatgtttctcattttccttgattttcagttttcttaccatattccatgtcctacagtggacatttctaaattttccaccttttctgttttcctcgccatatttcatgtcctaaagtgtgtatttctcattttccgtgattttcatttttcttgctatattccaagtcctacagtgtgcatttctcattttccatgattttcagttttcttgctatattccatgtcctacagtggaaatttctaaattttccacctttttcagttttcctcgccatatttcacgtcctaaagtgtgtatttctcattttccgtgattttcagttttttcgccatattacaggtcctatgtgtacatttctcatttttcacgtttttcagtgattttgtcatttttcaagttgtcaagtggatgtttctcatttttcttgattttcatttttcttgccatattccatgtcctacagtggaaatttctaaattttccacctttttcagttttcctcgccatatttcacgtcctaaagtgtgaatttctcattttccgtgattttcagttttctcgccatattccaggtctacagtgtgcatttctcatttttcacgttttcagtgattcgtcatttttcaagttgacaagtggatgtttctcattttccatgattttcagctttcttgccatattcaaagtcctacagtggacatttctaaattttcgacctttatcagttttcctcgccatatttcatgtcccaaagtgtgtacttctcattttccgtgattttcagttttcttgccatattccaagtcctacagtgtgcatttctcatttttcacgtttttcagtgattttgtcatttttcaatttgtcaactgcatgtttctcattttccatgattttcagttttcttgccatattccatgtcctacagtggaaatttctatattttccacctttttcagttttcctcgccatatttcacgtgctaaagtgtgtatttctcatttttcgtgtttttcaggtttctcgccatattccaggtcctacagtgtgcatttctcatttttcacgtttttcagtgattttgtcatttttcaagttgtcaagtggatgtttctcattttcaatgattttcatttttcttgccttattccacgtcctatagtggacatttctaaattttccacctttttcagtttttctcgccatatttcacgtcccaaaatgtgtattccttattttccatgattttcagtttcctcgccatattccaggtcctacagtgtgcatttctcatttttcacgtttttcagtgatttcgtcttttttcaagacgtcaagtggatgtttctcatttttcatgattttcagttttcttgccatattccctgtcctacagtggacatttctaaattttccacctttttctgttttcctcgccatatttcacgtcctaaagtgtgtatttctcattttccgtgattttcagttttctcgccagattccaggtcctacagtgtgcatttctcatttttcacgtttttcagtgattttgtcatttttcaatttgtcaactgcatgtttctctctttccatgattttcagttttcttgccatattccatgtcctacagtggacatttctaaattttccacctttttcagttttcctcgccatatttcacgtgctaaagtgtgtatttctcatttttcgtgtttttcaggtttctcgccatattccaggtcctacagtgtgcatttctcatttttcacgtttttcagtgattttgtcatttttcaagttgtcaagtggatgtttctcattttcaatgattttcatttttcttaccttattccacgtcctatagtggacatttctaaattttccacctttttcagtttttctcgccatatttcacgtcccaaaatgtgtattccttattttccatgattttcagtttcctcgccatattccaggtcctacagtgtgcatttctcatttttcacgtttttcagtgatttcgtcttttttcaagacgtcaagtggatgtttctcatttttcatgattttcagttttcttgccatattccctgtcctacagtggacatttctaaattttccacctttttctgttttcctcgccatatttcacgtcctaaagtgtgtatttctcattttccgtgattttcagttttctcgccagattccaggtcctacagtgtgcatttctcatttttcacgtttttcagtgatttcgtcatttttcaagtcttcaagtgtatgtttctcattttcaatgattttcatttttcttgccttattccacgtcctatagtggacatttctaaattttccacctttttcagtttttctcgccatatttcacgtcctaaagtgtgtatttctcattttctgtgattttcagttttcttaccatattccaggtcctacagtgtgcatttctcatttttcacgtttttcagtgatttcgtcatttttcaagttgtcaagtggaagtttctcattttccatgattttcagctttctagccatattccaggtattacagtggacatttccttattttcgacctttatcagttttcctcgccatatttcatgtcctaaagtgtgt	38399	1554	4%	7300	19%
9	3000001	3038400	Atcctacagtgtgcatttctcatttttcacgtttttcagtgatttcgtcatttttcaagtcatcaagtggctgtttctcattttccatgattttcagttttcttgccatattccttgtcctacagtggacatttctaaattttccacctttttcagttttccttgtcatatttcaggtcctacagtgtgtatttctcatttttcacgtttttcattgatttcgtcatttttcaagttgtcaagtgcatgtttctcattttccatgattttcagttttcttgccatattccatgtcctacaatggacatttctaaattttccaactttttcagttttcctcgccatatttcacgtcctaaagtgtgtatttctcattttccgtgattttcagttttctcgacatattccaggtcctacagtgtgcatttctcatttttcacgtttttcagtgatttcgtcatttttcacgtcgtcaagtggatgtttctcattttccatgattttcagttttcttgccatattccatgtcctacagtggacatttctaaattttccacctttttcagttttcctcgccatatttcacgtcctaaagtgtgtatttctcattttccgtgattttcagttttctcgacatattccaggtcttacagggtgcatttctcatttttcacgtttttcagtgatttcatcatttttcaagtcgtcaactgtatgtttctcattttcaatgattttcatttttcttgccatattccacgtcctatagtggacatttctaaattttccacctttttcagttttccttgccatatttcaggtcctacagtgtgcatttctcatttttcacgtttttcagtgatttcgtcatttttcaagtggtcaaatgcatgtttctcattttccatgattttcagttttcttgccatattccatgtcctacagtggacatttctaaattttccacctttttcagttttcctcgccatatttcacgtcctaaagtgtgtatttctcattttccgtgattttcagttttatcgccagattccaggtcctacggtgtgcatttttcatatttcacgtttttcagtgattttgtcatttttcaagttgtcaactgcatgtttctcattttccatgattttcagttttcttgccatattccatgtcctacagtggacatttctaaattttccacctttttcagttttcctcgccatatttcatgtcctaaagtgtgtatttctcattttcagtgattttctgttttctcgccatattccaggtcctacagtgtgcatttctcatttttcacgtttttcagtgatttcgtcatttttcaagttgtcaagtggatgtttctcattttccatgattttcagttttcttgccatattccatgtcctacaatggacatttctaaattttccacctttttcagttttcctcgccatatttcacgtcctaaagtgtgtatttctcattttccgtgattttcagttttctcgccatattccaggtcctatgtgtacatttctcatttttcacgtttttcagtgattttgtcatttttcaagttgtgaagtggatgtttctcatttttcttgattttcatttttcttgccatattccatgtcctagagtggaaatttttaaattttccacctttttcagttttcctcgccatatttcacgtcctaaagtgtgaatttctcattttccgtgattttcagttttctcgccatattccaagtcctacagtgtgcatttctcatttttcacgtttttcagtgatttcgtcatttttcaagttgtcaagtggatgtttctcattttccatgattttcagctttcttgccatattcaaagtcctacagtggacatttctaaattttcgacctttatcagttttcctcgccatatttcatgtcccaaagtgtgtacttctcattttccgtgattttcagtttcctcgccatattctaggtcctacagtgtgcatttctcatttttcaggtttttcagtgatttcgtcttttttcaagtcgtcaagtggatgtttctcattttccatgattttcagttttcttgccatattccatgtcctacagtggacatttctaaattttccaactttttcagttttcctcgccatatttcatgtcctaaagtgtgtatttctcattttcagtgattttcagttttctcgccatattccaggtcctacagtgtgcatttctcatttttcacgtttttcagtgatttcgtcatttttcaagttgtcaagtggatgtttctcatttttcatgattttcagttttcttgccatattccatgtcccacagtggacatttctaaatgttccacctttttctgttttccttgccatatttcatgtcctaaagtgtgtatttctcattttccgtgattttcagttttcttgctatattccaagtcctacagtgtgcatttctcatttttcacgtttttctgtgattttttcatttttcaatttgtcaactgcatgtttctcattttccatgattttcagttttcttgccatattccaggtcctacagtgtgcatttctcatttttcacgtttttcagtgattttgtcatttttcaagttgtcaactgcatgtttctcattttccatgattttcagttttcttgctatattccatgtcctacagtggaaatttctaaattttccacctttttcagttttcctcgccatatttcacgtcctaaagtgtgtatttctcattttccgtgattttcagttttctcgccatattccaggtcctatgtgtacatttctcatttttcacgtttttcagtgattttgtcatttttcaagttgtgaagtggatgtttctcatttttcttgattttcatttttcttgccatattccatgtcctagagtggaaatttttaaattttccacctttttcagttttcctcgccatatttcacgtcctaaattgtgaatttctcattttccgtgattttcagttttctcgccatattccaagtcctacagtgtgcatttctcatttttcacgtttttcagtgatttcgtcatttttcaagttgtcaagtggatgtttctcattttccatgattttcagctttcttgccatattcaaagtcctacagtggacatttctaaattttcgacctttatcagttttcctcgccatatttcatgtcccaaagtgtgtacttctcattttccgtgattttcagtttcctcgccatattctaggtcctacagtgtgcatttctcatttttcaggtttttcagtgatttcgtcttttttcaagtcgtcaagtggatgtttctcattttccatgattttcagttttcttgccatattccatgtcctacagtggacatttctaaattttccacctttttcagttttcctcgccatatttcatgtcctaaagtgtgtatttctcattttcagtgattttcagttttctcgccatattccaggtcctacagtgtgcatttctcatttttcacgtttttcagtgattttgtcatttttcaagttgtcaagtggatgtttctcattttccttgattttcagttttcttgccatattccatgtcctacagtggacatttctaaattttccacctttttcagttttccttgccatatttcatgtcctaaagtgtgtatttctcattttcagtgattttcagttttctcgccatattccaggtcctacagtgtgcatttctcattttttcaggtttttcagtgatttcgtcatttttcacgttgtcaagtggatgtttctcattttccatgattttcacttttcttgccatatttcatgtcctaaagtgtgtatttctcattttcagtgattttcagttttctcgccatattccaggtcctacagtgtgcatttctcattttttcacgtttttcagtgatttcgtcatttttcacgttgtcaagtggatgtttctcattttccattattttcacttttcttgccatatttcatgtcctacagtggacatttctaaattttccacctttttctgttttcctcgccatatttcacatcctaaagtgtgtatttctcattttccgtgattttcagttttcttgccatattccaggtcctacagtgtgcatttctcatttttcacgtttttcagtgatttcgtcatttttcaagtcgtcaagtggatgtttctcattttccatgattttcagttttctcgccatattccaggtcctacagttgacatttctaaattttccacattttttatgtttcctcgcgatatttcacatcctaaagtgtgtatttctcattttccgtgattttcagttttcttgccatattccaggtcctacagggtgcatttctcatttttcacgtttttcagtgatttcatcaatttcaagtcgtcaactgtatgtttctcattttcaatgattttcatttttcttgccatattccacgtcctatagtggacatttctacattttccacctttttcagttttcttcgccatatttcacgtcccaaagtgtgtatttctcattttccgtgattttcagtttcctcgccatattccaggtcctacagtgtgcatttctcatttttcacgtttttcagtgatttcgtcttttttcaagtcgtcaagtggatgtttctcattttccatgattttcagttttcttgccatattccatgtcctacagtggacatttctaaattttccacctttttctgttttcctcgccatatttcacgtcctaaagtgtgtatttctcatttaccgtgattttcagttttcttgctatattccaagtcctacagtgtgcatttctcatttttcacgtttttcactgattttgtcattgttcaagttgtcaactgcatgtttctcattttccatgattttcagttttcttgccatattccatgtcctacagtggaaatttctatattttccaactttttcagttttcctcgccatatttcacgtgctaaagtgtgtatttctcatttttcgtgtttttcaggtttctcgccatattccaggtcctacagtgtgcatttctcatttttcacgtttttcagtgattttgtaatttttcaagttgtcaagtggatgtttctcattttccttgattttcagttttcttgccatattccatgtcctactgtggacatttctaaattttccacctttttcagttttccttgccatatttcatgtcctaaagtgtgtatttctcattttcagtgattttcagttttctcgcaatattccaggtcctacagtgtgcatttctcattttttcaggtttttcagtgatttcgtcatttttcacgttgtcaagtggatgtttctcattttccatgattttcacttttcttgccatatttcatgtgctaaagtgtgtatttctcattttcagtgattttcagttttctgccatattccaggtcctacattgtgcatttctcattttttcacgtttttcagtgatttcgtcatttttcacgttgtcaagtggatgtttctcattttccatgattttcacttttcttgccatatttcatgttttacagtggacatttctaaattttccacctatttctgttttcctcgccatatttcacatcctaaagtgtgtatttctcattttccgtgattttcagttttctcgccatatgccaggtcatacagggtgcatttctcatttttcacgtttttcagtgatttcgtcatttttcacgtcgtcaagtggatgtttctcattttcaatgattttcatttttcttgccatattccacgtcctatagtggacatttctaaattttccacctttttcagttttccttgccatatttcaggtcctacagtgtgcatttctcttttttcacgtttttcagtgatttcgtcatttttcaagtggtcaagtgcatgtttctcattttccgtgattttcagttttcttgccatgttccaggtcctacagttgacgtttctaaaatttcactttttttaagttttcctcgccatatttcacttcctaaagtgtgtatttctcattttccgtgattttcagttttctcgccagattccaggtcctacagtgtgcatttttcatatttcacctttttcagtgattttgtcatttttcaagttgtcaactgcatgtttctcattttccatgattttcagttttcttgccatattccatgtcctactgtggacatttctaaattttccaactttttcagttttcctcgccatatttcatgtcctaaagtgtgtatttctcattttcagtgattttctgttttctcgccatattccaggtcctacagtgtgcatttctaatttttcacgtttttcagtgatttcgtcatttttcaagttgtcaagtggatgtttctcattttccatgattttcagttttcttgccatattccatgtcctacagtggacatttctaaattttccaactttttccattttcctcaccatatttcacgtcctaaagtgagtttttctcattttttgtgattttcagttttctcgacatattccaggtcctacagtgtgcatttctaattttttcttttttcagtgatttcgtcatttttcaagtggtcaagtgcatgtttctcattttccatgattttcagttttcttgccatattccatgtcctacaatggacatttctaaattttccaactttttcagttttcctcgccatatttcacgtcctaaagtgtgtatttctcattttccgtgattttcagttttctcgccatattccaggtcctacagtgtgcatttctcatttttcacgtttttcagtgatttcgtcatttttcaagttgtcaactgcatgtttctcattttccatgattttcagttttcttgccatattccatgtcttacagtggacatttttaaatttttcacatttttttaagttttcctccccatatttcacgttttaaagtgtgcatttctcattttcggtgattttcagttttctcgccagattccatgtcttacagtgtgcatttctcattttttcacgtttttcagtgatttcgtcatttttcaagtcgtcaagtggatgtttctcattttccatgattttcagttttcttgccatattccatgtcctacagtggaaatttctaaattttccacctttttcagttttccttgccatatttcaggtcctaaagtgtgtatttctcattttctgtgattttcagttttctcgccatattccaggtcctacagttgacatttctaaaatttccacattttttaagttttcctcgccatatttcacttcctaaagtgtgtatttctcattttccgtgattttcagttttctcgccatattccagatcctacagtgtacatttttcatttttcacgtttttcagtgattttgtcattttttagttgtcaactgcctgtttctcattttccatgattttcagttttcttgctatattccatgtcctacagtggaaatttctaaattttccacctttttcagttttcctcgccatatttcacgtcctaaagtgtgtatttctcattttccgtgattttcagttttctcgccatattccaggtcctatgtgtacatttctcatttttcacgtttttcagtgattttgtcatttttcaatttgtcaactgcatgtttctcattttccatgattttcagttttcttgccatattccatgtcctacagtggaaatttctatattttccaactttttcagttttcctcgccatatttcacgtgctaaagtgtgtatttctcatttttcgtgtttttcaggtttctcgccatattccaggtcctacagtgtgcatttctcatttttcacgtttttcagtgattttgtcatttttcaagttgtcaagtggatgtttctcattttccttgattttcagttttcttgccatattccatgtcctacagtggacatttctaaattttccacctttttcagttttccttgccatatttcatgtcctaaagtgtgtatttctcattttcagtgattttcagttttctcgccatattccaggtcctacagtgtgcatttctcattttttcaggtttttcagtgatttcgtcatttttcacgttgtcaagtggatgtttctcattttccatgattttcacttttcttgccatatttcatgtcctaaagtgtgtatttctcattttcagtgattttcagttttctcgctatattccaggtcctacagtgtgcatttctcattttttcacgtttttcagtgatttcgtcatttttcacgttgtcaagtggatgtttctcattttccatgattttcacttttcttgccatatttcatgtcctacaatggacatttctaaattttccacctttttctgttttcctcgccatatttcacatcctaaagtgtgtatttctcattttccgtgattttcagttttcttgccatattccaggtcctacagtgtgcatttctcatttttcacgtttttcagtgatttcgtcatttttcaagttgtcaagtggatgtttctcattttccttgattttcagttttcttgccatattccatgtcctactgtggacatttctaaattttccacctttttcagttttccttgccatatttcatgtcctaaagtgtgtatttctcattttcagtgattttcagttttctcgcaatattccaggtcctacagtgtgcatttctcattttttcaggtttttcagtgatttcgtcatttttcacgttgtcaagtggatgtttctcattttccatgattttcacttttcttgccatatttcatgtcctaaagtgtgtatttctcattttcagtgattttcagttttctgccatattccaggtcctacattgtgcatttctcattttttcacgtttttcagtgatttcgtcatttttcagttttctcgacatattccaggtcctacagtgtgcatttctaattttttcttttttcagtgatttcgtcatttttcaagttgtcaactgcatgtttctcattttccatgattttcagttttcttgccatattccatgtcttacagtggacatttttaaatttttcacatttttttaagttttcctccccatatttcacgttttaaagtgtgcatttctcattttcggtgattttcagttttctcgccagattccaggtcttacagtgtgcatttctcattttttcacgtttttcagtgatttcgtcatttttcaagtcgtcaagtggatgtttctcattttccatgattttcagttttcttgccatattccatgtcctacagtggaaatttctaaattttccacctttttcagttttccttgccatatttcaggtcctaaagtgtgtatttctcattttctgtgattttcagttttctcgccatattccaggtcctacagttgacatttctaaaatttccacattttttaagttttcctcgccatatttcacttcctaaagtgtgtatttctcattttccgtgattttcagttttctcgccatattccagatcctacagtgtgcatttttcatttttcacgtttttcagtgattttgtcattttttagttgtcaactgtctgtttctcattttccatgattttcagttttcttgccatattccatgtcctacactggacatttctaaattttccacctttttctgttttcctcgccatatttcacgtcctaaagtgtgtatttctcattttccgtgattttcagttttcttgccatattccaggtcctacagtgtgcatttctcatttttcacgtttttcagtgattttgtcatttttcaagttgtcaactgcatgtttctcattttctatgattttcagttttcttgctatattccatgtcctacagtggaaatttctaaattttccacctttttcagttttcctcgccatatttcacgtcctaaagtgtgtatttctcattttccgtgattttcagttttctcgccatattccaggtcctatgtgtacatttctcatttttcacgtttttcagtgattttgtcatttttcaagttgtgaagtggatgtttctcatttttcttgattttcatttttcttgccatattccatgtcctagagtggaaatttttaaattttccacctttttcagttttcctcgccatatttcacgtcctaaagtgtgaatttctcattttccgtgattttcagatttctcgccatattccaagtcctacagtgtgcatttctcatttttcacgtttttcagtgatttcgtcatttttcaagttgtcaagtggatgtttctcattttccatgattttcagctttcttgccatattcaaagtcctacagtggacatttctaaattttcgacctttatcagttttcctcgccatatttcatgtcccaaagtgtgtacttctcattttccgtgattttcagtttcctagccatattctaggtcctacagtgtgcatttctcatttttcaggtttttcagtgatttcgtcttttttcaagtcgtcaagtggatgtttctcattttccatgattttcacttttcttgccatatttcatgtcctaaagtgtgtatttctcattttcagtgattttcagttttctcgctatattccaggtcctacagtgtgcatttctcattttttcacgtttttcagtgatttcgtcatttttcacgttgtcaagtggatgtttctcattttccatgattttcacttttcttgccatatttcatgtcctacagtggacatttctaaattttccacctttttctgttttcctcgccatatttcacatcctaaagtgtgtatttctcattttccgtgattttcagttttcttgccatattccaggtcctacagtgtgcatttctcatttttcacgtttttcagtgatttcgtcatttttcaagttgtcaagtggatgtttctcattttccttgattttcagttttcttgccatattccatgtcctactgtggacatttctaaattttccacctttttcagttttccttgccatatttcatgtcctaaagtgtgtatttctcattttcagtgattttcagttttctcgcaatattccaggtcctacagtgtgcatttctcattttttcaggtttttcagtgatttcgtcatttttcacgttgtcaagtggatgtttctcattttccatgattttcacttttcttgccatatttcatgtcctaaagtgtgtatttctcattttcagtgattttcagttttctgccatattccaggtcctacattgtgcatttctcattttttcacgtttttcagtgatttcgtcatttttcacgttgtcaagtggatgtttctcattttccatgattttcacttttcttgccatatttcatgttttacagtggacatttctaaattttccacctttttctgttttcctcgccatatttcacatcctaaagtgtgtatttctcattttccgtgattttcagttttctcgccatatgccaggtcatacagggtgcatttctcatttttcacgtttttcagtgatttcgtcatttttcacgtcgtcaagtggatgtttctcattttcaatgattttcatttttcttgccatattccacgtcctatagtggacatttctaaattttccacctttttcagttttccttgccatatttcaggtcctacagtgtgcatttctcatttttcacgtttttcagtgatttcgtcatttttcaagtggtcaagtgcatgtttctcattttccgtgattttcagttttcttgccatgttccaggtcctacagttgacgtttctaaaatttcactttttttaagttttcctcgccatatttcacttcctaaagtgtgtatttctcattttccgtgattttcagttttctcgccagattccaggtcctacagtgtgcatttttcatatttcacctttttcagtgattttgtcatttttcaagttgtcaactgcatgtttctcattttccatgattttcagttttcttgccatattccatgtcctactgtggacatttctaaattttccaactttttcagttttcctcgccatatttcatgtcctaaagtgtgtatttctcattttcagtgattttctgttttctcgccatattccaggtcctacagtgtgcatttctaatttttcacgtttttcagtgatttcgtcatttttcaagttgtcaagtggatgtttctcattttccatgattttcagttttcttgccatattccatgtcctacagtggacatttctaaattttccaactttttccattttcctcaccatatttcacgtcctaaagtgtgtttttctcattttttgtgattttcagttttctcgacatattccaggtcctacagtgtgcatttctaattttttcttttttcagtgatttcgtcatttttcaagttgtcaactgcatgtttctcattttccatgattttcagttttcttgccatattccatgtcttacagtggacatttttaaatttttcacatttttttaagttttcctccccatatttcacgttttaaagtgtgcatttctcattttcggtgattttcagttttctcgccagattccaggtcttacagtgtgcatttctcattttttcacgtttttcagtgatttcgtcatttttcaagtcgtcaagtggatgtttctcattttccatgattttcagttttcttgccatattccatgtcctacagtggaaatttctaaattttccacctttttcagttttccttgccatatttcaggtcctaaagtgtgtatttctcattttctgtgattttcagttttctcgccatattccaggtcctacagttgacatttctaaaatttccacattttttaagttttcctcgccatatttcacttcctaaagtgtgtatttctcattttccgtgattttcagttttctcgccatattccagatcctacagtgtgcatttttcatttttcacgtttttcagtgattttgtcattttttagttgtcaactgtctgtttctcattttccatgattttcagttttcttgccatattccatgtcctacactggacatttctaaattttccacctttttctgttttcctcgccatatttcacgtcctaaagtgtgtatttctcattttccgtgattttcagttttcttgccatattccaggtcctacagtgtgcatttctcatttttcacgtttttcagtgattttgtcatttttcaagttgtcaactgcatgtttctcattttccatgattttcagttttcttgctatattccatgtcctacagtggaaatttctaaattttccacctttttcagttttcctcgccatatttcacgtcctaaagtgtgtatttctcattttccgtgattttcagttttctcgccatattccaggtcctatgtgtacatttctcatttttcacgtttttcagtgattttgtcatttttcaagttgtgaagtggatgtttctcatttttcttgattttcatttttcttgccatattccatgtcctagagtggaaatttttaaattttccacctttttcagttttcctcgccatatttcacgtcctaaagtgtgaatttctcattttccgtgattttcagatttctcgccatattccaagtcctacagtgtgcatttctcatttttcacgtttttcagtgatttcgtcatttttcaagttgtcaagtggatgtttctcattttccatgattttcagctttcttgccatattcaaagtcctacagtggacatttctaaattttcgacctttatcagttttcctcgccatatttcatgtcccaaagtgtgtacttctcattttccgtgattttcagtttcctcgccatattctaggtcctacagtgtgcatttctcatttttcaggtttttcagtgatttcgtcttttttcaagtcgtcaagtggatgtttctcattttccatgattttcagttttcttgccatattccatgtcctacagtggacatttctaaattttccacctttttcagttttcctcgccatatttcatgtcctaaagtgtgtatttctcattttcagtgattttcagttttctcgccatattccaggtcctacagtgtgcatttctcatttttcacgtttttcagtgatttcgtcatttttcaagttgtcaagtggatgtttctcattttccatgattttcagttttcttgccatattccatgtcccacagtggacatttctaaattttccacctttttctgttttccttgccatatttcatgtcctaaagtgtgtatttctcattttccgtgattttcagttttcttgctatattccaagtcctacagtgtgcatttctcatttttcacgtttttcagtgattttgtcatttttcaatttgtcaactgcatgtttctcattttccatgattttcagttttcttgccatattccatgtcctacagtggaaatttctatattttccaactttttcagttttcctcgccatatttcacgtgctaaagtgtgtatttctcatttttcgtgtttttcaggtttctcgccatattccaggtcctacagtgtgcatttctcatttttcacgtttttcagtgattttgtcatttttcaagttgtcaagtggatgtttctcattttccttgattttcagttttcttgccatattccatgtcctacagtggacatttctaaattttccacctttttcagttttccttgccatatttcatgtcctaaagtgtgtatttctcattttcagtgattttcagttttctcgccatattccaggtcctacagtgtgcatttctcattttttcaggtttttcagtgatttcgtcatttttcacgttgtcaagtggatgtttctcattttccatgattttcacttttcttgccatatttcatgtcctaaagtgtgtatttctcattttcagtgattttcagttttctcgctatattccaggtcctacagtgtgcatttctcattttttcacgtttttcagtgatttcgtcatttttcacgttgtcaagtggatgtttctcattttccatgattttcacttttcttgccatatttcatgtcctacagtggacatttctaaattttccacctttttctgttttcctcgccatatttcacatactaaagtgtgtatttctcattttccttgattttcagttttcttgccatattccaggtcctacagtgtgcatttctcatttttcacgtttttcagtgatttcgtcatttttcaagtcgtcaagtggatgtttctcattttccatgattttcagttttctcgccatattccaggtcctacagttgacatttctaaattttccacattttttaagtttcctcgcgatatttcacatcctaaagtgtgtatttctcattttccgtgattttcagttttcttgccatattccaggtcctacagggtgcatttctcatttttcacgtttttcagtgatttcatcaatttcaagtcgtcaactgtatgtttctcattttcaatgattttcatttttcttgccatattccatgtcctacagtggacatttctaaatttttcacctttttcagttttccttgccatatttcatgtcctaaagtgtgtatttctcattttcagtgattttcagttttctcgccatattccaggtcctacagtgtgcatttctcattttttcaggtttttcagtgatttcgtcatttttcacgttgtcaagtggatgtttctcattttccatgattttcacttttcttgccatatttcatgtcctaaagtgtgtatttctcattttcagtgattttcagttttctcgccatattccaggtcctacagtgtgcatttctcatttttcacgtttttcagtgatttcgtcatttttcaagttgtcaagtggatgtttctcattttccatgattttcacttttcttgccatattccatgtcccacagtggacatttctaaattttccacctttttctgttttcctcgccatatttcatgtcctaaagtgtgtatttctcattttccgtgattttcagttttcttgctatattccaagtcctacagtgtgcatttctcatttttcacgtttttcagtgattttgtcatttttcaatttgtcaactgcatgtttctcattttccatgattttcagttttcttgccatattccatgttctacagtggaaatttctatattttccaactttttcagttttcctcgccatatttcacgtgctaaagtgtgtatttctcatttttcgtgtttttcaggtttctcgccatattccaggtcctacagtgtgcatttctcatttttcacgtttttcagtgattttgtcatttttcaagttgtcaagtggatgtttctcattttccttgattttcagttttcttgccatattccatgtcctacagtggacatttctaaattttccacctttttcagttttccttgccatatttcatgtcctaaagtgtgtatttctcattttcagtgattttcagttttctcgccatattccaggtcctacagtgtgcatttctcattttttcaggtttttcagtgatttcgtcatttttcacgttgtcaagtggatgtttctcattttccatgattttcacttttcttgccatatttcatgtcctaaagtgtgtatttctcattttcagtgattttcagttttctcgctatattccaggtcctacagtgtgcatttctcattttttcacgttttgcagtgatttcgtcatttttcacgttgtcaagtggatgtttctcattttccatgattttcacttttcttgccatatttcatgtcctacagtggacatttctaaattttccacctttttctgttttcctcgccatatttcacatcctaaagtgtgtatttctcattttccgtgattttcagttttcttgccatattccaggtcctacagtgtgcatttctcatttttcacgtttttcagtgatttcgtcatttttcaagtcgtcaagtggatgtttctcattttccatgattttcagttttctcgccatattccaggtcctacagttgacatttctaaattttccacattttttaagtttcctcgcgatatttcacatcctaaagtgtgtatttctcattttccgtgattttcagttttcttgccatattccaggtcctacagggtgcatttctcatttttcacgtttttcagtgatttcatcaatttcaagtcgtcaactgtatgtttctcattttcaatgattttcatttttcttgccatattccatgtcctacagtggacatttctaaattttccacctttttcagttttccttgccatatttcatgtcctaaagtgtgtatttctcattttcagggattttcagttttctcgccatattccaggtcctacagtgtgcatttctcattttttcaggtttttcagtgatttcgtcatttttcacgttgtcaagtggatgtttctcattttccatgattttcacttttcttgccatatttcatgtcctaaagtgtgtatttctcattttcagtgattttcagttttctcgccatattccaggtcctacagtgtgcatttctcattttttcacgtttttcagtgatttcgtcatttttcacgttgtcaagtggatgtttctcattttccatgattttcacttttcttgccatatttcatgtcctacagtggacatttctaaattttccacctttttctgttttcctcgccatatttcacatcctaaagtgtgtatttctcattttccgtgattttcagttttcttgccatattccaggtcctacagtgtgcatttctcatttttcacgtttttcagtgatttcgtcatttttcaagtcgtcaagtggatgtttctcattttccatgattttcagttttctcgccatattccaggtcctacagttgacatttctaaattttccacattttttaagtttcctcgcgatatttcacatcctaaagtgtgtatttctcattttccgtgattttcagttttcttgccatattccaggtcctacagggtgcatttctcatttttcacgtttttcagtgatttcatcaatttcaagtcgtcaactgtatgtttctcattttcaatgattttcatttttcttgccatattccacgtcctatagtggacatttctaaattttccacctttttcagttttcttcgccatatttcacgtcccaaagtgtgtatttctcattttccgtgattttcagtttcctcgcaatattccaggtcctacagtgtgcatttctcatttttcacgtttttcagtgatttcgtcttttttcaagtcgtcaagtggatgtttctcattttccatgattttcagttttcttgccatattccatgtcctacagtggacatttctaaattttccacctttttctgttttcctcgccatatttcacgtcctaaagtgtgtatttctcattttccgtgattttcagttttcttgccatattccaggtcctacagtgtgcatttctcatttttcacgtttttcactgattttgtcattgttcaagttgtcaactgcatgtttctcattttccatgattttcaattttcttgccatattccatgtcctacagtggaaatttctatattttccaactttttcagttttcctcgccatatttcacgtgctaaagtgtgtatttctcatttttcgtgtttttcaggtttctcgccatattccaggtcctacagtgtgcatttctcatttttcacgtttttcagtgattttgtcatttttcaagttgtcaagtggttgtttctcattttccttgattttcagttttcttgccatattccatgtcctactgtggacatttctaaattttccacctttttcagttttccttgccatatttcatgtcctaaagtgtgtatttctcattttcagtgattttcagttttctcgcaatattccaggtcctacagtgtgcatttctcattttccgtgattttcagttttctcgccatatgccaggtcatacagggtgcatttctcatttttcacgtttttcagtgatttcgtcatttttcacgtcgtcaagtggatgtttctcattttcaatgattttcatttttcttgccatattccacgtcctatagtggacatttctaaattttccaactttttcagttttcttgccatatttcaggtcctacagtgtgcatttctcatttttcacgtttttcagtgatttcgtcatttttcaagtggtcaagtgcatgtttctgattttccgtgattttcagttttcttgccatgttccaggtcctacagttgacgtttctaaaatttcactttttttaagttttcctcgccatatttcacttcctaaagtgtgtatttctcattttccgtgattttcagttttctcgccagattccaggtcctacagtgtgcatttttcatatttcacctttttcagtgattttgtcatttttcaagttgtcaactgcatgtttctcattttccatgattttcagttttcttgccatattccatgtcctactgtggacatttctaaattttccaactttttcagttttcctcgccatatttcatgtcctaaagtgtgtatttctcattttcagtgtttttctgttttctcgccatattccaggtcctacagtgtgcatttctaatttttcacgtttttcagtgatttcgtcatttttcaagttgtcaagtggatgtttctcattttccatgattttcagttttcttgccatattccatgtcctacagtggacatttctaaattttccaactttttccattttcctcaccatatttcacgtcctaaagtgtgtttttctcattttttgtgattttcagttttctcgacatattccaggtcctacagtgtgcatttctaattttttcttttttcagtgatttcgtcatttttcaagtggtcaagtgcatgtttctcattttccatgattttcagttttcttgccatattccatgtcctacaatggacatttctaaattttccaactttttcagttttcctcgccatatttcacgtcctaaagtgtgtatttctcattttccgtgattttcagttttctcgccatattccaggtcctatgtgtacatttctcatttttcacgtttttcagtgattttgtcatttttcaagttgtgaagtggatgtttctcatttttcttgattttcatttttcttgccatattccatgtcctagagtggaaatttttaaattttccaactttttcagttttcctcgccatatttcacgtcctaaagtgtgtatttctcattttccgtgattttcagttttctcgccatattccaagtcctacagtgtgcatttctcatttttcacgtttttcagtgatttcgtcatttttcaagttgtcaagtggatgtttctcattttccatgattttcagctttcttgccatattcaaagtcctacagtggacatttctaaattttcgacctttatcagttttcctcgccatatttcatgtcccaaagtgtgtacttctcattttccgtgattttcagtttcctcgccatattctaggtcctacagtgtgcatttctcatttttcaggtttttcagtgatttcgtcttttttcaagtcgtcaagtggatgtttctcattttccatgattttcagttttcttgccatattccatgtcctacagtggacatttctaaattttccacctttttcagttttcctcgccatatttcatgtcctaaagtgtgtatttctcattttcagtgattttcagttttctcgccatattccaggtcctacagtgtgcatttctcatttttcacgtttttcagtgatttcgtcatttttcaagttgtcaagtggatgtttctcattttccatgattttcagttttcttgccatattccatgtcccacagtggacatttctaaattttccacctttttctgttttccttgccatatttcatgtcctaaagtgtgtatttctcattttccgtgattttcagttttcttgctatattccaagtcctacagtgtgcatttctcatttttcacgtttttaagtgattttgtcatttttcaatttgtcaactgcatgtttctcattttccatgattttcagttttcttgccatattccatgtcctacagtggaaatttctatattttccaactttttcagttttcctcgccatatttcacgtgctaaagtgtgtatttctcatttttcgtgtttttcaggtttctcgccatattccaggtcctacagtgtgcatttctcatttttcacgtttttcagtgattttgtcatttttcaagttgtcaagtggatgtttctcattttccttgattttcagttttcttgccatattccatgtcctacagtggacatttctaaattttccacctttttcagttttccttgccatatttcatgtcctaaagtgtgtatttctcattttcagtgattttcagttttctcgccatattccaggtcctacagtgtgcatttctcattttttcaggtttttcagtgatttcgtcatttttcacgttgtcaagtggatgtttctcattttccatgattttcacttttcttgccatatttcatgtcctaaagtgtgtatttctcattttcagtgattttcagttttctcgccatattccaggtcctacagtgtgcatttctcattttttcacgtttttcagtgatttcgtcatttttcacgttgtcaagtggatgtttctcattttccatgattttcacttttcttgccatatttcatgtcctacagtggacatttctaaattttccacctttttctgttttcctcgccatatttcacatcctaaagtgtgtatttctcattttccgtgattttcagttttcttgccatatttcaggtcctacagtgtgcatttctcatttttcacgtttttcagtgatttcgtcatttttcaagtcgtcaagaggatgtttctcattttccatgattttcagttttctcgccatattccaggtcctacagttgacatttctaaattttccacattttttaagtttcctcgcgatatttcacatcctaaagtgtgtatttctcattttccgtgattttcagttttcttgccatattccaggtcctacagggtgcatttctcatttttcacgtttttcagtgatttcatcaatttcaagtcgtcaactgtatgtttctcattttcaatgattttcatttttcttgccatattccacgtcctatagtggacatttctaaattttccacctttttctgttttcctcgccatatttcacgtcctaaagtgtgtatttctcattttccgtgattttcagttttcttgccatattccaggtcctacagtgtgcatttctcatttttcacgtttttcactgattttgtcattgttcaagttgtcaactgcatgtttctcattttccatgattttcagttttcttgccatattccatgtcctacagtggaaatttctatattttccacctttttcagttttcctcgccgtatttcatgtgctaaagtgtgtatttctcatttttcgtgtttttcaggtttctcgccatattccaggtcctacagtgtgcatttctcatttttcacgtttttcagtgattttgtcatttttcaagttgtcaactggatgtttctcattttccttgattttcagttttcttgccatattccatgtcctactgtggacatttctaaattttccacctttttcagttttccttgccatatttcatgtcctaaagtgtgtatttctcattttcagtgattttcagttttctcgcaatattccaggtcctacagtgtgcatttctcattttttcaggtttttcagtgatttcgtcatttttcacgttgtcaagtggatgtttctcattttccatgattttcacttttcttgccatatttcatgtcctaaagtgtgtatttctcattttcagtgattttcagttttctcgccatattccaggtcctacattgtgcatttctcattttttcacgtttttcagtgatttcgtcatttttcacgttgtcaagtggatgtttctcattttccatgattttcacttttcttgccatatttcatgttttacagtggacatttctaaattttccacctttttctgttttcctcgccatatttcacatcctaaagtgtgaatttctcattttccgtgattttcagttttcttgccatattccaggtcctacagtgtgcatttctcatttttcacgtttttcagtgatttcatcatttttcaagtcgtcaagtggatgtttctcattttccatgattttcagttttcttgccatattccatgtcctacagtggacatttctaaattttccacctttttctgttttcctcgccatatttcacgtcctaaagtgtgtatttctcattttccgtgattttcagttttcttgccatattccaggtcctacagtgtgcatttctcatttttcacgtttttcactgattttgtcatttttcaagttgtcaactgcatgtttctcattttccatgattttcagttttcttgctatattccatgtcctacagtggaaatttctaaattttccacctttttcagttttcctcgccatatttcacgtcctgaagtgtgtatttctcattttccgtgattttcagttttctcgccatattccaggtcctatgtgtacatttctcatttttcacgtttttcagtgattttgtcatttttcaagttgtgaagtggatgtttctcatttttcttgattttcatttttcttgccatattccatgtcctacagtggaaatttctaaattttccacctttttcagttttcctcgccatatttcacgtcctaaagtgtgtatttctcattttccgtgattttcagttttctcgccatattccaggtcctacagtgtgcatttctcatttttcacgtttttcagtgatttcgacatttttcaagttgtcaagtggatgtttctcattttccatgattttcagctttcttgccatattcaaagtcctacagtggacatttctaaattttcgacctttatcagttttcctcgccatatttcatgtcccaaagtgtgtacttctcattttccgtgattttcagtttcctcgccatattccaggtcctacagtgtgcatttctcatttttcacgtttttcagtgatttcgtcatttttcaagtcgtcaagtggatgtttctcattttccatgattttcagttttcttgccatattccatgtcctacagtggacatttctaaattttccacctttttctgttttcctcgccatatttcacgtcctaaagtgtgtatttctcattttccgtgattttcagttttcttgccatattccaggtcctacagtgtgcatttctcatttatcacgtttttcactgattttgtcatttttcaagttgtcaactgcatgtttctcattttccatgattttcagttttcttgctatattccatgtcctacagtggaatattctaaattttccacctttttcagttttcctcgccatatttcacgtcctgaagtgtgtatttctcattttccgtgattttcagttttctcgccatattccaggtcctatgtgtacatttctcatttttcacgtttttcagtgattttgtcatttttcaagttgtgaagtggatgtttctcatttttcttgattttcatttttcttgccatattccatgtcctacagtggaaatttctaaattttccacctttttcagttttcctcgccatatttcacgtcctaaagtgtgaatttctcattttccgtgattttcagttttctcgccatattccaggtcctacagtgtgcatttctcatttttcacgtttttcagtgatttcgacatttttcaagttgtcaagtggatgtttctcattttccatgattttcagctttcttgccatattcaaagtcctacagtggacatttctaaattttcgacctttatcagttttcctcgccatatttcatgtcccaaagtgtgtacttctcattttccgtgattttgagtttcctcgccatattccaggtcctacagtgtgcatttctcatttttcacgtttttcagtgatttcgtcttttttcaagttgtcaactgcatgtttctcattttccatgattttcagttttcttgccatattccatgtcctacagtggaaatttgtaaatttccacctttttcagttttcctcgccatatttcacgtcctaaagtatgtatttctcattttccgtgattttcagttttctcgccatattccaggtcctacagtgtgcatttctcatttttcacgtttttcagtgattttgtcattttttaagttttcaagtggatgtttctcattttccttgattttcagttttcttgccatattccatgtcctacagtggacatttctaaattttccacctttttcagttttcctcgccatatttcatgtcctaaagtgtgtatttctcattttcagtgattttcagttttctcgccatattccaggtcctacagtgtgcatttctcatttttcacgtttttcagtgatttcgtcatttttcaaggtgtcaagtggatgtttctcattttccatgattttcagttttcttgccatattccatgtcctacagtggacatttctaaattttccacctttttctgttttcctcgccatatttcatgtcctaaagtgtgtatttctcattttccgtgattttcagttttcttgctatattccaagtcctacagtgtgcatttctcatttttcacgtttttcagtgattttgtcatttttcaatttgtcaactgcatgtttctcattttccatgattttcagtttttttgccatattccatgtcctactgtggaaatttctatattttccacctttttcagttttcctcgccatatttcacgtgctaaagtgtgtatttctcatttttcgtgtttttcaggtttctcgccatattccaggtcctacagtgtgcatttctcatttttcacgtttttcagtgattttgtcatttttcaagttttcaagtggatgtttctcattttccttgattttcagttttcttgccatattccatgtcctacagtggacatttctaaattttccacctttttcagttttccttgccatatttcatgtcctaaagtgtgtatttctcattttcagtgattttcagtttccttgccatattccaggtcctacagtgtgcatttctcattttttcacgtttttcagtgatttcgtcatttttcacgttgtcaagtggatgtttctcattttccatgattttcacttttcttgccatatttcatgtcctacagtggacatttctaaattttccaactttttcaattttcctcgccatattttatgtcctaaagtgtgtatttctcatttttcgttattttcagttttcttgccatattccaggtcctacagtgtgcatttgtcatttttcacgtttttcagtgatttcgtcatttttcaagtcgtcaagtagatgtttctcatattccatgtttttcagttttctcgccatattccaggtcctacagttgacatttctaaattttctacatttttaaattttcctcgccatatttcacgtcctaaagtgtgtatttctcattttttgttattttcagttttctagccatattccaggtcctacaggatgcatttctcatttttcacgtttttcagtgatttcatcatttttcaagtcgtcaagtgtatgtttcttattttcaatgattttcatttttcttgccttattccacgtcctatagtggacatttctaaattttccacctttttcagtttttttcgccatatttcacgtcctaaagtgtgtatttctcattttctgtgattttcagttttctcaccatattccaggtcctacagtgtgcatttctcatttttcacgtttttcagtgatttcgtcatttttcaagttgtcaagtggaagtttctcattttccatgattttcagctttctagacatattccaggtcctacagtggacatttcctaattttcgacctttatcagttttcctcgtcatatttcacgtcccaaaatgtgtatttcttattttccatgattttcagtttcctcgccatattccaggtcctacagtgtgcaattctcatttttcacgtttttcagtgatttcgtcttttttcaagacgtcaagtggatgtttctcatttttcatgattttcagttttcttgccatattccatgtcctacagtggacatttctaaattttccacctttttctgttttcctcgccatatttcacgtcctaaagtgtgtatttctcattttccgtgattttcagttttcttgccatattcctggtcctacagtgtgcatttctcatttttcacgtttttcagtgattttgtcatttttcaatttgtcaactgcatgtttctcattttccattattttcagttttcttgccatattccatgtcctacagtggacatttctaaattttccacctttttctgttttcctcgccatatttcatgtcctaaagtgtgtatttctcattttccgtgattttcagttttcttgctatattccaagtcctacagtgtgcatttctcatttttcacgtttttcagtgattttgtcatttttcaatttgtcaactgcatgtttctcattttccatgattttcagtttttttgccatattccatgtcctacaggggaaatttctatattttccacctttttcagttttcctcgccatatttcatgtcctaaagtgtgtatttctcattttccgtgattttcagttttcttgccatattccaggtcctacagtgtgcatttctcatttttcacgtttttcagtgatttcgtcatttttcaagtcttcaagtagatgtttctcatattccatgtttttcagttttctcgccatattccaggtcctacagttgacatttctaaattttctacatttttaaattttcctcgccatatttcacgtcctaaagtgtgtatttctcatttttcgttattttcagttttctagccatattccaggtcctacaggatgcatttctcatttttcacgtttttcagtgatttcatcatttttcaagtcgtcaagtgtatgtttctcattttcaatgattttcatttttcttgccttattccacgtcctatagtggacatttctaaattttccacctttttcagtttttctcgccatatttcacgtcctaaagtgtgtatttctcattttctgtgattttcagttttctcaccatattccaggtcctacagtgtgcatttctcatttttcacgtttttcagtgatttcgtcatttttcaagttgtcaagtggaagtttctcattttccatgattttcagctttctagccatattccaggtcctacagtggacatttcctaattttcgacctttatcagttttcctcgccatatttcacgtcctaaagtgtgtatttctcattttccgtgattttcagttttcttgccatattccaggtcctacagtgtgcatttctcatttttcacgtttttcagtgattttgtcatttttcaatttgtcaactgcatgtttctcattttccatgatttttagttttcttgctatattccatgtcctacagtggaaatttctaaattttccacctttttcagttttcctcgccatatttcacgtcctaaagtgtgtatttctcattttccgtgattttcagttttcttgctatattccaagtcctacattgtgcatttctcatttttcacgtttttcagtgattttgtcatttttcaatttgtcaaaccacatgtttctcattttccatgattttcagtttttttgccatattccatgtcctacagtggaaatttctatattttccacctttttcagttttcctcgccatatttcacgtgctaaagtgtgtatttctcatttttcgtgtttttcaggtttctcgccatattccaggtcctacagtgtgcatttctcatttttcacgtttttcagtgattttgtcatttttcaagttgtcaagtggatgtttcccattttccttgattttcagttttcttaccatattccatgtcctacagtggacatttctaaattttccacctttttcagttttccttgccatatttcatgtcctaaagtgtgtatttctcattttcagtgattttcagtttcctcgccatattccaggtcctacagtgtgcatttctcattttttcacgtttttcagtgatttcgtcatttttcacgttgtcaagtggatgtttctcattttccatgattttcacttttcttgccatatttcatgtcctatagtggacatttctaaattttccacctttttcagtttttctcgccatatttcacgtcctaaagtgtgtatttctcattttctgtgattttcagttttctcaccatattccaggtcctacagtgtgcatttctcatttttcacgtttttcagtgatttcgtcatttttcaagtcgtcaagtagatgtttctcatattccatgtttttcagttttctcgccatattccaggtcctacagttgacatttctaaattttctacatttttaaattttcctcgccatatttcacgtcctaaagtgtgtatttctcatttttcgttattttcagttttctagccatattccaggtcctacaggatgcatttctcatttttcacgtttttcagtgatttcatcatttttcaagtcgtcaagtgtatgtttcttattttcaatgattttcatttttcttgccttattccacgtcctatagtggacatttctaaattttccaccttttttcagtttttctcgccatatttcacgtcctaaagtgtgtatttctcattttctgtgattatcagttttctcaccatattccaggtcctacagtgtgcatttctcatttttcacgtttttcagtgatttcgtcatttttcaagttgtcaagtggaagtttctcattttccatgattttcagctttctagccatattccaggtcctacagtggacatttcctaattttcgacctttatcagttttcctcgccatatttcacgtcccaaaatgtgtatttcttattttccatgattttcagtttcctcgccatattccaggtcctacagtgtgcatttctcatttttcacgtttttcagtgatttcgtcttttttcaagacgtcaagtggatgtttctcatttttcatgattttcagttttcttgccatattccatgtcctacagtggacatttctaaattttccacctttttctgttttcctcgccatatttcacgtcctaaagtgtgtatttctcattttccgtgattttcagttttcttgccatattcctggtcctacagtgtgcatttctcatttttcacgtttttcagtgattttgtcatttttcaatttgtcaactgcatgtttctcattttccatgattttcagttttcttgccatattccatgtcctacagtggacatttctaaattttccacctttttcagttttcctcgccatatttcacgtgctaaagtgtgtatttctcatttttcgtgtttttcaggtttctcgccatattccaggtcctacagtgtgcatttctcatttttcacgtttttcagtgattttgtcatttttcaagttgtcaagtggatgtttctcattttccttgattttcacttttcttgccatattccaagtcttacaggggcatttctcatttttcacgttttcagtgattttgtcattttcaatttgtcaactgcatgtttctcattttccatgattttcagtttttttgccatattccatgtcctacaggggaaatttctatattttccacctttttcagttttcctcgccatatttcatgtcctaaagtgtgtatttctcattttccgtgattttcagttttcttgccatattccaggtcctacagtgtgcatttctcatttttcacgtttttcagtgatttcgtcatttttcaagtcttcaagtagatgtttctcatattccatgtttttcagttttctcgccatattccaggtcctacagttgacatttctaaattttctacatttttaaattttcctcgccatatttcacgtcctaaagtgtgtatttctcatttttcgttattttcagttttctagccatattccaggtcctacaggatgcatttctcatttttcacgtttttcagtgatttcatcatttttcaagtcgtcaagtgtatgtttctcattttcaatgattttcatttttcttgccttattccacgtcctatagtggacatttctaaattttccacctttttcagtttttctcgccatatttcacgtcctaaagtgtgtatttctcattttctgtgattttcagttttctcaccatattccaggtcctacagtgtgcatttctcatttttcacgtttttcagtgatttcgtcatttttcaagttgtcaagtggaagtttctcattttccatgattttcagctttctagccatattccaagtcctacagtggacatttcctaattttcgacctttatcagttttcctcgccatatttcacgtcccaaaatgtgtattccttattttccatgattttcagtttcctcgccatattccaggtcctacagtgtgcatttatcatttttcacgtttttcagtgatttcgtcttttttcaagacgtcaagtggatgtttctcatttttcatgattttcagttttcttgccatattccatgtcctacagtggacatttctaaattttccacctttttctgttttcctcgccatatttcacgtcctaaagtgtgtatttctcattttccgtgattttcagttttcttgccatattcctggtcctacagtgtgcatttctcatttttcacgtttttcagtgattttgtcatttttcaagttgtcaagtggatgtttctcattttccttgattttcacttttcttgccatattccatgtcctacagtggacatttctatattttccacctttttccgttttccttgccatatttcacgtcctaaagtgtgtatttctcattttccgtgattttcaggtttctcgccatattccaggtcctacagtgtgcatttctcatttttcacgtttttcagtgattttgtcatttttcaagttgtcaagtggatgtttctcattttccttgattttcacttttcttgccatattccatgtcctacagtggacatttctaaattttccacctttttcagttttcctcgccatatttcatgtcctaaagtgtgtatttctcattttcagtgattttcagttttcttgccatattccaggtcctacagtgtgcatttctcatttttcacgtttttcagtgattttgtcatttttcaagttgtcaactgcatgtttctcattttctatgattttcagttttcttgctatattccatgtcctacagtggaaatttctaaattttccacctttttcagttttcctcgccatatttcacgtcctaaagtgtgtatttctcattttccgtgattttcagttttctcgccatattccaggtcctatgtgtacatttctcatttttcacgtttttcagtgattttgtcatttttcaagttgtgaagtggatgtttctcatttttcttgattttcatttttcttgccatattccatgtcctagagtggaaatttttaaattttccacctttttcagttttcctcgccatatttcacgtcctaaagtgtgaatttctcattttccgtgattttcagatttctcgccatattccaagtcctacagtgtgcatttctcatttttcacgtttttcagtgatttcgtcatttttcaagttgtcaagtggatgtttctcattttccatgattttcagctttcttgccatattcaaagtcctacagtggacatttctaaattttcgacctttatcagttttcctcgccatatttcatgtcccaaagtgtgtacttctcattttccgtgattttcagtttcctcgccatattctaggtcctacagtgtgcatttctcatttttcaggtttttcagtgatttcgtcttttttcaagtcgtcaagtggatgtttctcattttccatgattttcacttttcttgccatatttcatgtcctaaagtgtgtatttctcattttcagtgattttcagttttctcgctatattccaggtcctacagtgtgcatttctcattttttcacgtttttcagtgatttcgtcatttttcacgttgtcaagtggatgtttctcattttccatgattttcacttttcttgccatatttcatgtcctacagtggacatttctaaattttccacctttttctgttttcctcgccatatttcacatcctaaagtgtgtatttctcattttccgtgattttcagttttcttgccatattccaggtcctacagtgtgcatttctcatttttcacgtttttcagtgatttcgtcatttttcaagttgtcaagtggatgtttctcattttccttgattttcagttttcttgccatattccatgtcctactgtggacatttctaaattttccacctttttcagttttccttgccatatttcatgtcctaaagtgtgtatttctcattttcagtgattttcagttttctcgcaatattccaggtcctacagtgtgcatttctcattttttcaggtttttcagtgatttcgtcatttttcacgttgtcaagtggatgtttctcattttccatgattttcacttttcttgccatatttcatgtcctaaagtgtgtatttctcattttcagtgattttcagttttcctcgccatatttcacgtcccaaaatgtgtatttcttattttccatgattttcagtttcctcgccatattccaggtcctacagtgtgcatttctcatttttcacgtttttcagtgatttcgtcttttttcaagacgtcaagtggatgtttctcatttttcatgattttcagttttcttgccatattccatgtcctacagtggacatttctaaattttccacctttttctgttttcctcgccatatttcacgtcctaaagtgtgtatttctcattttccgtgattttcagttttcttgccatattcctggtcctacagtgtgcatttctcatttttcacgtttttcagtgattttgtcatttttcaatttgtcaactgcatgtttctcattttccatgattttcagttttcttgccatattccatgtcctacagtggacatttctaaattttccacctttttcagttttcctcgccatatttcacgtgctaaagtgtgtatttctcatttttcgtgtttttcaggtttctcgccatattccaggtcctacagtgtgcatttctcatttttcacgtttttcagtgattttgtcatttttcaagttgtcaagtggatgtttctcattttccttgattttcacttttcttgccatattccatgtcctacagtggacatttctaaattttccacctttttcagttttcctcgccatatttcatgtcctaaagtgtgtatttctcattttcagtgattttcagttttctcgccatattccaggtcctacagtgtgcatttctcatttttcacgtttttcagtgatttcgtcttttttcaagacgtcaagtggatgtttctcattttccatgattttcagttttcttgccatattccatgtcctacagtggacatttctaaattttccacctttttctgttttcctcgccatatttcacgtcctaaagtgtgtatttctcattttccgtgattttcagttttcttgccatattccaggtcctacagtgtgcatttctcatttttcacgtttttcagtgattttgtcatttttcaatttgtcaactgcatgtttctcattttccatgatttttagttttcttgctatattccatgtcctacagtggaaatttctaaattttccacctttttcagttttcctcgccatatttcacgtcctaaagtgtgtatttctcattttccgtgattttcagttttcttgctatattccaagtcctacattgtgcatttctcatttttcacgtttttcagtgattttgtcatttttcaatttgtcaaaccacatgtttctcattttccatgattttcagtttttttgccatattccatgtcctacagtggaaatttctatattttccacctttttcagttttcctcgccatatttcacgtgctaaagtgtgtatttctcatttttcgtgtttttcaggtttctcgccatattccaggtcctacagtgtgcatttctcatttttcacgtttttctgtgattttgtcatttttcaagttgtcaagtggatgtttctcattttccttgattttcagttttcttaccatattccatgtcctacagtggacatttctaaattttccaccttttctgttttcctcgccatatttcatgtcctaaagtgtgtatttctcattttccgtgattttcatttttcttgctatattccaagtcctacagtgtgcatttctcattttccatgattttcagttttcttgctatattccatgtcctacagtggaaatttctaaattttccacctttttcagttttcctcgccatatttcacgtcctaaagtgtgtatttctcattttccgtgattttcagttttttcgccatattacaggtcctatgtgtacatttctcatttttcacgtttttcagtgattttgtcatttttcaagttgtcaagtggatgtttctcatttttcttgattttcatttttcttgccatattccatgtcctacagtggaaatttctaaattttccacctttttcagttttcctcgccatatttcacgtcctaaagtgtgaatttctcattttccgtgattttcagttttctcgccatattccaggtctacagtgtgcatttctcatttttcacgttttcagtgattcgtcatttttcaagttgacaagtggatgtttctcattttccatgattttcagctttcttgccatattcaaagtcctacagtggacatttctaaattttcgacctttatcagttttcctcgccatatttcatgtcccaaagtgtgtacttctcattttccgtgattttcagttttcttgccatattccaagtcctacagtgtgcatttctcatttttcacgtttttcagtgattttgtcatttttcaatttgtcaactgcatgtttctcattttccatgattttcagttttcttgccatattccatgtcctacagtggaaatttctatattttccacctttttcagttttcctcgccatatttcacgtgctaaagtgtgtatttctcatttttcgtgtttttcaggtttctcgccatattccaggtcctacagtgtgcatttctcatttttcacgtttttcagtgattttgtcatttttcaagttgtcaagtggatgtttctcattttcaatgattttcatttttcttgccttattccacgtcctatagtggacatttctaaattttccacctttttcagtttttctcgccatatttcacgtcccaaaatgtgtattccttattttccatgattttcagtttcctcgccatattccaggtcctacagtgtgcatttctcatttttcacgtttttcagtgatttcgtcttttttcaagacgtcaagtggatgtttctcatttttcatgattttcagttttcttgccatattccctgtcctacagtggacatttctaaattttccacctttttctgttttcctcgccatatttcacgtcctaaagtgtgtatttctcattttccgtgattttcagttttctcgccagattccaggtcctacagtgtgcatttctcatttttcacgtttttcagtgattttgtcatttttcaatttgtcaactgcatgtttctctctttccatgattttcagttttcttgccatattccatgtcctacagtggacatttctaaattttccacctttttcagttttcctcgccatatttcacgtgctaaagtgtgtatttctcatttttcgtgtttttcaggtttctcgccatattccaggtcctacagtgtgcatttctcatttttcacgtttttcagtgattttgtcatttttcaagttgtcaagtggatgtttctcattttcaatgattttcatttttcttaccttattccacgtcctatagtggacatttctaaattttccacctttttcagtttttctcgccatatttcacgtcccaaaatgtgtattccttattttccatgattttcagtttcctcgccatattccaggtcctacagtgtgcatttctcatttttcacgtttttcagtgatttcgtcttttttcaagacgtcaagtggatgtttctcatttttcatgattttcagttttcttgccatattccctgtcctacagtggacatttctaaattttccacctttttctgttttcctcgccatatttcacgtcctaaagtgtgtatttctcattttccgtgattttcagttttctcgccagattccaggtcctacagtgtgcatttctcatttttcacgtttttcagtgatttcgtcatttttcaagtcttcaagtgtatgtttctcattttcaatgattttcatttttcttgccttattccacgtcctatagtggacatttctaaattttccacctttttcagtttttctcgccatatttcacgtcctaaagtgtgtatttctcattttctgtgattttcagttttcttaccatattccaggtcctacagtgtgcatttctcatttttcacgtttttcagtgatttcgtcatttttcaagttgtcaagtggaagtttctcattttccatgattttcagctttctagccatattccaggtattacagtggacatttccttattttcgacctttatcagttttcctcgccatatttcatgtcctaaagtgtgt	38399	1554	4%	7300	19%
9	3000001	3038400	Atcctacagtgtgcatttctcatttttcacgtttttcagtgatttcgtcatttttcaagtcatcaagtggctgtttctcattttccatgattttcagttttcttgccatattccttgtcctacagtggacatttctaaattttccacctttttcagttttccttgtcatatttcaggtcctacagtgtgtatttctcatttttcacgtttttcattgatttcgtcatttttcaagttgtcaagtgcatgtttctcattttccatgattttcagttttcttgccatattccatgtcctacaatggacatttctaaattttccaactttttcagttttcctcgccatatttcacgtcctaaagtgtgtatttctcattttccgtgattttcagttttctcgacatattccaggtcctacagtgtgcatttctcatttttcacgtttttcagtgatttcgtcatttttcacgtcgtcaagtggatgtttctcattttccatgattttcagttttcttgccatattccatgtcctacagtggacatttctaaattttccacctttttcagttttcctcgccatatttcacgtcctaaagtgtgtatttctcattttccgtgattttcagttttctcgacatattccaggtcttacagggtgcatttctcatttttcacgtttttcagtgatttcatcatttttcaagtcgtcaactgtatgtttctcattttcaatgattttcatttttcttgccatattccacgtcctatagtggacatttctaaattttccacctttttcagttttccttgccatatttcaggtcctacagtgtgcatttctcatttttcacgtttttcagtgatttcgtcatttttcaagtggtcaaatgcatgtttctcattttccatgattttcagttttcttgccatattccatgtcctacagtggacatttctaaattttccacctttttcagttttcctcgccatatttcacgtcctaaagtgtgtatttctcattttccgtgattttcagttttatcgccagattccaggtcctacggtgtgcatttttcatatttcacgtttttcagtgattttgtcatttttcaagttgtcaactgcatgtttctcattttccatgattttcagttttcttgccatattccatgtcctacagtggacatttctaaattttccacctttttcagttttcctcgccatatttcatgtcctaaagtgtgtatttctcattttcagtgattttctgttttctcgccatattccaggtcctacagtgtgcatttctcatttttcacgtttttcagtgatttcgtcatttttcaagttgtcaagtggatgtttctcattttccatgattttcagttttcttgccatattccatgtcctacaatggacatttctaaattttccacctttttcagttttcctcgccatatttcacgtcctaaagtgtgtatttctcattttccgtgattttcagttttctcgccatattccaggtcctatgtgtacatttctcatttttcacgtttttcagtgattttgtcatttttcaagttgtgaagtggatgtttctcatttttcttgattttcatttttcttgccatattccatgtcctagagtggaaatttttaaattttccacctttttcagttttcctcgccatatttcacgtcctaaagtgtgaatttctcattttccgtgattttcagttttctcgccatattccaagtcctacagtgtgcatttctcatttttcacgtttttcagtgatttcgtcatttttcaagttgtcaagtggatgtttctcattttccatgattttcagctttcttgccatattcaaagtcctacagtggacatttctaaattttcgacctttatcagttttcctcgccatatttcatgtcccaaagtgtgtacttctcattttccgtgattttcagtttcctcgccatattctaggtcctacagtgtgcatttctcatttttcaggtttttcagtgatttcgtcttttttcaagtcgtcaagtggatgtttctcattttccatgattttcagttttcttgccatattccatgtcctacagtggacatttctaaattttccaactttttcagttttcctcgccatatttcatgtcctaaagtgtgtatttctcattttcagtgattttcagttttctcgccatattccaggtcctacagtgtgcatttctcatttttcacgtttttcagtgatttcgtcatttttcaagttgtcaagtggatgtttctcatttttcatgattttcagttttcttgccatattccatgtcccacagtggacatttctaaatgttccacctttttctgttttccttgccatatttcatgtcctaaagtgtgtatttctcattttccgtgattttcagttttcttgctatattccaagtcctacagtgtgcatttctcatttttcacgtttttctgtgattttttcatttttcaatttgtcaactgcatgtttctcattttccatgattttcagttttcttgccatattccaggtcctacagtgtgcatttctcatttttcacgtttttcagtgattttgtcatttttcaagttgtcaactgcatgtttctcattttccatgattttcagttttcttgctatattccatgtcctacagtggaaatttctaaattttccacctttttcagttttcctcgccatatttcacgtcctaaagtgtgtatttctcattttccgtgattttcagttttctcgccatattccaggtcctatgtgtacatttctcatttttcacgtttttcagtgattttgtcatttttcaagttgtgaagtggatgtttctcatttttcttgattttcatttttcttgccatattccatgtcctagagtggaaatttttaaattttccacctttttcagttttcctcgccatatttcacgtcctaaattgtgaatttctcattttccgtgattttcagttttctcgccatattccaagtcctacagtgtgcatttctcatttttcacgtttttcagtgatttcgtcatttttcaagttgtcaagtggatgtttctcattttccatgattttcagctttcttgccatattcaaagtcctacagtggacatttctaaattttcgacctttatcagttttcctcgccatatttcatgtcccaaagtgtgtacttctcattttccgtgattttcagtttcctcgccatattctaggtcctacagtgtgcatttctcatttttcaggtttttcagtgatttcgtcttttttcaagtcgtcaagtggatgtttctcattttccatgattttcagttttcttgccatattccatgtcctacagtggacatttctaaattttccacctttttcagttttcctcgccatatttcatgtcctaaagtgtgtatttctcattttcagtgattttcagttttctcgccatattccaggtcctacagtgtgcatttctcatttttcacgtttttcagtgattttgtcatttttcaagttgtcaagtggatgtttctcattttccttgattttcagttttcttgccatattccatgtcctacagtggacatttctaaattttccacctttttcagttttccttgccatatttcatgtcctaaagtgtgtatttctcattttcagtgattttcagttttctcgccatattccaggtcctacagtgtgcatttctcattttttcaggtttttcagtgatttcgtcatttttcacgttgtcaagtggatgtttctcattttccatgattttcacttttcttgccatatttcatgtcctaaagtgtgtatttctcattttcagtgattttcagttttctcgccatattccaggtcctacagtgtgcatttctcattttttcacgtttttcagtgatttcgtcatttttcacgttgtcaagtggatgtttctcattttccattattttcacttttcttgccatatttcatgtcctacagtggacatttctaaattttccacctttttctgttttcctcgccatatttcacatcctaaagtgtgtatttctcattttccgtgattttcagttttcttgccatattccaggtcctacagtgtgcatttctcatttttcacgtttttcagtgatttcgtcatttttcaagtcgtcaagtggatgtttctcattttccatgattttcagttttctcgccatattccaggtcctacagttgacatttctaaattttccacattttttatgtttcctcgcgatatttcacatcctaaagtgtgtatttctcattttccgtgattttcagttttcttgccatattccaggtcctacagggtgcatttctcatttttcacgtttttcagtgatttcatcaatttcaagtcgtcaactgtatgtttctcattttcaatgattttcatttttcttgccatattccacgtcctatagtggacatttctacattttccacctttttcagttttcttcgccatatttcacgtcccaaagtgtgtatttctcattttccgtgattttcagtttcctcgccatattccaggtcctacagtgtgcatttctcatttttcacgtttttcagtgatttcgtcttttttcaagtcgtcaagtggatgtttctcattttccatgattttcagttttcttgccatattccatgtcctacagtggacatttctaaattttccacctttttctgttttcctcgccatatttcacgtcctaaagtgtgtatttctcatttaccgtgattttcagttttcttgctatattccaagtcctacagtgtgcatttctcatttttcacgtttttcactgattttgtcattgttcaagttgtcaactgcatgtttctcattttccatgattttcagttttcttgccatattccatgtcctacagtggaaatttctatattttccaactttttcagttttcctcgccatatttcacgtgctaaagtgtgtatttctcatttttcgtgtttttcaggtttctcgccatattccaggtcctacagtgtgcatttctcatttttcacgtttttcagtgattttgtaatttttcaagttgtcaagtggatgtttctcattttccttgattttcagttttcttgccatattccatgtcctactgtggacatttctaaattttccacctttttcagttttccttgccatatttcatgtcctaaagtgtgtatttctcattttcagtgattttcagttttctcgcaatattccaggtcctacagtgtgcatttctcattttttcaggtttttcagtgatttcgtcatttttcacgttgtcaagtggatgtttctcattttccatgattttcacttttcttgccatatttcatgtgctaaagtgtgtatttctcattttcagtgattttcagttttctgccatattccaggtcctacattgtgcatttctcattttttcacgtttttcagtgatttcgtcatttttcacgttgtcaagtggatgtttctcattttccatgattttcacttttcttgccatatttcatgttttacagtggacatttctaaattttccacctatttctgttttcctcgccatatttcacatcctaaagtgtgtatttctcattttccgtgattttcagttttctcgccatatgccaggtcatacagggtgcatttctcatttttcacgtttttcagtgatttcgtcatttttcacgtcgtcaagtggatgtttctcattttcaatgattttcatttttcttgccatattccacgtcctatagtggacatttctaaattttccacctttttcagttttccttgccatatttcaggtcctacagtgtgcatttctcttttttcacgtttttcagtgatttcgtcatttttcaagtggtcaagtgcatgtttctcattttccgtgattttcagttttcttgccatgttccaggtcctacagttgacgtttctaaaatttcactttttttaagttttcctcgccatatttcacttcctaaagtgtgtatttctcattttccgtgattttcagttttctcgccagattccaggtcctacagtgtgcatttttcatatttcacctttttcagtgattttgtcatttttcaagttgtcaactgcatgtttctcattttccatgattttcagttttcttgccatattccatgtcctactgtggacatttctaaattttccaactttttcagttttcctcgccatatttcatgtcctaaagtgtgtatttctcattttcagtgattttctgttttctcgccatattccaggtcctacagtgtgcatttctaatttttcacgtttttcagtgatttcgtcatttttcaagttgtcaagtggatgtttctcattttccatgattttcagttttcttgccatattccatgtcctacagtggacatttctaaattttccaactttttccattttcctcaccatatttcacgtcctaaagtgagtttttctcattttttgtgattttcagttttctcgacatattccaggtcctacagtgtgcatttctaattttttcttttttcagtgatttcgtcatttttcaagtggtcaagtgcatgtttctcattttccatgattttcagttttcttgccatattccatgtcctacaatggacatttctaaattttccaactttttcagttttcctcgccatatttcacgtcctaaagtgtgtatttctcattttccgtgattttcagttttctcgccatattccaggtcctacagtgtgcatttctcatttttcacgtttttcagtgatttcgtcatttttcaagttgtcaactgcatgtttctcattttccatgattttcagttttcttgccatattccatgtcttacagtggacatttttaaatttttcacatttttttaagttttcctccccatatttcacgttttaaagtgtgcatttctcattttcggtgattttcagttttctcgccagattccatgtcttacagtgtgcatttctcattttttcacgtttttcagtgatttcgtcatttttcaagtcgtcaagtggatgtttctcattttccatgattttcagttttcttgccatattccatgtcctacagtggaaatttctaaattttccacctttttcagttttccttgccatatttcaggtcctaaagtgtgtatttctcattttctgtgattttcagttttctcgccatattccaggtcctacagttgacatttctaaaatttccacattttttaagttttcctcgccatatttcacttcctaaagtgtgtatttctcattttccgtgattttcagttttctcgccatattccagatcctacagtgtacatttttcatttttcacgtttttcagtgattttgtcattttttagttgtcaactgcctgtttctcattttccatgattttcagttttcttgctatattccatgtcctacagtggaaatttctaaattttccacctttttcagttttcctcgccatatttcacgtcctaaagtgtgtatttctcattttccgtgattttcagttttctcgccatattccaggtcctatgtgtacatttctcatttttcacgtttttcagtgattttgtcatttttcaatttgtcaactgcatgtttctcattttccatgattttcagttttcttgccatattccatgtcctacagtggaaatttctatattttccaactttttcagttttcctcgccatatttcacgtgctaaagtgtgtatttctcatttttcgtgtttttcaggtttctcgccatattccaggtcctacagtgtgcatttctcatttttcacgtttttcagtgattttgtcatttttcaagttgtcaagtggatgtttctcattttccttgattttcagttttcttgccatattccatgtcctacagtggacatttctaaattttccacctttttcagttttccttgccatatttcatgtcctaaagtgtgtatttctcattttcagtgattttcagttttctcgccatattccaggtcctacagtgtgcatttctcattttttcaggtttttcagtgatttcgtcatttttcacgttgtcaagtggatgtttctcattttccatgattttcacttttcttgccatatttcatgtcctaaagtgtgtatttctcattttcagtgattttcagttttctcgctatattccaggtcctacagtgtgcatttctcattttttcacgtttttcagtgatttcgtcatttttcacgttgtcaagtggatgtttctcattttccatgattttcacttttcttgccatatttcatgtcctacaatggacatttctaaattttccacctttttctgttttcctcgccatatttcacatcctaaagtgtgtatttctcattttccgtgattttcagttttcttgccatattccaggtcctacagtgtgcatttctcatttttcacgtttttcagtgatttcgtcatttttcaagttgtcaagtggatgtttctcattttccttgattttcagttttcttgccatattccatgtcctactgtggacatttctaaattttccacctttttcagttttccttgccatatttcatgtcctaaagtgtgtatttctcattttcagtgattttcagttttctcgcaatattccaggtcctacagtgtgcatttctcattttttcaggtttttcagtgatttcgtcatttttcacgttgtcaagtggatgtttctcattttccatgattttcacttttcttgccatatttcatgtcctaaagtgtgtatttctcattttcagtgattttcagttttctgccatattccaggtcctacattgtgcatttctcattttttcacgtttttcagtgatttcgtcatttttcagttttctcgacatattccaggtcctacagtgtgcatttctaattttttcttttttcagtgatttcgtcatttttcaagttgtcaactgcatgtttctcattttccatgattttcagttttcttgccatattccatgtcttacagtggacatttttaaatttttcacatttttttaagttttcctccccatatttcacgttttaaagtgtgcatttctcattttcggtgattttcagttttctcgccagattccaggtcttacagtgtgcatttctcattttttcacgtttttcagtgatttcgtcatttttcaagtcgtcaagtggatgtttctcattttccatgattttcagttttcttgccatattccatgtcctacagtggaaatttctaaattttccacctttttcagttttccttgccatatttcaggtcctaaagtgtgtatttctcattttctgtgattttcagttttctcgccatattccaggtcctacagttgacatttctaaaatttccacattttttaagttttcctcgccatatttcacttcctaaagtgtgtatttctcattttccgtgattttcagttttctcgccatattccagatcctacagtgtgcatttttcatttttcacgtttttcagtgattttgtcattttttagttgtcaactgtctgtttctcattttccatgattttcagttttcttgccatattccatgtcctacactggacatttctaaattttccacctttttctgttttcctcgccatatttcacgtcctaaagtgtgtatttctcattttccgtgattttcagttttcttgccatattccaggtcctacagtgtgcatttctcatttttcacgtttttcagtgattttgtcatttttcaagttgtcaactgcatgtttctcattttctatgattttcagttttcttgctatattccatgtcctacagtggaaatttctaaattttccacctttttcagttttcctcgccatatttcacgtcctaaagtgtgtatttctcattttccgtgattttcagttttctcgccatattccaggtcctatgtgtacatttctcatttttcacgtttttcagtgattttgtcatttttcaagttgtgaagtggatgtttctcatttttcttgattttcatttttcttgccatattccatgtcctagagtggaaatttttaaattttccacctttttcagttttcctcgccatatttcacgtcctaaagtgtgaatttctcattttccgtgattttcagatttctcgccatattccaagtcctacagtgtgcatttctcatttttcacgtttttcagtgatttcgtcatttttcaagttgtcaagtggatgtttctcattttccatgattttcagctttcttgccatattcaaagtcctacagtggacatttctaaattttcgacctttatcagttttcctcgccatatttcatgtcccaaagtgtgtacttctcattttccgtgattttcagtttcctagccatattctaggtcctacagtgtgcatttctcatttttcaggtttttcagtgatttcgtcttttttcaagtcgtcaagtggatgtttctcattttccatgattttcacttttcttgccatatttcatgtcctaaagtgtgtatttctcattttcagtgattttcagttttctcgctatattccaggtcctacagtgtgcatttctcattttttcacgtttttcagtgatttcgtcatttttcacgttgtcaagtggatgtttctcattttccatgattttcacttttcttgccatatttcatgtcctacagtggacatttctaaattttccacctttttctgttttcctcgccatatttcacatcctaaagtgtgtatttctcattttccgtgattttcagttttcttgccatattccaggtcctacagtgtgcatttctcatttttcacgtttttcagtgatttcgtcatttttcaagttgtcaagtggatgtttctcattttccttgattttcagttttcttgccatattccatgtcctactgtggacatttctaaattttccacctttttcagttttccttgccatatttcatgtcctaaagtgtgtatttctcattttcagtgattttcagttttctcgcaatattccaggtcctacagtgtgcatttctcattttttcaggtttttcagtgatttcgtcatttttcacgttgtcaagtggatgtttctcattttccatgattttcacttttcttgccatatttcatgtcctaaagtgtgtatttctcattttcagtgattttcagttttctgccatattccaggtcctacattgtgcatttctcattttttcacgtttttcagtgatttcgtcatttttcacgttgtcaagtggatgtttctcattttccatgattttcacttttcttgccatatttcatgttttacagtggacatttctaaattttccacctttttctgttttcctcgccatatttcacatcctaaagtgtgtatttctcattttccgtgattttcagttttctcgccatatgccaggtcatacagggtgcatttctcatttttcacgtttttcagtgatttcgtcatttttcacgtcgtcaagtggatgtttctcattttcaatgattttcatttttcttgccatattccacgtcctatagtggacatttctaaattttccacctttttcagttttccttgccatatttcaggtcctacagtgtgcatttctcatttttcacgtttttcagtgatttcgtcatttttcaagtggtcaagtgcatgtttctcattttccgtgattttcagttttcttgccatgttccaggtcctacagttgacgtttctaaaatttcactttttttaagttttcctcgccatatttcacttcctaaagtgtgtatttctcattttccgtgattttcagttttctcgccagattccaggtcctacagtgtgcatttttcatatttcacctttttcagtgattttgtcatttttcaagttgtcaactgcatgtttctcattttccatgattttcagttttcttgccatattccatgtcctactgtggacatttctaaattttccaactttttcagttttcctcgccatatttcatgtcctaaagtgtgtatttctcattttcagtgattttctgttttctcgccatattccaggtcctacagtgtgcatttctaatttttcacgtttttcagtgatttcgtcatttttcaagttgtcaagtggatgtttctcattttccatgattttcagttttcttgccatattccatgtcctacagtggacatttctaaattttccaactttttccattttcctcaccatatttcacgtcctaaagtgtgtttttctcattttttgtgattttcagttttctcgacatattccaggtcctacagtgtgcatttctaattttttcttttttcagtgatttcgtcatttttcaagttgtcaactgcatgtttctcattttccatgattttcagttttcttgccatattccatgtcttacagtggacatttttaaatttttcacatttttttaagttttcctccccatatttcacgttttaaagtgtgcatttctcattttcggtgattttcagttttctcgccagattccaggtcttacagtgtgcatttctcattttttcacgtttttcagtgatttcgtcatttttcaagtcgtcaagtggatgtttctcattttccatgattttcagttttcttgccatattccatgtcctacagtggaaatttctaaattttccacctttttcagttttccttgccatatttcaggtcctaaagtgtgtatttctcattttctgtgattttcagttttctcgccatattccaggtcctacagttgacatttctaaaatttccacattttttaagttttcctcgccatatttcacttcctaaagtgtgtatttctcattttccgtgattttcagttttctcgccatattccagatcctacagtgtgcatttttcatttttcacgtttttcagtgattttgtcattttttagttgtcaactgtctgtttctcattttccatgattttcagttttcttgccatattccatgtcctacactggacatttctaaattttccacctttttctgttttcctcgccatatttcacgtcctaaagtgtgtatttctcattttccgtgattttcagttttcttgccatattccaggtcctacagtgtgcatttctcatttttcacgtttttcagtgattttgtcatttttcaagttgtcaactgcatgtttctcattttccatgattttcagttttcttgctatattccatgtcctacagtggaaatttctaaattttccacctttttcagttttcctcgccatatttcacgtcctaaagtgtgtatttctcattttccgtgattttcagttttctcgccatattccaggtcctatgtgtacatttctcatttttcacgtttttcagtgattttgtcatttttcaagttgtgaagtggatgtttctcatttttcttgattttcatttttcttgccatattccatgtcctagagtggaaatttttaaattttccacctttttcagttttcctcgccatatttcacgtcctaaagtgtgaatttctcattttccgtgattttcagatttctcgccatattccaagtcctacagtgtgcatttctcatttttcacgtttttcagtgatttcgtcatttttcaagttgtcaagtggatgtttctcattttccatgattttcagctttcttgccatattcaaagtcctacagtggacatttctaaattttcgacctttatcagttttcctcgccatatttcatgtcccaaagtgtgtacttctcattttccgtgattttcagtttcctcgccatattctaggtcctacagtgtgcatttctcatttttcaggtttttcagtgatttcgtcttttttcaagtcgtcaagtggatgtttctcattttccatgattttcagttttcttgccatattccatgtcctacagtggacatttctaaattttccacctttttcagttttcctcgccatatttcatgtcctaaagtgtgtatttctcattttcagtgattttcagttttctcgccatattccaggtcctacagtgtgcatttctcatttttcacgtttttcagtgatttcgtcatttttcaagttgtcaagtggatgtttctcattttccatgattttcagttttcttgccatattccatgtcccacagtggacatttctaaattttccacctttttctgttttccttgccatatttcatgtcctaaagtgtgtatttctcattttccgtgattttcagttttcttgctatattccaagtcctacagtgtgcatttctcatttttcacgtttttcagtgattttgtcatttttcaatttgtcaactgcatgtttctcattttccatgattttcagttttcttgccatattccatgtcctacagtggaaatttctatattttccaactttttcagttttcctcgccatatttcacgtgctaaagtgtgtatttctcatttttcgtgtttttcaggtttctcgccatattccaggtcctacagtgtgcatttctcatttttcacgtttttcagtgattttgtcatttttcaagttgtcaagtggatgtttctcattttccttgattttcagttttcttgccatattccatgtcctacagtggacatttctaaattttccacctttttcagttttccttgccatatttcatgtcctaaagtgtgtatttctcattttcagtgattttcagttttctcgccatattccaggtcctacagtgtgcatttctcattttttcaggtttttcagtgatttcgtcatttttcacgttgtcaagtggatgtttctcattttccatgattttcacttttcttgccatatttcatgtcctaaagtgtgtatttctcattttcagtgattttcagttttctcgctatattccaggtcctacagtgtgcatttctcattttttcacgtttttcagtgatttcgtcatttttcacgttgtcaagtggatgtttctcattttccatgattttcacttttcttgccatatttcatgtcctacagtggacatttctaaattttccacctttttctgttttcctcgccatatttcacatactaaagtgtgtatttctcattttccttgattttcagttttcttgccatattccaggtcctacagtgtgcatttctcatttttcacgtttttcagtgatttcgtcatttttcaagtcgtcaagtggatgtttctcattttccatgattttcagttttctcgccatattccaggtcctacagttgacatttctaaattttccacattttttaagtttcctcgcgatatttcacatcctaaagtgtgtatttctcattttccgtgattttcagttttcttgccatattccaggtcctacagggtgcatttctcatttttcacgtttttcagtgatttcatcaatttcaagtcgtcaactgtatgtttctcattttcaatgattttcatttttcttgccatattccatgtcctacagtggacatttctaaatttttcacctttttcagttttccttgccatatttcatgtcctaaagtgtgtatttctcattttcagtgattttcagttttctcgccatattccaggtcctacagtgtgcatttctcattttttcaggtttttcagtgatttcgtcatttttcacgttgtcaagtggatgtttctcattttccatgattttcacttttcttgccatatttcatgtcctaaagtgtgtatttctcattttcagtgattttcagttttctcgccatattccaggtcctacagtgtgcatttctcatttttcacgtttttcagtgatttcgtcatttttcaagttgtcaagtggatgtttctcattttccatgattttcacttttcttgccatattccatgtcccacagtggacatttctaaattttccacctttttctgttttcctcgccatatttcatgtcctaaagtgtgtatttctcattttccgtgattttcagttttcttgctatattccaagtcctacagtgtgcatttctcatttttcacgtttttcagtgattttgtcatttttcaatttgtcaactgcatgtttctcattttccatgattttcagttttcttgccatattccatgttctacagtggaaatttctatattttccaactttttcagttttcctcgccatatttcacgtgctaaagtgtgtatttctcatttttcgtgtttttcaggtttctcgccatattccaggtcctacagtgtgcatttctcatttttcacgtttttcagtgattttgtcatttttcaagttgtcaagtggatgtttctcattttccttgattttcagttttcttgccatattccatgtcctacagtggacatttctaaattttccacctttttcagttttccttgccatatttcatgtcctaaagtgtgtatttctcattttcagtgattttcagttttctcgccatattccaggtcctacagtgtgcatttctcattttttcaggtttttcagtgatttcgtcatttttcacgttgtcaagtggatgtttctcattttccatgattttcacttttcttgccatatttcatgtcctaaagtgtgtatttctcattttcagtgattttcagttttctcgctatattccaggtcctacagtgtgcatttctcattttttcacgttttgcagtgatttcgtcatttttcacgttgtcaagtggatgtttctcattttccatgattttcacttttcttgccatatttcatgtcctacagtggacatttctaaattttccacctttttctgttttcctcgccatatttcacatcctaaagtgtgtatttctcattttccgtgattttcagttttcttgccatattccaggtcctacagtgtgcatttctcatttttcacgtttttcagtgatttcgtcatttttcaagtcgtcaagtggatgtttctcattttccatgattttcagttttctcgccatattccaggtcctacagttgacatttctaaattttccacattttttaagtttcctcgcgatatttcacatcctaaagtgtgtatttctcattttccgtgattttcagttttcttgccatattccaggtcctacagggtgcatttctcatttttcacgtttttcagtgatttcatcaatttcaagtcgtcaactgtatgtttctcattttcaatgattttcatttttcttgccatattccatgtcctacagtggacatttctaaattttccacctttttcagttttccttgccatatttcatgtcctaaagtgtgtatttctcattttcagggattttcagttttctcgccatattccaggtcctacagtgtgcatttctcattttttcaggtttttcagtgatttcgtcatttttcacgttgtcaagtggatgtttctcattttccatgattttcacttttcttgccatatttcatgtcctaaagtgtgtatttctcattttcagtgattttcagttttctcgccatattccaggtcctacagtgtgcatttctcattttttcacgtttttcagtgatttcgtcatttttcacgttgtcaagtggatgtttctcattttccatgattttcacttttcttgccatatttcatgtcctacagtggacatttctaaattttccacctttttctgttttcctcgccatatttcacatcctaaagtgtgtatttctcattttccgtgattttcagttttcttgccatattccaggtcctacagtgtgcatttctcatttttcacgtttttcagtgatttcgtcatttttcaagtcgtcaagtggatgtttctcattttccatgattttcagttttctcgccatattccaggtcctacagttgacatttctaaattttccacattttttaagtttcctcgcgatatttcacatcctaaagtgtgtatttctcattttccgtgattttcagttttcttgccatattccaggtcctacagggtgcatttctcatttttcacgtttttcagtgatttcatcaatttcaagtcgtcaactgtatgtttctcattttcaatgattttcatttttcttgccatattccacgtcctatagtggacatttctaaattttccacctttttcagttttcttcgccatatttcacgtcccaaagtgtgtatttctcattttccgtgattttcagtttcctcgcaatattccaggtcctacagtgtgcatttctcatttttcacgtttttcagtgatttcgtcttttttcaagtcgtcaagtggatgtttctcattttccatgattttcagttttcttgccatattccatgtcctacagtggacatttctaaattttccacctttttctgttttcctcgccatatttcacgtcctaaagtgtgtatttctcattttccgtgattttcagttttcttgccatattccaggtcctacagtgtgcatttctcatttttcacgtttttcactgattttgtcattgttcaagttgtcaactgcatgtttctcattttccatgattttcaattttcttgccatattccatgtcctacagtggaaatttctatattttccaactttttcagttttcctcgccatatttcacgtgctaaagtgtgtatttctcatttttcgtgtttttcaggtttctcgccatattccaggtcctacagtgtgcatttctcatttttcacgtttttcagtgattttgtcatttttcaagttgtcaagtggttgtttctcattttccttgattttcagttttcttgccatattccatgtcctactgtggacatttctaaattttccacctttttcagttttccttgccatatttcatgtcctaaagtgtgtatttctcattttcagtgattttcagttttctcgcaatattccaggtcctacagtgtgcatttctcattttccgtgattttcagttttctcgccatatgccaggtcatacagggtgcatttctcatttttcacgtttttcagtgatttcgtcatttttcacgtcgtcaagtggatgtttctcattttcaatgattttcatttttcttgccatattccacgtcctatagtggacatttctaaattttccaactttttcagttttcttgccatatttcaggtcctacagtgtgcatttctcatttttcacgtttttcagtgatttcgtcatttttcaagtggtcaagtgcatgtttctgattttccgtgattttcagttttcttgccatgttccaggtcctacagttgacgtttctaaaatttcactttttttaagttttcctcgccatatttcacttcctaaagtgtgtatttctcattttccgtgattttcagttttctcgccagattccaggtcctacagtgtgcatttttcatatttcacctttttcagtgattttgtcatttttcaagttgtcaactgcatgtttctcattttccatgattttcagttttcttgccatattccatgtcctactgtggacatttctaaattttccaactttttcagttttcctcgccatatttcatgtcctaaagtgtgtatttctcattttcagtgtttttctgttttctcgccatattccaggtcctacagtgtgcatttctaatttttcacgtttttcagtgatttcgtcatttttcaagttgtcaagtggatgtttctcattttccatgattttcagttttcttgccatattccatgtcctacagtggacatttctaaattttccaactttttccattttcctcaccatatttcacgtcctaaagtgtgtttttctcattttttgtgattttcagttttctcgacatattccaggtcctacagtgtgcatttctaattttttcttttttcagtgatttcgtcatttttcaagtggtcaagtgcatgtttctcattttccatgattttcagttttcttgccatattccatgtcctacaatggacatttctaaattttccaactttttcagttttcctcgccatatttcacgtcctaaagtgtgtatttctcattttccgtgattttcagttttctcgccatattccaggtcctatgtgtacatttctcatttttcacgtttttcagtgattttgtcatttttcaagttgtgaagtggatgtttctcatttttcttgattttcatttttcttgccatattccatgtcctagagtggaaatttttaaattttccaactttttcagttttcctcgccatatttcacgtcctaaagtgtgtatttctcattttccgtgattttcagttttctcgccatattccaagtcctacagtgtgcatttctcatttttcacgtttttcagtgatttcgtcatttttcaagttgtcaagtggatgtttctcattttccatgattttcagctttcttgccatattcaaagtcctacagtggacatttctaaattttcgacctttatcagttttcctcgccatatttcatgtcccaaagtgtgtacttctcattttccgtgattttcagtttcctcgccatattctaggtcctacagtgtgcatttctcatttttcaggtttttcagtgatttcgtcttttttcaagtcgtcaagtggatgtttctcattttccatgattttcagttttcttgccatattccatgtcctacagtggacatttctaaattttccacctttttcagttttcctcgccatatttcatgtcctaaagtgtgtatttctcattttcagtgattttcagttttctcgccatattccaggtcctacagtgtgcatttctcatttttcacgtttttcagtgatttcgtcatttttcaagttgtcaagtggatgtttctcattttccatgattttcagttttcttgccatattccatgtcccacagtggacatttctaaattttccacctttttctgttttccttgccatatttcatgtcctaaagtgtgtatttctcattttccgtgattttcagttttcttgctatattccaagtcctacagtgtgcatttctcatttttcacgtttttaagtgattttgtcatttttcaatttgtcaactgcatgtttctcattttccatgattttcagttttcttgccatattccatgtcctacagtggaaatttctatattttccaactttttcagttttcctcgccatatttcacgtgctaaagtgtgtatttctcatttttcgtgtttttcaggtttctcgccatattccaggtcctacagtgtgcatttctcatttttcacgtttttcagtgattttgtcatttttcaagttgtcaagtggatgtttctcattttccttgattttcagttttcttgccatattccatgtcctacagtggacatttctaaattttccacctttttcagttttccttgccatatttcatgtcctaaagtgtgtatttctcattttcagtgattttcagttttctcgccatattccaggtcctacagtgtgcatttctcattttttcaggtttttcagtgatttcgtcatttttcacgttgtcaagtggatgtttctcattttccatgattttcacttttcttgccatatttcatgtcctaaagtgtgtatttctcattttcagtgattttcagttttctcgccatattccaggtcctacagtgtgcatttctcattttttcacgtttttcagtgatttcgtcatttttcacgttgtcaagtggatgtttctcattttccatgattttcacttttcttgccatatttcatgtcctacagtggacatttctaaattttccacctttttctgttttcctcgccatatttcacatcctaaagtgtgtatttctcattttccgtgattttcagttttcttgccatatttcaggtcctacagtgtgcatttctcatttttcacgtttttcagtgatttcgtcatttttcaagtcgtcaagaggatgtttctcattttccatgattttcagttttctcgccatattccaggtcctacagttgacatttctaaattttccacattttttaagtttcctcgcgatatttcacatcctaaagtgtgtatttctcattttccgtgattttcagttttcttgccatattccaggtcctacagggtgcatttctcatttttcacgtttttcagtgatttcatcaatttcaagtcgtcaactgtatgtttctcattttcaatgattttcatttttcttgccatattccacgtcctatagtggacatttctaaattttccacctttttctgttttcctcgccatatttcacgtcctaaagtgtgtatttctcattttccgtgattttcagttttcttgccatattccaggtcctacagtgtgcatttctcatttttcacgtttttcactgattttgtcattgttcaagttgtcaactgcatgtttctcattttccatgattttcagttttcttgccatattccatgtcctacagtggaaatttctatattttccacctttttcagttttcctcgccgtatttcatgtgctaaagtgtgtatttctcatttttcgtgtttttcaggtttctcgccatattccaggtcctacagtgtgcatttctcatttttcacgtttttcagtgattttgtcatttttcaagttgtcaactggatgtttctcattttccttgattttcagttttcttgccatattccatgtcctactgtggacatttctaaattttccacctttttcagttttccttgccatatttcatgtcctaaagtgtgtatttctcattttcagtgattttcagttttctcgcaatattccaggtcctacagtgtgcatttctcattttttcaggtttttcagtgatttcgtcatttttcacgttgtcaagtggatgtttctcattttccatgattttcacttttcttgccatatttcatgtcctaaagtgtgtatttctcattttcagtgattttcagttttctcgccatattccaggtcctacattgtgcatttctcattttttcacgtttttcagtgatttcgtcatttttcacgttgtcaagtggatgtttctcattttccatgattttcacttttcttgccatatttcatgttttacagtggacatttctaaattttccacctttttctgttttcctcgccatatttcacatcctaaagtgtgaatttctcattttccgtgattttcagttttcttgccatattccaggtcctacagtgtgcatttctcatttttcacgtttttcagtgatttcatcatttttcaagtcgtcaagtggatgtttctcattttccatgattttcagttttcttgccatattccatgtcctacagtggacatttctaaattttccacctttttctgttttcctcgccatatttcacgtcctaaagtgtgtatttctcattttccgtgattttcagttttcttgccatattccaggtcctacagtgtgcatttctcatttttcacgtttttcactgattttgtcatttttcaagttgtcaactgcatgtttctcattttccatgattttcagttttcttgctatattccatgtcctacagtggaaatttctaaattttccacctttttcagttttcctcgccatatttcacgtcctgaagtgtgtatttctcattttccgtgattttcagttttctcgccatattccaggtcctatgtgtacatttctcatttttcacgtttttcagtgattttgtcatttttcaagttgtgaagtggatgtttctcatttttcttgattttcatttttcttgccatattccatgtcctacagtggaaatttctaaattttccacctttttcagttttcctcgccatatttcacgtcctaaagtgtgtatttctcattttccgtgattttcagttttctcgccatattccaggtcctacagtgtgcatttctcatttttcacgtttttcagtgatttcgacatttttcaagttgtcaagtggatgtttctcattttccatgattttcagctttcttgccatattcaaagtcctacagtggacatttctaaattttcgacctttatcagttttcctcgccatatttcatgtcccaaagtgtgtacttctcattttccgtgattttcagtttcctcgccatattccaggtcctacagtgtgcatttctcatttttcacgtttttcagtgatttcgtcatttttcaagtcgtcaagtggatgtttctcattttccatgattttcagttttcttgccatattccatgtcctacagtggacatttctaaattttccacctttttctgttttcctcgccatatttcacgtcctaaagtgtgtatttctcattttccgtgattttcagttttcttgccatattccaggtcctacagtgtgcatttctcatttatcacgtttttcactgattttgtcatttttcaagttgtcaactgcatgtttctcattttccatgattttcagttttcttgctatattccatgtcctacagtggaatattctaaattttccacctttttcagttttcctcgccatatttcacgtcctgaagtgtgtatttctcattttccgtgattttcagttttctcgccatattccaggtcctatgtgtacatttctcatttttcacgtttttcagtgattttgtcatttttcaagttgtgaagtggatgtttctcatttttcttgattttcatttttcttgccatattccatgtcctacagtggaaatttctaaattttccacctttttcagttttcctcgccatatttcacgtcctaaagtgtgaatttctcattttccgtgattttcagttttctcgccatattccaggtcctacagtgtgcatttctcatttttcacgtttttcagtgatttcgacatttttcaagttgtcaagtggatgtttctcattttccatgattttcagctttcttgccatattcaaagtcctacagtggacatttctaaattttcgacctttatcagttttcctcgccatatttcatgtcccaaagtgtgtacttctcattttccgtgattttgagtttcctcgccatattccaggtcctacagtgtgcatttctcatttttcacgtttttcagtgatttcgtcttttttcaagttgtcaactgcatgtttctcattttccatgattttcagttttcttgccatattccatgtcctacagtggaaatttgtaaatttccacctttttcagttttcctcgccatatttcacgtcctaaagtatgtatttctcattttccgtgattttcagttttctcgccatattccaggtcctacagtgtgcatttctcatttttcacgtttttcagtgattttgtcattttttaagttttcaagtggatgtttctcattttccttgattttcagttttcttgccatattccatgtcctacagtggacatttctaaattttccacctttttcagttttcctcgccatatttcatgtcctaaagtgtgtatttctcattttcagtgattttcagttttctcgccatattccaggtcctacagtgtgcatttctcatttttcacgtttttcagtgatttcgtcatttttcaaggtgtcaagtggatgtttctcattttccatgattttcagttttcttgccatattccatgtcctacagtggacatttctaaattttccacctttttctgttttcctcgccatatttcatgtcctaaagtgtgtatttctcattttccgtgattttcagttttcttgctatattccaagtcctacagtgtgcatttctcatttttcacgtttttcagtgattttgtcatttttcaatttgtcaactgcatgtttctcattttccatgattttcagtttttttgccatattccatgtcctactgtggaaatttctatattttccacctttttcagttttcctcgccatatttcacgtgctaaagtgtgtatttctcatttttcgtgtttttcaggtttctcgccatattccaggtcctacagtgtgcatttctcatttttcacgtttttcagtgattttgtcatttttcaagttttcaagtggatgtttctcattttccttgattttcagttttcttgccatattccatgtcctacagtggacatttctaaattttccacctttttcagttttccttgccatatttcatgtcctaaagtgtgtatttctcattttcagtgattttcagtttccttgccatattccaggtcctacagtgtgcatttctcattttttcacgtttttcagtgatttcgtcatttttcacgttgtcaagtggatgtttctcattttccatgattttcacttttcttgccatatttcatgtcctacagtggacatttctaaattttccaactttttcaattttcctcgccatattttatgtcctaaagtgtgtatttctcatttttcgttattttcagttttcttgccatattccaggtcctacagtgtgcatttgtcatttttcacgtttttcagtgatttcgtcatttttcaagtcgtcaagtagatgtttctcatattccatgtttttcagttttctcgccatattccaggtcctacagttgacatttctaaattttctacatttttaaattttcctcgccatatttcacgtcctaaagtgtgtatttctcattttttgttattttcagttttctagccatattccaggtcctacaggatgcatttctcatttttcacgtttttcagtgatttcatcatttttcaagtcgtcaagtgtatgtttcttattttcaatgattttcatttttcttgccttattccacgtcctatagtggacatttctaaattttccacctttttcagtttttttcgccatatttcacgtcctaaagtgtgtatttctcattttctgtgattttcagttttctcaccatattccaggtcctacagtgtgcatttctcatttttcacgtttttcagtgatttcgtcatttttcaagttgtcaagtggaagtttctcattttccatgattttcagctttctagacatattccaggtcctacagtggacatttcctaattttcgacctttatcagttttcctcgtcatatttcacgtcccaaaatgtgtatttcttattttccatgattttcagtttcctcgccatattccaggtcctacagtgtgcaattctcatttttcacgtttttcagtgatttcgtcttttttcaagacgtcaagtggatgtttctcatttttcatgattttcagttttcttgccatattccatgtcctacagtggacatttctaaattttccacctttttctgttttcctcgccatatttcacgtcctaaagtgtgtatttctcattttccgtgattttcagttttcttgccatattcctggtcctacagtgtgcatttctcatttttcacgtttttcagtgattttgtcatttttcaatttgtcaactgcatgtttctcattttccattattttcagttttcttgccatattccatgtcctacagtggacatttctaaattttccacctttttctgttttcctcgccatatttcatgtcctaaagtgtgtatttctcattttccgtgattttcagttttcttgctatattccaagtcctacagtgtgcatttctcatttttcacgtttttcagtgattttgtcatttttcaatttgtcaactgcatgtttctcattttccatgattttcagtttttttgccatattccatgtcctacaggggaaatttctatattttccacctttttcagttttcctcgccatatttcatgtcctaaagtgtgtatttctcattttccgtgattttcagttttcttgccatattccaggtcctacagtgtgcatttctcatttttcacgtttttcagtgatttcgtcatttttcaagtcttcaagtagatgtttctcatattccatgtttttcagttttctcgccatattccaggtcctacagttgacatttctaaattttctacatttttaaattttcctcgccatatttcacgtcctaaagtgtgtatttctcatttttcgttattttcagttttctagccatattccaggtcctacaggatgcatttctcatttttcacgtttttcagtgatttcatcatttttcaagtcgtcaagtgtatgtttctcattttcaatgattttcatttttcttgccttattccacgtcctatagtggacatttctaaattttccacctttttcagtttttctcgccatatttcacgtcctaaagtgtgtatttctcattttctgtgattttcagttttctcaccatattccaggtcctacagtgtgcatttctcatttttcacgtttttcagtgatttcgtcatttttcaagttgtcaagtggaagtttctcattttccatgattttcagctttctagccatattccaggtcctacagtggacatttcctaattttcgacctttatcagttttcctcgccatatttcacgtcctaaagtgtgtatttctcattttccgtgattttcagttttcttgccatattccaggtcctacagtgtgcatttctcatttttcacgtttttcagtgattttgtcatttttcaatttgtcaactgcatgtttctcattttccatgatttttagttttcttgctatattccatgtcctacagtggaaatttctaaattttccacctttttcagttttcctcgccatatttcacgtcctaaagtgtgtatttctcattttccgtgattttcagttttcttgctatattccaagtcctacattgtgcatttctcatttttcacgtttttcagtgattttgtcatttttcaatttgtcaaaccacatgtttctcattttccatgattttcagtttttttgccatattccatgtcctacagtggaaatttctatattttccacctttttcagttttcctcgccatatttcacgtgctaaagtgtgtatttctcatttttcgtgtttttcaggtttctcgccatattccaggtcctacagtgtgcatttctcatttttcacgtttttcagtgattttgtcatttttcaagttgtcaagtggatgtttcccattttccttgattttcagttttcttaccatattccatgtcctacagtggacatttctaaattttccacctttttcagttttccttgccatatttcatgtcctaaagtgtgtatttctcattttcagtgattttcagtttcctcgccatattccaggtcctacagtgtgcatttctcattttttcacgtttttcagtgatttcgtcatttttcacgttgtcaagtggatgtttctcattttccatgattttcacttttcttgccatatttcatgtcctatagtggacatttctaaattttccacctttttcagtttttctcgccatatttcacgtcctaaagtgtgtatttctcattttctgtgattttcagttttctcaccatattccaggtcctacagtgtgcatttctcatttttcacgtttttcagtgatttcgtcatttttcaagtcgtcaagtagatgtttctcatattccatgtttttcagttttctcgccatattccaggtcctacagttgacatttctaaattttctacatttttaaattttcctcgccatatttcacgtcctaaagtgtgtatttctcatttttcgttattttcagttttctagccatattccaggtcctacaggatgcatttctcatttttcacgtttttcagtgatttcatcatttttcaagtcgtcaagtgtatgtttcttattttcaatgattttcatttttcttgccttattccacgtcctatagtggacatttctaaattttccaccttttttcagtttttctcgccatatttcacgtcctaaagtgtgtatttctcattttctgtgattatcagttttctcaccatattccaggtcctacagtgtgcatttctcatttttcacgtttttcagtgatttcgtcatttttcaagttgtcaagtggaagtttctcattttccatgattttcagctttctagccatattccaggtcctacagtggacatttcctaattttcgacctttatcagttttcctcgccatatttcacgtcccaaaatgtgtatttcttattttccatgattttcagtttcctcgccatattccaggtcctacagtgtgcatttctcatttttcacgtttttcagtgatttcgtcttttttcaagacgtcaagtggatgtttctcatttttcatgattttcagttttcttgccatattccatgtcctacagtggacatttctaaattttccacctttttctgttttcctcgccatatttcacgtcctaaagtgtgtatttctcattttccgtgattttcagttttcttgccatattcctggtcctacagtgtgcatttctcatttttcacgtttttcagtgattttgtcatttttcaatttgtcaactgcatgtttctcattttccatgattttcagttttcttgccatattccatgtcctacagtggacatttctaaattttccacctttttcagttttcctcgccatatttcacgtgctaaagtgtgtatttctcatttttcgtgtttttcaggtttctcgccatattccaggtcctacagtgtgcatttctcatttttcacgtttttcagtgattttgtcatttttcaagttgtcaagtggatgtttctcattttccttgattttcacttttcttgccatattccaagtcttacaggggcatttctcatttttcacgttttcagtgattttgtcattttcaatttgtcaactgcatgtttctcattttccatgattttcagtttttttgccatattccatgtcctacaggggaaatttctatattttccacctttttcagttttcctcgccatatttcatgtcctaaagtgtgtatttctcattttccgtgattttcagttttcttgccatattccaggtcctacagtgtgcatttctcatttttcacgtttttcagtgatttcgtcatttttcaagtcttcaagtagatgtttctcatattccatgtttttcagttttctcgccatattccaggtcctacagttgacatttctaaattttctacatttttaaattttcctcgccatatttcacgtcctaaagtgtgtatttctcatttttcgttattttcagttttctagccatattccaggtcctacaggatgcatttctcatttttcacgtttttcagtgatttcatcatttttcaagtcgtcaagtgtatgtttctcattttcaatgattttcatttttcttgccttattccacgtcctatagtggacatttctaaattttccacctttttcagtttttctcgccatatttcacgtcctaaagtgtgtatttctcattttctgtgattttcagttttctcaccatattccaggtcctacagtgtgcatttctcatttttcacgtttttcagtgatttcgtcatttttcaagttgtcaagtggaagtttctcattttccatgattttcagctttctagccatattccaagtcctacagtggacatttcctaattttcgacctttatcagttttcctcgccatatttcacgtcccaaaatgtgtattccttattttccatgattttcagtttcctcgccatattccaggtcctacagtgtgcatttatcatttttcacgtttttcagtgatttcgtcttttttcaagacgtcaagtggatgtttctcatttttcatgattttcagttttcttgccatattccatgtcctacagtggacatttctaaattttccacctttttctgttttcctcgccatatttcacgtcctaaagtgtgtatttctcattttccgtgattttcagttttcttgccatattcctggtcctacagtgtgcatttctcatttttcacgtttttcagtgattttgtcatttttcaagttgtcaagtggatgtttctcattttccttgattttcacttttcttgccatattccatgtcctacagtggacatttctatattttccacctttttccgttttccttgccatatttcacgtcctaaagtgtgtatttctcattttccgtgattttcaggtttctcgccatattccaggtcctacagtgtgcatttctcatttttcacgtttttcagtgattttgtcatttttcaagttgtcaagtggatgtttctcattttccttgattttcacttttcttgccatattccatgtcctacagtggacatttctaaattttccacctttttcagttttcctcgccatatttcatgtcctaaagtgtgtatttctcattttcagtgattttcagttttcttgccatattccaggtcctacagtgtgcatttctcatttttcacgtttttcagtgattttgtcatttttcaagttgtcaactgcatgtttctcattttctatgattttcagttttcttgctatattccatgtcctacagtggaaatttctaaattttccacctttttcagttttcctcgccatatttcacgtcctaaagtgtgtatttctcattttccgtgattttcagttttctcgccatattccaggtcctatgtgtacatttctcatttttcacgtttttcagtgattttgtcatttttcaagttgtgaagtggatgtttctcatttttcttgattttcatttttcttgccatattccatgtcctagagtggaaatttttaaattttccacctttttcagttttcctcgccatatttcacgtcctaaagtgtgaatttctcattttccgtgattttcagatttctcgccatattccaagtcctacagtgtgcatttctcatttttcacgtttttcagtgatttcgtcatttttcaagttgtcaagtggatgtttctcattttccatgattttcagctttcttgccatattcaaagtcctacagtggacatttctaaattttcgacctttatcagttttcctcgccatatttcatgtcccaaagtgtgtacttctcattttccgtgattttcagtttcctcgccatattctaggtcctacagtgtgcatttctcatttttcaggtttttcagtgatttcgtcttttttcaagtcgtcaagtggatgtttctcattttccatgattttcacttttcttgccatatttcatgtcctaaagtgtgtatttctcattttcagtgattttcagttttctcgctatattccaggtcctacagtgtgcatttctcattttttcacgtttttcagtgatttcgtcatttttcacgttgtcaagtggatgtttctcattttccatgattttcacttttcttgccatatttcatgtcctacagtggacatttctaaattttccacctttttctgttttcctcgccatatttcacatcctaaagtgtgtatttctcattttccgtgattttcagttttcttgccatattccaggtcctacagtgtgcatttctcatttttcacgtttttcagtgatttcgtcatttttcaagttgtcaagtggatgtttctcattttccttgattttcagttttcttgccatattccatgtcctactgtggacatttctaaattttccacctttttcagttttccttgccatatttcatgtcctaaagtgtgtatttctcattttcagtgattttcagttttctcgcaatattccaggtcctacagtgtgcatttctcattttttcaggtttttcagtgatttcgtcatttttcacgttgtcaagtggatgtttctcattttccatgattttcacttttcttgccatatttcatgtcctaaagtgtgtatttctcattttcagtgattttcagttttcctcgccatatttcacgtcccaaaatgtgtatttcttattttccatgattttcagtttcctcgccatattccaggtcctacagtgtgcatttctcatttttcacgtttttcagtgatttcgtcttttttcaagacgtcaagtggatgtttctcatttttcatgattttcagttttcttgccatattccatgtcctacagtggacatttctaaattttccacctttttctgttttcctcgccatatttcacgtcctaaagtgtgtatttctcattttccgtgattttcagttttcttgccatattcctggtcctacagtgtgcatttctcatttttcacgtttttcagtgattttgtcatttttcaatttgtcaactgcatgtttctcattttccatgattttcagttttcttgccatattccatgtcctacagtggacatttctaaattttccacctttttcagttttcctcgccatatttcacgtgctaaagtgtgtatttctcatttttcgtgtttttcaggtttctcgccatattccaggtcctacagtgtgcatttctcatttttcacgtttttcagtgattttgtcatttttcaagttgtcaagtggatgtttctcattttccttgattttcacttttcttgccatattccatgtcctacagtggacatttctaaattttccacctttttcagttttcctcgccatatttcatgtcctaaagtgtgtatttctcattttcagtgattttcagttttctcgccatattccaggtcctacagtgtgcatttctcatttttcacgtttttcagtgatttcgtcttttttcaagacgtcaagtggatgtttctcattttccatgattttcagttttcttgccatattccatgtcctacagtggacatttctaaattttccacctttttctgttttcctcgccatatttcacgtcctaaagtgtgtatttctcattttccgtgattttcagttttcttgccatattccaggtcctacagtgtgcatttctcatttttcacgtttttcagtgattttgtcatttttcaatttgtcaactgcatgtttctcattttccatgatttttagttttcttgctatattccatgtcctacagtggaaatttctaaattttccacctttttcagttttcctcgccatatttcacgtcctaaagtgtgtatttctcattttccgtgattttcagttttcttgctatattccaagtcctacattgtgcatttctcatttttcacgtttttcagtgattttgtcatttttcaatttgtcaaaccacatgtttctcattttccatgattttcagtttttttgccatattccatgtcctacagtggaaatttctatattttccacctttttcagttttcctcgccatatttcacgtgctaaagtgtgtatttctcatttttcgtgtttttcaggtttctcgccatattccaggtcctacagtgtgcatttctcatttttcacgtttttctgtgattttgtcatttttcaagttgtcaagtggatgtttctcattttccttgattttcagttttcttaccatattccatgtcctacagtggacatttctaaattttccaccttttctgttttcctcgccatatttcatgtcctaaagtgtgtatttctcattttccgtgattttcatttttcttgctatattccaagtcctacagtgtgcatttctcattttccatgattttcagttttcttgctatattccatgtcctacagtggaaatttctaaattttccacctttttcagttttcctcgccatatttcacgtcctaaagtgtgtatttctcattttccgtgattttcagttttttcgccatattacaggtcctatgtgtacatttctcatttttcacgtttttcagtgattttgtcatttttcaagttgtcaagtggatgtttctcatttttcttgattttcatttttcttgccatattccatgtcctacagtggaaatttctaaattttccacctttttcagttttcctcgccatatttcacgtcctaaagtgtgaatttctcattttccgtgattttcagttttctcgccatattccaggtctacagtgtgcatttctcatttttcacgttttcagtgattcgtcatttttcaagttgacaagtggatgtttctcattttccatgattttcagctttcttgccatattcaaagtcctacagtggacatttctaaattttcgacctttatcagttttcctcgccatatttcatgtcccaaagtgtgtacttctcattttccgtgattttcagttttcttgccatattccaagtcctacagtgtgcatttctcatttttcacgtttttcagtgattttgtcatttttcaatttgtcaactgcatgtttctcattttccatgattttcagttttcttgccatattccatgtcctacagtggaaatttctatattttccacctttttcagttttcctcgccatatttcacgtgctaaagtgtgtatttctcatttttcgtgtttttcaggtttctcgccatattccaggtcctacagtgtgcatttctcatttttcacgtttttcagtgattttgtcatttttcaagttgtcaagtggatgtttctcattttcaatgattttcatttttcttgccttattccacgtcctatagtggacatttctaaattttccacctttttcagtttttctcgccatatttcacgtcccaaaatgtgtattccttattttccatgattttcagtttcctcgccatattccaggtcctacagtgtgcatttctcatttttcacgtttttcagtgatttcgtcttttttcaagacgtcaagtggatgtttctcatttttcatgattttcagttttcttgccatattccctgtcctacagtggacatttctaaattttccacctttttctgttttcctcgccatatttcacgtcctaaagtgtgtatttctcattttccgtgattttcagttttctcgccagattccaggtcctacagtgtgcatttctcatttttcacgtttttcagtgattttgtcatttttcaatttgtcaactgcatgtttctctctttccatgattttcagttttcttgccatattccatgtcctacagtggacatttctaaattttccacctttttcagttttcctcgccatatttcacgtgctaaagtgtgtatttctcatttttcgtgtttttcaggtttctcgccatattccaggtcctacagtgtgcatttctcatttttcacgtttttcagtgattttgtcatttttcaagttgtcaagtggatgtttctcattttcaatgattttcatttttcttaccttattccacgtcctatagtggacatttctaaattttccacctttttcagtttttctcgccatatttcacgtcccaaaatgtgtattccttattttccatgattttcagtttcctcgccatattccaggtcctacagtgtgcatttctcatttttcacgtttttcagtgatttcgtcttttttcaagacgtcaagtggatgtttctcatttttcatgattttcagttttcttgccatattccctgtcctacagtggacatttctaaattttccacctttttctgttttcctcgccatatttcacgtcctaaagtgtgtatttctcattttccgtgattttcagttttctcgccagattccaggtcctacagtgtgcatttctcatttttcacgtttttcagtgatttcgtcatttttcaagtcttcaagtgtatgtttctcattttcaatgattttcatttttcttgccttattccacgtcctatagtggacatttctaaattttccacctttttcagtttttctcgccatatttcacgtcctaaagtgtgtatttctcattttctgtgattttcagttttcttaccatattccaggtcctacagtgtgcatttctcatttttcacgtttttcagtgatttcgtcatttttcaagttgtcaagtggaagtttctcattttccatgattttcagctttctagccatattccaggtattacagtggacatttccttattttcgacctttatcagttttcctcgccatatttcatgtcctaaagtgtgt	38399	1554	4%	7300	19%
9	3000001	3038400	Atcctacagtgtgcatttctcatttttcacgtttttcagtgatttcgtcatttttcaagtcatcaagtggctgtttctcattttccatgattttcagttttcttgccatattccttgtcctacagtggacatttctaaattttccacctttttcagttttccttgtcatatttcaggtcctacagtgtgtatttctcatttttcacgtttttcattgatttcgtcatttttcaagttgtcaagtgcatgtttctcattttccatgattttcagttttcttgccatattccatgtcctacaatggacatttctaaattttccaactttttcagttttcctcgccatatttcacgtcctaaagtgtgtatttctcattttccgtgattttcagttttctcgacatattccaggtcctacagtgtgcatttctcatttttcacgtttttcagtgatttcgtcatttttcacgtcgtcaagtggatgtttctcattttccatgattttcagttttcttgccatattccatgtcctacagtggacatttctaaattttccacctttttcagttttcctcgccatatttcacgtcctaaagtgtgtatttctcattttccgtgattttcagttttctcgacatattccaggtcttacagggtgcatttctcatttttcacgtttttcagtgatttcatcatttttcaagtcgtcaactgtatgtttctcattttcaatgattttcatttttcttgccatattccacgtcctatagtggacatttctaaattttccacctttttcagttttccttgccatatttcaggtcctacagtgtgcatttctcatttttcacgtttttcagtgatttcgtcatttttcaagtggtcaaatgcatgtttctcattttccatgattttcagttttcttgccatattccatgtcctacagtggacatttctaaattttccacctttttcagttttcctcgccatatttcacgtcctaaagtgtgtatttctcattttccgtgattttcagttttatcgccagattccaggtcctacggtgtgcatttttcatatttcacgtttttcagtgattttgtcatttttcaagttgtcaactgcatgtttctcattttccatgattttcagttttcttgccatattccatgtcctacagtggacatttctaaattttccacctttttcagttttcctcgccatatttcatgtcctaaagtgtgtatttctcattttcagtgattttctgttttctcgccatattccaggtcctacagtgtgcatttctcatttttcacgtttttcagtgatttcgtcatttttcaagttgtcaagtggatgtttctcattttccatgattttcagttttcttgccatattccatgtcctacaatggacatttctaaattttccacctttttcagttttcctcgccatatttcacgtcctaaagtgtgtatttctcattttccgtgattttcagttttctcgccatattccaggtcctatgtgtacatttctcatttttcacgtttttcagtgattttgtcatttttcaagttgtgaagtggatgtttctcatttttcttgattttcatttttcttgccatattccatgtcctagagtggaaatttttaaattttccacctttttcagttttcctcgccatatttcacgtcctaaagtgtgaatttctcattttccgtgattttcagttttctcgccatattccaagtcctacagtgtgcatttctcatttttcacgtttttcagtgatttcgtcatttttcaagttgtcaagtggatgtttctcattttccatgattttcagctttcttgccatattcaaagtcctacagtggacatttctaaattttcgacctttatcagttttcctcgccatatttcatgtcccaaagtgtgtacttctcattttccgtgattttcagtttcctcgccatattctaggtcctacagtgtgcatttctcatttttcaggtttttcagtgatttcgtcttttttcaagtcgtcaagtggatgtttctcattttccatgattttcagttttcttgccatattccatgtcctacagtggacatttctaaattttccaactttttcagttttcctcgccatatttcatgtcctaaagtgtgtatttctcattttcagtgattttcagttttctcgccatattccaggtcctacagtgtgcatttctcatttttcacgtttttcagtgatttcgtcatttttcaagttgtcaagtggatgtttctcatttttcatgattttcagttttcttgccatattccatgtcccacagtggacatttctaaatgttccacctttttctgttttccttgccatatttcatgtcctaaagtgtgtatttctcattttccgtgattttcagttttcttgctatattccaagtcctacagtgtgcatttctcatttttcacgtttttctgtgattttttcatttttcaatttgtcaactgcatgtttctcattttccatgattttcagttttcttgccatattccaggtcctacagtgtgcatttctcatttttcacgtttttcagtgattttgtcatttttcaagttgtcaactgcatgtttctcattttccatgattttcagttttcttgctatattccatgtcctacagtggaaatttctaaattttccacctttttcagttttcctcgccatatttcacgtcctaaagtgtgtatttctcattttccgtgattttcagttttctcgccatattccaggtcctatgtgtacatttctcatttttcacgtttttcagtgattttgtcatttttcaagttgtgaagtggatgtttctcatttttcttgattttcatttttcttgccatattccatgtcctagagtggaaatttttaaattttccacctttttcagttttcctcgccatatttcacgtcctaaattgtgaatttctcattttccgtgattttcagttttctcgccatattccaagtcctacagtgtgcatttctcatttttcacgtttttcagtgatttcgtcatttttcaagttgtcaagtggatgtttctcattttccatgattttcagctttcttgccatattcaaagtcctacagtggacatttctaaattttcgacctttatcagttttcctcgccatatttcatgtcccaaagtgtgtacttctcattttccgtgattttcagtttcctcgccatattctaggtcctacagtgtgcatttctcatttttcaggtttttcagtgatttcgtcttttttcaagtcgtcaagtggatgtttctcattttccatgattttcagttttcttgccatattccatgtcctacagtggacatttctaaattttccacctttttcagttttcctcgccatatttcatgtcctaaagtgtgtatttctcattttcagtgattttcagttttctcgccatattccaggtcctacagtgtgcatttctcatttttcacgtttttcagtgattttgtcatttttcaagttgtcaagtggatgtttctcattttccttgattttcagttttcttgccatattccatgtcctacagtggacatttctaaattttccacctttttcagttttccttgccatatttcatgtcctaaagtgtgtatttctcattttcagtgattttcagttttctcgccatattccaggtcctacagtgtgcatttctcattttttcaggtttttcagtgatttcgtcatttttcacgttgtcaagtggatgtttctcattttccatgattttcacttttcttgccatatttcatgtcctaaagtgtgtatttctcattttcagtgattttcagttttctcgccatattccaggtcctacagtgtgcatttctcattttttcacgtttttcagtgatttcgtcatttttcacgttgtcaagtggatgtttctcattttccattattttcacttttcttgccatatttcatgtcctacagtggacatttctaaattttccacctttttctgttttcctcgccatatttcacatcctaaagtgtgtatttctcattttccgtgattttcagttttcttgccatattccaggtcctacagtgtgcatttctcatttttcacgtttttcagtgatttcgtcatttttcaagtcgtcaagtggatgtttctcattttccatgattttcagttttctcgccatattccaggtcctacagttgacatttctaaattttccacattttttatgtttcctcgcgatatttcacatcctaaagtgtgtatttctcattttccgtgattttcagttttcttgccatattccaggtcctacagggtgcatttctcatttttcacgtttttcagtgatttcatcaatttcaagtcgtcaactgtatgtttctcattttcaatgattttcatttttcttgccatattccacgtcctatagtggacatttctacattttccacctttttcagttttcttcgccatatttcacgtcccaaagtgtgtatttctcattttccgtgattttcagtttcctcgccatattccaggtcctacagtgtgcatttctcatttttcacgtttttcagtgatttcgtcttttttcaagtcgtcaagtggatgtttctcattttccatgattttcagttttcttgccatattccatgtcctacagtggacatttctaaattttccacctttttctgttttcctcgccatatttcacgtcctaaagtgtgtatttctcatttaccgtgattttcagttttcttgctatattccaagtcctacagtgtgcatttctcatttttcacgtttttcactgattttgtcattgttcaagttgtcaactgcatgtttctcattttccatgattttcagttttcttgccatattccatgtcctacagtggaaatttctatattttccaactttttcagttttcctcgccatatttcacgtgctaaagtgtgtatttctcatttttcgtgtttttcaggtttctcgccatattccaggtcctacagtgtgcatttctcatttttcacgtttttcagtgattttgtaatttttcaagttgtcaagtggatgtttctcattttccttgattttcagttttcttgccatattccatgtcctactgtggacatttctaaattttccacctttttcagttttccttgccatatttcatgtcctaaagtgtgtatttctcattttcagtgattttcagttttctcgcaatattccaggtcctacagtgtgcatttctcattttttcaggtttttcagtgatttcgtcatttttcacgttgtcaagtggatgtttctcattttccatgattttcacttttcttgccatatttcatgtgctaaagtgtgtatttctcattttcagtgattttcagttttctgccatattccaggtcctacattgtgcatttctcattttttcacgtttttcagtgatttcgtcatttttcacgttgtcaagtggatgtttctcattttccatgattttcacttttcttgccatatttcatgttttacagtggacatttctaaattttccacctatttctgttttcctcgccatatttcacatcctaaagtgtgtatttctcattttccgtgattttcagttttctcgccatatgccaggtcatacagggtgcatttctcatttttcacgtttttcagtgatttcgtcatttttcacgtcgtcaagtggatgtttctcattttcaatgattttcatttttcttgccatattccacgtcctatagtggacatttctaaattttccacctttttcagttttccttgccatatttcaggtcctacagtgtgcatttctcttttttcacgtttttcagtgatttcgtcatttttcaagtggtcaagtgcatgtttctcattttccgtgattttcagttttcttgccatgttccaggtcctacagttgacgtttctaaaatttcactttttttaagttttcctcgccatatttcacttcctaaagtgtgtatttctcattttccgtgattttcagttttctcgccagattccaggtcctacagtgtgcatttttcatatttcacctttttcagtgattttgtcatttttcaagttgtcaactgcatgtttctcattttccatgattttcagttttcttgccatattccatgtcctactgtggacatttctaaattttccaactttttcagttttcctcgccatatttcatgtcctaaagtgtgtatttctcattttcagtgattttctgttttctcgccatattccaggtcctacagtgtgcatttctaatttttcacgtttttcagtgatttcgtcatttttcaagttgtcaagtggatgtttctcattttccatgattttcagttttcttgccatattccatgtcctacagtggacatttctaaattttccaactttttccattttcctcaccatatttcacgtcctaaagtgagtttttctcattttttgtgattttcagttttctcgacatattccaggtcctacagtgtgcatttctaattttttcttttttcagtgatttcgtcatttttcaagtggtcaagtgcatgtttctcattttccatgattttcagttttcttgccatattccatgtcctacaatggacatttctaaattttccaactttttcagttttcctcgccatatttcacgtcctaaagtgtgtatttctcattttccgtgattttcagttttctcgccatattccaggtcctacagtgtgcatttctcatttttcacgtttttcagtgatttcgtcatttttcaagttgtcaactgcatgtttctcattttccatgattttcagttttcttgccatattccatgtcttacagtggacatttttaaatttttcacatttttttaagttttcctccccatatttcacgttttaaagtgtgcatttctcattttcggtgattttcagttttctcgccagattccatgtcttacagtgtgcatttctcattttttcacgtttttcagtgatttcgtcatttttcaagtcgtcaagtggatgtttctcattttccatgattttcagttttcttgccatattccatgtcctacagtggaaatttctaaattttccacctttttcagttttccttgccatatttcaggtcctaaagtgtgtatttctcattttctgtgattttcagttttctcgccatattccaggtcctacagttgacatttctaaaatttccacattttttaagttttcctcgccatatttcacttcctaaagtgtgtatttctcattttccgtgattttcagttttctcgccatattccagatcctacagtgtacatttttcatttttcacgtttttcagtgattttgtcattttttagttgtcaactgcctgtttctcattttccatgattttcagttttcttgctatattccatgtcctacagtggaaatttctaaattttccacctttttcagttttcctcgccatatttcacgtcctaaagtgtgtatttctcattttccgtgattttcagttttctcgccatattccaggtcctatgtgtacatttctcatttttcacgtttttcagtgattttgtcatttttcaatttgtcaactgcatgtttctcattttccatgattttcagttttcttgccatattccatgtcctacagtggaaatttctatattttccaactttttcagttttcctcgccatatttcacgtgctaaagtgtgtatttctcatttttcgtgtttttcaggtttctcgccatattccaggtcctacagtgtgcatttctcatttttcacgtttttcagtgattttgtcatttttcaagttgtcaagtggatgtttctcattttccttgattttcagttttcttgccatattccatgtcctacagtggacatttctaaattttccacctttttcagttttccttgccatatttcatgtcctaaagtgtgtatttctcattttcagtgattttcagttttctcgccatattccaggtcctacagtgtgcatttctcattttttcaggtttttcagtgatttcgtcatttttcacgttgtcaagtggatgtttctcattttccatgattttcacttttcttgccatatttcatgtcctaaagtgtgtatttctcattttcagtgattttcagttttctcgctatattccaggtcctacagtgtgcatttctcattttttcacgtttttcagtgatttcgtcatttttcacgttgtcaagtggatgtttctcattttccatgattttcacttttcttgccatatttcatgtcctacaatggacatttctaaattttccacctttttctgttttcctcgccatatttcacatcctaaagtgtgtatttctcattttccgtgattttcagttttcttgccatattccaggtcctacagtgtgcatttctcatttttcacgtttttcagtgatttcgtcatttttcaagttgtcaagtggatgtttctcattttccttgattttcagttttcttgccatattccatgtcctactgtggacatttctaaattttccacctttttcagttttccttgccatatttcatgtcctaaagtgtgtatttctcattttcagtgattttcagttttctcgcaatattccaggtcctacagtgtgcatttctcattttttcaggtttttcagtgatttcgtcatttttcacgttgtcaagtggatgtttctcattttccatgattttcacttttcttgccatatttcatgtcctaaagtgtgtatttctcattttcagtgattttcagttttctgccatattccaggtcctacattgtgcatttctcattttttcacgtttttcagtgatttcgtcatttttcagttttctcgacatattccaggtcctacagtgtgcatttctaattttttcttttttcagtgatttcgtcatttttcaagttgtcaactgcatgtttctcattttccatgattttcagttttcttgccatattccatgtcttacagtggacatttttaaatttttcacatttttttaagttttcctccccatatttcacgttttaaagtgtgcatttctcattttcggtgattttcagttttctcgccagattccaggtcttacagtgtgcatttctcattttttcacgtttttcagtgatttcgtcatttttcaagtcgtcaagtggatgtttctcattttccatgattttcagttttcttgccatattccatgtcctacagtggaaatttctaaattttccacctttttcagttttccttgccatatttcaggtcctaaagtgtgtatttctcattttctgtgattttcagttttctcgccatattccaggtcctacagttgacatttctaaaatttccacattttttaagttttcctcgccatatttcacttcctaaagtgtgtatttctcattttccgtgattttcagttttctcgccatattccagatcctacagtgtgcatttttcatttttcacgtttttcagtgattttgtcattttttagttgtcaactgtctgtttctcattttccatgattttcagttttcttgccatattccatgtcctacactggacatttctaaattttccacctttttctgttttcctcgccatatttcacgtcctaaagtgtgtatttctcattttccgtgattttcagttttcttgccatattccaggtcctacagtgtgcatttctcatttttcacgtttttcagtgattttgtcatttttcaagttgtcaactgcatgtttctcattttctatgattttcagttttcttgctatattccatgtcctacagtggaaatttctaaattttccacctttttcagttttcctcgccatatttcacgtcctaaagtgtgtatttctcattttccgtgattttcagttttctcgccatattccaggtcctatgtgtacatttctcatttttcacgtttttcagtgattttgtcatttttcaagttgtgaagtggatgtttctcatttttcttgattttcatttttcttgccatattccatgtcctagagtggaaatttttaaattttccacctttttcagttttcctcgccatatttcacgtcctaaagtgtgaatttctcattttccgtgattttcagatttctcgccatattccaagtcctacagtgtgcatttctcatttttcacgtttttcagtgatttcgtcatttttcaagttgtcaagtggatgtttctcattttccatgattttcagctttcttgccatattcaaagtcctacagtggacatttctaaattttcgacctttatcagttttcctcgccatatttcatgtcccaaagtgtgtacttctcattttccgtgattttcagtttcctagccatattctaggtcctacagtgtgcatttctcatttttcaggtttttcagtgatttcgtcttttttcaagtcgtcaagtggatgtttctcattttccatgattttcacttttcttgccatatttcatgtcctaaagtgtgtatttctcattttcagtgattttcagttttctcgctatattccaggtcctacagtgtgcatttctcattttttcacgtttttcagtgatttcgtcatttttcacgttgtcaagtggatgtttctcattttccatgattttcacttttcttgccatatttcatgtcctacagtggacatttctaaattttccacctttttctgttttcctcgccatatttcacatcctaaagtgtgtatttctcattttccgtgattttcagttttcttgccatattccaggtcctacagtgtgcatttctcatttttcacgtttttcagtgatttcgtcatttttcaagttgtcaagtggatgtttctcattttccttgattttcagttttcttgccatattccatgtcctactgtggacatttctaaattttccacctttttcagttttccttgccatatttcatgtcctaaagtgtgtatttctcattttcagtgattttcagttttctcgcaatattccaggtcctacagtgtgcatttctcattttttcaggtttttcagtgatttcgtcatttttcacgttgtcaagtggatgtttctcattttccatgattttcacttttcttgccatatttcatgtcctaaagtgtgtatttctcattttcagtgattttcagttttctgccatattccaggtcctacattgtgcatttctcattttttcacgtttttcagtgatttcgtcatttttcacgttgtcaagtggatgtttctcattttccatgattttcacttttcttgccatatttcatgttttacagtggacatttctaaattttccacctttttctgttttcctcgccatatttcacatcctaaagtgtgtatttctcattttccgtgattttcagttttctcgccatatgccaggtcatacagggtgcatttctcatttttcacgtttttcagtgatttcgtcatttttcacgtcgtcaagtggatgtttctcattttcaatgattttcatttttcttgccatattccacgtcctatagtggacatttctaaattttccacctttttcagttttccttgccatatttcaggtcctacagtgtgcatttctcatttttcacgtttttcagtgatttcgtcatttttcaagtggtcaagtgcatgtttctcattttccgtgattttcagttttcttgccatgttccaggtcctacagttgacgtttctaaaatttcactttttttaagttttcctcgccatatttcacttcctaaagtgtgtatttctcattttccgtgattttcagttttctcgccagattccaggtcctacagtgtgcatttttcatatttcacctttttcagtgattttgtcatttttcaagttgtcaactgcatgtttctcattttccatgattttcagttttcttgccatattccatgtcctactgtggacatttctaaattttccaactttttcagttttcctcgccatatttcatgtcctaaagtgtgtatttctcattttcagtgattttctgttttctcgccatattccaggtcctacagtgtgcatttctaatttttcacgtttttcagtgatttcgtcatttttcaagttgtcaagtggatgtttctcattttccatgattttcagttttcttgccatattccatgtcctacagtggacatttctaaattttccaactttttccattttcctcaccatatttcacgtcctaaagtgtgtttttctcattttttgtgattttcagttttctcgacatattccaggtcctacagtgtgcatttctaattttttcttttttcagtgatttcgtcatttttcaagttgtcaactgcatgtttctcattttccatgattttcagttttcttgccatattccatgtcttacagtggacatttttaaatttttcacatttttttaagttttcctccccatatttcacgttttaaagtgtgcatttctcattttcggtgattttcagttttctcgccagattccaggtcttacagtgtgcatttctcattttttcacgtttttcagtgatttcgtcatttttcaagtcgtcaagtggatgtttctcattttccatgattttcagttttcttgccatattccatgtcctacagtggaaatttctaaattttccacctttttcagttttccttgccatatttcaggtcctaaagtgtgtatttctcattttctgtgattttcagttttctcgccatattccaggtcctacagttgacatttctaaaatttccacattttttaagttttcctcgccatatttcacttcctaaagtgtgtatttctcattttccgtgattttcagttttctcgccatattccagatcctacagtgtgcatttttcatttttcacgtttttcagtgattttgtcattttttagttgtcaactgtctgtttctcattttccatgattttcagttttcttgccatattccatgtcctacactggacatttctaaattttccacctttttctgttttcctcgccatatttcacgtcctaaagtgtgtatttctcattttccgtgattttcagttttcttgccatattccaggtcctacagtgtgcatttctcatttttcacgtttttcagtgattttgtcatttttcaagttgtcaactgcatgtttctcattttccatgattttcagttttcttgctatattccatgtcctacagtggaaatttctaaattttccacctttttcagttttcctcgccatatttcacgtcctaaagtgtgtatttctcattttccgtgattttcagttttctcgccatattccaggtcctatgtgtacatttctcatttttcacgtttttcagtgattttgtcatttttcaagttgtgaagtggatgtttctcatttttcttgattttcatttttcttgccatattccatgtcctagagtggaaatttttaaattttccacctttttcagttttcctcgccatatttcacgtcctaaagtgtgaatttctcattttccgtgattttcagatttctcgccatattccaagtcctacagtgtgcatttctcatttttcacgtttttcagtgatttcgtcatttttcaagttgtcaagtggatgtttctcattttccatgattttcagctttcttgccatattcaaagtcctacagtggacatttctaaattttcgacctttatcagttttcctcgccatatttcatgtcccaaagtgtgtacttctcattttccgtgattttcagtttcctcgccatattctaggtcctacagtgtgcatttctcatttttcaggtttttcagtgatttcgtcttttttcaagtcgtcaagtggatgtttctcattttccatgattttcagttttcttgccatattccatgtcctacagtggacatttctaaattttccacctttttcagttttcctcgccatatttcatgtcctaaagtgtgtatttctcattttcagtgattttcagttttctcgccatattccaggtcctacagtgtgcatttctcatttttcacgtttttcagtgatttcgtcatttttcaagttgtcaagtggatgtttctcattttccatgattttcagttttcttgccatattccatgtcccacagtggacatttctaaattttccacctttttctgttttccttgccatatttcatgtcctaaagtgtgtatttctcattttccgtgattttcagttttcttgctatattccaagtcctacagtgtgcatttctcatttttcacgtttttcagtgattttgtcatttttcaatttgtcaactgcatgtttctcattttccatgattttcagttttcttgccatattccatgtcctacagtggaaatttctatattttccaactttttcagttttcctcgccatatttcacgtgctaaagtgtgtatttctcatttttcgtgtttttcaggtttctcgccatattccaggtcctacagtgtgcatttctcatttttcacgtttttcagtgattttgtcatttttcaagttgtcaagtggatgtttctcattttccttgattttcagttttcttgccatattccatgtcctacagtggacatttctaaattttccacctttttcagttttccttgccatatttcatgtcctaaagtgtgtatttctcattttcagtgattttcagttttctcgccatattccaggtcctacagtgtgcatttctcattttttcaggtttttcagtgatttcgtcatttttcacgttgtcaagtggatgtttctcattttccatgattttcacttttcttgccatatttcatgtcctaaagtgtgtatttctcattttcagtgattttcagttttctcgctatattccaggtcctacagtgtgcatttctcattttttcacgtttttcagtgatttcgtcatttttcacgttgtcaagtggatgtttctcattttccatgattttcacttttcttgccatatttcatgtcctacagtggacatttctaaattttccacctttttctgttttcctcgccatatttcacatactaaagtgtgtatttctcattttccttgattttcagttttcttgccatattccaggtcctacagtgtgcatttctcatttttcacgtttttcagtgatttcgtcatttttcaagtcgtcaagtggatgtttctcattttccatgattttcagttttctcgccatattccaggtcctacagttgacatttctaaattttccacattttttaagtttcctcgcgatatttcacatcctaaagtgtgtatttctcattttccgtgattttcagttttcttgccatattccaggtcctacagggtgcatttctcatttttcacgtttttcagtgatttcatcaatttcaagtcgtcaactgtatgtttctcattttcaatgattttcatttttcttgccatattccatgtcctacagtggacatttctaaatttttcacctttttcagttttccttgccatatttcatgtcctaaagtgtgtatttctcattttcagtgattttcagttttctcgccatattccaggtcctacagtgtgcatttctcattttttcaggtttttcagtgatttcgtcatttttcacgttgtcaagtggatgtttctcattttccatgattttcacttttcttgccatatttcatgtcctaaagtgtgtatttctcattttcagtgattttcagttttctcgccatattccaggtcctacagtgtgcatttctcatttttcacgtttttcagtgatttcgtcatttttcaagttgtcaagtggatgtttctcattttccatgattttcacttttcttgccatattccatgtcccacagtggacatttctaaattttccacctttttctgttttcctcgccatatttcatgtcctaaagtgtgtatttctcattttccgtgattttcagttttcttgctatattccaagtcctacagtgtgcatttctcatttttcacgtttttcagtgattttgtcatttttcaatttgtcaactgcatgtttctcattttccatgattttcagttttcttgccatattccatgttctacagtggaaatttctatattttccaactttttcagttttcctcgccatatttcacgtgctaaagtgtgtatttctcatttttcgtgtttttcaggtttctcgccatattccaggtcctacagtgtgcatttctcatttttcacgtttttcagtgattttgtcatttttcaagttgtcaagtggatgtttctcattttccttgattttcagttttcttgccatattccatgtcctacagtggacatttctaaattttccacctttttcagttttccttgccatatttcatgtcctaaagtgtgtatttctcattttcagtgattttcagttttctcgccatattccaggtcctacagtgtgcatttctcattttttcaggtttttcagtgatttcgtcatttttcacgttgtcaagtggatgtttctcattttccatgattttcacttttcttgccatatttcatgtcctaaagtgtgtatttctcattttcagtgattttcagttttctcgctatattccaggtcctacagtgtgcatttctcattttttcacgttttgcagtgatttcgtcatttttcacgttgtcaagtggatgtttctcattttccatgattttcacttttcttgccatatttcatgtcctacagtggacatttctaaattttccacctttttctgttttcctcgccatatttcacatcctaaagtgtgtatttctcattttccgtgattttcagttttcttgccatattccaggtcctacagtgtgcatttctcatttttcacgtttttcagtgatttcgtcatttttcaagtcgtcaagtggatgtttctcattttccatgattttcagttttctcgccatattccaggtcctacagttgacatttctaaattttccacattttttaagtttcctcgcgatatttcacatcctaaagtgtgtatttctcattttccgtgattttcagttttcttgccatattccaggtcctacagggtgcatttctcatttttcacgtttttcagtgatttcatcaatttcaagtcgtcaactgtatgtttctcattttcaatgattttcatttttcttgccatattccatgtcctacagtggacatttctaaattttccacctttttcagttttccttgccatatttcatgtcctaaagtgtgtatttctcattttcagggattttcagttttctcgccatattccaggtcctacagtgtgcatttctcattttttcaggtttttcagtgatttcgtcatttttcacgttgtcaagtggatgtttctcattttccatgattttcacttttcttgccatatttcatgtcctaaagtgtgtatttctcattttcagtgattttcagttttctcgccatattccaggtcctacagtgtgcatttctcattttttcacgtttttcagtgatttcgtcatttttcacgttgtcaagtggatgtttctcattttccatgattttcacttttcttgccatatttcatgtcctacagtggacatttctaaattttccacctttttctgttttcctcgccatatttcacatcctaaagtgtgtatttctcattttccgtgattttcagttttcttgccatattccaggtcctacagtgtgcatttctcatttttcacgtttttcagtgatttcgtcatttttcaagtcgtcaagtggatgtttctcattttccatgattttcagttttctcgccatattccaggtcctacagttgacatttctaaattttccacattttttaagtttcctcgcgatatttcacatcctaaagtgtgtatttctcattttccgtgattttcagttttcttgccatattccaggtcctacagggtgcatttctcatttttcacgtttttcagtgatttcatcaatttcaagtcgtcaactgtatgtttctcattttcaatgattttcatttttcttgccatattccacgtcctatagtggacatttctaaattttccacctttttcagttttcttcgccatatttcacgtcccaaagtgtgtatttctcattttccgtgattttcagtttcctcgcaatattccaggtcctacagtgtgcatttctcatttttcacgtttttcagtgatttcgtcttttttcaagtcgtcaagtggatgtttctcattttccatgattttcagttttcttgccatattccatgtcctacagtggacatttctaaattttccacctttttctgttttcctcgccatatttcacgtcctaaagtgtgtatttctcattttccgtgattttcagttttcttgccatattccaggtcctacagtgtgcatttctcatttttcacgtttttcactgattttgtcattgttcaagttgtcaactgcatgtttctcattttccatgattttcaattttcttgccatattccatgtcctacagtggaaatttctatattttccaactttttcagttttcctcgccatatttcacgtgctaaagtgtgtatttctcatttttcgtgtttttcaggtttctcgccatattccaggtcctacagtgtgcatttctcatttttcacgtttttcagtgattttgtcatttttcaagttgtcaagtggttgtttctcattttccttgattttcagttttcttgccatattccatgtcctactgtggacatttctaaattttccacctttttcagttttccttgccatatttcatgtcctaaagtgtgtatttctcattttcagtgattttcagttttctcgcaatattccaggtcctacagtgtgcatttctcattttccgtgattttcagttttctcgccatatgccaggtcatacagggtgcatttctcatttttcacgtttttcagtgatttcgtcatttttcacgtcgtcaagtggatgtttctcattttcaatgattttcatttttcttgccatattccacgtcctatagtggacatttctaaattttccaactttttcagttttcttgccatatttcaggtcctacagtgtgcatttctcatttttcacgtttttcagtgatttcgtcatttttcaagtggtcaagtgcatgtttctgattttccgtgattttcagttttcttgccatgttccaggtcctacagttgacgtttctaaaatttcactttttttaagttttcctcgccatatttcacttcctaaagtgtgtatttctcattttccgtgattttcagttttctcgccagattccaggtcctacagtgtgcatttttcatatttcacctttttcagtgattttgtcatttttcaagttgtcaactgcatgtttctcattttccatgattttcagttttcttgccatattccatgtcctactgtggacatttctaaattttccaactttttcagttttcctcgccatatttcatgtcctaaagtgtgtatttctcattttcagtgtttttctgttttctcgccatattccaggtcctacagtgtgcatttctaatttttcacgtttttcagtgatttcgtcatttttcaagttgtcaagtggatgtttctcattttccatgattttcagttttcttgccatattccatgtcctacagtggacatttctaaattttccaactttttccattttcctcaccatatttcacgtcctaaagtgtgtttttctcattttttgtgattttcagttttctcgacatattccaggtcctacagtgtgcatttctaattttttcttttttcagtgatttcgtcatttttcaagtggtcaagtgcatgtttctcattttccatgattttcagttttcttgccatattccatgtcctacaatggacatttctaaattttccaactttttcagttttcctcgccatatttcacgtcctaaagtgtgtatttctcattttccgtgattttcagttttctcgccatattccaggtcctatgtgtacatttctcatttttcacgtttttcagtgattttgtcatttttcaagttgtgaagtggatgtttctcatttttcttgattttcatttttcttgccatattccatgtcctagagtggaaatttttaaattttccaactttttcagttttcctcgccatatttcacgtcctaaagtgtgtatttctcattttccgtgattttcagttttctcgccatattccaagtcctacagtgtgcatttctcatttttcacgtttttcagtgatttcgtcatttttcaagttgtcaagtggatgtttctcattttccatgattttcagctttcttgccatattcaaagtcctacagtggacatttctaaattttcgacctttatcagttttcctcgccatatttcatgtcccaaagtgtgtacttctcattttccgtgattttcagtttcctcgccatattctaggtcctacagtgtgcatttctcatttttcaggtttttcagtgatttcgtcttttttcaagtcgtcaagtggatgtttctcattttccatgattttcagttttcttgccatattccatgtcctacagtggacatttctaaattttccacctttttcagttttcctcgccatatttcatgtcctaaagtgtgtatttctcattttcagtgattttcagttttctcgccatattccaggtcctacagtgtgcatttctcatttttcacgtttttcagtgatttcgtcatttttcaagttgtcaagtggatgtttctcattttccatgattttcagttttcttgccatattccatgtcccacagtggacatttctaaattttccacctttttctgttttccttgccatatttcatgtcctaaagtgtgtatttctcattttccgtgattttcagttttcttgctatattccaagtcctacagtgtgcatttctcatttttcacgtttttaagtgattttgtcatttttcaatttgtcaactgcatgtttctcattttccatgattttcagttttcttgccatattccatgtcctacagtggaaatttctatattttccaactttttcagttttcctcgccatatttcacgtgctaaagtgtgtatttctcatttttcgtgtttttcaggtttctcgccatattccaggtcctacagtgtgcatttctcatttttcacgtttttcagtgattttgtcatttttcaagttgtcaagtggatgtttctcattttccttgattttcagttttcttgccatattccatgtcctacagtggacatttctaaattttccacctttttcagttttccttgccatatttcatgtcctaaagtgtgtatttctcattttcagtgattttcagttttctcgccatattccaggtcctacagtgtgcatttctcattttttcaggtttttcagtgatttcgtcatttttcacgttgtcaagtggatgtttctcattttccatgattttcacttttcttgccatatttcatgtcctaaagtgtgtatttctcattttcagtgattttcagttttctcgccatattccaggtcctacagtgtgcatttctcattttttcacgtttttcagtgatttcgtcatttttcacgttgtcaagtggatgtttctcattttccatgattttcacttttcttgccatatttcatgtcctacagtggacatttctaaattttccacctttttctgttttcctcgccatatttcacatcctaaagtgtgtatttctcattttccgtgattttcagttttcttgccatatttcaggtcctacagtgtgcatttctcatttttcacgtttttcagtgatttcgtcatttttcaagtcgtcaagaggatgtttctcattttccatgattttcagttttctcgccatattccaggtcctacagttgacatttctaaattttccacattttttaagtttcctcgcgatatttcacatcctaaagtgtgtatttctcattttccgtgattttcagttttcttgccatattccaggtcctacagggtgcatttctcatttttcacgtttttcagtgatttcatcaatttcaagtcgtcaactgtatgtttctcattttcaatgattttcatttttcttgccatattccacgtcctatagtggacatttctaaattttccacctttttctgttttcctcgccatatttcacgtcctaaagtgtgtatttctcattttccgtgattttcagttttcttgccatattccaggtcctacagtgtgcatttctcatttttcacgtttttcactgattttgtcattgttcaagttgtcaactgcatgtttctcattttccatgattttcagttttcttgccatattccatgtcctacagtggaaatttctatattttccacctttttcagttttcctcgccgtatttcatgtgctaaagtgtgtatttctcatttttcgtgtttttcaggtttctcgccatattccaggtcctacagtgtgcatttctcatttttcacgtttttcagtgattttgtcatttttcaagttgtcaactggatgtttctcattttccttgattttcagttttcttgccatattccatgtcctactgtggacatttctaaattttccacctttttcagttttccttgccatatttcatgtcctaaagtgtgtatttctcattttcagtgattttcagttttctcgcaatattccaggtcctacagtgtgcatttctcattttttcaggtttttcagtgatttcgtcatttttcacgttgtcaagtggatgtttctcattttccatgattttcacttttcttgccatatttcatgtcctaaagtgtgtatttctcattttcagtgattttcagttttctcgccatattccaggtcctacattgtgcatttctcattttttcacgtttttcagtgatttcgtcatttttcacgttgtcaagtggatgtttctcattttccatgattttcacttttcttgccatatttcatgttttacagtggacatttctaaattttccacctttttctgttttcctcgccatatttcacatcctaaagtgtgaatttctcattttccgtgattttcagttttcttgccatattccaggtcctacagtgtgcatttctcatttttcacgtttttcagtgatttcatcatttttcaagtcgtcaagtggatgtttctcattttccatgattttcagttttcttgccatattccatgtcctacagtggacatttctaaattttccacctttttctgttttcctcgccatatttcacgtcctaaagtgtgtatttctcattttccgtgattttcagttttcttgccatattccaggtcctacagtgtgcatttctcatttttcacgtttttcactgattttgtcatttttcaagttgtcaactgcatgtttctcattttccatgattttcagttttcttgctatattccatgtcctacagtggaaatttctaaattttccacctttttcagttttcctcgccatatttcacgtcctgaagtgtgtatttctcattttccgtgattttcagttttctcgccatattccaggtcctatgtgtacatttctcatttttcacgtttttcagtgattttgtcatttttcaagttgtgaagtggatgtttctcatttttcttgattttcatttttcttgccatattccatgtcctacagtggaaatttctaaattttccacctttttcagttttcctcgccatatttcacgtcctaaagtgtgtatttctcattttccgtgattttcagttttctcgccatattccaggtcctacagtgtgcatttctcatttttcacgtttttcagtgatttcgacatttttcaagttgtcaagtggatgtttctcattttccatgattttcagctttcttgccatattcaaagtcctacagtggacatttctaaattttcgacctttatcagttttcctcgccatatttcatgtcccaaagtgtgtacttctcattttccgtgattttcagtttcctcgccatattccaggtcctacagtgtgcatttctcatttttcacgtttttcagtgatttcgtcatttttcaagtcgtcaagtggatgtttctcattttccatgattttcagttttcttgccatattccatgtcctacagtggacatttctaaattttccacctttttctgttttcctcgccatatttcacgtcctaaagtgtgtatttctcattttccgtgattttcagttttcttgccatattccaggtcctacagtgtgcatttctcatttatcacgtttttcactgattttgtcatttttcaagttgtcaactgcatgtttctcattttccatgattttcagttttcttgctatattccatgtcctacagtggaatattctaaattttccacctttttcagttttcctcgccatatttcacgtcctgaagtgtgtatttctcattttccgtgattttcagttttctcgccatattccaggtcctatgtgtacatttctcatttttcacgtttttcagtgattttgtcatttttcaagttgtgaagtggatgtttctcatttttcttgattttcatttttcttgccatattccatgtcctacagtggaaatttctaaattttccacctttttcagttttcctcgccatatttcacgtcctaaagtgtgaatttctcattttccgtgattttcagttttctcgccatattccaggtcctacagtgtgcatttctcatttttcacgtttttcagtgatttcgacatttttcaagttgtcaagtggatgtttctcattttccatgattttcagctttcttgccatattcaaagtcctacagtggacatttctaaattttcgacctttatcagttttcctcgccatatttcatgtcccaaagtgtgtacttctcattttccgtgattttgagtttcctcgccatattccaggtcctacagtgtgcatttctcatttttcacgtttttcagtgatttcgtcttttttcaagttgtcaactgcatgtttctcattttccatgattttcagttttcttgccatattccatgtcctacagtggaaatttgtaaatttccacctttttcagttttcctcgccatatttcacgtcctaaagtatgtatttctcattttccgtgattttcagttttctcgccatattccaggtcctacagtgtgcatttctcatttttcacgtttttcagtgattttgtcattttttaagttttcaagtggatgtttctcattttccttgattttcagttttcttgccatattccatgtcctacagtggacatttctaaattttccacctttttcagttttcctcgccatatttcatgtcctaaagtgtgtatttctcattttcagtgattttcagttttctcgccatattccaggtcctacagtgtgcatttctcatttttcacgtttttcagtgatttcgtcatttttcaaggtgtcaagtggatgtttctcattttccatgattttcagttttcttgccatattccatgtcctacagtggacatttctaaattttccacctttttctgttttcctcgccatatttcatgtcctaaagtgtgtatttctcattttccgtgattttcagttttcttgctatattccaagtcctacagtgtgcatttctcatttttcacgtttttcagtgattttgtcatttttcaatttgtcaactgcatgtttctcattttccatgattttcagtttttttgccatattccatgtcctactgtggaaatttctatattttccacctttttcagttttcctcgccatatttcacgtgctaaagtgtgtatttctcatttttcgtgtttttcaggtttctcgccatattccaggtcctacagtgtgcatttctcatttttcacgtttttcagtgattttgtcatttttcaagttttcaagtggatgtttctcattttccttgattttcagttttcttgccatattccatgtcctacagtggacatttctaaattttccacctttttcagttttccttgccatatttcatgtcctaaagtgtgtatttctcattttcagtgattttcagtttccttgccatattccaggtcctacagtgtgcatttctcattttttcacgtttttcagtgatttcgtcatttttcacgttgtcaagtggatgtttctcattttccatgattttcacttttcttgccatatttcatgtcctacagtggacatttctaaattttccaactttttcaattttcctcgccatattttatgtcctaaagtgtgtatttctcatttttcgttattttcagttttcttgccatattccaggtcctacagtgtgcatttgtcatttttcacgtttttcagtgatttcgtcatttttcaagtcgtcaagtagatgtttctcatattccatgtttttcagttttctcgccatattccaggtcctacagttgacatttctaaattttctacatttttaaattttcctcgccatatttcacgtcctaaagtgtgtatttctcattttttgttattttcagttttctagccatattccaggtcctacaggatgcatttctcatttttcacgtttttcagtgatttcatcatttttcaagtcgtcaagtgtatgtttcttattttcaatgattttcatttttcttgccttattccacgtcctatagtggacatttctaaattttccacctttttcagtttttttcgccatatttcacgtcctaaagtgtgtatttctcattttctgtgattttcagttttctcaccatattccaggtcctacagtgtgcatttctcatttttcacgtttttcagtgatttcgtcatttttcaagttgtcaagtggaagtttctcattttccatgattttcagctttctagacatattccaggtcctacagtggacatttcctaattttcgacctttatcagttttcctcgtcatatttcacgtcccaaaatgtgtatttcttattttccatgattttcagtttcctcgccatattccaggtcctacagtgtgcaattctcatttttcacgtttttcagtgatttcgtcttttttcaagacgtcaagtggatgtttctcatttttcatgattttcagttttcttgccatattccatgtcctacagtggacatttctaaattttccacctttttctgttttcctcgccatatttcacgtcctaaagtgtgtatttctcattttccgtgattttcagttttcttgccatattcctggtcctacagtgtgcatttctcatttttcacgtttttcagtgattttgtcatttttcaatttgtcaactgcatgtttctcattttccattattttcagttttcttgccatattccatgtcctacagtggacatttctaaattttccacctttttctgttttcctcgccatatttcatgtcctaaagtgtgtatttctcattttccgtgattttcagttttcttgctatattccaagtcctacagtgtgcatttctcatttttcacgtttttcagtgattttgtcatttttcaatttgtcaactgcatgtttctcattttccatgattttcagtttttttgccatattccatgtcctacaggggaaatttctatattttccacctttttcagttttcctcgccatatttcatgtcctaaagtgtgtatttctcattttccgtgattttcagttttcttgccatattccaggtcctacagtgtgcatttctcatttttcacgtttttcagtgatttcgtcatttttcaagtcttcaagtagatgtttctcatattccatgtttttcagttttctcgccatattccaggtcctacagttgacatttctaaattttctacatttttaaattttcctcgccatatttcacgtcctaaagtgtgtatttctcatttttcgttattttcagttttctagccatattccaggtcctacaggatgcatttctcatttttcacgtttttcagtgatttcatcatttttcaagtcgtcaagtgtatgtttctcattttcaatgattttcatttttcttgccttattccacgtcctatagtggacatttctaaattttccacctttttcagtttttctcgccatatttcacgtcctaaagtgtgtatttctcattttctgtgattttcagttttctcaccatattccaggtcctacagtgtgcatttctcatttttcacgtttttcagtgatttcgtcatttttcaagttgtcaagtggaagtttctcattttccatgattttcagctttctagccatattccaggtcctacagtggacatttcctaattttcgacctttatcagttttcctcgccatatttcacgtcctaaagtgtgtatttctcattttccgtgattttcagttttcttgccatattccaggtcctacagtgtgcatttctcatttttcacgtttttcagtgattttgtcatttttcaatttgtcaactgcatgtttctcattttccatgatttttagttttcttgctatattccatgtcctacagtggaaatttctaaattttccacctttttcagttttcctcgccatatttcacgtcctaaagtgtgtatttctcattttccgtgattttcagttttcttgctatattccaagtcctacattgtgcatttctcatttttcacgtttttcagtgattttgtcatttttcaatttgtcaaaccacatgtttctcattttccatgattttcagtttttttgccatattccatgtcctacagtggaaatttctatattttccacctttttcagttttcctcgccatatttcacgtgctaaagtgtgtatttctcatttttcgtgtttttcaggtttctcgccatattccaggtcctacagtgtgcatttctcatttttcacgtttttcagtgattttgtcatttttcaagttgtcaagtggatgtttcccattttccttgattttcagttttcttaccatattccatgtcctacagtggacatttctaaattttccacctttttcagttttccttgccatatttcatgtcctaaagtgtgtatttctcattttcagtgattttcagtttcctcgccatattccaggtcctacagtgtgcatttctcattttttcacgtttttcagtgatttcgtcatttttcacgttgtcaagtggatgtttctcattttccatgattttcacttttcttgccatatttcatgtcctatagtggacatttctaaattttccacctttttcagtttttctcgccatatttcacgtcctaaagtgtgtatttctcattttctgtgattttcagttttctcaccatattccaggtcctacagtgtgcatttctcatttttcacgtttttcagtgatttcgtcatttttcaagtcgtcaagtagatgtttctcatattccatgtttttcagttttctcgccatattccaggtcctacagttgacatttctaaattttctacatttttaaattttcctcgccatatttcacgtcctaaagtgtgtatttctcatttttcgttattttcagttttctagccatattccaggtcctacaggatgcatttctcatttttcacgtttttcagtgatttcatcatttttcaagtcgtcaagtgtatgtttcttattttcaatgattttcatttttcttgccttattccacgtcctatagtggacatttctaaattttccaccttttttcagtttttctcgccatatttcacgtcctaaagtgtgtatttctcattttctgtgattatcagttttctcaccatattccaggtcctacagtgtgcatttctcatttttcacgtttttcagtgatttcgtcatttttcaagttgtcaagtggaagtttctcattttccatgattttcagctttctagccatattccaggtcctacagtggacatttcctaattttcgacctttatcagttttcctcgccatatttcacgtcccaaaatgtgtatttcttattttccatgattttcagtttcctcgccatattccaggtcctacagtgtgcatttctcatttttcacgtttttcagtgatttcgtcttttttcaagacgtcaagtggatgtttctcatttttcatgattttcagttttcttgccatattccatgtcctacagtggacatttctaaattttccacctttttctgttttcctcgccatatttcacgtcctaaagtgtgtatttctcattttccgtgattttcagttttcttgccatattcctggtcctacagtgtgcatttctcatttttcacgtttttcagtgattttgtcatttttcaatttgtcaactgcatgtttctcattttccatgattttcagttttcttgccatattccatgtcctacagtggacatttctaaattttccacctttttcagttttcctcgccatatttcacgtgctaaagtgtgtatttctcatttttcgtgtttttcaggtttctcgccatattccaggtcctacagtgtgcatttctcatttttcacgtttttcagtgattttgtcatttttcaagttgtcaagtggatgtttctcattttccttgattttcacttttcttgccatattccaagtcttacaggggcatttctcatttttcacgttttcagtgattttgtcattttcaatttgtcaactgcatgtttctcattttccatgattttcagtttttttgccatattccatgtcctacaggggaaatttctatattttccacctttttcagttttcctcgccatatttcatgtcctaaagtgtgtatttctcattttccgtgattttcagttttcttgccatattccaggtcctacagtgtgcatttctcatttttcacgtttttcagtgatttcgtcatttttcaagtcttcaagtagatgtttctcatattccatgtttttcagttttctcgccatattccaggtcctacagttgacatttctaaattttctacatttttaaattttcctcgccatatttcacgtcctaaagtgtgtatttctcatttttcgttattttcagttttctagccatattccaggtcctacaggatgcatttctcatttttcacgtttttcagtgatttcatcatttttcaagtcgtcaagtgtatgtttctcattttcaatgattttcatttttcttgccttattccacgtcctatagtggacatttctaaattttccacctttttcagtttttctcgccatatttcacgtcctaaagtgtgtatttctcattttctgtgattttcagttttctcaccatattccaggtcctacagtgtgcatttctcatttttcacgtttttcagtgatttcgtcatttttcaagttgtcaagtggaagtttctcattttccatgattttcagctttctagccatattccaagtcctacagtggacatttcctaattttcgacctttatcagttttcctcgccatatttcacgtcccaaaatgtgtattccttattttccatgattttcagtttcctcgccatattccaggtcctacagtgtgcatttatcatttttcacgtttttcagtgatttcgtcttttttcaagacgtcaagtggatgtttctcatttttcatgattttcagttttcttgccatattccatgtcctacagtggacatttctaaattttccacctttttctgttttcctcgccatatttcacgtcctaaagtgtgtatttctcattttccgtgattttcagttttcttgccatattcctggtcctacagtgtgcatttctcatttttcacgtttttcagtgattttgtcatttttcaagttgtcaagtggatgtttctcattttccttgattttcacttttcttgccatattccatgtcctacagtggacatttctatattttccacctttttccgttttccttgccatatttcacgtcctaaagtgtgtatttctcattttccgtgattttcaggtttctcgccatattccaggtcctacagtgtgcatttctcatttttcacgtttttcagtgattttgtcatttttcaagttgtcaagtggatgtttctcattttccttgattttcacttttcttgccatattccatgtcctacagtggacatttctaaattttccacctttttcagttttcctcgccatatttcatgtcctaaagtgtgtatttctcattttcagtgattttcagttttcttgccatattccaggtcctacagtgtgcatttctcatttttcacgtttttcagtgattttgtcatttttcaagttgtcaactgcatgtttctcattttctatgattttcagttttcttgctatattccatgtcctacagtggaaatttctaaattttccacctttttcagttttcctcgccatatttcacgtcctaaagtgtgtatttctcattttccgtgattttcagttttctcgccatattccaggtcctatgtgtacatttctcatttttcacgtttttcagtgattttgtcatttttcaagttgtgaagtggatgtttctcatttttcttgattttcatttttcttgccatattccatgtcctagagtggaaatttttaaattttccacctttttcagttttcctcgccatatttcacgtcctaaagtgtgaatttctcattttccgtgattttcagatttctcgccatattccaagtcctacagtgtgcatttctcatttttcacgtttttcagtgatttcgtcatttttcaagttgtcaagtggatgtttctcattttccatgattttcagctttcttgccatattcaaagtcctacagtggacatttctaaattttcgacctttatcagttttcctcgccatatttcatgtcccaaagtgtgtacttctcattttccgtgattttcagtttcctcgccatattctaggtcctacagtgtgcatttctcatttttcaggtttttcagtgatttcgtcttttttcaagtcgtcaagtggatgtttctcattttccatgattttcacttttcttgccatatttcatgtcctaaagtgtgtatttctcattttcagtgattttcagttttctcgctatattccaggtcctacagtgtgcatttctcattttttcacgtttttcagtgatttcgtcatttttcacgttgtcaagtggatgtttctcattttccatgattttcacttttcttgccatatttcatgtcctacagtggacatttctaaattttccacctttttctgttttcctcgccatatttcacatcctaaagtgtgtatttctcattttccgtgattttcagttttcttgccatattccaggtcctacagtgtgcatttctcatttttcacgtttttcagtgatttcgtcatttttcaagttgtcaagtggatgtttctcattttccttgattttcagttttcttgccatattccatgtcctactgtggacatttctaaattttccacctttttcagttttccttgccatatttcatgtcctaaagtgtgtatttctcattttcagtgattttcagttttctcgcaatattccaggtcctacagtgtgcatttctcattttttcaggtttttcagtgatttcgtcatttttcacgttgtcaagtggatgtttctcattttccatgattttcacttttcttgccatatttcatgtcctaaagtgtgtatttctcattttcagtgattttcagttttcctcgccatatttcacgtcccaaaatgtgtatttcttattttccatgattttcagtttcctcgccatattccaggtcctacagtgtgcatttctcatttttcacgtttttcagtgatttcgtcttttttcaagacgtcaagtggatgtttctcatttttcatgattttcagttttcttgccatattccatgtcctacagtggacatttctaaattttccacctttttctgttttcctcgccatatttcacgtcctaaagtgtgtatttctcattttccgtgattttcagttttcttgccatattcctggtcctacagtgtgcatttctcatttttcacgtttttcagtgattttgtcatttttcaatttgtcaactgcatgtttctcattttccatgattttcagttttcttgccatattccatgtcctacagtggacatttctaaattttccacctttttcagttttcctcgccatatttcacgtgctaaagtgtgtatttctcatttttcgtgtttttcaggtttctcgccatattccaggtcctacagtgtgcatttctcatttttcacgtttttcagtgattttgtcatttttcaagttgtcaagtggatgtttctcattttccttgattttcacttttcttgccatattccatgtcctacagtggacatttctaaattttccacctttttcagttttcctcgccatatttcatgtcctaaagtgtgtatttctcattttcagtgattttcagttttctcgccatattccaggtcctacagtgtgcatttctcatttttcacgtttttcagtgatttcgtcttttttcaagacgtcaagtggatgtttctcattttccatgattttcagttttcttgccatattccatgtcctacagtggacatttctaaattttccacctttttctgttttcctcgccatatttcacgtcctaaagtgtgtatttctcattttccgtgattttcagttttcttgccatattccaggtcctacagtgtgcatttctcatttttcacgtttttcagtgattttgtcatttttcaatttgtcaactgcatgtttctcattttccatgatttttagttttcttgctatattccatgtcctacagtggaaatttctaaattttccacctttttcagttttcctcgccatatttcacgtcctaaagtgtgtatttctcattttccgtgattttcagttttcttgctatattccaagtcctacattgtgcatttctcatttttcacgtttttcagtgattttgtcatttttcaatttgtcaaaccacatgtttctcattttccatgattttcagtttttttgccatattccatgtcctacagtggaaatttctatattttccacctttttcagttttcctcgccatatttcacgtgctaaagtgtgtatttctcatttttcgtgtttttcaggtttctcgccatattccaggtcctacagtgtgcatttctcatttttcacgtttttctgtgattttgtcatttttcaagttgtcaagtggatgtttctcattttccttgattttcagttttcttaccatattccatgtcctacagtggacatttctaaattttccaccttttctgttttcctcgccatatttcatgtcctaaagtgtgtatttctcattttccgtgattttcatttttcttgctatattccaagtcctacagtgtgcatttctcattttccatgattttcagttttcttgctatattccatgtcctacagtggaaatttctaaattttccacctttttcagttttcctcgccatatttcacgtcctaaagtgtgtatttctcattttccgtgattttcagttttttcgccatattacaggtcctatgtgtacatttctcatttttcacgtttttcagtgattttgtcatttttcaagttgtcaagtggatgtttctcatttttcttgattttcatttttcttgccatattccatgtcctacagtggaaatttctaaattttccacctttttcagttttcctcgccatatttcacgtcctaaagtgtgaatttctcattttccgtgattttcagttttctcgccatattccaggtctacagtgtgcatttctcatttttcacgttttcagtgattcgtcatttttcaagttgacaagtggatgtttctcattttccatgattttcagctttcttgccatattcaaagtcctacagtggacatttctaaattttcgacctttatcagttttcctcgccatatttcatgtcccaaagtgtgtacttctcattttccgtgattttcagttttcttgccatattccaagtcctacagtgtgcatttctcatttttcacgtttttcagtgattttgtcatttttcaatttgtcaactgcatgtttctcattttccatgattttcagttttcttgccatattccatgtcctacagtggaaatttctatattttccacctttttcagttttcctcgccatatttcacgtgctaaagtgtgtatttctcatttttcgtgtttttcaggtttctcgccatattccaggtcctacagtgtgcatttctcatttttcacgtttttcagtgattttgtcatttttcaagttgtcaagtggatgtttctcattttcaatgattttcatttttcttgccttattccacgtcctatagtggacatttctaaattttccacctttttcagtttttctcgccatatttcacgtcccaaaatgtgtattccttattttccatgattttcagtttcctcgccatattccaggtcctacagtgtgcatttctcatttttcacgtttttcagtgatttcgtcttttttcaagacgtcaagtggatgtttctcatttttcatgattttcagttttcttgccatattccctgtcctacagtggacatttctaaattttccacctttttctgttttcctcgccatatttcacgtcctaaagtgtgtatttctcattttccgtgattttcagttttctcgccagattccaggtcctacagtgtgcatttctcatttttcacgtttttcagtgattttgtcatttttcaatttgtcaactgcatgtttctctctttccatgattttcagttttcttgccatattccatgtcctacagtggacatttctaaattttccacctttttcagttttcctcgccatatttcacgtgctaaagtgtgtatttctcatttttcgtgtttttcaggtttctcgccatattccaggtcctacagtgtgcatttctcatttttcacgtttttcagtgattttgtcatttttcaagttgtcaagtggatgtttctcattttcaatgattttcatttttcttaccttattccacgtcctatagtggacatttctaaattttccacctttttcagtttttctcgccatatttcacgtcccaaaatgtgtattccttattttccatgattttcagtttcctcgccatattccaggtcctacagtgtgcatttctcatttttcacgtttttcagtgatttcgtcttttttcaagacgtcaagtggatgtttctcatttttcatgattttcagttttcttgccatattccctgtcctacagtggacatttctaaattttccacctttttctgttttcctcgccatatttcacgtcctaaagtgtgtatttctcattttccgtgattttcagttttctcgccagattccaggtcctacagtgtgcatttctcatttttcacgtttttcagtgatttcgtcatttttcaagtcttcaagtgtatgtttctcattttcaatgattttcatttttcttgccttattccacgtcctatagtggacatttctaaattttccacctttttcagtttttctcgccatatttcacgtcctaaagtgtgtatttctcattttctgtgattttcagttttcttaccatattccaggtcctacagtgtgcatttctcatttttcacgtttttcagtgatttcgtcatttttcaagttgtcaagtggaagtttctcattttccatgattttcagctttctagccatattccaggtattacagtggacatttccttattttcgacctttatcagttttcctcgccatatttcatgtcctaaagtgtgt	38399	1554	4%	7300	19%
9	3000001	3038400	Atcctacagtgtgcatttctcatttttcacgtttttcagtgatttcgtcatttttcaagtcatcaagtggctgtttctcattttccatgattttcagttttcttgccatattccttgtcctacagtggacatttctaaattttccacctttttcagttttccttgtcatatttcaggtcctacagtgtgtatttctcatttttcacgtttttcattgatttcgtcatttttcaagttgtcaagtgcatgtttctcattttccatgattttcagttttcttgccatattccatgtcctacaatggacatttctaaattttccaactttttcagttttcctcgccatatttcacgtcctaaagtgtgtatttctcattttccgtgattttcagttttctcgacatattccaggtcctacagtgtgcatttctcatttttcacgtttttcagtgatttcgtcatttttcacgtcgtcaagtggatgtttctcattttccatgattttcagttttcttgccatattccatgtcctacagtggacatttctaaattttccacctttttcagttttcctcgccatatttcacgtcctaaagtgtgtatttctcattttccgtgattttcagttttctcgacatattccaggtcttacagggtgcatttctcatttttcacgtttttcagtgatttcatcatttttcaagtcgtcaactgtatgtttctcattttcaatgattttcatttttcttgccatattccacgtcctatagtggacatttctaaattttccacctttttcagttttccttgccatatttcaggtcctacagtgtgcatttctcatttttcacgtttttcagtgatttcgtcatttttcaagtggtcaaatgcatgtttctcattttccatgattttcagttttcttgccatattccatgtcctacagtggacatttctaaattttccacctttttcagttttcctcgccatatttcacgtcctaaagtgtgtatttctcattttccgtgattttcagttttatcgccagattccaggtcctacggtgtgcatttttcatatttcacgtttttcagtgattttgtcatttttcaagttgtcaactgcatgtttctcattttccatgattttcagttttcttgccatattccatgtcctacagtggacatttctaaattttccacctttttcagttttcctcgccatatttcatgtcctaaagtgtgtatttctcattttcagtgattttctgttttctcgccatattccaggtcctacagtgtgcatttctcatttttcacgtttttcagtgatttcgtcatttttcaagttgtcaagtggatgtttctcattttccatgattttcagttttcttgccatattccatgtcctacaatggacatttctaaattttccacctttttcagttttcctcgccatatttcacgtcctaaagtgtgtatttctcattttccgtgattttcagttttctcgccatattccaggtcctatgtgtacatttctcatttttcacgtttttcagtgattttgtcatttttcaagttgtgaagtggatgtttctcatttttcttgattttcatttttcttgccatattccatgtcctagagtggaaatttttaaattttccacctttttcagttttcctcgccatatttcacgtcctaaagtgtgaatttctcattttccgtgattttcagttttctcgccatattccaagtcctacagtgtgcatttctcatttttcacgtttttcagtgatttcgtcatttttcaagttgtcaagtggatgtttctcattttccatgattttcagctttcttgccatattcaaagtcctacagtggacatttctaaattttcgacctttatcagttttcctcgccatatttcatgtcccaaagtgtgtacttctcattttccgtgattttcagtttcctcgccatattctaggtcctacagtgtgcatttctcatttttcaggtttttcagtgatttcgtcttttttcaagtcgtcaagtggatgtttctcattttccatgattttcagttttcttgccatattccatgtcctacagtggacatttctaaattttccaactttttcagttttcctcgccatatttcatgtcctaaagtgtgtatttctcattttcagtgattttcagttttctcgccatattccaggtcctacagtgtgcatttctcatttttcacgtttttcagtgatttcgtcatttttcaagttgtcaagtggatgtttctcatttttcatgattttcagttttcttgccatattccatgtcccacagtggacatttctaaatgttccacctttttctgttttccttgccatatttcatgtcctaaagtgtgtatttctcattttccgtgattttcagttttcttgctatattccaagtcctacagtgtgcatttctcatttttcacgtttttctgtgattttttcatttttcaatttgtcaactgcatgtttctcattttccatgattttcagttttcttgccatattccaggtcctacagtgtgcatttctcatttttcacgtttttcagtgattttgtcatttttcaagttgtcaactgcatgtttctcattttccatgattttcagttttcttgctatattccatgtcctacagtggaaatttctaaattttccacctttttcagttttcctcgccatatttcacgtcctaaagtgtgtatttctcattttccgtgattttcagttttctcgccatattccaggtcctatgtgtacatttctcatttttcacgtttttcagtgattttgtcatttttcaagttgtgaagtggatgtttctcatttttcttgattttcatttttcttgccatattccatgtcctagagtggaaatttttaaattttccacctttttcagttttcctcgccatatttcacgtcctaaattgtgaatttctcattttccgtgattttcagttttctcgccatattccaagtcctacagtgtgcatttctcatttttcacgtttttcagtgatttcgtcatttttcaagttgtcaagtggatgtttctcattttccatgattttcagctttcttgccatattcaaagtcctacagtggacatttctaaattttcgacctttatcagttttcctcgccatatttcatgtcccaaagtgtgtacttctcattttccgtgattttcagtttcctcgccatattctaggtcctacagtgtgcatttctcatttttcaggtttttcagtgatttcgtcttttttcaagtcgtcaagtggatgtttctcattttccatgattttcagttttcttgccatattccatgtcctacagtggacatttctaaattttccacctttttcagttttcctcgccatatttcatgtcctaaagtgtgtatttctcattttcagtgattttcagttttctcgccatattccaggtcctacagtgtgcatttctcatttttcacgtttttcagtgattttgtcatttttcaagttgtcaagtggatgtttctcattttccttgattttcagttttcttgccatattccatgtcctacagtggacatttctaaattttccacctttttcagttttccttgccatatttcatgtcctaaagtgtgtatttctcattttcagtgattttcagttttctcgccatattccaggtcctacagtgtgcatttctcattttttcaggtttttcagtgatttcgtcatttttcacgttgtcaagtggatgtttctcattttccatgattttcacttttcttgccatatttcatgtcctaaagtgtgtatttctcattttcagtgattttcagttttctcgccatattccaggtcctacagtgtgcatttctcattttttcacgtttttcagtgatttcgtcatttttcacgttgtcaagtggatgtttctcattttccattattttcacttttcttgccatatttcatgtcctacagtggacatttctaaattttccacctttttctgttttcctcgccatatttcacatcctaaagtgtgtatttctcattttccgtgattttcagttttcttgccatattccaggtcctacagtgtgcatttctcatttttcacgtttttcagtgatttcgtcatttttcaagtcgtcaagtggatgtttctcattttccatgattttcagttttctcgccatattccaggtcctacagttgacatttctaaattttccacattttttatgtttcctcgcgatatttcacatcctaaagtgtgtatttctcattttccgtgattttcagttttcttgccatattccaggtcctacagggtgcatttctcatttttcacgtttttcagtgatttcatcaatttcaagtcgtcaactgtatgtttctcattttcaatgattttcatttttcttgccatattccacgtcctatagtggacatttctacattttccacctttttcagttttcttcgccatatttcacgtcccaaagtgtgtatttctcattttccgtgattttcagtttcctcgccatattccaggtcctacagtgtgcatttctcatttttcacgtttttcagtgatttcgtcttttttcaagtcgtcaagtggatgtttctcattttccatgattttcagttttcttgccatattccatgtcctacagtggacatttctaaattttccacctttttctgttttcctcgccatatttcacgtcctaaagtgtgtatttctcatttaccgtgattttcagttttcttgctatattccaagtcctacagtgtgcatttctcatttttcacgtttttcactgattttgtcattgttcaagttgtcaactgcatgtttctcattttccatgattttcagttttcttgccatattccatgtcctacagtggaaatttctatattttccaactttttcagttttcctcgccatatttcacgtgctaaagtgtgtatttctcatttttcgtgtttttcaggtttctcgccatattccaggtcctacagtgtgcatttctcatttttcacgtttttcagtgattttgtaatttttcaagttgtcaagtggatgtttctcattttccttgattttcagttttcttgccatattccatgtcctactgtggacatttctaaattttccacctttttcagttttccttgccatatttcatgtcctaaagtgtgtatttctcattttcagtgattttcagttttctcgcaatattccaggtcctacagtgtgcatttctcattttttcaggtttttcagtgatttcgtcatttttcacgttgtcaagtggatgtttctcattttccatgattttcacttttcttgccatatttcatgtgctaaagtgtgtatttctcattttcagtgattttcagttttctgccatattccaggtcctacattgtgcatttctcattttttcacgtttttcagtgatttcgtcatttttcacgttgtcaagtggatgtttctcattttccatgattttcacttttcttgccatatttcatgttttacagtggacatttctaaattttccacctatttctgttttcctcgccatatttcacatcctaaagtgtgtatttctcattttccgtgattttcagttttctcgccatatgccaggtcatacagggtgcatttctcatttttcacgtttttcagtgatttcgtcatttttcacgtcgtcaagtggatgtttctcattttcaatgattttcatttttcttgccatattccacgtcctatagtggacatttctaaattttccacctttttcagttttccttgccatatttcaggtcctacagtgtgcatttctcttttttcacgtttttcagtgatttcgtcatttttcaagtggtcaagtgcatgtttctcattttccgtgattttcagttttcttgccatgttccaggtcctacagttgacgtttctaaaatttcactttttttaagttttcctcgccatatttcacttcctaaagtgtgtatttctcattttccgtgattttcagttttctcgccagattccaggtcctacagtgtgcatttttcatatttcacctttttcagtgattttgtcatttttcaagttgtcaactgcatgtttctcattttccatgattttcagttttcttgccatattccatgtcctactgtggacatttctaaattttccaactttttcagttttcctcgccatatttcatgtcctaaagtgtgtatttctcattttcagtgattttctgttttctcgccatattccaggtcctacagtgtgcatttctaatttttcacgtttttcagtgatttcgtcatttttcaagttgtcaagtggatgtttctcattttccatgattttcagttttcttgccatattccatgtcctacagtggacatttctaaattttccaactttttccattttcctcaccatatttcacgtcctaaagtgagtttttctcattttttgtgattttcagttttctcgacatattccaggtcctacagtgtgcatttctaattttttcttttttcagtgatttcgtcatttttcaagtggtcaagtgcatgtttctcattttccatgattttcagttttcttgccatattccatgtcctacaatggacatttctaaattttccaactttttcagttttcctcgccatatttcacgtcctaaagtgtgtatttctcattttccgtgattttcagttttctcgccatattccaggtcctacagtgtgcatttctcatttttcacgtttttcagtgatttcgtcatttttcaagttgtcaactgcatgtttctcattttccatgattttcagttttcttgccatattccatgtcttacagtggacatttttaaatttttcacatttttttaagttttcctccccatatttcacgttttaaagtgtgcatttctcattttcggtgattttcagttttctcgccagattccatgtcttacagtgtgcatttctcattttttcacgtttttcagtgatttcgtcatttttcaagtcgtcaagtggatgtttctcattttccatgattttcagttttcttgccatattccatgtcctacagtggaaatttctaaattttccacctttttcagttttccttgccatatttcaggtcctaaagtgtgtatttctcattttctgtgattttcagttttctcgccatattccaggtcctacagttgacatttctaaaatttccacattttttaagttttcctcgccatatttcacttcctaaagtgtgtatttctcattttccgtgattttcagttttctcgccatattccagatcctacagtgtacatttttcatttttcacgtttttcagtgattttgtcattttttagttgtcaactgcctgtttctcattttccatgattttcagttttcttgctatattccatgtcctacagtggaaatttctaaattttccacctttttcagttttcctcgccatatttcacgtcctaaagtgtgtatttctcattttccgtgattttcagttttctcgccatattccaggtcctatgtgtacatttctcatttttcacgtttttcagtgattttgtcatttttcaatttgtcaactgcatgtttctcattttccatgattttcagttttcttgccatattccatgtcctacagtggaaatttctatattttccaactttttcagttttcctcgccatatttcacgtgctaaagtgtgtatttctcatttttcgtgtttttcaggtttctcgccatattccaggtcctacagtgtgcatttctcatttttcacgtttttcagtgattttgtcatttttcaagttgtcaagtggatgtttctcattttccttgattttcagttttcttgccatattccatgtcctacagtggacatttctaaattttccacctttttcagttttccttgccatatttcatgtcctaaagtgtgtatttctcattttcagtgattttcagttttctcgccatattccaggtcctacagtgtgcatttctcattttttcaggtttttcagtgatttcgtcatttttcacgttgtcaagtggatgtttctcattttccatgattttcacttttcttgccatatttcatgtcctaaagtgtgtatttctcattttcagtgattttcagttttctcgctatattccaggtcctacagtgtgcatttctcattttttcacgtttttcagtgatttcgtcatttttcacgttgtcaagtggatgtttctcattttccatgattttcacttttcttgccatatttcatgtcctacaatggacatttctaaattttccacctttttctgttttcctcgccatatttcacatcctaaagtgtgtatttctcattttccgtgattttcagttttcttgccatattccaggtcctacagtgtgcatttctcatttttcacgtttttcagtgatttcgtcatttttcaagttgtcaagtggatgtttctcattttccttgattttcagttttcttgccatattccatgtcctactgtggacatttctaaattttccacctttttcagttttccttgccatatttcatgtcctaaagtgtgtatttctcattttcagtgattttcagttttctcgcaatattccaggtcctacagtgtgcatttctcattttttcaggtttttcagtgatttcgtcatttttcacgttgtcaagtggatgtttctcattttccatgattttcacttttcttgccatatttcatgtcctaaagtgtgtatttctcattttcagtgattttcagttttctgccatattccaggtcctacattgtgcatttctcattttttcacgtttttcagtgatttcgtcatttttcagttttctcgacatattccaggtcctacagtgtgcatttctaattttttcttttttcagtgatttcgtcatttttcaagttgtcaactgcatgtttctcattttccatgattttcagttttcttgccatattccatgtcttacagtggacatttttaaatttttcacatttttttaagttttcctccccatatttcacgttttaaagtgtgcatttctcattttcggtgattttcagttttctcgccagattccaggtcttacagtgtgcatttctcattttttcacgtttttcagtgatttcgtcatttttcaagtcgtcaagtggatgtttctcattttccatgattttcagttttcttgccatattccatgtcctacagtggaaatttctaaattttccacctttttcagttttccttgccatatttcaggtcctaaagtgtgtatttctcattttctgtgattttcagttttctcgccatattccaggtcctacagttgacatttctaaaatttccacattttttaagttttcctcgccatatttcacttcctaaagtgtgtatttctcattttccgtgattttcagttttctcgccatattccagatcctacagtgtgcatttttcatttttcacgtttttcagtgattttgtcattttttagttgtcaactgtctgtttctcattttccatgattttcagttttcttgccatattccatgtcctacactggacatttctaaattttccacctttttctgttttcctcgccatatttcacgtcctaaagtgtgtatttctcattttccgtgattttcagttttcttgccatattccaggtcctacagtgtgcatttctcatttttcacgtttttcagtgattttgtcatttttcaagttgtcaactgcatgtttctcattttctatgattttcagttttcttgctatattccatgtcctacagtggaaatttctaaattttccacctttttcagttttcctcgccatatttcacgtcctaaagtgtgtatttctcattttccgtgattttcagttttctcgccatattccaggtcctatgtgtacatttctcatttttcacgtttttcagtgattttgtcatttttcaagttgtgaagtggatgtttctcatttttcttgattttcatttttcttgccatattccatgtcctagagtggaaatttttaaattttccacctttttcagttttcctcgccatatttcacgtcctaaagtgtgaatttctcattttccgtgattttcagatttctcgccatattccaagtcctacagtgtgcatttctcatttttcacgtttttcagtgatttcgtcatttttcaagttgtcaagtggatgtttctcattttccatgattttcagctttcttgccatattcaaagtcctacagtggacatttctaaattttcgacctttatcagttttcctcgccatatttcatgtcccaaagtgtgtacttctcattttccgtgattttcagtttcctagccatattctaggtcctacagtgtgcatttctcatttttcaggtttttcagtgatttcgtcttttttcaagtcgtcaagtggatgtttctcattttccatgattttcacttttcttgccatatttcatgtcctaaagtgtgtatttctcattttcagtgattttcagttttctcgctatattccaggtcctacagtgtgcatttctcattttttcacgtttttcagtgatttcgtcatttttcacgttgtcaagtggatgtttctcattttccatgattttcacttttcttgccatatttcatgtcctacagtggacatttctaaattttccacctttttctgttttcctcgccatatttcacatcctaaagtgtgtatttctcattttccgtgattttcagttttcttgccatattccaggtcctacagtgtgcatttctcatttttcacgtttttcagtgatttcgtcatttttcaagttgtcaagtggatgtttctcattttccttgattttcagttttcttgccatattccatgtcctactgtggacatttctaaattttccacctttttcagttttccttgccatatttcatgtcctaaagtgtgtatttctcattttcagtgattttcagttttctcgcaatattccaggtcctacagtgtgcatttctcattttttcaggtttttcagtgatttcgtcatttttcacgttgtcaagtggatgtttctcattttccatgattttcacttttcttgccatatttcatgtcctaaagtgtgtatttctcattttcagtgattttcagttttctgccatattccaggtcctacattgtgcatttctcattttttcacgtttttcagtgatttcgtcatttttcacgttgtcaagtggatgtttctcattttccatgattttcacttttcttgccatatttcatgttttacagtggacatttctaaattttccacctttttctgttttcctcgccatatttcacatcctaaagtgtgtatttctcattttccgtgattttcagttttctcgccatatgccaggtcatacagggtgcatttctcatttttcacgtttttcagtgatttcgtcatttttcacgtcgtcaagtggatgtttctcattttcaatgattttcatttttcttgccatattccacgtcctatagtggacatttctaaattttccacctttttcagttttccttgccatatttcaggtcctacagtgtgcatttctcatttttcacgtttttcagtgatttcgtcatttttcaagtggtcaagtgcatgtttctcattttccgtgattttcagttttcttgccatgttccaggtcctacagttgacgtttctaaaatttcactttttttaagttttcctcgccatatttcacttcctaaagtgtgtatttctcattttccgtgattttcagttttctcgccagattccaggtcctacagtgtgcatttttcatatttcacctttttcagtgattttgtcatttttcaagttgtcaactgcatgtttctcattttccatgattttcagttttcttgccatattccatgtcctactgtggacatttctaaattttccaactttttcagttttcctcgccatatttcatgtcctaaagtgtgtatttctcattttcagtgattttctgttttctcgccatattccaggtcctacagtgtgcatttctaatttttcacgtttttcagtgatttcgtcatttttcaagttgtcaagtggatgtttctcattttccatgattttcagttttcttgccatattccatgtcctacagtggacatttctaaattttccaactttttccattttcctcaccatatttcacgtcctaaagtgtgtttttctcattttttgtgattttcagttttctcgacatattccaggtcctacagtgtgcatttctaattttttcttttttcagtgatttcgtcatttttcaagttgtcaactgcatgtttctcattttccatgattttcagttttcttgccatattccatgtcttacagtggacatttttaaatttttcacatttttttaagttttcctccccatatttcacgttttaaagtgtgcatttctcattttcggtgattttcagttttctcgccagattccaggtcttacagtgtgcatttctcattttttcacgtttttcagtgatttcgtcatttttcaagtcgtcaagtggatgtttctcattttccatgattttcagttttcttgccatattccatgtcctacagtggaaatttctaaattttccacctttttcagttttccttgccatatttcaggtcctaaagtgtgtatttctcattttctgtgattttcagttttctcgccatattccaggtcctacagttgacatttctaaaatttccacattttttaagttttcctcgccatatttcacttcctaaagtgtgtatttctcattttccgtgattttcagttttctcgccatattccagatcctacagtgtgcatttttcatttttcacgtttttcagtgattttgtcattttttagttgtcaactgtctgtttctcattttccatgattttcagttttcttgccatattccatgtcctacactggacatttctaaattttccacctttttctgttttcctcgccatatttcacgtcctaaagtgtgtatttctcattttccgtgattttcagttttcttgccatattccaggtcctacagtgtgcatttctcatttttcacgtttttcagtgattttgtcatttttcaagttgtcaactgcatgtttctcattttccatgattttcagttttcttgctatattccatgtcctacagtggaaatttctaaattttccacctttttcagttttcctcgccatatttcacgtcctaaagtgtgtatttctcattttccgtgattttcagttttctcgccatattccaggtcctatgtgtacatttctcatttttcacgtttttcagtgattttgtcatttttcaagttgtgaagtggatgtttctcatttttcttgattttcatttttcttgccatattccatgtcctagagtggaaatttttaaattttccacctttttcagttttcctcgccatatttcacgtcctaaagtgtgaatttctcattttccgtgattttcagatttctcgccatattccaagtcctacagtgtgcatttctcatttttcacgtttttcagtgatttcgtcatttttcaagttgtcaagtggatgtttctcattttccatgattttcagctttcttgccatattcaaagtcctacagtggacatttctaaattttcgacctttatcagttttcctcgccatatttcatgtcccaaagtgtgtacttctcattttccgtgattttcagtttcctcgccatattctaggtcctacagtgtgcatttctcatttttcaggtttttcagtgatttcgtcttttttcaagtcgtcaagtggatgtttctcattttccatgattttcagttttcttgccatattccatgtcctacagtggacatttctaaattttccacctttttcagttttcctcgccatatttcatgtcctaaagtgtgtatttctcattttcagtgattttcagttttctcgccatattccaggtcctacagtgtgcatttctcatttttcacgtttttcagtgatttcgtcatttttcaagttgtcaagtggatgtttctcattttccatgattttcagttttcttgccatattccatgtcccacagtggacatttctaaattttccacctttttctgttttccttgccatatttcatgtcctaaagtgtgtatttctcattttccgtgattttcagttttcttgctatattccaagtcctacagtgtgcatttctcatttttcacgtttttcagtgattttgtcatttttcaatttgtcaactgcatgtttctcattttccatgattttcagttttcttgccatattccatgtcctacagtggaaatttctatattttccaactttttcagttttcctcgccatatttcacgtgctaaagtgtgtatttctcatttttcgtgtttttcaggtttctcgccatattccaggtcctacagtgtgcatttctcatttttcacgtttttcagtgattttgtcatttttcaagttgtcaagtggatgtttctcattttccttgattttcagttttcttgccatattccatgtcctacagtggacatttctaaattttccacctttttcagttttccttgccatatttcatgtcctaaagtgtgtatttctcattttcagtgattttcagttttctcgccatattccaggtcctacagtgtgcatttctcattttttcaggtttttcagtgatttcgtcatttttcacgttgtcaagtggatgtttctcattttccatgattttcacttttcttgccatatttcatgtcctaaagtgtgtatttctcattttcagtgattttcagttttctcgctatattccaggtcctacagtgtgcatttctcattttttcacgtttttcagtgatttcgtcatttttcacgttgtcaagtggatgtttctcattttccatgattttcacttttcttgccatatttcatgtcctacagtggacatttctaaattttccacctttttctgttttcctcgccatatttcacatactaaagtgtgtatttctcattttccttgattttcagttttcttgccatattccaggtcctacagtgtgcatttctcatttttcacgtttttcagtgatttcgtcatttttcaagtcgtcaagtggatgtttctcattttccatgattttcagttttctcgccatattccaggtcctacagttgacatttctaaattttccacattttttaagtttcctcgcgatatttcacatcctaaagtgtgtatttctcattttccgtgattttcagttttcttgccatattccaggtcctacagggtgcatttctcatttttcacgtttttcagtgatttcatcaatttcaagtcgtcaactgtatgtttctcattttcaatgattttcatttttcttgccatattccatgtcctacagtggacatttctaaatttttcacctttttcagttttccttgccatatttcatgtcctaaagtgtgtatttctcattttcagtgattttcagttttctcgccatattccaggtcctacagtgtgcatttctcattttttcaggtttttcagtgatttcgtcatttttcacgttgtcaagtggatgtttctcattttccatgattttcacttttcttgccatatttcatgtcctaaagtgtgtatttctcattttcagtgattttcagttttctcgccatattccaggtcctacagtgtgcatttctcatttttcacgtttttcagtgatttcgtcatttttcaagttgtcaagtggatgtttctcattttccatgattttcacttttcttgccatattccatgtcccacagtggacatttctaaattttccacctttttctgttttcctcgccatatttcatgtcctaaagtgtgtatttctcattttccgtgattttcagttttcttgctatattccaagtcctacagtgtgcatttctcatttttcacgtttttcagtgattttgtcatttttcaatttgtcaactgcatgtttctcattttccatgattttcagttttcttgccatattccatgttctacagtggaaatttctatattttccaactttttcagttttcctcgccatatttcacgtgctaaagtgtgtatttctcatttttcgtgtttttcaggtttctcgccatattccaggtcctacagtgtgcatttctcatttttcacgtttttcagtgattttgtcatttttcaagttgtcaagtggatgtttctcattttccttgattttcagttttcttgccatattccatgtcctacagtggacatttctaaattttccacctttttcagttttccttgccatatttcatgtcctaaagtgtgtatttctcattttcagtgattttcagttttctcgccatattccaggtcctacagtgtgcatttctcattttttcaggtttttcagtgatttcgtcatttttcacgttgtcaagtggatgtttctcattttccatgattttcacttttcttgccatatttcatgtcctaaagtgtgtatttctcattttcagtgattttcagttttctcgctatattccaggtcctacagtgtgcatttctcattttttcacgttttgcagtgatttcgtcatttttcacgttgtcaagtggatgtttctcattttccatgattttcacttttcttgccatatttcatgtcctacagtggacatttctaaattttccacctttttctgttttcctcgccatatttcacatcctaaagtgtgtatttctcattttccgtgattttcagttttcttgccatattccaggtcctacagtgtgcatttctcatttttcacgtttttcagtgatttcgtcatttttcaagtcgtcaagtggatgtttctcattttccatgattttcagttttctcgccatattccaggtcctacagttgacatttctaaattttccacattttttaagtttcctcgcgatatttcacatcctaaagtgtgtatttctcattttccgtgattttcagttttcttgccatattccaggtcctacagggtgcatttctcatttttcacgtttttcagtgatttcatcaatttcaagtcgtcaactgtatgtttctcattttcaatgattttcatttttcttgccatattccatgtcctacagtggacatttctaaattttccacctttttcagttttccttgccatatttcatgtcctaaagtgtgtatttctcattttcagggattttcagttttctcgccatattccaggtcctacagtgtgcatttctcattttttcaggtttttcagtgatttcgtcatttttcacgttgtcaagtggatgtttctcattttccatgattttcacttttcttgccatatttcatgtcctaaagtgtgtatttctcattttcagtgattttcagttttctcgccatattccaggtcctacagtgtgcatttctcattttttcacgtttttcagtgatttcgtcatttttcacgttgtcaagtggatgtttctcattttccatgattttcacttttcttgccatatttcatgtcctacagtggacatttctaaattttccacctttttctgttttcctcgccatatttcacatcctaaagtgtgtatttctcattttccgtgattttcagttttcttgccatattccaggtcctacagtgtgcatttctcatttttcacgtttttcagtgatttcgtcatttttcaagtcgtcaagtggatgtttctcattttccatgattttcagttttctcgccatattccaggtcctacagttgacatttctaaattttccacattttttaagtttcctcgcgatatttcacatcctaaagtgtgtatttctcattttccgtgattttcagttttcttgccatattccaggtcctacagggtgcatttctcatttttcacgtttttcagtgatttcatcaatttcaagtcgtcaactgtatgtttctcattttcaatgattttcatttttcttgccatattccacgtcctatagtggacatttctaaattttccacctttttcagttttcttcgccatatttcacgtcccaaagtgtgtatttctcattttccgtgattttcagtttcctcgcaatattccaggtcctacagtgtgcatttctcatttttcacgtttttcagtgatttcgtcttttttcaagtcgtcaagtggatgtttctcattttccatgattttcagttttcttgccatattccatgtcctacagtggacatttctaaattttccacctttttctgttttcctcgccatatttcacgtcctaaagtgtgtatttctcattttccgtgattttcagttttcttgccatattccaggtcctacagtgtgcatttctcatttttcacgtttttcactgattttgtcattgttcaagttgtcaactgcatgtttctcattttccatgattttcaattttcttgccatattccatgtcctacagtggaaatttctatattttccaactttttcagttttcctcgccatatttcacgtgctaaagtgtgtatttctcatttttcgtgtttttcaggtttctcgccatattccaggtcctacagtgtgcatttctcatttttcacgtttttcagtgattttgtcatttttcaagttgtcaagtggttgtttctcattttccttgattttcagttttcttgccatattccatgtcctactgtggacatttctaaattttccacctttttcagttttccttgccatatttcatgtcctaaagtgtgtatttctcattttcagtgattttcagttttctcgcaatattccaggtcctacagtgtgcatttctcattttccgtgattttcagttttctcgccatatgccaggtcatacagggtgcatttctcatttttcacgtttttcagtgatttcgtcatttttcacgtcgtcaagtggatgtttctcattttcaatgattttcatttttcttgccatattccacgtcctatagtggacatttctaaattttccaactttttcagttttcttgccatatttcaggtcctacagtgtgcatttctcatttttcacgtttttcagtgatttcgtcatttttcaagtggtcaagtgcatgtttctgattttccgtgattttcagttttcttgccatgttccaggtcctacagttgacgtttctaaaatttcactttttttaagttttcctcgccatatttcacttcctaaagtgtgtatttctcattttccgtgattttcagttttctcgccagattccaggtcctacagtgtgcatttttcatatttcacctttttcagtgattttgtcatttttcaagttgtcaactgcatgtttctcattttccatgattttcagttttcttgccatattccatgtcctactgtggacatttctaaattttccaactttttcagttttcctcgccatatttcatgtcctaaagtgtgtatttctcattttcagtgtttttctgttttctcgccatattccaggtcctacagtgtgcatttctaatttttcacgtttttcagtgatttcgtcatttttcaagttgtcaagtggatgtttctcattttccatgattttcagttttcttgccatattccatgtcctacagtggacatttctaaattttccaactttttccattttcctcaccatatttcacgtcctaaagtgtgtttttctcattttttgtgattttcagttttctcgacatattccaggtcctacagtgtgcatttctaattttttcttttttcagtgatttcgtcatttttcaagtggtcaagtgcatgtttctcattttccatgattttcagttttcttgccatattccatgtcctacaatggacatttctaaattttccaactttttcagttttcctcgccatatttcacgtcctaaagtgtgtatttctcattttccgtgattttcagttttctcgccatattccaggtcctatgtgtacatttctcatttttcacgtttttcagtgattttgtcatttttcaagttgtgaagtggatgtttctcatttttcttgattttcatttttcttgccatattccatgtcctagagtggaaatttttaaattttccaactttttcagttttcctcgccatatttcacgtcctaaagtgtgtatttctcattttccgtgattttcagttttctcgccatattccaagtcctacagtgtgcatttctcatttttcacgtttttcagtgatttcgtcatttttcaagttgtcaagtggatgtttctcattttccatgattttcagctttcttgccatattcaaagtcctacagtggacatttctaaattttcgacctttatcagttttcctcgccatatttcatgtcccaaagtgtgtacttctcattttccgtgattttcagtttcctcgccatattctaggtcctacagtgtgcatttctcatttttcaggtttttcagtgatttcgtcttttttcaagtcgtcaagtggatgtttctcattttccatgattttcagttttcttgccatattccatgtcctacagtggacatttctaaattttccacctttttcagttttcctcgccatatttcatgtcctaaagtgtgtatttctcattttcagtgattttcagttttctcgccatattccaggtcctacagtgtgcatttctcatttttcacgtttttcagtgatttcgtcatttttcaagttgtcaagtggatgtttctcattttccatgattttcagttttcttgccatattccatgtcccacagtggacatttctaaattttccacctttttctgttttccttgccatatttcatgtcctaaagtgtgtatttctcattttccgtgattttcagttttcttgctatattccaagtcctacagtgtgcatttctcatttttcacgtttttaagtgattttgtcatttttcaatttgtcaactgcatgtttctcattttccatgattttcagttttcttgccatattccatgtcctacagtggaaatttctatattttccaactttttcagttttcctcgccatatttcacgtgctaaagtgtgtatttctcatttttcgtgtttttcaggtttctcgccatattccaggtcctacagtgtgcatttctcatttttcacgtttttcagtgattttgtcatttttcaagttgtcaagtggatgtttctcattttccttgattttcagttttcttgccatattccatgtcctacagtggacatttctaaattttccacctttttcagttttccttgccatatttcatgtcctaaagtgtgtatttctcattttcagtgattttcagttttctcgccatattccaggtcctacagtgtgcatttctcattttttcaggtttttcagtgatttcgtcatttttcacgttgtcaagtggatgtttctcattttccatgattttcacttttcttgccatatttcatgtcctaaagtgtgtatttctcattttcagtgattttcagttttctcgccatattccaggtcctacagtgtgcatttctcattttttcacgtttttcagtgatttcgtcatttttcacgttgtcaagtggatgtttctcattttccatgattttcacttttcttgccatatttcatgtcctacagtggacatttctaaattttccacctttttctgttttcctcgccatatttcacatcctaaagtgtgtatttctcattttccgtgattttcagttttcttgccatatttcaggtcctacagtgtgcatttctcatttttcacgtttttcagtgatttcgtcatttttcaagtcgtcaagaggatgtttctcattttccatgattttcagttttctcgccatattccaggtcctacagttgacatttctaaattttccacattttttaagtttcctcgcgatatttcacatcctaaagtgtgtatttctcattttccgtgattttcagttttcttgccatattccaggtcctacagggtgcatttctcatttttcacgtttttcagtgatttcatcaatttcaagtcgtcaactgtatgtttctcattttcaatgattttcatttttcttgccatattccacgtcctatagtggacatttctaaattttccacctttttctgttttcctcgccatatttcacgtcctaaagtgtgtatttctcattttccgtgattttcagttttcttgccatattccaggtcctacagtgtgcatttctcatttttcacgtttttcactgattttgtcattgttcaagttgtcaactgcatgtttctcattttccatgattttcagttttcttgccatattccatgtcctacagtggaaatttctatattttccacctttttcagttttcctcgccgtatttcatgtgctaaagtgtgtatttctcatttttcgtgtttttcaggtttctcgccatattccaggtcctacagtgtgcatttctcatttttcacgtttttcagtgattttgtcatttttcaagttgtcaactggatgtttctcattttccttgattttcagttttcttgccatattccatgtcctactgtggacatttctaaattttccacctttttcagttttccttgccatatttcatgtcctaaagtgtgtatttctcattttcagtgattttcagttttctcgcaatattccaggtcctacagtgtgcatttctcattttttcaggtttttcagtgatttcgtcatttttcacgttgtcaagtggatgtttctcattttccatgattttcacttttcttgccatatttcatgtcctaaagtgtgtatttctcattttcagtgattttcagttttctcgccatattccaggtcctacattgtgcatttctcattttttcacgtttttcagtgatttcgtcatttttcacgttgtcaagtggatgtttctcattttccatgattttcacttttcttgccatatttcatgttttacagtggacatttctaaattttccacctttttctgttttcctcgccatatttcacatcctaaagtgtgaatttctcattttccgtgattttcagttttcttgccatattccaggtcctacagtgtgcatttctcatttttcacgtttttcagtgatttcatcatttttcaagtcgtcaagtggatgtttctcattttccatgattttcagttttcttgccatattccatgtcctacagtggacatttctaaattttccacctttttctgttttcctcgccatatttcacgtcctaaagtgtgtatttctcattttccgtgattttcagttttcttgccatattccaggtcctacagtgtgcatttctcatttttcacgtttttcactgattttgtcatttttcaagttgtcaactgcatgtttctcattttccatgattttcagttttcttgctatattccatgtcctacagtggaaatttctaaattttccacctttttcagttttcctcgccatatttcacgtcctgaagtgtgtatttctcattttccgtgattttcagttttctcgccatattccaggtcctatgtgtacatttctcatttttcacgtttttcagtgattttgtcatttttcaagttgtgaagtggatgtttctcatttttcttgattttcatttttcttgccatattccatgtcctacagtggaaatttctaaattttccacctttttcagttttcctcgccatatttcacgtcctaaagtgtgtatttctcattttccgtgattttcagttttctcgccatattccaggtcctacagtgtgcatttctcatttttcacgtttttcagtgatttcgacatttttcaagttgtcaagtggatgtttctcattttccatgattttcagctttcttgccatattcaaagtcctacagtggacatttctaaattttcgacctttatcagttttcctcgccatatttcatgtcccaaagtgtgtacttctcattttccgtgattttcagtttcctcgccatattccaggtcctacagtgtgcatttctcatttttcacgtttttcagtgatttcgtcatttttcaagtcgtcaagtggatgtttctcattttccatgattttcagttttcttgccatattccatgtcctacagtggacatttctaaattttccacctttttctgttttcctcgccatatttcacgtcctaaagtgtgtatttctcattttccgtgattttcagttttcttgccatattccaggtcctacagtgtgcatttctcatttatcacgtttttcactgattttgtcatttttcaagttgtcaactgcatgtttctcattttccatgattttcagttttcttgctatattccatgtcctacagtggaatattctaaattttccacctttttcagttttcctcgccatatttcacgtcctgaagtgtgtatttctcattttccgtgattttcagttttctcgccatattccaggtcctatgtgtacatttctcatttttcacgtttttcagtgattttgtcatttttcaagttgtgaagtggatgtttctcatttttcttgattttcatttttcttgccatattccatgtcctacagtggaaatttctaaattttccacctttttcagttttcctcgccatatttcacgtcctaaagtgtgaatttctcattttccgtgattttcagttttctcgccatattccaggtcctacagtgtgcatttctcatttttcacgtttttcagtgatttcgacatttttcaagttgtcaagtggatgtttctcattttccatgattttcagctttcttgccatattcaaagtcctacagtggacatttctaaattttcgacctttatcagttttcctcgccatatttcatgtcccaaagtgtgtacttctcattttccgtgattttgagtttcctcgccatattccaggtcctacagtgtgcatttctcatttttcacgtttttcagtgatttcgtcttttttcaagttgtcaactgcatgtttctcattttccatgattttcagttttcttgccatattccatgtcctacagtggaaatttgtaaatttccacctttttcagttttcctcgccatatttcacgtcctaaagtatgtatttctcattttccgtgattttcagttttctcgccatattccaggtcctacagtgtgcatttctcatttttcacgtttttcagtgattttgtcattttttaagttttcaagtggatgtttctcattttccttgattttcagttttcttgccatattccatgtcctacagtggacatttctaaattttccacctttttcagttttcctcgccatatttcatgtcctaaagtgtgtatttctcattttcagtgattttcagttttctcgccatattccaggtcctacagtgtgcatttctcatttttcacgtttttcagtgatttcgtcatttttcaaggtgtcaagtggatgtttctcattttccatgattttcagttttcttgccatattccatgtcctacagtggacatttctaaattttccacctttttctgttttcctcgccatatttcatgtcctaaagtgtgtatttctcattttccgtgattttcagttttcttgctatattccaagtcctacagtgtgcatttctcatttttcacgtttttcagtgattttgtcatttttcaatttgtcaactgcatgtttctcattttccatgattttcagtttttttgccatattccatgtcctactgtggaaatttctatattttccacctttttcagttttcctcgccatatttcacgtgctaaagtgtgtatttctcatttttcgtgtttttcaggtttctcgccatattccaggtcctacagtgtgcatttctcatttttcacgtttttcagtgattttgtcatttttcaagttttcaagtggatgtttctcattttccttgattttcagttttcttgccatattccatgtcctacagtggacatttctaaattttccacctttttcagttttccttgccatatttcatgtcctaaagtgtgtatttctcattttcagtgattttcagtttccttgccatattccaggtcctacagtgtgcatttctcattttttcacgtttttcagtgatttcgtcatttttcacgttgtcaagtggatgtttctcattttccatgattttcacttttcttgccatatttcatgtcctacagtggacatttctaaattttccaactttttcaattttcctcgccatattttatgtcctaaagtgtgtatttctcatttttcgttattttcagttttcttgccatattccaggtcctacagtgtgcatttgtcatttttcacgtttttcagtgatttcgtcatttttcaagtcgtcaagtagatgtttctcatattccatgtttttcagttttctcgccatattccaggtcctacagttgacatttctaaattttctacatttttaaattttcctcgccatatttcacgtcctaaagtgtgtatttctcattttttgttattttcagttttctagccatattccaggtcctacaggatgcatttctcatttttcacgtttttcagtgatttcatcatttttcaagtcgtcaagtgtatgtttcttattttcaatgattttcatttttcttgccttattccacgtcctatagtggacatttctaaattttccacctttttcagtttttttcgccatatttcacgtcctaaagtgtgtatttctcattttctgtgattttcagttttctcaccatattccaggtcctacagtgtgcatttctcatttttcacgtttttcagtgatttcgtcatttttcaagttgtcaagtggaagtttctcattttccatgattttcagctttctagacatattccaggtcctacagtggacatttcctaattttcgacctttatcagttttcctcgtcatatttcacgtcccaaaatgtgtatttcttattttccatgattttcagtttcctcgccatattccaggtcctacagtgtgcaattctcatttttcacgtttttcagtgatttcgtcttttttcaagacgtcaagtggatgtttctcatttttcatgattttcagttttcttgccatattccatgtcctacagtggacatttctaaattttccacctttttctgttttcctcgccatatttcacgtcctaaagtgtgtatttctcattttccgtgattttcagttttcttgccatattcctggtcctacagtgtgcatttctcatttttcacgtttttcagtgattttgtcatttttcaatttgtcaactgcatgtttctcattttccattattttcagttttcttgccatattccatgtcctacagtggacatttctaaattttccacctttttctgttttcctcgccatatttcatgtcctaaagtgtgtatttctcattttccgtgattttcagttttcttgctatattccaagtcctacagtgtgcatttctcatttttcacgtttttcagtgattttgtcatttttcaatttgtcaactgcatgtttctcattttccatgattttcagtttttttgccatattccatgtcctacaggggaaatttctatattttccacctttttcagttttcctcgccatatttcatgtcctaaagtgtgtatttctcattttccgtgattttcagttttcttgccatattccaggtcctacagtgtgcatttctcatttttcacgtttttcagtgatttcgtcatttttcaagtcttcaagtagatgtttctcatattccatgtttttcagttttctcgccatattccaggtcctacagttgacatttctaaattttctacatttttaaattttcctcgccatatttcacgtcctaaagtgtgtatttctcatttttcgttattttcagttttctagccatattccaggtcctacaggatgcatttctcatttttcacgtttttcagtgatttcatcatttttcaagtcgtcaagtgtatgtttctcattttcaatgattttcatttttcttgccttattccacgtcctatagtggacatttctaaattttccacctttttcagtttttctcgccatatttcacgtcctaaagtgtgtatttctcattttctgtgattttcagttttctcaccatattccaggtcctacagtgtgcatttctcatttttcacgtttttcagtgatttcgtcatttttcaagttgtcaagtggaagtttctcattttccatgattttcagctttctagccatattccaggtcctacagtggacatttcctaattttcgacctttatcagttttcctcgccatatttcacgtcctaaagtgtgtatttctcattttccgtgattttcagttttcttgccatattccaggtcctacagtgtgcatttctcatttttcacgtttttcagtgattttgtcatttttcaatttgtcaactgcatgtttctcattttccatgatttttagttttcttgctatattccatgtcctacagtggaaatttctaaattttccacctttttcagttttcctcgccatatttcacgtcctaaagtgtgtatttctcattttccgtgattttcagttttcttgctatattccaagtcctacattgtgcatttctcatttttcacgtttttcagtgattttgtcatttttcaatttgtcaaaccacatgtttctcattttccatgattttcagtttttttgccatattccatgtcctacagtggaaatttctatattttccacctttttcagttttcctcgccatatttcacgtgctaaagtgtgtatttctcatttttcgtgtttttcaggtttctcgccatattccaggtcctacagtgtgcatttctcatttttcacgtttttcagtgattttgtcatttttcaagttgtcaagtggatgtttcccattttccttgattttcagttttcttaccatattccatgtcctacagtggacatttctaaattttccacctttttcagttttccttgccatatttcatgtcctaaagtgtgtatttctcattttcagtgattttcagtttcctcgccatattccaggtcctacagtgtgcatttctcattttttcacgtttttcagtgatttcgtcatttttcacgttgtcaagtggatgtttctcattttccatgattttcacttttcttgccatatttcatgtcctatagtggacatttctaaattttccacctttttcagtttttctcgccatatttcacgtcctaaagtgtgtatttctcattttctgtgattttcagttttctcaccatattccaggtcctacagtgtgcatttctcatttttcacgtttttcagtgatttcgtcatttttcaagtcgtcaagtagatgtttctcatattccatgtttttcagttttctcgccatattccaggtcctacagttgacatttctaaattttctacatttttaaattttcctcgccatatttcacgtcctaaagtgtgtatttctcatttttcgttattttcagttttctagccatattccaggtcctacaggatgcatttctcatttttcacgtttttcagtgatttcatcatttttcaagtcgtcaagtgtatgtttcttattttcaatgattttcatttttcttgccttattccacgtcctatagtggacatttctaaattttccaccttttttcagtttttctcgccatatttcacgtcctaaagtgtgtatttctcattttctgtgattatcagttttctcaccatattccaggtcctacagtgtgcatttctcatttttcacgtttttcagtgatttcgtcatttttcaagttgtcaagtggaagtttctcattttccatgattttcagctttctagccatattccaggtcctacagtggacatttcctaattttcgacctttatcagttttcctcgccatatttcacgtcccaaaatgtgtatttcttattttccatgattttcagtttcctcgccatattccaggtcctacagtgtgcatttctcatttttcacgtttttcagtgatttcgtcttttttcaagacgtcaagtggatgtttctcatttttcatgattttcagttttcttgccatattccatgtcctacagtggacatttctaaattttccacctttttctgttttcctcgccatatttcacgtcctaaagtgtgtatttctcattttccgtgattttcagttttcttgccatattcctggtcctacagtgtgcatttctcatttttcacgtttttcagtgattttgtcatttttcaatttgtcaactgcatgtttctcattttccatgattttcagttttcttgccatattccatgtcctacagtggacatttctaaattttccacctttttcagttttcctcgccatatttcacgtgctaaagtgtgtatttctcatttttcgtgtttttcaggtttctcgccatattccaggtcctacagtgtgcatttctcatttttcacgtttttcagtgattttgtcatttttcaagttgtcaagtggatgtttctcattttccttgattttcacttttcttgccatattccaagtcttacaggggcatttctcatttttcacgttttcagtgattttgtcattttcaatttgtcaactgcatgtttctcattttccatgattttcagtttttttgccatattccatgtcctacaggggaaatttctatattttccacctttttcagttttcctcgccatatttcatgtcctaaagtgtgtatttctcattttccgtgattttcagttttcttgccatattccaggtcctacagtgtgcatttctcatttttcacgtttttcagtgatttcgtcatttttcaagtcttcaagtagatgtttctcatattccatgtttttcagttttctcgccatattccaggtcctacagttgacatttctaaattttctacatttttaaattttcctcgccatatttcacgtcctaaagtgtgtatttctcatttttcgttattttcagttttctagccatattccaggtcctacaggatgcatttctcatttttcacgtttttcagtgatttcatcatttttcaagtcgtcaagtgtatgtttctcattttcaatgattttcatttttcttgccttattccacgtcctatagtggacatttctaaattttccacctttttcagtttttctcgccatatttcacgtcctaaagtgtgtatttctcattttctgtgattttcagttttctcaccatattccaggtcctacagtgtgcatttctcatttttcacgtttttcagtgatttcgtcatttttcaagttgtcaagtggaagtttctcattttccatgattttcagctttctagccatattccaagtcctacagtggacatttcctaattttcgacctttatcagttttcctcgccatatttcacgtcccaaaatgtgtattccttattttccatgattttcagtttcctcgccatattccaggtcctacagtgtgcatttatcatttttcacgtttttcagtgatttcgtcttttttcaagacgtcaagtggatgtttctcatttttcatgattttcagttttcttgccatattccatgtcctacagtggacatttctaaattttccacctttttctgttttcctcgccatatttcacgtcctaaagtgtgtatttctcattttccgtgattttcagttttcttgccatattcctggtcctacagtgtgcatttctcatttttcacgtttttcagtgattttgtcatttttcaagttgtcaagtggatgtttctcattttccttgattttcacttttcttgccatattccatgtcctacagtggacatttctatattttccacctttttccgttttccttgccatatttcacgtcctaaagtgtgtatttctcattttccgtgattttcaggtttctcgccatattccaggtcctacagtgtgcatttctcatttttcacgtttttcagtgattttgtcatttttcaagttgtcaagtggatgtttctcattttccttgattttcacttttcttgccatattccatgtcctacagtggacatttctaaattttccacctttttcagttttcctcgccatatttcatgtcctaaagtgtgtatttctcattttcagtgattttcagttttcttgccatattccaggtcctacagtgtgcatttctcatttttcacgtttttcagtgattttgtcatttttcaagttgtcaactgcatgtttctcattttctatgattttcagttttcttgctatattccatgtcctacagtggaaatttctaaattttccacctttttcagttttcctcgccatatttcacgtcctaaagtgtgtatttctcattttccgtgattttcagttttctcgccatattccaggtcctatgtgtacatttctcatttttcacgtttttcagtgattttgtcatttttcaagttgtgaagtggatgtttctcatttttcttgattttcatttttcttgccatattccatgtcctagagtggaaatttttaaattttccacctttttcagttttcctcgccatatttcacgtcctaaagtgtgaatttctcattttccgtgattttcagatttctcgccatattccaagtcctacagtgtgcatttctcatttttcacgtttttcagtgatttcgtcatttttcaagttgtcaagtggatgtttctcattttccatgattttcagctttcttgccatattcaaagtcctacagtggacatttctaaattttcgacctttatcagttttcctcgccatatttcatgtcccaaagtgtgtacttctcattttccgtgattttcagtttcctcgccatattctaggtcctacagtgtgcatttctcatttttcaggtttttcagtgatttcgtcttttttcaagtcgtcaagtggatgtttctcattttccatgattttcacttttcttgccatatttcatgtcctaaagtgtgtatttctcattttcagtgattttcagttttctcgctatattccaggtcctacagtgtgcatttctcattttttcacgtttttcagtgatttcgtcatttttcacgttgtcaagtggatgtttctcattttccatgattttcacttttcttgccatatttcatgtcctacagtggacatttctaaattttccacctttttctgttttcctcgccatatttcacatcctaaagtgtgtatttctcattttccgtgattttcagttttcttgccatattccaggtcctacagtgtgcatttctcatttttcacgtttttcagtgatttcgtcatttttcaagttgtcaagtggatgtttctcattttccttgattttcagttttcttgccatattccatgtcctactgtggacatttctaaattttccacctttttcagttttccttgccatatttcatgtcctaaagtgtgtatttctcattttcagtgattttcagttttctcgcaatattccaggtcctacagtgtgcatttctcattttttcaggtttttcagtgatttcgtcatttttcacgttgtcaagtggatgtttctcattttccatgattttcacttttcttgccatatttcatgtcctaaagtgtgtatttctcattttcagtgattttcagttttcctcgccatatttcacgtcccaaaatgtgtatttcttattttccatgattttcagtttcctcgccatattccaggtcctacagtgtgcatttctcatttttcacgtttttcagtgatttcgtcttttttcaagacgtcaagtggatgtttctcatttttcatgattttcagttttcttgccatattccatgtcctacagtggacatttctaaattttccacctttttctgttttcctcgccatatttcacgtcctaaagtgtgtatttctcattttccgtgattttcagttttcttgccatattcctggtcctacagtgtgcatttctcatttttcacgtttttcagtgattttgtcatttttcaatttgtcaactgcatgtttctcattttccatgattttcagttttcttgccatattccatgtcctacagtggacatttctaaattttccacctttttcagttttcctcgccatatttcacgtgctaaagtgtgtatttctcatttttcgtgtttttcaggtttctcgccatattccaggtcctacagtgtgcatttctcatttttcacgtttttcagtgattttgtcatttttcaagttgtcaagtggatgtttctcattttccttgattttcacttttcttgccatattccatgtcctacagtggacatttctaaattttccacctttttcagttttcctcgccatatttcatgtcctaaagtgtgtatttctcattttcagtgattttcagttttctcgccatattccaggtcctacagtgtgcatttctcatttttcacgtttttcagtgatttcgtcttttttcaagacgtcaagtggatgtttctcattttccatgattttcagttttcttgccatattccatgtcctacagtggacatttctaaattttccacctttttctgttttcctcgccatatttcacgtcctaaagtgtgtatttctcattttccgtgattttcagttttcttgccatattccaggtcctacagtgtgcatttctcatttttcacgtttttcagtgattttgtcatttttcaatttgtcaactgcatgtttctcattttccatgatttttagttttcttgctatattccatgtcctacagtggaaatttctaaattttccacctttttcagttttcctcgccatatttcacgtcctaaagtgtgtatttctcattttccgtgattttcagttttcttgctatattccaagtcctacattgtgcatttctcatttttcacgtttttcagtgattttgtcatttttcaatttgtcaaaccacatgtttctcattttccatgattttcagtttttttgccatattccatgtcctacagtggaaatttctatattttccacctttttcagttttcctcgccatatttcacgtgctaaagtgtgtatttctcatttttcgtgtttttcaggtttctcgccatattccaggtcctacagtgtgcatttctcatttttcacgtttttctgtgattttgtcatttttcaagttgtcaagtggatgtttctcattttccttgattttcagttttcttaccatattccatgtcctacagtggacatttctaaattttccaccttttctgttttcctcgccatatttcatgtcctaaagtgtgtatttctcattttccgtgattttcatttttcttgctatattccaagtcctacagtgtgcatttctcattttccatgattttcagttttcttgctatattccatgtcctacagtggaaatttctaaattttccacctttttcagttttcctcgccatatttcacgtcctaaagtgtgtatttctcattttccgtgattttcagttttttcgccatattacaggtcctatgtgtacatttctcatttttcacgtttttcagtgattttgtcatttttcaagttgtcaagtggatgtttctcatttttcttgattttcatttttcttgccatattccatgtcctacagtggaaatttctaaattttccacctttttcagttttcctcgccatatttcacgtcctaaagtgtgaatttctcattttccgtgattttcagttttctcgccatattccaggtctacagtgtgcatttctcatttttcacgttttcagtgattcgtcatttttcaagttgacaagtggatgtttctcattttccatgattttcagctttcttgccatattcaaagtcctacagtggacatttctaaattttcgacctttatcagttttcctcgccatatttcatgtcccaaagtgtgtacttctcattttccgtgattttcagttttcttgccatattccaagtcctacagtgtgcatttctcatttttcacgtttttcagtgattttgtcatttttcaatttgtcaactgcatgtttctcattttccatgattttcagttttcttgccatattccatgtcctacagtggaaatttctatattttccacctttttcagttttcctcgccatatttcacgtgctaaagtgtgtatttctcatttttcgtgtttttcaggtttctcgccatattccaggtcctacagtgtgcatttctcatttttcacgtttttcagtgattttgtcatttttcaagttgtcaagtggatgtttctcattttcaatgattttcatttttcttgccttattccacgtcctatagtggacatttctaaattttccacctttttcagtttttctcgccatatttcacgtcccaaaatgtgtattccttattttccatgattttcagtttcctcgccatattccaggtcctacagtgtgcatttctcatttttcacgtttttcagtgatttcgtcttttttcaagacgtcaagtggatgtttctcatttttcatgattttcagttttcttgccatattccctgtcctacagtggacatttctaaattttccacctttttctgttttcctcgccatatttcacgtcctaaagtgtgtatttctcattttccgtgattttcagttttctcgccagattccaggtcctacagtgtgcatttctcatttttcacgtttttcagtgattttgtcatttttcaatttgtcaactgcatgtttctctctttccatgattttcagttttcttgccatattccatgtcctacagtggacatttctaaattttccacctttttcagttttcctcgccatatttcacgtgctaaagtgtgtatttctcatttttcgtgtttttcaggtttctcgccatattccaggtcctacagtgtgcatttctcatttttcacgtttttcagtgattttgtcatttttcaagttgtcaagtggatgtttctcattttcaatgattttcatttttcttaccttattccacgtcctatagtggacatttctaaattttccacctttttcagtttttctcgccatatttcacgtcccaaaatgtgtattccttattttccatgattttcagtttcctcgccatattccaggtcctacagtgtgcatttctcatttttcacgtttttcagtgatttcgtcttttttcaagacgtcaagtggatgtttctcatttttcatgattttcagttttcttgccatattccctgtcctacagtggacatttctaaattttccacctttttctgttttcctcgccatatttcacgtcctaaagtgtgtatttctcattttccgtgattttcagttttctcgccagattccaggtcctacagtgtgcatttctcatttttcacgtttttcagtgatttcgtcatttttcaagtcttcaagtgtatgtttctcattttcaatgattttcatttttcttgccttattccacgtcctatagtggacatttctaaattttccacctttttcagtttttctcgccatatttcacgtcctaaagtgtgtatttctcattttctgtgattttcagttttcttaccatattccaggtcctacagtgtgcatttctcatttttcacgtttttcagtgatttcgtcatttttcaagttgtcaagtggaagtttctcattttccatgattttcagctttctagccatattccaggtattacagtggacatttccttattttcgacctttatcagttttcctcgccatatttcatgtcctaaagtgtgt	38399	1554	4%	7300	19%
9	3000001	3038400	Atcctacagtgtgcatttctcatttttcacgtttttcagtgatttcgtcatttttcaagtcatcaagtggctgtttctcattttccatgattttcagttttcttgccatattccttgtcctacagtggacatttctaaattttccacctttttcagttttccttgtcatatttcaggtcctacagtgtgtatttctcatttttcacgtttttcattgatttcgtcatttttcaagttgtcaagtgcatgtttctcattttccatgattttcagttttcttgccatattccatgtcctacaatggacatttctaaattttccaactttttcagttttcctcgccatatttcacgtcctaaagtgtgtatttctcattttccgtgattttcagttttctcgacatattccaggtcctacagtgtgcatttctcatttttcacgtttttcagtgatttcgtcatttttcacgtcgtcaagtggatgtttctcattttccatgattttcagttttcttgccatattccatgtcctacagtggacatttctaaattttccacctttttcagttttcctcgccatatttcacgtcctaaagtgtgtatttctcattttccgtgattttcagttttctcgacatattccaggtcttacagggtgcatttctcatttttcacgtttttcagtgatttcatcatttttcaagtcgtcaactgtatgtttctcattttcaatgattttcatttttcttgccatattccacgtcctatagtggacatttctaaattttccacctttttcagttttccttgccatatttcaggtcctacagtgtgcatttctcatttttcacgtttttcagtgatttcgtcatttttcaagtggtcaaatgcatgtttctcattttccatgattttcagttttcttgccatattccatgtcctacagtggacatttctaaattttccacctttttcagttttcctcgccatatttcacgtcctaaagtgtgtatttctcattttccgtgattttcagttttatcgccagattccaggtcctacggtgtgcatttttcatatttcacgtttttcagtgattttgtcatttttcaagttgtcaactgcatgtttctcattttccatgattttcagttttcttgccatattccatgtcctacagtggacatttctaaattttccacctttttcagttttcctcgccatatttcatgtcctaaagtgtgtatttctcattttcagtgattttctgttttctcgccatattccaggtcctacagtgtgcatttctcatttttcacgtttttcagtgatttcgtcatttttcaagttgtcaagtggatgtttctcattttccatgattttcagttttcttgccatattccatgtcctacaatggacatttctaaattttccacctttttcagttttcctcgccatatttcacgtcctaaagtgtgtatttctcattttccgtgattttcagttttctcgccatattccaggtcctatgtgtacatttctcatttttcacgtttttcagtgattttgtcatttttcaagttgtgaagtggatgtttctcatttttcttgattttcatttttcttgccatattccatgtcctagagtggaaatttttaaattttccacctttttcagttttcctcgccatatttcacgtcctaaagtgtgaatttctcattttccgtgattttcagttttctcgccatattccaagtcctacagtgtgcatttctcatttttcacgtttttcagtgatttcgtcatttttcaagttgtcaagtggatgtttctcattttccatgattttcagctttcttgccatattcaaagtcctacagtggacatttctaaattttcgacctttatcagttttcctcgccatatttcatgtcccaaagtgtgtacttctcattttccgtgattttcagtttcctcgccatattctaggtcctacagtgtgcatttctcatttttcaggtttttcagtgatttcgtcttttttcaagtcgtcaagtggatgtttctcattttccatgattttcagttttcttgccatattccatgtcctacagtggacatttctaaattttccaactttttcagttttcctcgccatatttcatgtcctaaagtgtgtatttctcattttcagtgattttcagttttctcgccatattccaggtcctacagtgtgcatttctcatttttcacgtttttcagtgatttcgtcatttttcaagttgtcaagtggatgtttctcatttttcatgattttcagttttcttgccatattccatgtcccacagtggacatttctaaatgttccacctttttctgttttccttgccatatttcatgtcctaaagtgtgtatttctcattttccgtgattttcagttttcttgctatattccaagtcctacagtgtgcatttctcatttttcacgtttttctgtgattttttcatttttcaatttgtcaactgcatgtttctcattttccatgattttcagttttcttgccatattccaggtcctacagtgtgcatttctcatttttcacgtttttcagtgattttgtcatttttcaagttgtcaactgcatgtttctcattttccatgattttcagttttcttgctatattccatgtcctacagtggaaatttctaaattttccacctttttcagttttcctcgccatatttcacgtcctaaagtgtgtatttctcattttccgtgattttcagttttctcgccatattccaggtcctatgtgtacatttctcatttttcacgtttttcagtgattttgtcatttttcaagttgtgaagtggatgtttctcatttttcttgattttcatttttcttgccatattccatgtcctagagtggaaatttttaaattttccacctttttcagttttcctcgccatatttcacgtcctaaattgtgaatttctcattttccgtgattttcagttttctcgccatattccaagtcctacagtgtgcatttctcatttttcacgtttttcagtgatttcgtcatttttcaagttgtcaagtggatgtttctcattttccatgattttcagctttcttgccatattcaaagtcctacagtggacatttctaaattttcgacctttatcagttttcctcgccatatttcatgtcccaaagtgtgtacttctcattttccgtgattttcagtttcctcgccatattctaggtcctacagtgtgcatttctcatttttcaggtttttcagtgatttcgtcttttttcaagtcgtcaagtggatgtttctcattttccatgattttcagttttcttgccatattccatgtcctacagtggacatttctaaattttccacctttttcagttttcctcgccatatttcatgtcctaaagtgtgtatttctcattttcagtgattttcagttttctcgccatattccaggtcctacagtgtgcatttctcatttttcacgtttttcagtgattttgtcatttttcaagttgtcaagtggatgtttctcattttccttgattttcagttttcttgccatattccatgtcctacagtggacatttctaaattttccacctttttcagttttccttgccatatttcatgtcctaaagtgtgtatttctcattttcagtgattttcagttttctcgccatattccaggtcctacagtgtgcatttctcattttttcaggtttttcagtgatttcgtcatttttcacgttgtcaagtggatgtttctcattttccatgattttcacttttcttgccatatttcatgtcctaaagtgtgtatttctcattttcagtgattttcagttttctcgccatattccaggtcctacagtgtgcatttctcattttttcacgtttttcagtgatttcgtcatttttcacgttgtcaagtggatgtttctcattttccattattttcacttttcttgccatatttcatgtcctacagtggacatttctaaattttccacctttttctgttttcctcgccatatttcacatcctaaagtgtgtatttctcattttccgtgattttcagttttcttgccatattccaggtcctacagtgtgcatttctcatttttcacgtttttcagtgatttcgtcatttttcaagtcgtcaagtggatgtttctcattttccatgattttcagttttctcgccatattccaggtcctacagttgacatttctaaattttccacattttttatgtttcctcgcgatatttcacatcctaaagtgtgtatttctcattttccgtgattttcagttttcttgccatattccaggtcctacagggtgcatttctcatttttcacgtttttcagtgatttcatcaatttcaagtcgtcaactgtatgtttctcattttcaatgattttcatttttcttgccatattccacgtcctatagtggacatttctacattttccacctttttcagttttcttcgccatatttcacgtcccaaagtgtgtatttctcattttccgtgattttcagtttcctcgccatattccaggtcctacagtgtgcatttctcatttttcacgtttttcagtgatttcgtcttttttcaagtcgtcaagtggatgtttctcattttccatgattttcagttttcttgccatattccatgtcctacagtggacatttctaaattttccacctttttctgttttcctcgccatatttcacgtcctaaagtgtgtatttctcatttaccgtgattttcagttttcttgctatattccaagtcctacagtgtgcatttctcatttttcacgtttttcactgattttgtcattgttcaagttgtcaactgcatgtttctcattttccatgattttcagttttcttgccatattccatgtcctacagtggaaatttctatattttccaactttttcagttttcctcgccatatttcacgtgctaaagtgtgtatttctcatttttcgtgtttttcaggtttctcgccatattccaggtcctacagtgtgcatttctcatttttcacgtttttcagtgattttgtaatttttcaagttgtcaagtggatgtttctcattttccttgattttcagttttcttgccatattccatgtcctactgtggacatttctaaattttccacctttttcagttttccttgccatatttcatgtcctaaagtgtgtatttctcattttcagtgattttcagttttctcgcaatattccaggtcctacagtgtgcatttctcattttttcaggtttttcagtgatttcgtcatttttcacgttgtcaagtggatgtttctcattttccatgattttcacttttcttgccatatttcatgtgctaaagtgtgtatttctcattttcagtgattttcagttttctgccatattccaggtcctacattgtgcatttctcattttttcacgtttttcagtgatttcgtcatttttcacgttgtcaagtggatgtttctcattttccatgattttcacttttcttgccatatttcatgttttacagtggacatttctaaattttccacctatttctgttttcctcgccatatttcacatcctaaagtgtgtatttctcattttccgtgattttcagttttctcgccatatgccaggtcatacagggtgcatttctcatttttcacgtttttcagtgatttcgtcatttttcacgtcgtcaagtggatgtttctcattttcaatgattttcatttttcttgccatattccacgtcctatagtggacatttctaaattttccacctttttcagttttccttgccatatttcaggtcctacagtgtgcatttctcttttttcacgtttttcagtgatttcgtcatttttcaagtggtcaagtgcatgtttctcattttccgtgattttcagttttcttgccatgttccaggtcctacagttgacgtttctaaaatttcactttttttaagttttcctcgccatatttcacttcctaaagtgtgtatttctcattttccgtgattttcagttttctcgccagattccaggtcctacagtgtgcatttttcatatttcacctttttcagtgattttgtcatttttcaagttgtcaactgcatgtttctcattttccatgattttcagttttcttgccatattccatgtcctactgtggacatttctaaattttccaactttttcagttttcctcgccatatttcatgtcctaaagtgtgtatttctcattttcagtgattttctgttttctcgccatattccaggtcctacagtgtgcatttctaatttttcacgtttttcagtgatttcgtcatttttcaagttgtcaagtggatgtttctcattttccatgattttcagttttcttgccatattccatgtcctacagtggacatttctaaattttccaactttttccattttcctcaccatatttcacgtcctaaagtgagtttttctcattttttgtgattttcagttttctcgacatattccaggtcctacagtgtgcatttctaattttttcttttttcagtgatttcgtcatttttcaagtggtcaagtgcatgtttctcattttccatgattttcagttttcttgccatattccatgtcctacaatggacatttctaaattttccaactttttcagttttcctcgccatatttcacgtcctaaagtgtgtatttctcattttccgtgattttcagttttctcgccatattccaggtcctacagtgtgcatttctcatttttcacgtttttcagtgatttcgtcatttttcaagttgtcaactgcatgtttctcattttccatgattttcagttttcttgccatattccatgtcttacagtggacatttttaaatttttcacatttttttaagttttcctccccatatttcacgttttaaagtgtgcatttctcattttcggtgattttcagttttctcgccagattccatgtcttacagtgtgcatttctcattttttcacgtttttcagtgatttcgtcatttttcaagtcgtcaagtggatgtttctcattttccatgattttcagttttcttgccatattccatgtcctacagtggaaatttctaaattttccacctttttcagttttccttgccatatttcaggtcctaaagtgtgtatttctcattttctgtgattttcagttttctcgccatattccaggtcctacagttgacatttctaaaatttccacattttttaagttttcctcgccatatttcacttcctaaagtgtgtatttctcattttccgtgattttcagttttctcgccatattccagatcctacagtgtacatttttcatttttcacgtttttcagtgattttgtcattttttagttgtcaactgcctgtttctcattttccatgattttcagttttcttgctatattccatgtcctacagtggaaatttctaaattttccacctttttcagttttcctcgccatatttcacgtcctaaagtgtgtatttctcattttccgtgattttcagttttctcgccatattccaggtcctatgtgtacatttctcatttttcacgtttttcagtgattttgtcatttttcaatttgtcaactgcatgtttctcattttccatgattttcagttttcttgccatattccatgtcctacagtggaaatttctatattttccaactttttcagttttcctcgccatatttcacgtgctaaagtgtgtatttctcatttttcgtgtttttcaggtttctcgccatattccaggtcctacagtgtgcatttctcatttttcacgtttttcagtgattttgtcatttttcaagttgtcaagtggatgtttctcattttccttgattttcagttttcttgccatattccatgtcctacagtggacatttctaaattttccacctttttcagttttccttgccatatttcatgtcctaaagtgtgtatttctcattttcagtgattttcagttttctcgccatattccaggtcctacagtgtgcatttctcattttttcaggtttttcagtgatttcgtcatttttcacgttgtcaagtggatgtttctcattttccatgattttcacttttcttgccatatttcatgtcctaaagtgtgtatttctcattttcagtgattttcagttttctcgctatattccaggtcctacagtgtgcatttctcattttttcacgtttttcagtgatttcgtcatttttcacgttgtcaagtggatgtttctcattttccatgattttcacttttcttgccatatttcatgtcctacaatggacatttctaaattttccacctttttctgttttcctcgccatatttcacatcctaaagtgtgtatttctcattttccgtgattttcagttttcttgccatattccaggtcctacagtgtgcatttctcatttttcacgtttttcagtgatttcgtcatttttcaagttgtcaagtggatgtttctcattttccttgattttcagttttcttgccatattccatgtcctactgtggacatttctaaattttccacctttttcagttttccttgccatatttcatgtcctaaagtgtgtatttctcattttcagtgattttcagttttctcgcaatattccaggtcctacagtgtgcatttctcattttttcaggtttttcagtgatttcgtcatttttcacgttgtcaagtggatgtttctcattttccatgattttcacttttcttgccatatttcatgtcctaaagtgtgtatttctcattttcagtgattttcagttttctgccatattccaggtcctacattgtgcatttctcattttttcacgtttttcagtgatttcgtcatttttcagttttctcgacatattccaggtcctacagtgtgcatttctaattttttcttttttcagtgatttcgtcatttttcaagttgtcaactgcatgtttctcattttccatgattttcagttttcttgccatattccatgtcttacagtggacatttttaaatttttcacatttttttaagttttcctccccatatttcacgttttaaagtgtgcatttctcattttcggtgattttcagttttctcgccagattccaggtcttacagtgtgcatttctcattttttcacgtttttcagtgatttcgtcatttttcaagtcgtcaagtggatgtttctcattttccatgattttcagttttcttgccatattccatgtcctacagtggaaatttctaaattttccacctttttcagttttccttgccatatttcaggtcctaaagtgtgtatttctcattttctgtgattttcagttttctcgccatattccaggtcctacagttgacatttctaaaatttccacattttttaagttttcctcgccatatttcacttcctaaagtgtgtatttctcattttccgtgattttcagttttctcgccatattccagatcctacagtgtgcatttttcatttttcacgtttttcagtgattttgtcattttttagttgtcaactgtctgtttctcattttccatgattttcagttttcttgccatattccatgtcctacactggacatttctaaattttccacctttttctgttttcctcgccatatttcacgtcctaaagtgtgtatttctcattttccgtgattttcagttttcttgccatattccaggtcctacagtgtgcatttctcatttttcacgtttttcagtgattttgtcatttttcaagttgtcaactgcatgtttctcattttctatgattttcagttttcttgctatattccatgtcctacagtggaaatttctaaattttccacctttttcagttttcctcgccatatttcacgtcctaaagtgtgtatttctcattttccgtgattttcagttttctcgccatattccaggtcctatgtgtacatttctcatttttcacgtttttcagtgattttgtcatttttcaagttgtgaagtggatgtttctcatttttcttgattttcatttttcttgccatattccatgtcctagagtggaaatttttaaattttccacctttttcagttttcctcgccatatttcacgtcctaaagtgtgaatttctcattttccgtgattttcagatttctcgccatattccaagtcctacagtgtgcatttctcatttttcacgtttttcagtgatttcgtcatttttcaagttgtcaagtggatgtttctcattttccatgattttcagctttcttgccatattcaaagtcctacagtggacatttctaaattttcgacctttatcagttttcctcgccatatttcatgtcccaaagtgtgtacttctcattttccgtgattttcagtttcctagccatattctaggtcctacagtgtgcatttctcatttttcaggtttttcagtgatttcgtcttttttcaagtcgtcaagtggatgtttctcattttccatgattttcacttttcttgccatatttcatgtcctaaagtgtgtatttctcattttcagtgattttcagttttctcgctatattccaggtcctacagtgtgcatttctcattttttcacgtttttcagtgatttcgtcatttttcacgttgtcaagtggatgtttctcattttccatgattttcacttttcttgccatatttcatgtcctacagtggacatttctaaattttccacctttttctgttttcctcgccatatttcacatcctaaagtgtgtatttctcattttccgtgattttcagttttcttgccatattccaggtcctacagtgtgcatttctcatttttcacgtttttcagtgatttcgtcatttttcaagttgtcaagtggatgtttctcattttccttgattttcagttttcttgccatattccatgtcctactgtggacatttctaaattttccacctttttcagttttccttgccatatttcatgtcctaaagtgtgtatttctcattttcagtgattttcagttttctcgcaatattccaggtcctacagtgtgcatttctcattttttcaggtttttcagtgatttcgtcatttttcacgttgtcaagtggatgtttctcattttccatgattttcacttttcttgccatatttcatgtcctaaagtgtgtatttctcattttcagtgattttcagttttctgccatattccaggtcctacattgtgcatttctcattttttcacgtttttcagtgatttcgtcatttttcacgttgtcaagtggatgtttctcattttccatgattttcacttttcttgccatatttcatgttttacagtggacatttctaaattttccacctttttctgttttcctcgccatatttcacatcctaaagtgtgtatttctcattttccgtgattttcagttttctcgccatatgccaggtcatacagggtgcatttctcatttttcacgtttttcagtgatttcgtcatttttcacgtcgtcaagtggatgtttctcattttcaatgattttcatttttcttgccatattccacgtcctatagtggacatttctaaattttccacctttttcagttttccttgccatatttcaggtcctacagtgtgcatttctcatttttcacgtttttcagtgatttcgtcatttttcaagtggtcaagtgcatgtttctcattttccgtgattttcagttttcttgccatgttccaggtcctacagttgacgtttctaaaatttcactttttttaagttttcctcgccatatttcacttcctaaagtgtgtatttctcattttccgtgattttcagttttctcgccagattccaggtcctacagtgtgcatttttcatatttcacctttttcagtgattttgtcatttttcaagttgtcaactgcatgtttctcattttccatgattttcagttttcttgccatattccatgtcctactgtggacatttctaaattttccaactttttcagttttcctcgccatatttcatgtcctaaagtgtgtatttctcattttcagtgattttctgttttctcgccatattccaggtcctacagtgtgcatttctaatttttcacgtttttcagtgatttcgtcatttttcaagttgtcaagtggatgtttctcattttccatgattttcagttttcttgccatattccatgtcctacagtggacatttctaaattttccaactttttccattttcctcaccatatttcacgtcctaaagtgtgtttttctcattttttgtgattttcagttttctcgacatattccaggtcctacagtgtgcatttctaattttttcttttttcagtgatttcgtcatttttcaagttgtcaactgcatgtttctcattttccatgattttcagttttcttgccatattccatgtcttacagtggacatttttaaatttttcacatttttttaagttttcctccccatatttcacgttttaaagtgtgcatttctcattttcggtgattttcagttttctcgccagattccaggtcttacagtgtgcatttctcattttttcacgtttttcagtgatttcgtcatttttcaagtcgtcaagtggatgtttctcattttccatgattttcagttttcttgccatattccatgtcctacagtggaaatttctaaattttccacctttttcagttttccttgccatatttcaggtcctaaagtgtgtatttctcattttctgtgattttcagttttctcgccatattccaggtcctacagttgacatttctaaaatttccacattttttaagttttcctcgccatatttcacttcctaaagtgtgtatttctcattttccgtgattttcagttttctcgccatattccagatcctacagtgtgcatttttcatttttcacgtttttcagtgattttgtcattttttagttgtcaactgtctgtttctcattttccatgattttcagttttcttgccatattccatgtcctacactggacatttctaaattttccacctttttctgttttcctcgccatatttcacgtcctaaagtgtgtatttctcattttccgtgattttcagttttcttgccatattccaggtcctacagtgtgcatttctcatttttcacgtttttcagtgattttgtcatttttcaagttgtcaactgcatgtttctcattttccatgattttcagttttcttgctatattccatgtcctacagtggaaatttctaaattttccacctttttcagttttcctcgccatatttcacgtcctaaagtgtgtatttctcattttccgtgattttcagttttctcgccatattccaggtcctatgtgtacatttctcatttttcacgtttttcagtgattttgtcatttttcaagttgtgaagtggatgtttctcatttttcttgattttcatttttcttgccatattccatgtcctagagtggaaatttttaaattttccacctttttcagttttcctcgccatatttcacgtcctaaagtgtgaatttctcattttccgtgattttcagatttctcgccatattccaagtcctacagtgtgcatttctcatttttcacgtttttcagtgatttcgtcatttttcaagttgtcaagtggatgtttctcattttccatgattttcagctttcttgccatattcaaagtcctacagtggacatttctaaattttcgacctttatcagttttcctcgccatatttcatgtcccaaagtgtgtacttctcattttccgtgattttcagtttcctcgccatattctaggtcctacagtgtgcatttctcatttttcaggtttttcagtgatttcgtcttttttcaagtcgtcaagtggatgtttctcattttccatgattttcagttttcttgccatattccatgtcctacagtggacatttctaaattttccacctttttcagttttcctcgccatatttcatgtcctaaagtgtgtatttctcattttcagtgattttcagttttctcgccatattccaggtcctacagtgtgcatttctcatttttcacgtttttcagtgatttcgtcatttttcaagttgtcaagtggatgtttctcattttccatgattttcagttttcttgccatattccatgtcccacagtggacatttctaaattttccacctttttctgttttccttgccatatttcatgtcctaaagtgtgtatttctcattttccgtgattttcagttttcttgctatattccaagtcctacagtgtgcatttctcatttttcacgtttttcagtgattttgtcatttttcaatttgtcaactgcatgtttctcattttccatgattttcagttttcttgccatattccatgtcctacagtggaaatttctatattttccaactttttcagttttcctcgccatatttcacgtgctaaagtgtgtatttctcatttttcgtgtttttcaggtttctcgccatattccaggtcctacagtgtgcatttctcatttttcacgtttttcagtgattttgtcatttttcaagttgtcaagtggatgtttctcattttccttgattttcagttttcttgccatattccatgtcctacagtggacatttctaaattttccacctttttcagttttccttgccatatttcatgtcctaaagtgtgtatttctcattttcagtgattttcagttttctcgccatattccaggtcctacagtgtgcatttctcattttttcaggtttttcagtgatttcgtcatttttcacgttgtcaagtggatgtttctcattttccatgattttcacttttcttgccatatttcatgtcctaaagtgtgtatttctcattttcagtgattttcagttttctcgctatattccaggtcctacagtgtgcatttctcattttttcacgtttttcagtgatttcgtcatttttcacgttgtcaagtggatgtttctcattttccatgattttcacttttcttgccatatttcatgtcctacagtggacatttctaaattttccacctttttctgttttcctcgccatatttcacatactaaagtgtgtatttctcattttccttgattttcagttttcttgccatattccaggtcctacagtgtgcatttctcatttttcacgtttttcagtgatttcgtcatttttcaagtcgtcaagtggatgtttctcattttccatgattttcagttttctcgccatattccaggtcctacagttgacatttctaaattttccacattttttaagtttcctcgcgatatttcacatcctaaagtgtgtatttctcattttccgtgattttcagttttcttgccatattccaggtcctacagggtgcatttctcatttttcacgtttttcagtgatttcatcaatttcaagtcgtcaactgtatgtttctcattttcaatgattttcatttttcttgccatattccatgtcctacagtggacatttctaaatttttcacctttttcagttttccttgccatatttcatgtcctaaagtgtgtatttctcattttcagtgattttcagttttctcgccatattccaggtcctacagtgtgcatttctcattttttcaggtttttcagtgatttcgtcatttttcacgttgtcaagtggatgtttctcattttccatgattttcacttttcttgccatatttcatgtcctaaagtgtgtatttctcattttcagtgattttcagttttctcgccatattccaggtcctacagtgtgcatttctcatttttcacgtttttcagtgatttcgtcatttttcaagttgtcaagtggatgtttctcattttccatgattttcacttttcttgccatattccatgtcccacagtggacatttctaaattttccacctttttctgttttcctcgccatatttcatgtcctaaagtgtgtatttctcattttccgtgattttcagttttcttgctatattccaagtcctacagtgtgcatttctcatttttcacgtttttcagtgattttgtcatttttcaatttgtcaactgcatgtttctcattttccatgattttcagttttcttgccatattccatgttctacagtggaaatttctatattttccaactttttcagttttcctcgccatatttcacgtgctaaagtgtgtatttctcatttttcgtgtttttcaggtttctcgccatattccaggtcctacagtgtgcatttctcatttttcacgtttttcagtgattttgtcatttttcaagttgtcaagtggatgtttctcattttccttgattttcagttttcttgccatattccatgtcctacagtggacatttctaaattttccacctttttcagttttccttgccatatttcatgtcctaaagtgtgtatttctcattttcagtgattttcagttttctcgccatattccaggtcctacagtgtgcatttctcattttttcaggtttttcagtgatttcgtcatttttcacgttgtcaagtggatgtttctcattttccatgattttcacttttcttgccatatttcatgtcctaaagtgtgtatttctcattttcagtgattttcagttttctcgctatattccaggtcctacagtgtgcatttctcattttttcacgttttgcagtgatttcgtcatttttcacgttgtcaagtggatgtttctcattttccatgattttcacttttcttgccatatttcatgtcctacagtggacatttctaaattttccacctttttctgttttcctcgccatatttcacatcctaaagtgtgtatttctcattttccgtgattttcagttttcttgccatattccaggtcctacagtgtgcatttctcatttttcacgtttttcagtgatttcgtcatttttcaagtcgtcaagtggatgtttctcattttccatgattttcagttttctcgccatattccaggtcctacagttgacatttctaaattttccacattttttaagtttcctcgcgatatttcacatcctaaagtgtgtatttctcattttccgtgattttcagttttcttgccatattccaggtcctacagggtgcatttctcatttttcacgtttttcagtgatttcatcaatttcaagtcgtcaactgtatgtttctcattttcaatgattttcatttttcttgccatattccatgtcctacagtggacatttctaaattttccacctttttcagttttccttgccatatttcatgtcctaaagtgtgtatttctcattttcagggattttcagttttctcgccatattccaggtcctacagtgtgcatttctcattttttcaggtttttcagtgatttcgtcatttttcacgttgtcaagtggatgtttctcattttccatgattttcacttttcttgccatatttcatgtcctaaagtgtgtatttctcattttcagtgattttcagttttctcgccatattccaggtcctacagtgtgcatttctcattttttcacgtttttcagtgatttcgtcatttttcacgttgtcaagtggatgtttctcattttccatgattttcacttttcttgccatatttcatgtcctacagtggacatttctaaattttccacctttttctgttttcctcgccatatttcacatcctaaagtgtgtatttctcattttccgtgattttcagttttcttgccatattccaggtcctacagtgtgcatttctcatttttcacgtttttcagtgatttcgtcatttttcaagtcgtcaagtggatgtttctcattttccatgattttcagttttctcgccatattccaggtcctacagttgacatttctaaattttccacattttttaagtttcctcgcgatatttcacatcctaaagtgtgtatttctcattttccgtgattttcagttttcttgccatattccaggtcctacagggtgcatttctcatttttcacgtttttcagtgatttcatcaatttcaagtcgtcaactgtatgtttctcattttcaatgattttcatttttcttgccatattccacgtcctatagtggacatttctaaattttccacctttttcagttttcttcgccatatttcacgtcccaaagtgtgtatttctcattttccgtgattttcagtttcctcgcaatattccaggtcctacagtgtgcatttctcatttttcacgtttttcagtgatttcgtcttttttcaagtcgtcaagtggatgtttctcattttccatgattttcagttttcttgccatattccatgtcctacagtggacatttctaaattttccacctttttctgttttcctcgccatatttcacgtcctaaagtgtgtatttctcattttccgtgattttcagttttcttgccatattccaggtcctacagtgtgcatttctcatttttcacgtttttcactgattttgtcattgttcaagttgtcaactgcatgtttctcattttccatgattttcaattttcttgccatattccatgtcctacagtggaaatttctatattttccaactttttcagttttcctcgccatatttcacgtgctaaagtgtgtatttctcatttttcgtgtttttcaggtttctcgccatattccaggtcctacagtgtgcatttctcatttttcacgtttttcagtgattttgtcatttttcaagttgtcaagtggttgtttctcattttccttgattttcagttttcttgccatattccatgtcctactgtggacatttctaaattttccacctttttcagttttccttgccatatttcatgtcctaaagtgtgtatttctcattttcagtgattttcagttttctcgcaatattccaggtcctacagtgtgcatttctcattttccgtgattttcagttttctcgccatatgccaggtcatacagggtgcatttctcatttttcacgtttttcagtgatttcgtcatttttcacgtcgtcaagtggatgtttctcattttcaatgattttcatttttcttgccatattccacgtcctatagtggacatttctaaattttccaactttttcagttttcttgccatatttcaggtcctacagtgtgcatttctcatttttcacgtttttcagtgatttcgtcatttttcaagtggtcaagtgcatgtttctgattttccgtgattttcagttttcttgccatgttccaggtcctacagttgacgtttctaaaatttcactttttttaagttttcctcgccatatttcacttcctaaagtgtgtatttctcattttccgtgattttcagttttctcgccagattccaggtcctacagtgtgcatttttcatatttcacctttttcagtgattttgtcatttttcaagttgtcaactgcatgtttctcattttccatgattttcagttttcttgccatattccatgtcctactgtggacatttctaaattttccaactttttcagttttcctcgccatatttcatgtcctaaagtgtgtatttctcattttcagtgtttttctgttttctcgccatattccaggtcctacagtgtgcatttctaatttttcacgtttttcagtgatttcgtcatttttcaagttgtcaagtggatgtttctcattttccatgattttcagttttcttgccatattccatgtcctacagtggacatttctaaattttccaactttttccattttcctcaccatatttcacgtcctaaagtgtgtttttctcattttttgtgattttcagttttctcgacatattccaggtcctacagtgtgcatttctaattttttcttttttcagtgatttcgtcatttttcaagtggtcaagtgcatgtttctcattttccatgattttcagttttcttgccatattccatgtcctacaatggacatttctaaattttccaactttttcagttttcctcgccatatttcacgtcctaaagtgtgtatttctcattttccgtgattttcagttttctcgccatattccaggtcctatgtgtacatttctcatttttcacgtttttcagtgattttgtcatttttcaagttgtgaagtggatgtttctcatttttcttgattttcatttttcttgccatattccatgtcctagagtggaaatttttaaattttccaactttttcagttttcctcgccatatttcacgtcctaaagtgtgtatttctcattttccgtgattttcagttttctcgccatattccaagtcctacagtgtgcatttctcatttttcacgtttttcagtgatttcgtcatttttcaagttgtcaagtggatgtttctcattttccatgattttcagctttcttgccatattcaaagtcctacagtggacatttctaaattttcgacctttatcagttttcctcgccatatttcatgtcccaaagtgtgtacttctcattttccgtgattttcagtttcctcgccatattctaggtcctacagtgtgcatttctcatttttcaggtttttcagtgatttcgtcttttttcaagtcgtcaagtggatgtttctcattttccatgattttcagttttcttgccatattccatgtcctacagtggacatttctaaattttccacctttttcagttttcctcgccatatttcatgtcctaaagtgtgtatttctcattttcagtgattttcagttttctcgccatattccaggtcctacagtgtgcatttctcatttttcacgtttttcagtgatttcgtcatttttcaagttgtcaagtggatgtttctcattttccatgattttcagttttcttgccatattccatgtcccacagtggacatttctaaattttccacctttttctgttttccttgccatatttcatgtcctaaagtgtgtatttctcattttccgtgattttcagttttcttgctatattccaagtcctacagtgtgcatttctcatttttcacgtttttaagtgattttgtcatttttcaatttgtcaactgcatgtttctcattttccatgattttcagttttcttgccatattccatgtcctacagtggaaatttctatattttccaactttttcagttttcctcgccatatttcacgtgctaaagtgtgtatttctcatttttcgtgtttttcaggtttctcgccatattccaggtcctacagtgtgcatttctcatttttcacgtttttcagtgattttgtcatttttcaagttgtcaagtggatgtttctcattttccttgattttcagttttcttgccatattccatgtcctacagtggacatttctaaattttccacctttttcagttttccttgccatatttcatgtcctaaagtgtgtatttctcattttcagtgattttcagttttctcgccatattccaggtcctacagtgtgcatttctcattttttcaggtttttcagtgatttcgtcatttttcacgttgtcaagtggatgtttctcattttccatgattttcacttttcttgccatatttcatgtcctaaagtgtgtatttctcattttcagtgattttcagttttctcgccatattccaggtcctacagtgtgcatttctcattttttcacgtttttcagtgatttcgtcatttttcacgttgtcaagtggatgtttctcattttccatgattttcacttttcttgccatatttcatgtcctacagtggacatttctaaattttccacctttttctgttttcctcgccatatttcacatcctaaagtgtgtatttctcattttccgtgattttcagttttcttgccatatttcaggtcctacagtgtgcatttctcatttttcacgtttttcagtgatttcgtcatttttcaagtcgtcaagaggatgtttctcattttccatgattttcagttttctcgccatattccaggtcctacagttgacatttctaaattttccacattttttaagtttcctcgcgatatttcacatcctaaagtgtgtatttctcattttccgtgattttcagttttcttgccatattccaggtcctacagggtgcatttctcatttttcacgtttttcagtgatttcatcaatttcaagtcgtcaactgtatgtttctcattttcaatgattttcatttttcttgccatattccacgtcctatagtggacatttctaaattttccacctttttctgttttcctcgccatatttcacgtcctaaagtgtgtatttctcattttccgtgattttcagttttcttgccatattccaggtcctacagtgtgcatttctcatttttcacgtttttcactgattttgtcattgttcaagttgtcaactgcatgtttctcattttccatgattttcagttttcttgccatattccatgtcctacagtggaaatttctatattttccacctttttcagttttcctcgccgtatttcatgtgctaaagtgtgtatttctcatttttcgtgtttttcaggtttctcgccatattccaggtcctacagtgtgcatttctcatttttcacgtttttcagtgattttgtcatttttcaagttgtcaactggatgtttctcattttccttgattttcagttttcttgccatattccatgtcctactgtggacatttctaaattttccacctttttcagttttccttgccatatttcatgtcctaaagtgtgtatttctcattttcagtgattttcagttttctcgcaatattccaggtcctacagtgtgcatttctcattttttcaggtttttcagtgatttcgtcatttttcacgttgtcaagtggatgtttctcattttccatgattttcacttttcttgccatatttcatgtcctaaagtgtgtatttctcattttcagtgattttcagttttctcgccatattccaggtcctacattgtgcatttctcattttttcacgtttttcagtgatttcgtcatttttcacgttgtcaagtggatgtttctcattttccatgattttcacttttcttgccatatttcatgttttacagtggacatttctaaattttccacctttttctgttttcctcgccatatttcacatcctaaagtgtgaatttctcattttccgtgattttcagttttcttgccatattccaggtcctacagtgtgcatttctcatttttcacgtttttcagtgatttcatcatttttcaagtcgtcaagtggatgtttctcattttccatgattttcagttttcttgccatattccatgtcctacagtggacatttctaaattttccacctttttctgttttcctcgccatatttcacgtcctaaagtgtgtatttctcattttccgtgattttcagttttcttgccatattccaggtcctacagtgtgcatttctcatttttcacgtttttcactgattttgtcatttttcaagttgtcaactgcatgtttctcattttccatgattttcagttttcttgctatattccatgtcctacagtggaaatttctaaattttccacctttttcagttttcctcgccatatttcacgtcctgaagtgtgtatttctcattttccgtgattttcagttttctcgccatattccaggtcctatgtgtacatttctcatttttcacgtttttcagtgattttgtcatttttcaagttgtgaagtggatgtttctcatttttcttgattttcatttttcttgccatattccatgtcctacagtggaaatttctaaattttccacctttttcagttttcctcgccatatttcacgtcctaaagtgtgtatttctcattttccgtgattttcagttttctcgccatattccaggtcctacagtgtgcatttctcatttttcacgtttttcagtgatttcgacatttttcaagttgtcaagtggatgtttctcattttccatgattttcagctttcttgccatattcaaagtcctacagtggacatttctaaattttcgacctttatcagttttcctcgccatatttcatgtcccaaagtgtgtacttctcattttccgtgattttcagtttcctcgccatattccaggtcctacagtgtgcatttctcatttttcacgtttttcagtgatttcgtcatttttcaagtcgtcaagtggatgtttctcattttccatgattttcagttttcttgccatattccatgtcctacagtggacatttctaaattttccacctttttctgttttcctcgccatatttcacgtcctaaagtgtgtatttctcattttccgtgattttcagttttcttgccatattccaggtcctacagtgtgcatttctcatttatcacgtttttcactgattttgtcatttttcaagttgtcaactgcatgtttctcattttccatgattttcagttttcttgctatattccatgtcctacagtggaatattctaaattttccacctttttcagttttcctcgccatatttcacgtcctgaagtgtgtatttctcattttccgtgattttcagttttctcgccatattccaggtcctatgtgtacatttctcatttttcacgtttttcagtgattttgtcatttttcaagttgtgaagtggatgtttctcatttttcttgattttcatttttcttgccatattccatgtcctacagtggaaatttctaaattttccacctttttcagttttcctcgccatatttcacgtcctaaagtgtgaatttctcattttccgtgattttcagttttctcgccatattccaggtcctacagtgtgcatttctcatttttcacgtttttcagtgatttcgacatttttcaagttgtcaagtggatgtttctcattttccatgattttcagctttcttgccatattcaaagtcctacagtggacatttctaaattttcgacctttatcagttttcctcgccatatttcatgtcccaaagtgtgtacttctcattttccgtgattttgagtttcctcgccatattccaggtcctacagtgtgcatttctcatttttcacgtttttcagtgatttcgtcttttttcaagttgtcaactgcatgtttctcattttccatgattttcagttttcttgccatattccatgtcctacagtggaaatttgtaaatttccacctttttcagttttcctcgccatatttcacgtcctaaagtatgtatttctcattttccgtgattttcagttttctcgccatattccaggtcctacagtgtgcatttctcatttttcacgtttttcagtgattttgtcattttttaagttttcaagtggatgtttctcattttccttgattttcagttttcttgccatattccatgtcctacagtggacatttctaaattttccacctttttcagttttcctcgccatatttcatgtcctaaagtgtgtatttctcattttcagtgattttcagttttctcgccatattccaggtcctacagtgtgcatttctcatttttcacgtttttcagtgatttcgtcatttttcaaggtgtcaagtggatgtttctcattttccatgattttcagttttcttgccatattccatgtcctacagtggacatttctaaattttccacctttttctgttttcctcgccatatttcatgtcctaaagtgtgtatttctcattttccgtgattttcagttttcttgctatattccaagtcctacagtgtgcatttctcatttttcacgtttttcagtgattttgtcatttttcaatttgtcaactgcatgtttctcattttccatgattttcagtttttttgccatattccatgtcctactgtggaaatttctatattttccacctttttcagttttcctcgccatatttcacgtgctaaagtgtgtatttctcatttttcgtgtttttcaggtttctcgccatattccaggtcctacagtgtgcatttctcatttttcacgtttttcagtgattttgtcatttttcaagttttcaagtggatgtttctcattttccttgattttcagttttcttgccatattccatgtcctacagtggacatttctaaattttccacctttttcagttttccttgccatatttcatgtcctaaagtgtgtatttctcattttcagtgattttcagtttccttgccatattccaggtcctacagtgtgcatttctcattttttcacgtttttcagtgatttcgtcatttttcacgttgtcaagtggatgtttctcattttccatgattttcacttttcttgccatatttcatgtcctacagtggacatttctaaattttccaactttttcaattttcctcgccatattttatgtcctaaagtgtgtatttctcatttttcgttattttcagttttcttgccatattccaggtcctacagtgtgcatttgtcatttttcacgtttttcagtgatttcgtcatttttcaagtcgtcaagtagatgtttctcatattccatgtttttcagttttctcgccatattccaggtcctacagttgacatttctaaattttctacatttttaaattttcctcgccatatttcacgtcctaaagtgtgtatttctcattttttgttattttcagttttctagccatattccaggtcctacaggatgcatttctcatttttcacgtttttcagtgatttcatcatttttcaagtcgtcaagtgtatgtttcttattttcaatgattttcatttttcttgccttattccacgtcctatagtggacatttctaaattttccacctttttcagtttttttcgccatatttcacgtcctaaagtgtgtatttctcattttctgtgattttcagttttctcaccatattccaggtcctacagtgtgcatttctcatttttcacgtttttcagtgatttcgtcatttttcaagttgtcaagtggaagtttctcattttccatgattttcagctttctagacatattccaggtcctacagtggacatttcctaattttcgacctttatcagttttcctcgtcatatttcacgtcccaaaatgtgtatttcttattttccatgattttcagtttcctcgccatattccaggtcctacagtgtgcaattctcatttttcacgtttttcagtgatttcgtcttttttcaagacgtcaagtggatgtttctcatttttcatgattttcagttttcttgccatattccatgtcctacagtggacatttctaaattttccacctttttctgttttcctcgccatatttcacgtcctaaagtgtgtatttctcattttccgtgattttcagttttcttgccatattcctggtcctacagtgtgcatttctcatttttcacgtttttcagtgattttgtcatttttcaatttgtcaactgcatgtttctcattttccattattttcagttttcttgccatattccatgtcctacagtggacatttctaaattttccacctttttctgttttcctcgccatatttcatgtcctaaagtgtgtatttctcattttccgtgattttcagttttcttgctatattccaagtcctacagtgtgcatttctcatttttcacgtttttcagtgattttgtcatttttcaatttgtcaactgcatgtttctcattttccatgattttcagtttttttgccatattccatgtcctacaggggaaatttctatattttccacctttttcagttttcctcgccatatttcatgtcctaaagtgtgtatttctcattttccgtgattttcagttttcttgccatattccaggtcctacagtgtgcatttctcatttttcacgtttttcagtgatttcgtcatttttcaagtcttcaagtagatgtttctcatattccatgtttttcagttttctcgccatattccaggtcctacagttgacatttctaaattttctacatttttaaattttcctcgccatatttcacgtcctaaagtgtgtatttctcatttttcgttattttcagttttctagccatattccaggtcctacaggatgcatttctcatttttcacgtttttcagtgatttcatcatttttcaagtcgtcaagtgtatgtttctcattttcaatgattttcatttttcttgccttattccacgtcctatagtggacatttctaaattttccacctttttcagtttttctcgccatatttcacgtcctaaagtgtgtatttctcattttctgtgattttcagttttctcaccatattccaggtcctacagtgtgcatttctcatttttcacgtttttcagtgatttcgtcatttttcaagttgtcaagtggaagtttctcattttccatgattttcagctttctagccatattccaggtcctacagtggacatttcctaattttcgacctttatcagttttcctcgccatatttcacgtcctaaagtgtgtatttctcattttccgtgattttcagttttcttgccatattccaggtcctacagtgtgcatttctcatttttcacgtttttcagtgattttgtcatttttcaatttgtcaactgcatgtttctcattttccatgatttttagttttcttgctatattccatgtcctacagtggaaatttctaaattttccacctttttcagttttcctcgccatatttcacgtcctaaagtgtgtatttctcattttccgtgattttcagttttcttgctatattccaagtcctacattgtgcatttctcatttttcacgtttttcagtgattttgtcatttttcaatttgtcaaaccacatgtttctcattttccatgattttcagtttttttgccatattccatgtcctacagtggaaatttctatattttccacctttttcagttttcctcgccatatttcacgtgctaaagtgtgtatttctcatttttcgtgtttttcaggtttctcgccatattccaggtcctacagtgtgcatttctcatttttcacgtttttcagtgattttgtcatttttcaagttgtcaagtggatgtttcccattttccttgattttcagttttcttaccatattccatgtcctacagtggacatttctaaattttccacctttttcagttttccttgccatatttcatgtcctaaagtgtgtatttctcattttcagtgattttcagtttcctcgccatattccaggtcctacagtgtgcatttctcattttttcacgtttttcagtgatttcgtcatttttcacgttgtcaagtggatgtttctcattttccatgattttcacttttcttgccatatttcatgtcctatagtggacatttctaaattttccacctttttcagtttttctcgccatatttcacgtcctaaagtgtgtatttctcattttctgtgattttcagttttctcaccatattccaggtcctacagtgtgcatttctcatttttcacgtttttcagtgatttcgtcatttttcaagtcgtcaagtagatgtttctcatattccatgtttttcagttttctcgccatattccaggtcctacagttgacatttctaaattttctacatttttaaattttcctcgccatatttcacgtcctaaagtgtgtatttctcatttttcgttattttcagttttctagccatattccaggtcctacaggatgcatttctcatttttcacgtttttcagtgatttcatcatttttcaagtcgtcaagtgtatgtttcttattttcaatgattttcatttttcttgccttattccacgtcctatagtggacatttctaaattttccaccttttttcagtttttctcgccatatttcacgtcctaaagtgtgtatttctcattttctgtgattatcagttttctcaccatattccaggtcctacagtgtgcatttctcatttttcacgtttttcagtgatttcgtcatttttcaagttgtcaagtggaagtttctcattttccatgattttcagctttctagccatattccaggtcctacagtggacatttcctaattttcgacctttatcagttttcctcgccatatttcacgtcccaaaatgtgtatttcttattttccatgattttcagtttcctcgccatattccaggtcctacagtgtgcatttctcatttttcacgtttttcagtgatttcgtcttttttcaagacgtcaagtggatgtttctcatttttcatgattttcagttttcttgccatattccatgtcctacagtggacatttctaaattttccacctttttctgttttcctcgccatatttcacgtcctaaagtgtgtatttctcattttccgtgattttcagttttcttgccatattcctggtcctacagtgtgcatttctcatttttcacgtttttcagtgattttgtcatttttcaatttgtcaactgcatgtttctcattttccatgattttcagttttcttgccatattccatgtcctacagtggacatttctaaattttccacctttttcagttttcctcgccatatttcacgtgctaaagtgtgtatttctcatttttcgtgtttttcaggtttctcgccatattccaggtcctacagtgtgcatttctcatttttcacgtttttcagtgattttgtcatttttcaagttgtcaagtggatgtttctcattttccttgattttcacttttcttgccatattccaagtcttacaggggcatttctcatttttcacgttttcagtgattttgtcattttcaatttgtcaactgcatgtttctcattttccatgattttcagtttttttgccatattccatgtcctacaggggaaatttctatattttccacctttttcagttttcctcgccatatttcatgtcctaaagtgtgtatttctcattttccgtgattttcagttttcttgccatattccaggtcctacagtgtgcatttctcatttttcacgtttttcagtgatttcgtcatttttcaagtcttcaagtagatgtttctcatattccatgtttttcagttttctcgccatattccaggtcctacagttgacatttctaaattttctacatttttaaattttcctcgccatatttcacgtcctaaagtgtgtatttctcatttttcgttattttcagttttctagccatattccaggtcctacaggatgcatttctcatttttcacgtttttcagtgatttcatcatttttcaagtcgtcaagtgtatgtttctcattttcaatgattttcatttttcttgccttattccacgtcctatagtggacatttctaaattttccacctttttcagtttttctcgccatatttcacgtcctaaagtgtgtatttctcattttctgtgattttcagttttctcaccatattccaggtcctacagtgtgcatttctcatttttcacgtttttcagtgatttcgtcatttttcaagttgtcaagtggaagtttctcattttccatgattttcagctttctagccatattccaagtcctacagtggacatttcctaattttcgacctttatcagttttcctcgccatatttcacgtcccaaaatgtgtattccttattttccatgattttcagtttcctcgccatattccaggtcctacagtgtgcatttatcatttttcacgtttttcagtgatttcgtcttttttcaagacgtcaagtggatgtttctcatttttcatgattttcagttttcttgccatattccatgtcctacagtggacatttctaaattttccacctttttctgttttcctcgccatatttcacgtcctaaagtgtgtatttctcattttccgtgattttcagttttcttgccatattcctggtcctacagtgtgcatttctcatttttcacgtttttcagtgattttgtcatttttcaagttgtcaagtggatgtttctcattttccttgattttcacttttcttgccatattccatgtcctacagtggacatttctatattttccacctttttccgttttccttgccatatttcacgtcctaaagtgtgtatttctcattttccgtgattttcaggtttctcgccatattccaggtcctacagtgtgcatttctcatttttcacgtttttcagtgattttgtcatttttcaagttgtcaagtggatgtttctcattttccttgattttcacttttcttgccatattccatgtcctacagtggacatttctaaattttccacctttttcagttttcctcgccatatttcatgtcctaaagtgtgtatttctcattttcagtgattttcagttttcttgccatattccaggtcctacagtgtgcatttctcatttttcacgtttttcagtgattttgtcatttttcaagttgtcaactgcatgtttctcattttctatgattttcagttttcttgctatattccatgtcctacagtggaaatttctaaattttccacctttttcagttttcctcgccatatttcacgtcctaaagtgtgtatttctcattttccgtgattttcagttttctcgccatattccaggtcctatgtgtacatttctcatttttcacgtttttcagtgattttgtcatttttcaagttgtgaagtggatgtttctcatttttcttgattttcatttttcttgccatattccatgtcctagagtggaaatttttaaattttccacctttttcagttttcctcgccatatttcacgtcctaaagtgtgaatttctcattttccgtgattttcagatttctcgccatattccaagtcctacagtgtgcatttctcatttttcacgtttttcagtgatttcgtcatttttcaagttgtcaagtggatgtttctcattttccatgattttcagctttcttgccatattcaaagtcctacagtggacatttctaaattttcgacctttatcagttttcctcgccatatttcatgtcccaaagtgtgtacttctcattttccgtgattttcagtttcctcgccatattctaggtcctacagtgtgcatttctcatttttcaggtttttcagtgatttcgtcttttttcaagtcgtcaagtggatgtttctcattttccatgattttcacttttcttgccatatttcatgtcctaaagtgtgtatttctcattttcagtgattttcagttttctcgctatattccaggtcctacagtgtgcatttctcattttttcacgtttttcagtgatttcgtcatttttcacgttgtcaagtggatgtttctcattttccatgattttcacttttcttgccatatttcatgtcctacagtggacatttctaaattttccacctttttctgttttcctcgccatatttcacatcctaaagtgtgtatttctcattttccgtgattttcagttttcttgccatattccaggtcctacagtgtgcatttctcatttttcacgtttttcagtgatttcgtcatttttcaagttgtcaagtggatgtttctcattttccttgattttcagttttcttgccatattccatgtcctactgtggacatttctaaattttccacctttttcagttttccttgccatatttcatgtcctaaagtgtgtatttctcattttcagtgattttcagttttctcgcaatattccaggtcctacagtgtgcatttctcattttttcaggtttttcagtgatttcgtcatttttcacgttgtcaagtggatgtttctcattttccatgattttcacttttcttgccatatttcatgtcctaaagtgtgtatttctcattttcagtgattttcagttttcctcgccatatttcacgtcccaaaatgtgtatttcttattttccatgattttcagtttcctcgccatattccaggtcctacagtgtgcatttctcatttttcacgtttttcagtgatttcgtcttttttcaagacgtcaagtggatgtttctcatttttcatgattttcagttttcttgccatattccatgtcctacagtggacatttctaaattttccacctttttctgttttcctcgccatatttcacgtcctaaagtgtgtatttctcattttccgtgattttcagttttcttgccatattcctggtcctacagtgtgcatttctcatttttcacgtttttcagtgattttgtcatttttcaatttgtcaactgcatgtttctcattttccatgattttcagttttcttgccatattccatgtcctacagtggacatttctaaattttccacctttttcagttttcctcgccatatttcacgtgctaaagtgtgtatttctcatttttcgtgtttttcaggtttctcgccatattccaggtcctacagtgtgcatttctcatttttcacgtttttcagtgattttgtcatttttcaagttgtcaagtggatgtttctcattttccttgattttcacttttcttgccatattccatgtcctacagtggacatttctaaattttccacctttttcagttttcctcgccatatttcatgtcctaaagtgtgtatttctcattttcagtgattttcagttttctcgccatattccaggtcctacagtgtgcatttctcatttttcacgtttttcagtgatttcgtcttttttcaagacgtcaagtggatgtttctcattttccatgattttcagttttcttgccatattccatgtcctacagtggacatttctaaattttccacctttttctgttttcctcgccatatttcacgtcctaaagtgtgtatttctcattttccgtgattttcagttttcttgccatattccaggtcctacagtgtgcatttctcatttttcacgtttttcagtgattttgtcatttttcaatttgtcaactgcatgtttctcattttccatgatttttagttttcttgctatattccatgtcctacagtggaaatttctaaattttccacctttttcagttttcctcgccatatttcacgtcctaaagtgtgtatttctcattttccgtgattttcagttttcttgctatattccaagtcctacattgtgcatttctcatttttcacgtttttcagtgattttgtcatttttcaatttgtcaaaccacatgtttctcattttccatgattttcagtttttttgccatattccatgtcctacagtggaaatttctatattttccacctttttcagttttcctcgccatatttcacgtgctaaagtgtgtatttctcatttttcgtgtttttcaggtttctcgccatattccaggtcctacagtgtgcatttctcatttttcacgtttttctgtgattttgtcatttttcaagttgtcaagtggatgtttctcattttccttgattttcagttttcttaccatattccatgtcctacagtggacatttctaaattttccaccttttctgttttcctcgccatatttcatgtcctaaagtgtgtatttctcattttccgtgattttcatttttcttgctatattccaagtcctacagtgtgcatttctcattttccatgattttcagttttcttgctatattccatgtcctacagtggaaatttctaaattttccacctttttcagttttcctcgccatatttcacgtcctaaagtgtgtatttctcattttccgtgattttcagttttttcgccatattacaggtcctatgtgtacatttctcatttttcacgtttttcagtgattttgtcatttttcaagttgtcaagtggatgtttctcatttttcttgattttcatttttcttgccatattccatgtcctacagtggaaatttctaaattttccacctttttcagttttcctcgccatatttcacgtcctaaagtgtgaatttctcattttccgtgattttcagttttctcgccatattccaggtctacagtgtgcatttctcatttttcacgttttcagtgattcgtcatttttcaagttgacaagtggatgtttctcattttccatgattttcagctttcttgccatattcaaagtcctacagtggacatttctaaattttcgacctttatcagttttcctcgccatatttcatgtcccaaagtgtgtacttctcattttccgtgattttcagttttcttgccatattccaagtcctacagtgtgcatttctcatttttcacgtttttcagtgattttgtcatttttcaatttgtcaactgcatgtttctcattttccatgattttcagttttcttgccatattccatgtcctacagtggaaatttctatattttccacctttttcagttttcctcgccatatttcacgtgctaaagtgtgtatttctcatttttcgtgtttttcaggtttctcgccatattccaggtcctacagtgtgcatttctcatttttcacgtttttcagtgattttgtcatttttcaagttgtcaagtggatgtttctcattttcaatgattttcatttttcttgccttattccacgtcctatagtggacatttctaaattttccacctttttcagtttttctcgccatatttcacgtcccaaaatgtgtattccttattttccatgattttcagtttcctcgccatattccaggtcctacagtgtgcatttctcatttttcacgtttttcagtgatttcgtcttttttcaagacgtcaagtggatgtttctcatttttcatgattttcagttttcttgccatattccctgtcctacagtggacatttctaaattttccacctttttctgttttcctcgccatatttcacgtcctaaagtgtgtatttctcattttccgtgattttcagttttctcgccagattccaggtcctacagtgtgcatttctcatttttcacgtttttcagtgattttgtcatttttcaatttgtcaactgcatgtttctctctttccatgattttcagttttcttgccatattccatgtcctacagtggacatttctaaattttccacctttttcagttttcctcgccatatttcacgtgctaaagtgtgtatttctcatttttcgtgtttttcaggtttctcgccatattccaggtcctacagtgtgcatttctcatttttcacgtttttcagtgattttgtcatttttcaagttgtcaagtggatgtttctcattttcaatgattttcatttttcttaccttattccacgtcctatagtggacatttctaaattttccacctttttcagtttttctcgccatatttcacgtcccaaaatgtgtattccttattttccatgattttcagtttcctcgccatattccaggtcctacagtgtgcatttctcatttttcacgtttttcagtgatttcgtcttttttcaagacgtcaagtggatgtttctcatttttcatgattttcagttttcttgccatattccctgtcctacagtggacatttctaaattttccacctttttctgttttcctcgccatatttcacgtcctaaagtgtgtatttctcattttccgtgattttcagttttctcgccagattccaggtcctacagtgtgcatttctcatttttcacgtttttcagtgatttcgtcatttttcaagtcttcaagtgtatgtttctcattttcaatgattttcatttttcttgccttattccacgtcctatagtggacatttctaaattttccacctttttcagtttttctcgccatatttcacgtcctaaagtgtgtatttctcattttctgtgattttcagttttcttaccatattccaggtcctacagtgtgcatttctcatttttcacgtttttcagtgatttcgtcatttttcaagttgtcaagtggaagtttctcattttccatgattttcagctttctagccatattccaggtattacagtggacatttccttattttcgacctttatcagttttcctcgccatatttcatgtcctaaagtgtgt	38399	1554	4%	7300	19%
9	3000001	3038400	Atcctacagtgtgcatttctcatttttcacgtttttcagtgatttcgtcatttttcaagtcatcaagtggctgtttctcattttccatgattttcagttttcttgccatattccttgtcctacagtggacatttctaaattttccacctttttcagttttccttgtcatatttcaggtcctacagtgtgtatttctcatttttcacgtttttcattgatttcgtcatttttcaagttgtcaagtgcatgtttctcattttccatgattttcagttttcttgccatattccatgtcctacaatggacatttctaaattttccaactttttcagttttcctcgccatatttcacgtcctaaagtgtgtatttctcattttccgtgattttcagttttctcgacatattccaggtcctacagtgtgcatttctcatttttcacgtttttcagtgatttcgtcatttttcacgtcgtcaagtggatgtttctcattttccatgattttcagttttcttgccatattccatgtcctacagtggacatttctaaattttccacctttttcagttttcctcgccatatttcacgtcctaaagtgtgtatttctcattttccgtgattttcagttttctcgacatattccaggtcttacagggtgcatttctcatttttcacgtttttcagtgatttcatcatttttcaagtcgtcaactgtatgtttctcattttcaatgattttcatttttcttgccatattccacgtcctatagtggacatttctaaattttccacctttttcagttttccttgccatatttcaggtcctacagtgtgcatttctcatttttcacgtttttcagtgatttcgtcatttttcaagtggtcaaatgcatgtttctcattttccatgattttcagttttcttgccatattccatgtcctacagtggacatttctaaattttccacctttttcagttttcctcgccatatttcacgtcctaaagtgtgtatttctcattttccgtgattttcagttttatcgccagattccaggtcctacggtgtgcatttttcatatttcacgtttttcagtgattttgtcatttttcaagttgtcaactgcatgtttctcattttccatgattttcagttttcttgccatattccatgtcctacagtggacatttctaaattttccacctttttcagttttcctcgccatatttcatgtcctaaagtgtgtatttctcattttcagtgattttctgttttctcgccatattccaggtcctacagtgtgcatttctcatttttcacgtttttcagtgatttcgtcatttttcaagttgtcaagtggatgtttctcattttccatgattttcagttttcttgccatattccatgtcctacaatggacatttctaaattttccacctttttcagttttcctcgccatatttcacgtcctaaagtgtgtatttctcattttccgtgattttcagttttctcgccatattccaggtcctatgtgtacatttctcatttttcacgtttttcagtgattttgtcatttttcaagttgtgaagtggatgtttctcatttttcttgattttcatttttcttgccatattccatgtcctagagtggaaatttttaaattttccacctttttcagttttcctcgccatatttcacgtcctaaagtgtgaatttctcattttccgtgattttcagttttctcgccatattccaagtcctacagtgtgcatttctcatttttcacgtttttcagtgatttcgtcatttttcaagttgtcaagtggatgtttctcattttccatgattttcagctttcttgccatattcaaagtcctacagtggacatttctaaattttcgacctttatcagttttcctcgccatatttcatgtcccaaagtgtgtacttctcattttccgtgattttcagtttcctcgccatattctaggtcctacagtgtgcatttctcatttttcaggtttttcagtgatttcgtcttttttcaagtcgtcaagtggatgtttctcattttccatgattttcagttttcttgccatattccatgtcctacagtggacatttctaaattttccaactttttcagttttcctcgccatatttcatgtcctaaagtgtgtatttctcattttcagtgattttcagttttctcgccatattccaggtcctacagtgtgcatttctcatttttcacgtttttcagtgatttcgtcatttttcaagttgtcaagtggatgtttctcatttttcatgattttcagttttcttgccatattccatgtcccacagtggacatttctaaatgttccacctttttctgttttccttgccatatttcatgtcctaaagtgtgtatttctcattttccgtgattttcagttttcttgctatattccaagtcctacagtgtgcatttctcatttttcacgtttttctgtgattttttcatttttcaatttgtcaactgcatgtttctcattttccatgattttcagttttcttgccatattccaggtcctacagtgtgcatttctcatttttcacgtttttcagtgattttgtcatttttcaagttgtcaactgcatgtttctcattttccatgattttcagttttcttgctatattccatgtcctacagtggaaatttctaaattttccacctttttcagttttcctcgccatatttcacgtcctaaagtgtgtatttctcattttccgtgattttcagttttctcgccatattccaggtcctatgtgtacatttctcatttttcacgtttttcagtgattttgtcatttttcaagttgtgaagtggatgtttctcatttttcttgattttcatttttcttgccatattccatgtcctagagtggaaatttttaaattttccacctttttcagttttcctcgccatatttcacgtcctaaattgtgaatttctcattttccgtgattttcagttttctcgccatattccaagtcctacagtgtgcatttctcatttttcacgtttttcagtgatttcgtcatttttcaagttgtcaagtggatgtttctcattttccatgattttcagctttcttgccatattcaaagtcctacagtggacatttctaaattttcgacctttatcagttttcctcgccatatttcatgtcccaaagtgtgtacttctcattttccgtgattttcagtttcctcgccatattctaggtcctacagtgtgcatttctcatttttcaggtttttcagtgatttcgtcttttttcaagtcgtcaagtggatgtttctcattttccatgattttcagttttcttgccatattccatgtcctacagtggacatttctaaattttccacctttttcagttttcctcgccatatttcatgtcctaaagtgtgtatttctcattttcagtgattttcagttttctcgccatattccaggtcctacagtgtgcatttctcatttttcacgtttttcagtgattttgtcatttttcaagttgtcaagtggatgtttctcattttccttgattttcagttttcttgccatattccatgtcctacagtggacatttctaaattttccacctttttcagttttccttgccatatttcatgtcctaaagtgtgtatttctcattttcagtgattttcagttttctcgccatattccaggtcctacagtgtgcatttctcattttttcaggtttttcagtgatttcgtcatttttcacgttgtcaagtggatgtttctcattttccatgattttcacttttcttgccatatttcatgtcctaaagtgtgtatttctcattttcagtgattttcagttttctcgccatattccaggtcctacagtgtgcatttctcattttttcacgtttttcagtgatttcgtcatttttcacgttgtcaagtggatgtttctcattttccattattttcacttttcttgccatatttcatgtcctacagtggacatttctaaattttccacctttttctgttttcctcgccatatttcacatcctaaagtgtgtatttctcattttccgtgattttcagttttcttgccatattccaggtcctacagtgtgcatttctcatttttcacgtttttcagtgatttcgtcatttttcaagtcgtcaagtggatgtttctcattttccatgattttcagttttctcgccatattccaggtcctacagttgacatttctaaattttccacattttttatgtttcctcgcgatatttcacatcctaaagtgtgtatttctcattttccgtgattttcagttttcttgccatattccaggtcctacagggtgcatttctcatttttcacgtttttcagtgatttcatcaatttcaagtcgtcaactgtatgtttctcattttcaatgattttcatttttcttgccatattccacgtcctatagtggacatttctacattttccacctttttcagttttcttcgccatatttcacgtcccaaagtgtgtatttctcattttccgtgattttcagtttcctcgccatattccaggtcctacagtgtgcatttctcatttttcacgtttttcagtgatttcgtcttttttcaagtcgtcaagtggatgtttctcattttccatgattttcagttttcttgccatattccatgtcctacagtggacatttctaaattttccacctttttctgttttcctcgccatatttcacgtcctaaagtgtgtatttctcatttaccgtgattttcagttttcttgctatattccaagtcctacagtgtgcatttctcatttttcacgtttttcactgattttgtcattgttcaagttgtcaactgcatgtttctcattttccatgattttcagttttcttgccatattccatgtcctacagtggaaatttctatattttccaactttttcagttttcctcgccatatttcacgtgctaaagtgtgtatttctcatttttcgtgtttttcaggtttctcgccatattccaggtcctacagtgtgcatttctcatttttcacgtttttcagtgattttgtaatttttcaagttgtcaagtggatgtttctcattttccttgattttcagttttcttgccatattccatgtcctactgtggacatttctaaattttccacctttttcagttttccttgccatatttcatgtcctaaagtgtgtatttctcattttcagtgattttcagttttctcgcaatattccaggtcctacagtgtgcatttctcattttttcaggtttttcagtgatttcgtcatttttcacgttgtcaagtggatgtttctcattttccatgattttcacttttcttgccatatttcatgtgctaaagtgtgtatttctcattttcagtgattttcagttttctgccatattccaggtcctacattgtgcatttctcattttttcacgtttttcagtgatttcgtcatttttcacgttgtcaagtggatgtttctcattttccatgattttcacttttcttgccatatttcatgttttacagtggacatttctaaattttccacctatttctgttttcctcgccatatttcacatcctaaagtgtgtatttctcattttccgtgattttcagttttctcgccatatgccaggtcatacagggtgcatttctcatttttcacgtttttcagtgatttcgtcatttttcacgtcgtcaagtggatgtttctcattttcaatgattttcatttttcttgccatattccacgtcctatagtggacatttctaaattttccacctttttcagttttccttgccatatttcaggtcctacagtgtgcatttctcttttttcacgtttttcagtgatttcgtcatttttcaagtggtcaagtgcatgtttctcattttccgtgattttcagttttcttgccatgttccaggtcctacagttgacgtttctaaaatttcactttttttaagttttcctcgccatatttcacttcctaaagtgtgtatttctcattttccgtgattttcagttttctcgccagattccaggtcctacagtgtgcatttttcatatttcacctttttcagtgattttgtcatttttcaagttgtcaactgcatgtttctcattttccatgattttcagttttcttgccatattccatgtcctactgtggacatttctaaattttccaactttttcagttttcctcgccatatttcatgtcctaaagtgtgtatttctcattttcagtgattttctgttttctcgccatattccaggtcctacagtgtgcatttctaatttttcacgtttttcagtgatttcgtcatttttcaagttgtcaagtggatgtttctcattttccatgattttcagttttcttgccatattccatgtcctacagtggacatttctaaattttccaactttttccattttcctcaccatatttcacgtcctaaagtgagtttttctcattttttgtgattttcagttttctcgacatattccaggtcctacagtgtgcatttctaattttttcttttttcagtgatttcgtcatttttcaagtggtcaagtgcatgtttctcattttccatgattttcagttttcttgccatattccatgtcctacaatggacatttctaaattttccaactttttcagttttcctcgccatatttcacgtcctaaagtgtgtatttctcattttccgtgattttcagttttctcgccatattccaggtcctacagtgtgcatttctcatttttcacgtttttcagtgatttcgtcatttttcaagttgtcaactgcatgtttctcattttccatgattttcagttttcttgccatattccatgtcttacagtggacatttttaaatttttcacatttttttaagttttcctccccatatttcacgttttaaagtgtgcatttctcattttcggtgattttcagttttctcgccagattccatgtcttacagtgtgcatttctcattttttcacgtttttcagtgatttcgtcatttttcaagtcgtcaagtggatgtttctcattttccatgattttcagttttcttgccatattccatgtcctacagtggaaatttctaaattttccacctttttcagttttccttgccatatttcaggtcctaaagtgtgtatttctcattttctgtgattttcagttttctcgccatattccaggtcctacagttgacatttctaaaatttccacattttttaagttttcctcgccatatttcacttcctaaagtgtgtatttctcattttccgtgattttcagttttctcgccatattccagatcctacagtgtacatttttcatttttcacgtttttcagtgattttgtcattttttagttgtcaactgcctgtttctcattttccatgattttcagttttcttgctatattccatgtcctacagtggaaatttctaaattttccacctttttcagttttcctcgccatatttcacgtcctaaagtgtgtatttctcattttccgtgattttcagttttctcgccatattccaggtcctatgtgtacatttctcatttttcacgtttttcagtgattttgtcatttttcaatttgtcaactgcatgtttctcattttccatgattttcagttttcttgccatattccatgtcctacagtggaaatttctatattttccaactttttcagttttcctcgccatatttcacgtgctaaagtgtgtatttctcatttttcgtgtttttcaggtttctcgccatattccaggtcctacagtgtgcatttctcatttttcacgtttttcagtgattttgtcatttttcaagttgtcaagtggatgtttctcattttccttgattttcagttttcttgccatattccatgtcctacagtggacatttctaaattttccacctttttcagttttccttgccatatttcatgtcctaaagtgtgtatttctcattttcagtgattttcagttttctcgccatattccaggtcctacagtgtgcatttctcattttttcaggtttttcagtgatttcgtcatttttcacgttgtcaagtggatgtttctcattttccatgattttcacttttcttgccatatttcatgtcctaaagtgtgtatttctcattttcagtgattttcagttttctcgctatattccaggtcctacagtgtgcatttctcattttttcacgtttttcagtgatttcgtcatttttcacgttgtcaagtggatgtttctcattttccatgattttcacttttcttgccatatttcatgtcctacaatggacatttctaaattttccacctttttctgttttcctcgccatatttcacatcctaaagtgtgtatttctcattttccgtgattttcagttttcttgccatattccaggtcctacagtgtgcatttctcatttttcacgtttttcagtgatttcgtcatttttcaagttgtcaagtggatgtttctcattttccttgattttcagttttcttgccatattccatgtcctactgtggacatttctaaattttccacctttttcagttttccttgccatatttcatgtcctaaagtgtgtatttctcattttcagtgattttcagttttctcgcaatattccaggtcctacagtgtgcatttctcattttttcaggtttttcagtgatttcgtcatttttcacgttgtcaagtggatgtttctcattttccatgattttcacttttcttgccatatttcatgtcctaaagtgtgtatttctcattttcagtgattttcagttttctgccatattccaggtcctacattgtgcatttctcattttttcacgtttttcagtgatttcgtcatttttcagttttctcgacatattccaggtcctacagtgtgcatttctaattttttcttttttcagtgatttcgtcatttttcaagttgtcaactgcatgtttctcattttccatgattttcagttttcttgccatattccatgtcttacagtggacatttttaaatttttcacatttttttaagttttcctccccatatttcacgttttaaagtgtgcatttctcattttcggtgattttcagttttctcgccagattccaggtcttacagtgtgcatttctcattttttcacgtttttcagtgatttcgtcatttttcaagtcgtcaagtggatgtttctcattttccatgattttcagttttcttgccatattccatgtcctacagtggaaatttctaaattttccacctttttcagttttccttgccatatttcaggtcctaaagtgtgtatttctcattttctgtgattttcagttttctcgccatattccaggtcctacagttgacatttctaaaatttccacattttttaagttttcctcgccatatttcacttcctaaagtgtgtatttctcattttccgtgattttcagttttctcgccatattccagatcctacagtgtgcatttttcatttttcacgtttttcagtgattttgtcattttttagttgtcaactgtctgtttctcattttccatgattttcagttttcttgccatattccatgtcctacactggacatttctaaattttccacctttttctgttttcctcgccatatttcacgtcctaaagtgtgtatttctcattttccgtgattttcagttttcttgccatattccaggtcctacagtgtgcatttctcatttttcacgtttttcagtgattttgtcatttttcaagttgtcaactgcatgtttctcattttctatgattttcagttttcttgctatattccatgtcctacagtggaaatttctaaattttccacctttttcagttttcctcgccatatttcacgtcctaaagtgtgtatttctcattttccgtgattttcagttttctcgccatattccaggtcctatgtgtacatttctcatttttcacgtttttcagtgattttgtcatttttcaagttgtgaagtggatgtttctcatttttcttgattttcatttttcttgccatattccatgtcctagagtggaaatttttaaattttccacctttttcagttttcctcgccatatttcacgtcctaaagtgtgaatttctcattttccgtgattttcagatttctcgccatattccaagtcctacagtgtgcatttctcatttttcacgtttttcagtgatttcgtcatttttcaagttgtcaagtggatgtttctcattttccatgattttcagctttcttgccatattcaaagtcctacagtggacatttctaaattttcgacctttatcagttttcctcgccatatttcatgtcccaaagtgtgtacttctcattttccgtgattttcagtttcctagccatattctaggtcctacagtgtgcatttctcatttttcaggtttttcagtgatttcgtcttttttcaagtcgtcaagtggatgtttctcattttccatgattttcacttttcttgccatatttcatgtcctaaagtgtgtatttctcattttcagtgattttcagttttctcgctatattccaggtcctacagtgtgcatttctcattttttcacgtttttcagtgatttcgtcatttttcacgttgtcaagtggatgtttctcattttccatgattttcacttttcttgccatatttcatgtcctacagtggacatttctaaattttccacctttttctgttttcctcgccatatttcacatcctaaagtgtgtatttctcattttccgtgattttcagttttcttgccatattccaggtcctacagtgtgcatttctcatttttcacgtttttcagtgatttcgtcatttttcaagttgtcaagtggatgtttctcattttccttgattttcagttttcttgccatattccatgtcctactgtggacatttctaaattttccacctttttcagttttccttgccatatttcatgtcctaaagtgtgtatttctcattttcagtgattttcagttttctcgcaatattccaggtcctacagtgtgcatttctcattttttcaggtttttcagtgatttcgtcatttttcacgttgtcaagtggatgtttctcattttccatgattttcacttttcttgccatatttcatgtcctaaagtgtgtatttctcattttcagtgattttcagttttctgccatattccaggtcctacattgtgcatttctcattttttcacgtttttcagtgatttcgtcatttttcacgttgtcaagtggatgtttctcattttccatgattttcacttttcttgccatatttcatgttttacagtggacatttctaaattttccacctttttctgttttcctcgccatatttcacatcctaaagtgtgtatttctcattttccgtgattttcagttttctcgccatatgccaggtcatacagggtgcatttctcatttttcacgtttttcagtgatttcgtcatttttcacgtcgtcaagtggatgtttctcattttcaatgattttcatttttcttgccatattccacgtcctatagtggacatttctaaattttccacctttttcagttttccttgccatatttcaggtcctacagtgtgcatttctcatttttcacgtttttcagtgatttcgtcatttttcaagtggtcaagtgcatgtttctcattttccgtgattttcagttttcttgccatgttccaggtcctacagttgacgtttctaaaatttcactttttttaagttttcctcgccatatttcacttcctaaagtgtgtatttctcattttccgtgattttcagttttctcgccagattccaggtcctacagtgtgcatttttcatatttcacctttttcagtgattttgtcatttttcaagttgtcaactgcatgtttctcattttccatgattttcagttttcttgccatattccatgtcctactgtggacatttctaaattttccaactttttcagttttcctcgccatatttcatgtcctaaagtgtgtatttctcattttcagtgattttctgttttctcgccatattccaggtcctacagtgtgcatttctaatttttcacgtttttcagtgatttcgtcatttttcaagttgtcaagtggatgtttctcattttccatgattttcagttttcttgccatattccatgtcctacagtggacatttctaaattttccaactttttccattttcctcaccatatttcacgtcctaaagtgtgtttttctcattttttgtgattttcagttttctcgacatattccaggtcctacagtgtgcatttctaattttttcttttttcagtgatttcgtcatttttcaagttgtcaactgcatgtttctcattttccatgattttcagttttcttgccatattccatgtcttacagtggacatttttaaatttttcacatttttttaagttttcctccccatatttcacgttttaaagtgtgcatttctcattttcggtgattttcagttttctcgccagattccaggtcttacagtgtgcatttctcattttttcacgtttttcagtgatttcgtcatttttcaagtcgtcaagtggatgtttctcattttccatgattttcagttttcttgccatattccatgtcctacagtggaaatttctaaattttccacctttttcagttttccttgccatatttcaggtcctaaagtgtgtatttctcattttctgtgattttcagttttctcgccatattccaggtcctacagttgacatttctaaaatttccacattttttaagttttcctcgccatatttcacttcctaaagtgtgtatttctcattttccgtgattttcagttttctcgccatattccagatcctacagtgtgcatttttcatttttcacgtttttcagtgattttgtcattttttagttgtcaactgtctgtttctcattttccatgattttcagttttcttgccatattccatgtcctacactggacatttctaaattttccacctttttctgttttcctcgccatatttcacgtcctaaagtgtgtatttctcattttccgtgattttcagttttcttgccatattccaggtcctacagtgtgcatttctcatttttcacgtttttcagtgattttgtcatttttcaagttgtcaactgcatgtttctcattttccatgattttcagttttcttgctatattccatgtcctacagtggaaatttctaaattttccacctttttcagttttcctcgccatatttcacgtcctaaagtgtgtatttctcattttccgtgattttcagttttctcgccatattccaggtcctatgtgtacatttctcatttttcacgtttttcagtgattttgtcatttttcaagttgtgaagtggatgtttctcatttttcttgattttcatttttcttgccatattccatgtcctagagtggaaatttttaaattttccacctttttcagttttcctcgccatatttcacgtcctaaagtgtgaatttctcattttccgtgattttcagatttctcgccatattccaagtcctacagtgtgcatttctcatttttcacgtttttcagtgatttcgtcatttttcaagttgtcaagtggatgtttctcattttccatgattttcagctttcttgccatattcaaagtcctacagtggacatttctaaattttcgacctttatcagttttcctcgccatatttcatgtcccaaagtgtgtacttctcattttccgtgattttcagtttcctcgccatattctaggtcctacagtgtgcatttctcatttttcaggtttttcagtgatttcgtcttttttcaagtcgtcaagtggatgtttctcattttccatgattttcagttttcttgccatattccatgtcctacagtggacatttctaaattttccacctttttcagttttcctcgccatatttcatgtcctaaagtgtgtatttctcattttcagtgattttcagttttctcgccatattccaggtcctacagtgtgcatttctcatttttcacgtttttcagtgatttcgtcatttttcaagttgtcaagtggatgtttctcattttccatgattttcagttttcttgccatattccatgtcccacagtggacatttctaaattttccacctttttctgttttccttgccatatttcatgtcctaaagtgtgtatttctcattttccgtgattttcagttttcttgctatattccaagtcctacagtgtgcatttctcatttttcacgtttttcagtgattttgtcatttttcaatttgtcaactgcatgtttctcattttccatgattttcagttttcttgccatattccatgtcctacagtggaaatttctatattttccaactttttcagttttcctcgccatatttcacgtgctaaagtgtgtatttctcatttttcgtgtttttcaggtttctcgccatattccaggtcctacagtgtgcatttctcatttttcacgtttttcagtgattttgtcatttttcaagttgtcaagtggatgtttctcattttccttgattttcagttttcttgccatattccatgtcctacagtggacatttctaaattttccacctttttcagttttccttgccatatttcatgtcctaaagtgtgtatttctcattttcagtgattttcagttttctcgccatattccaggtcctacagtgtgcatttctcattttttcaggtttttcagtgatttcgtcatttttcacgttgtcaagtggatgtttctcattttccatgattttcacttttcttgccatatttcatgtcctaaagtgtgtatttctcattttcagtgattttcagttttctcgctatattccaggtcctacagtgtgcatttctcattttttcacgtttttcagtgatttcgtcatttttcacgttgtcaagtggatgtttctcattttccatgattttcacttttcttgccatatttcatgtcctacagtggacatttctaaattttccacctttttctgttttcctcgccatatttcacatactaaagtgtgtatttctcattttccttgattttcagttttcttgccatattccaggtcctacagtgtgcatttctcatttttcacgtttttcagtgatttcgtcatttttcaagtcgtcaagtggatgtttctcattttccatgattttcagttttctcgccatattccaggtcctacagttgacatttctaaattttccacattttttaagtttcctcgcgatatttcacatcctaaagtgtgtatttctcattttccgtgattttcagttttcttgccatattccaggtcctacagggtgcatttctcatttttcacgtttttcagtgatttcatcaatttcaagtcgtcaactgtatgtttctcattttcaatgattttcatttttcttgccatattccatgtcctacagtggacatttctaaatttttcacctttttcagttttccttgccatatttcatgtcctaaagtgtgtatttctcattttcagtgattttcagttttctcgccatattccaggtcctacagtgtgcatttctcattttttcaggtttttcagtgatttcgtcatttttcacgttgtcaagtggatgtttctcattttccatgattttcacttttcttgccatatttcatgtcctaaagtgtgtatttctcattttcagtgattttcagttttctcgccatattccaggtcctacagtgtgcatttctcatttttcacgtttttcagtgatttcgtcatttttcaagttgtcaagtggatgtttctcattttccatgattttcacttttcttgccatattccatgtcccacagtggacatttctaaattttccacctttttctgttttcctcgccatatttcatgtcctaaagtgtgtatttctcattttccgtgattttcagttttcttgctatattccaagtcctacagtgtgcatttctcatttttcacgtttttcagtgattttgtcatttttcaatttgtcaactgcatgtttctcattttccatgattttcagttttcttgccatattccatgttctacagtggaaatttctatattttccaactttttcagttttcctcgccatatttcacgtgctaaagtgtgtatttctcatttttcgtgtttttcaggtttctcgccatattccaggtcctacagtgtgcatttctcatttttcacgtttttcagtgattttgtcatttttcaagttgtcaagtggatgtttctcattttccttgattttcagttttcttgccatattccatgtcctacagtggacatttctaaattttccacctttttcagttttccttgccatatttcatgtcctaaagtgtgtatttctcattttcagtgattttcagttttctcgccatattccaggtcctacagtgtgcatttctcattttttcaggtttttcagtgatttcgtcatttttcacgttgtcaagtggatgtttctcattttccatgattttcacttttcttgccatatttcatgtcctaaagtgtgtatttctcattttcagtgattttcagttttctcgctatattccaggtcctacagtgtgcatttctcattttttcacgttttgcagtgatttcgtcatttttcacgttgtcaagtggatgtttctcattttccatgattttcacttttcttgccatatttcatgtcctacagtggacatttctaaattttccacctttttctgttttcctcgccatatttcacatcctaaagtgtgtatttctcattttccgtgattttcagttttcttgccatattccaggtcctacagtgtgcatttctcatttttcacgtttttcagtgatttcgtcatttttcaagtcgtcaagtggatgtttctcattttccatgattttcagttttctcgccatattccaggtcctacagttgacatttctaaattttccacattttttaagtttcctcgcgatatttcacatcctaaagtgtgtatttctcattttccgtgattttcagttttcttgccatattccaggtcctacagggtgcatttctcatttttcacgtttttcagtgatttcatcaatttcaagtcgtcaactgtatgtttctcattttcaatgattttcatttttcttgccatattccatgtcctacagtggacatttctaaattttccacctttttcagttttccttgccatatttcatgtcctaaagtgtgtatttctcattttcagggattttcagttttctcgccatattccaggtcctacagtgtgcatttctcattttttcaggtttttcagtgatttcgtcatttttcacgttgtcaagtggatgtttctcattttccatgattttcacttttcttgccatatttcatgtcctaaagtgtgtatttctcattttcagtgattttcagttttctcgccatattccaggtcctacagtgtgcatttctcattttttcacgtttttcagtgatttcgtcatttttcacgttgtcaagtggatgtttctcattttccatgattttcacttttcttgccatatttcatgtcctacagtggacatttctaaattttccacctttttctgttttcctcgccatatttcacatcctaaagtgtgtatttctcattttccgtgattttcagttttcttgccatattccaggtcctacagtgtgcatttctcatttttcacgtttttcagtgatttcgtcatttttcaagtcgtcaagtggatgtttctcattttccatgattttcagttttctcgccatattccaggtcctacagttgacatttctaaattttccacattttttaagtttcctcgcgatatttcacatcctaaagtgtgtatttctcattttccgtgattttcagttttcttgccatattccaggtcctacagggtgcatttctcatttttcacgtttttcagtgatttcatcaatttcaagtcgtcaactgtatgtttctcattttcaatgattttcatttttcttgccatattccacgtcctatagtggacatttctaaattttccacctttttcagttttcttcgccatatttcacgtcccaaagtgtgtatttctcattttccgtgattttcagtttcctcgcaatattccaggtcctacagtgtgcatttctcatttttcacgtttttcagtgatttcgtcttttttcaagtcgtcaagtggatgtttctcattttccatgattttcagttttcttgccatattccatgtcctacagtggacatttctaaattttccacctttttctgttttcctcgccatatttcacgtcctaaagtgtgtatttctcattttccgtgattttcagttttcttgccatattccaggtcctacagtgtgcatttctcatttttcacgtttttcactgattttgtcattgttcaagttgtcaactgcatgtttctcattttccatgattttcaattttcttgccatattccatgtcctacagtggaaatttctatattttccaactttttcagttttcctcgccatatttcacgtgctaaagtgtgtatttctcatttttcgtgtttttcaggtttctcgccatattccaggtcctacagtgtgcatttctcatttttcacgtttttcagtgattttgtcatttttcaagttgtcaagtggttgtttctcattttccttgattttcagttttcttgccatattccatgtcctactgtggacatttctaaattttccacctttttcagttttccttgccatatttcatgtcctaaagtgtgtatttctcattttcagtgattttcagttttctcgcaatattccaggtcctacagtgtgcatttctcattttccgtgattttcagttttctcgccatatgccaggtcatacagggtgcatttctcatttttcacgtttttcagtgatttcgtcatttttcacgtcgtcaagtggatgtttctcattttcaatgattttcatttttcttgccatattccacgtcctatagtggacatttctaaattttccaactttttcagttttcttgccatatttcaggtcctacagtgtgcatttctcatttttcacgtttttcagtgatttcgtcatttttcaagtggtcaagtgcatgtttctgattttccgtgattttcagttttcttgccatgttccaggtcctacagttgacgtttctaaaatttcactttttttaagttttcctcgccatatttcacttcctaaagtgtgtatttctcattttccgtgattttcagttttctcgccagattccaggtcctacagtgtgcatttttcatatttcacctttttcagtgattttgtcatttttcaagttgtcaactgcatgtttctcattttccatgattttcagttttcttgccatattccatgtcctactgtggacatttctaaattttccaactttttcagttttcctcgccatatttcatgtcctaaagtgtgtatttctcattttcagtgtttttctgttttctcgccatattccaggtcctacagtgtgcatttctaatttttcacgtttttcagtgatttcgtcatttttcaagttgtcaagtggatgtttctcattttccatgattttcagttttcttgccatattccatgtcctacagtggacatttctaaattttccaactttttccattttcctcaccatatttcacgtcctaaagtgtgtttttctcattttttgtgattttcagttttctcgacatattccaggtcctacagtgtgcatttctaattttttcttttttcagtgatttcgtcatttttcaagtggtcaagtgcatgtttctcattttccatgattttcagttttcttgccatattccatgtcctacaatggacatttctaaattttccaactttttcagttttcctcgccatatttcacgtcctaaagtgtgtatttctcattttccgtgattttcagttttctcgccatattccaggtcctatgtgtacatttctcatttttcacgtttttcagtgattttgtcatttttcaagttgtgaagtggatgtttctcatttttcttgattttcatttttcttgccatattccatgtcctagagtggaaatttttaaattttccaactttttcagttttcctcgccatatttcacgtcctaaagtgtgtatttctcattttccgtgattttcagttttctcgccatattccaagtcctacagtgtgcatttctcatttttcacgtttttcagtgatttcgtcatttttcaagttgtcaagtggatgtttctcattttccatgattttcagctttcttgccatattcaaagtcctacagtggacatttctaaattttcgacctttatcagttttcctcgccatatttcatgtcccaaagtgtgtacttctcattttccgtgattttcagtttcctcgccatattctaggtcctacagtgtgcatttctcatttttcaggtttttcagtgatttcgtcttttttcaagtcgtcaagtggatgtttctcattttccatgattttcagttttcttgccatattccatgtcctacagtggacatttctaaattttccacctttttcagttttcctcgccatatttcatgtcctaaagtgtgtatttctcattttcagtgattttcagttttctcgccatattccaggtcctacagtgtgcatttctcatttttcacgtttttcagtgatttcgtcatttttcaagttgtcaagtggatgtttctcattttccatgattttcagttttcttgccatattccatgtcccacagtggacatttctaaattttccacctttttctgttttccttgccatatttcatgtcctaaagtgtgtatttctcattttccgtgattttcagttttcttgctatattccaagtcctacagtgtgcatttctcatttttcacgtttttaagtgattttgtcatttttcaatttgtcaactgcatgtttctcattttccatgattttcagttttcttgccatattccatgtcctacagtggaaatttctatattttccaactttttcagttttcctcgccatatttcacgtgctaaagtgtgtatttctcatttttcgtgtttttcaggtttctcgccatattccaggtcctacagtgtgcatttctcatttttcacgtttttcagtgattttgtcatttttcaagttgtcaagtggatgtttctcattttccttgattttcagttttcttgccatattccatgtcctacagtggacatttctaaattttccacctttttcagttttccttgccatatttcatgtcctaaagtgtgtatttctcattttcagtgattttcagttttctcgccatattccaggtcctacagtgtgcatttctcattttttcaggtttttcagtgatttcgtcatttttcacgttgtcaagtggatgtttctcattttccatgattttcacttttcttgccatatttcatgtcctaaagtgtgtatttctcattttcagtgattttcagttttctcgccatattccaggtcctacagtgtgcatttctcattttttcacgtttttcagtgatttcgtcatttttcacgttgtcaagtggatgtttctcattttccatgattttcacttttcttgccatatttcatgtcctacagtggacatttctaaattttccacctttttctgttttcctcgccatatttcacatcctaaagtgtgtatttctcattttccgtgattttcagttttcttgccatatttcaggtcctacagtgtgcatttctcatttttcacgtttttcagtgatttcgtcatttttcaagtcgtcaagaggatgtttctcattttccatgattttcagttttctcgccatattccaggtcctacagttgacatttctaaattttccacattttttaagtttcctcgcgatatttcacatcctaaagtgtgtatttctcattttccgtgattttcagttttcttgccatattccaggtcctacagggtgcatttctcatttttcacgtttttcagtgatttcatcaatttcaagtcgtcaactgtatgtttctcattttcaatgattttcatttttcttgccatattccacgtcctatagtggacatttctaaattttccacctttttctgttttcctcgccatatttcacgtcctaaagtgtgtatttctcattttccgtgattttcagttttcttgccatattccaggtcctacagtgtgcatttctcatttttcacgtttttcactgattttgtcattgttcaagttgtcaactgcatgtttctcattttccatgattttcagttttcttgccatattccatgtcctacagtggaaatttctatattttccacctttttcagttttcctcgccgtatttcatgtgctaaagtgtgtatttctcatttttcgtgtttttcaggtttctcgccatattccaggtcctacagtgtgcatttctcatttttcacgtttttcagtgattttgtcatttttcaagttgtcaactggatgtttctcattttccttgattttcagttttcttgccatattccatgtcctactgtggacatttctaaattttccacctttttcagttttccttgccatatttcatgtcctaaagtgtgtatttctcattttcagtgattttcagttttctcgcaatattccaggtcctacagtgtgcatttctcattttttcaggtttttcagtgatttcgtcatttttcacgttgtcaagtggatgtttctcattttccatgattttcacttttcttgccatatttcatgtcctaaagtgtgtatttctcattttcagtgattttcagttttctcgccatattccaggtcctacattgtgcatttctcattttttcacgtttttcagtgatttcgtcatttttcacgttgtcaagtggatgtttctcattttccatgattttcacttttcttgccatatttcatgttttacagtggacatttctaaattttccacctttttctgttttcctcgccatatttcacatcctaaagtgtgaatttctcattttccgtgattttcagttttcttgccatattccaggtcctacagtgtgcatttctcatttttcacgtttttcagtgatttcatcatttttcaagtcgtcaagtggatgtttctcattttccatgattttcagttttcttgccatattccatgtcctacagtggacatttctaaattttccacctttttctgttttcctcgccatatttcacgtcctaaagtgtgtatttctcattttccgtgattttcagttttcttgccatattccaggtcctacagtgtgcatttctcatttttcacgtttttcactgattttgtcatttttcaagttgtcaactgcatgtttctcattttccatgattttcagttttcttgctatattccatgtcctacagtggaaatttctaaattttccacctttttcagttttcctcgccatatttcacgtcctgaagtgtgtatttctcattttccgtgattttcagttttctcgccatattccaggtcctatgtgtacatttctcatttttcacgtttttcagtgattttgtcatttttcaagttgtgaagtggatgtttctcatttttcttgattttcatttttcttgccatattccatgtcctacagtggaaatttctaaattttccacctttttcagttttcctcgccatatttcacgtcctaaagtgtgtatttctcattttccgtgattttcagttttctcgccatattccaggtcctacagtgtgcatttctcatttttcacgtttttcagtgatttcgacatttttcaagttgtcaagtggatgtttctcattttccatgattttcagctttcttgccatattcaaagtcctacagtggacatttctaaattttcgacctttatcagttttcctcgccatatttcatgtcccaaagtgtgtacttctcattttccgtgattttcagtttcctcgccatattccaggtcctacagtgtgcatttctcatttttcacgtttttcagtgatttcgtcatttttcaagtcgtcaagtggatgtttctcattttccatgattttcagttttcttgccatattccatgtcctacagtggacatttctaaattttccacctttttctgttttcctcgccatatttcacgtcctaaagtgtgtatttctcattttccgtgattttcagttttcttgccatattccaggtcctacagtgtgcatttctcatttatcacgtttttcactgattttgtcatttttcaagttgtcaactgcatgtttctcattttccatgattttcagttttcttgctatattccatgtcctacagtggaatattctaaattttccacctttttcagttttcctcgccatatttcacgtcctgaagtgtgtatttctcattttccgtgattttcagttttctcgccatattccaggtcctatgtgtacatttctcatttttcacgtttttcagtgattttgtcatttttcaagttgtgaagtggatgtttctcatttttcttgattttcatttttcttgccatattccatgtcctacagtggaaatttctaaattttccacctttttcagttttcctcgccatatttcacgtcctaaagtgtgaatttctcattttccgtgattttcagttttctcgccatattccaggtcctacagtgtgcatttctcatttttcacgtttttcagtgatttcgacatttttcaagttgtcaagtggatgtttctcattttccatgattttcagctttcttgccatattcaaagtcctacagtggacatttctaaattttcgacctttatcagttttcctcgccatatttcatgtcccaaagtgtgtacttctcattttccgtgattttgagtttcctcgccatattccaggtcctacagtgtgcatttctcatttttcacgtttttcagtgatttcgtcttttttcaagttgtcaactgcatgtttctcattttccatgattttcagttttcttgccatattccatgtcctacagtggaaatttgtaaatttccacctttttcagttttcctcgccatatttcacgtcctaaagtatgtatttctcattttccgtgattttcagttttctcgccatattccaggtcctacagtgtgcatttctcatttttcacgtttttcagtgattttgtcattttttaagttttcaagtggatgtttctcattttccttgattttcagttttcttgccatattccatgtcctacagtggacatttctaaattttccacctttttcagttttcctcgccatatttcatgtcctaaagtgtgtatttctcattttcagtgattttcagttttctcgccatattccaggtcctacagtgtgcatttctcatttttcacgtttttcagtgatttcgtcatttttcaaggtgtcaagtggatgtttctcattttccatgattttcagttttcttgccatattccatgtcctacagtggacatttctaaattttccacctttttctgttttcctcgccatatttcatgtcctaaagtgtgtatttctcattttccgtgattttcagttttcttgctatattccaagtcctacagtgtgcatttctcatttttcacgtttttcagtgattttgtcatttttcaatttgtcaactgcatgtttctcattttccatgattttcagtttttttgccatattccatgtcctactgtggaaatttctatattttccacctttttcagttttcctcgccatatttcacgtgctaaagtgtgtatttctcatttttcgtgtttttcaggtttctcgccatattccaggtcctacagtgtgcatttctcatttttcacgtttttcagtgattttgtcatttttcaagttttcaagtggatgtttctcattttccttgattttcagttttcttgccatattccatgtcctacagtggacatttctaaattttccacctttttcagttttccttgccatatttcatgtcctaaagtgtgtatttctcattttcagtgattttcagtttccttgccatattccaggtcctacagtgtgcatttctcattttttcacgtttttcagtgatttcgtcatttttcacgttgtcaagtggatgtttctcattttccatgattttcacttttcttgccatatttcatgtcctacagtggacatttctaaattttccaactttttcaattttcctcgccatattttatgtcctaaagtgtgtatttctcatttttcgttattttcagttttcttgccatattccaggtcctacagtgtgcatttgtcatttttcacgtttttcagtgatttcgtcatttttcaagtcgtcaagtagatgtttctcatattccatgtttttcagttttctcgccatattccaggtcctacagttgacatttctaaattttctacatttttaaattttcctcgccatatttcacgtcctaaagtgtgtatttctcattttttgttattttcagttttctagccatattccaggtcctacaggatgcatttctcatttttcacgtttttcagtgatttcatcatttttcaagtcgtcaagtgtatgtttcttattttcaatgattttcatttttcttgccttattccacgtcctatagtggacatttctaaattttccacctttttcagtttttttcgccatatttcacgtcctaaagtgtgtatttctcattttctgtgattttcagttttctcaccatattccaggtcctacagtgtgcatttctcatttttcacgtttttcagtgatttcgtcatttttcaagttgtcaagtggaagtttctcattttccatgattttcagctttctagacatattccaggtcctacagtggacatttcctaattttcgacctttatcagttttcctcgtcatatttcacgtcccaaaatgtgtatttcttattttccatgattttcagtttcctcgccatattccaggtcctacagtgtgcaattctcatttttcacgtttttcagtgatttcgtcttttttcaagacgtcaagtggatgtttctcatttttcatgattttcagttttcttgccatattccatgtcctacagtggacatttctaaattttccacctttttctgttttcctcgccatatttcacgtcctaaagtgtgtatttctcattttccgtgattttcagttttcttgccatattcctggtcctacagtgtgcatttctcatttttcacgtttttcagtgattttgtcatttttcaatttgtcaactgcatgtttctcattttccattattttcagttttcttgccatattccatgtcctacagtggacatttctaaattttccacctttttctgttttcctcgccatatttcatgtcctaaagtgtgtatttctcattttccgtgattttcagttttcttgctatattccaagtcctacagtgtgcatttctcatttttcacgtttttcagtgattttgtcatttttcaatttgtcaactgcatgtttctcattttccatgattttcagtttttttgccatattccatgtcctacaggggaaatttctatattttccacctttttcagttttcctcgccatatttcatgtcctaaagtgtgtatttctcattttccgtgattttcagttttcttgccatattccaggtcctacagtgtgcatttctcatttttcacgtttttcagtgatttcgtcatttttcaagtcttcaagtagatgtttctcatattccatgtttttcagttttctcgccatattccaggtcctacagttgacatttctaaattttctacatttttaaattttcctcgccatatttcacgtcctaaagtgtgtatttctcatttttcgttattttcagttttctagccatattccaggtcctacaggatgcatttctcatttttcacgtttttcagtgatttcatcatttttcaagtcgtcaagtgtatgtttctcattttcaatgattttcatttttcttgccttattccacgtcctatagtggacatttctaaattttccacctttttcagtttttctcgccatatttcacgtcctaaagtgtgtatttctcattttctgtgattttcagttttctcaccatattccaggtcctacagtgtgcatttctcatttttcacgtttttcagtgatttcgtcatttttcaagttgtcaagtggaagtttctcattttccatgattttcagctttctagccatattccaggtcctacagtggacatttcctaattttcgacctttatcagttttcctcgccatatttcacgtcctaaagtgtgtatttctcattttccgtgattttcagttttcttgccatattccaggtcctacagtgtgcatttctcatttttcacgtttttcagtgattttgtcatttttcaatttgtcaactgcatgtttctcattttccatgatttttagttttcttgctatattccatgtcctacagtggaaatttctaaattttccacctttttcagttttcctcgccatatttcacgtcctaaagtgtgtatttctcattttccgtgattttcagttttcttgctatattccaagtcctacattgtgcatttctcatttttcacgtttttcagtgattttgtcatttttcaatttgtcaaaccacatgtttctcattttccatgattttcagtttttttgccatattccatgtcctacagtggaaatttctatattttccacctttttcagttttcctcgccatatttcacgtgctaaagtgtgtatttctcatttttcgtgtttttcaggtttctcgccatattccaggtcctacagtgtgcatttctcatttttcacgtttttcagtgattttgtcatttttcaagttgtcaagtggatgtttcccattttccttgattttcagttttcttaccatattccatgtcctacagtggacatttctaaattttccacctttttcagttttccttgccatatttcatgtcctaaagtgtgtatttctcattttcagtgattttcagtttcctcgccatattccaggtcctacagtgtgcatttctcattttttcacgtttttcagtgatttcgtcatttttcacgttgtcaagtggatgtttctcattttccatgattttcacttttcttgccatatttcatgtcctatagtggacatttctaaattttccacctttttcagtttttctcgccatatttcacgtcctaaagtgtgtatttctcattttctgtgattttcagttttctcaccatattccaggtcctacagtgtgcatttctcatttttcacgtttttcagtgatttcgtcatttttcaagtcgtcaagtagatgtttctcatattccatgtttttcagttttctcgccatattccaggtcctacagttgacatttctaaattttctacatttttaaattttcctcgccatatttcacgtcctaaagtgtgtatttctcatttttcgttattttcagttttctagccatattccaggtcctacaggatgcatttctcatttttcacgtttttcagtgatttcatcatttttcaagtcgtcaagtgtatgtttcttattttcaatgattttcatttttcttgccttattccacgtcctatagtggacatttctaaattttccaccttttttcagtttttctcgccatatttcacgtcctaaagtgtgtatttctcattttctgtgattatcagttttctcaccatattccaggtcctacagtgtgcatttctcatttttcacgtttttcagtgatttcgtcatttttcaagttgtcaagtggaagtttctcattttccatgattttcagctttctagccatattccaggtcctacagtggacatttcctaattttcgacctttatcagttttcctcgccatatttcacgtcccaaaatgtgtatttcttattttccatgattttcagtttcctcgccatattccaggtcctacagtgtgcatttctcatttttcacgtttttcagtgatttcgtcttttttcaagacgtcaagtggatgtttctcatttttcatgattttcagttttcttgccatattccatgtcctacagtggacatttctaaattttccacctttttctgttttcctcgccatatttcacgtcctaaagtgtgtatttctcattttccgtgattttcagttttcttgccatattcctggtcctacagtgtgcatttctcatttttcacgtttttcagtgattttgtcatttttcaatttgtcaactgcatgtttctcattttccatgattttcagttttcttgccatattccatgtcctacagtggacatttctaaattttccacctttttcagttttcctcgccatatttcacgtgctaaagtgtgtatttctcatttttcgtgtttttcaggtttctcgccatattccaggtcctacagtgtgcatttctcatttttcacgtttttcagtgattttgtcatttttcaagttgtcaagtggatgtttctcattttccttgattttcacttttcttgccatattccaagtcttacaggggcatttctcatttttcacgttttcagtgattttgtcattttcaatttgtcaactgcatgtttctcattttccatgattttcagtttttttgccatattccatgtcctacaggggaaatttctatattttccacctttttcagttttcctcgccatatttcatgtcctaaagtgtgtatttctcattttccgtgattttcagttttcttgccatattccaggtcctacagtgtgcatttctcatttttcacgtttttcagtgatttcgtcatttttcaagtcttcaagtagatgtttctcatattccatgtttttcagttttctcgccatattccaggtcctacagttgacatttctaaattttctacatttttaaattttcctcgccatatttcacgtcctaaagtgtgtatttctcatttttcgttattttcagttttctagccatattccaggtcctacaggatgcatttctcatttttcacgtttttcagtgatttcatcatttttcaagtcgtcaagtgtatgtttctcattttcaatgattttcatttttcttgccttattccacgtcctatagtggacatttctaaattttccacctttttcagtttttctcgccatatttcacgtcctaaagtgtgtatttctcattttctgtgattttcagttttctcaccatattccaggtcctacagtgtgcatttctcatttttcacgtttttcagtgatttcgtcatttttcaagttgtcaagtggaagtttctcattttccatgattttcagctttctagccatattccaagtcctacagtggacatttcctaattttcgacctttatcagttttcctcgccatatttcacgtcccaaaatgtgtattccttattttccatgattttcagtttcctcgccatattccaggtcctacagtgtgcatttatcatttttcacgtttttcagtgatttcgtcttttttcaagacgtcaagtggatgtttctcatttttcatgattttcagttttcttgccatattccatgtcctacagtggacatttctaaattttccacctttttctgttttcctcgccatatttcacgtcctaaagtgtgtatttctcattttccgtgattttcagttttcttgccatattcctggtcctacagtgtgcatttctcatttttcacgtttttcagtgattttgtcatttttcaagttgtcaagtggatgtttctcattttccttgattttcacttttcttgccatattccatgtcctacagtggacatttctatattttccacctttttccgttttccttgccatatttcacgtcctaaagtgtgtatttctcattttccgtgattttcaggtttctcgccatattccaggtcctacagtgtgcatttctcatttttcacgtttttcagtgattttgtcatttttcaagttgtcaagtggatgtttctcattttccttgattttcacttttcttgccatattccatgtcctacagtggacatttctaaattttccacctttttcagttttcctcgccatatttcatgtcctaaagtgtgtatttctcattttcagtgattttcagttttcttgccatattccaggtcctacagtgtgcatttctcatttttcacgtttttcagtgattttgtcatttttcaagttgtcaactgcatgtttctcattttctatgattttcagttttcttgctatattccatgtcctacagtggaaatttctaaattttccacctttttcagttttcctcgccatatttcacgtcctaaagtgtgtatttctcattttccgtgattttcagttttctcgccatattccaggtcctatgtgtacatttctcatttttcacgtttttcagtgattttgtcatttttcaagttgtgaagtggatgtttctcatttttcttgattttcatttttcttgccatattccatgtcctagagtggaaatttttaaattttccacctttttcagttttcctcgccatatttcacgtcctaaagtgtgaatttctcattttccgtgattttcagatttctcgccatattccaagtcctacagtgtgcatttctcatttttcacgtttttcagtgatttcgtcatttttcaagttgtcaagtggatgtttctcattttccatgattttcagctttcttgccatattcaaagtcctacagtggacatttctaaattttcgacctttatcagttttcctcgccatatttcatgtcccaaagtgtgtacttctcattttccgtgattttcagtttcctcgccatattctaggtcctacagtgtgcatttctcatttttcaggtttttcagtgatttcgtcttttttcaagtcgtcaagtggatgtttctcattttccatgattttcacttttcttgccatatttcatgtcctaaagtgtgtatttctcattttcagtgattttcagttttctcgctatattccaggtcctacagtgtgcatttctcattttttcacgtttttcagtgatttcgtcatttttcacgttgtcaagtggatgtttctcattttccatgattttcacttttcttgccatatttcatgtcctacagtggacatttctaaattttccacctttttctgttttcctcgccatatttcacatcctaaagtgtgtatttctcattttccgtgattttcagttttcttgccatattccaggtcctacagtgtgcatttctcatttttcacgtttttcagtgatttcgtcatttttcaagttgtcaagtggatgtttctcattttccttgattttcagttttcttgccatattccatgtcctactgtggacatttctaaattttccacctttttcagttttccttgccatatttcatgtcctaaagtgtgtatttctcattttcagtgattttcagttttctcgcaatattccaggtcctacagtgtgcatttctcattttttcaggtttttcagtgatttcgtcatttttcacgttgtcaagtggatgtttctcattttccatgattttcacttttcttgccatatttcatgtcctaaagtgtgtatttctcattttcagtgattttcagttttcctcgccatatttcacgtcccaaaatgtgtatttcttattttccatgattttcagtttcctcgccatattccaggtcctacagtgtgcatttctcatttttcacgtttttcagtgatttcgtcttttttcaagacgtcaagtggatgtttctcatttttcatgattttcagttttcttgccatattccatgtcctacagtggacatttctaaattttccacctttttctgttttcctcgccatatttcacgtcctaaagtgtgtatttctcattttccgtgattttcagttttcttgccatattcctggtcctacagtgtgcatttctcatttttcacgtttttcagtgattttgtcatttttcaatttgtcaactgcatgtttctcattttccatgattttcagttttcttgccatattccatgtcctacagtggacatttctaaattttccacctttttcagttttcctcgccatatttcacgtgctaaagtgtgtatttctcatttttcgtgtttttcaggtttctcgccatattccaggtcctacagtgtgcatttctcatttttcacgtttttcagtgattttgtcatttttcaagttgtcaagtggatgtttctcattttccttgattttcacttttcttgccatattccatgtcctacagtggacatttctaaattttccacctttttcagttttcctcgccatatttcatgtcctaaagtgtgtatttctcattttcagtgattttcagttttctcgccatattccaggtcctacagtgtgcatttctcatttttcacgtttttcagtgatttcgtcttttttcaagacgtcaagtggatgtttctcattttccatgattttcagttttcttgccatattccatgtcctacagtggacatttctaaattttccacctttttctgttttcctcgccatatttcacgtcctaaagtgtgtatttctcattttccgtgattttcagttttcttgccatattccaggtcctacagtgtgcatttctcatttttcacgtttttcagtgattttgtcatttttcaatttgtcaactgcatgtttctcattttccatgatttttagttttcttgctatattccatgtcctacagtggaaatttctaaattttccacctttttcagttttcctcgccatatttcacgtcctaaagtgtgtatttctcattttccgtgattttcagttttcttgctatattccaagtcctacattgtgcatttctcatttttcacgtttttcagtgattttgtcatttttcaatttgtcaaaccacatgtttctcattttccatgattttcagtttttttgccatattccatgtcctacagtggaaatttctatattttccacctttttcagttttcctcgccatatttcacgtgctaaagtgtgtatttctcatttttcgtgtttttcaggtttctcgccatattccaggtcctacagtgtgcatttctcatttttcacgtttttctgtgattttgtcatttttcaagttgtcaagtggatgtttctcattttccttgattttcagttttcttaccatattccatgtcctacagtggacatttctaaattttccaccttttctgttttcctcgccatatttcatgtcctaaagtgtgtatttctcattttccgtgattttcatttttcttgctatattccaagtcctacagtgtgcatttctcattttccatgattttcagttttcttgctatattccatgtcctacagtggaaatttctaaattttccacctttttcagttttcctcgccatatttcacgtcctaaagtgtgtatttctcattttccgtgattttcagttttttcgccatattacaggtcctatgtgtacatttctcatttttcacgtttttcagtgattttgtcatttttcaagttgtcaagtggatgtttctcatttttcttgattttcatttttcttgccatattccatgtcctacagtggaaatttctaaattttccacctttttcagttttcctcgccatatttcacgtcctaaagtgtgaatttctcattttccgtgattttcagttttctcgccatattccaggtctacagtgtgcatttctcatttttcacgttttcagtgattcgtcatttttcaagttgacaagtggatgtttctcattttccatgattttcagctttcttgccatattcaaagtcctacagtggacatttctaaattttcgacctttatcagttttcctcgccatatttcatgtcccaaagtgtgtacttctcattttccgtgattttcagttttcttgccatattccaagtcctacagtgtgcatttctcatttttcacgtttttcagtgattttgtcatttttcaatttgtcaactgcatgtttctcattttccatgattttcagttttcttgccatattccatgtcctacagtggaaatttctatattttccacctttttcagttttcctcgccatatttcacgtgctaaagtgtgtatttctcatttttcgtgtttttcaggtttctcgccatattccaggtcctacagtgtgcatttctcatttttcacgtttttcagtgattttgtcatttttcaagttgtcaagtggatgtttctcattttcaatgattttcatttttcttgccttattccacgtcctatagtggacatttctaaattttccacctttttcagtttttctcgccatatttcacgtcccaaaatgtgtattccttattttccatgattttcagtttcctcgccatattccaggtcctacagtgtgcatttctcatttttcacgtttttcagtgatttcgtcttttttcaagacgtcaagtggatgtttctcatttttcatgattttcagttttcttgccatattccctgtcctacagtggacatttctaaattttccacctttttctgttttcctcgccatatttcacgtcctaaagtgtgtatttctcattttccgtgattttcagttttctcgccagattccaggtcctacagtgtgcatttctcatttttcacgtttttcagtgattttgtcatttttcaatttgtcaactgcatgtttctctctttccatgattttcagttttcttgccatattccatgtcctacagtggacatttctaaattttccacctttttcagttttcctcgccatatttcacgtgctaaagtgtgtatttctcatttttcgtgtttttcaggtttctcgccatattccaggtcctacagtgtgcatttctcatttttcacgtttttcagtgattttgtcatttttcaagttgtcaagtggatgtttctcattttcaatgattttcatttttcttaccttattccacgtcctatagtggacatttctaaattttccacctttttcagtttttctcgccatatttcacgtcccaaaatgtgtattccttattttccatgattttcagtttcctcgccatattccaggtcctacagtgtgcatttctcatttttcacgtttttcagtgatttcgtcttttttcaagacgtcaagtggatgtttctcatttttcatgattttcagttttcttgccatattccctgtcctacagtggacatttctaaattttccacctttttctgttttcctcgccatatttcacgtcctaaagtgtgtatttctcattttccgtgattttcagttttctcgccagattccaggtcctacagtgtgcatttctcatttttcacgtttttcagtgatttcgtcatttttcaagtcttcaagtgtatgtttctcattttcaatgattttcatttttcttgccttattccacgtcctatagtggacatttctaaattttccacctttttcagtttttctcgccatatttcacgtcctaaagtgtgtatttctcattttctgtgattttcagttttcttaccatattccaggtcctacagtgtgcatttctcatttttcacgtttttcagtgatttcgtcatttttcaagttgtcaagtggaagtttctcattttccatgattttcagctttctagccatattccaggtattacagtggacatttccttattttcgacctttatcagttttcctcgccatatttcatgtcctaaagtgtgt	38399	1554	4%	7300	19%
9	3000001	3038400	Atcctacagtgtgcatttctcatttttcacgtttttcagtgatttcgtcatttttcaagtcatcaagtggctgtttctcattttccatgattttcagttttcttgccatattccttgtcctacagtggacatttctaaattttccacctttttcagttttccttgtcatatttcaggtcctacagtgtgtatttctcatttttcacgtttttcattgatttcgtcatttttcaagttgtcaagtgcatgtttctcattttccatgattttcagttttcttgccatattccatgtcctacaatggacatttctaaattttccaactttttcagttttcctcgccatatttcacgtcctaaagtgtgtatttctcattttccgtgattttcagttttctcgacatattccaggtcctacagtgtgcatttctcatttttcacgtttttcagtgatttcgtcatttttcacgtcgtcaagtggatgtttctcattttccatgattttcagttttcttgccatattccatgtcctacagtggacatttctaaattttccacctttttcagttttcctcgccatatttcacgtcctaaagtgtgtatttctcattttccgtgattttcagttttctcgacatattccaggtcttacagggtgcatttctcatttttcacgtttttcagtgatttcatcatttttcaagtcgtcaactgtatgtttctcattttcaatgattttcatttttcttgccatattccacgtcctatagtggacatttctaaattttccacctttttcagttttccttgccatatttcaggtcctacagtgtgcatttctcatttttcacgtttttcagtgatttcgtcatttttcaagtggtcaaatgcatgtttctcattttccatgattttcagttttcttgccatattccatgtcctacagtggacatttctaaattttccacctttttcagttttcctcgccatatttcacgtcctaaagtgtgtatttctcattttccgtgattttcagttttatcgccagattccaggtcctacggtgtgcatttttcatatttcacgtttttcagtgattttgtcatttttcaagttgtcaactgcatgtttctcattttccatgattttcagttttcttgccatattccatgtcctacagtggacatttctaaattttccacctttttcagttttcctcgccatatttcatgtcctaaagtgtgtatttctcattttcagtgattttctgttttctcgccatattccaggtcctacagtgtgcatttctcatttttcacgtttttcagtgatttcgtcatttttcaagttgtcaagtggatgtttctcattttccatgattttcagttttcttgccatattccatgtcctacaatggacatttctaaattttccacctttttcagttttcctcgccatatttcacgtcctaaagtgtgtatttctcattttccgtgattttcagttttctcgccatattccaggtcctatgtgtacatttctcatttttcacgtttttcagtgattttgtcatttttcaagttgtgaagtggatgtttctcatttttcttgattttcatttttcttgccatattccatgtcctagagtggaaatttttaaattttccacctttttcagttttcctcgccatatttcacgtcctaaagtgtgaatttctcattttccgtgattttcagttttctcgccatattccaagtcctacagtgtgcatttctcatttttcacgtttttcagtgatttcgtcatttttcaagttgtcaagtggatgtttctcattttccatgattttcagctttcttgccatattcaaagtcctacagtggacatttctaaattttcgacctttatcagttttcctcgccatatttcatgtcccaaagtgtgtacttctcattttccgtgattttcagtttcctcgccatattctaggtcctacagtgtgcatttctcatttttcaggtttttcagtgatttcgtcttttttcaagtcgtcaagtggatgtttctcattttccatgattttcagttttcttgccatattccatgtcctacagtggacatttctaaattttccaactttttcagttttcctcgccatatttcatgtcctaaagtgtgtatttctcattttcagtgattttcagttttctcgccatattccaggtcctacagtgtgcatttctcatttttcacgtttttcagtgatttcgtcatttttcaagttgtcaagtggatgtttctcatttttcatgattttcagttttcttgccatattccatgtcccacagtggacatttctaaatgttccacctttttctgttttccttgccatatttcatgtcctaaagtgtgtatttctcattttccgtgattttcagttttcttgctatattccaagtcctacagtgtgcatttctcatttttcacgtttttctgtgattttttcatttttcaatttgtcaactgcatgtttctcattttccatgattttcagttttcttgccatattccaggtcctacagtgtgcatttctcatttttcacgtttttcagtgattttgtcatttttcaagttgtcaactgcatgtttctcattttccatgattttcagttttcttgctatattccatgtcctacagtggaaatttctaaattttccacctttttcagttttcctcgccatatttcacgtcctaaagtgtgtatttctcattttccgtgattttcagttttctcgccatattccaggtcctatgtgtacatttctcatttttcacgtttttcagtgattttgtcatttttcaagttgtgaagtggatgtttctcatttttcttgattttcatttttcttgccatattccatgtcctagagtggaaatttttaaattttccacctttttcagttttcctcgccatatttcacgtcctaaattgtgaatttctcattttccgtgattttcagttttctcgccatattccaagtcctacagtgtgcatttctcatttttcacgtttttcagtgatttcgtcatttttcaagttgtcaagtggatgtttctcattttccatgattttcagctttcttgccatattcaaagtcctacagtggacatttctaaattttcgacctttatcagttttcctcgccatatttcatgtcccaaagtgtgtacttctcattttccgtgattttcagtttcctcgccatattctaggtcctacagtgtgcatttctcatttttcaggtttttcagtgatttcgtcttttttcaagtcgtcaagtggatgtttctcattttccatgattttcagttttcttgccatattccatgtcctacagtggacatttctaaattttccacctttttcagttttcctcgccatatttcatgtcctaaagtgtgtatttctcattttcagtgattttcagttttctcgccatattccaggtcctacagtgtgcatttctcatttttcacgtttttcagtgattttgtcatttttcaagttgtcaagtggatgtttctcattttccttgattttcagttttcttgccatattccatgtcctacagtggacatttctaaattttccacctttttcagttttccttgccatatttcatgtcctaaagtgtgtatttctcattttcagtgattttcagttttctcgccatattccaggtcctacagtgtgcatttctcattttttcaggtttttcagtgatttcgtcatttttcacgttgtcaagtggatgtttctcattttccatgattttcacttttcttgccatatttcatgtcctaaagtgtgtatttctcattttcagtgattttcagttttctcgccatattccaggtcctacagtgtgcatttctcattttttcacgtttttcagtgatttcgtcatttttcacgttgtcaagtggatgtttctcattttccattattttcacttttcttgccatatttcatgtcctacagtggacatttctaaattttccacctttttctgttttcctcgccatatttcacatcctaaagtgtgtatttctcattttccgtgattttcagttttcttgccatattccaggtcctacagtgtgcatttctcatttttcacgtttttcagtgatttcgtcatttttcaagtcgtcaagtggatgtttctcattttccatgattttcagttttctcgccatattccaggtcctacagttgacatttctaaattttccacattttttatgtttcctcgcgatatttcacatcctaaagtgtgtatttctcattttccgtgattttcagttttcttgccatattccaggtcctacagggtgcatttctcatttttcacgtttttcagtgatttcatcaatttcaagtcgtcaactgtatgtttctcattttcaatgattttcatttttcttgccatattccacgtcctatagtggacatttctacattttccacctttttcagttttcttcgccatatttcacgtcccaaagtgtgtatttctcattttccgtgattttcagtttcctcgccatattccaggtcctacagtgtgcatttctcatttttcacgtttttcagtgatttcgtcttttttcaagtcgtcaagtggatgtttctcattttccatgattttcagttttcttgccatattccatgtcctacagtggacatttctaaattttccacctttttctgttttcctcgccatatttcacgtcctaaagtgtgtatttctcatttaccgtgattttcagttttcttgctatattccaagtcctacagtgtgcatttctcatttttcacgtttttcactgattttgtcattgttcaagttgtcaactgcatgtttctcattttccatgattttcagttttcttgccatattccatgtcctacagtggaaatttctatattttccaactttttcagttttcctcgccatatttcacgtgctaaagtgtgtatttctcatttttcgtgtttttcaggtttctcgccatattccaggtcctacagtgtgcatttctcatttttcacgtttttcagtgattttgtaatttttcaagttgtcaagtggatgtttctcattttccttgattttcagttttcttgccatattccatgtcctactgtggacatttctaaattttccacctttttcagttttccttgccatatttcatgtcctaaagtgtgtatttctcattttcagtgattttcagttttctcgcaatattccaggtcctacagtgtgcatttctcattttttcaggtttttcagtgatttcgtcatttttcacgttgtcaagtggatgtttctcattttccatgattttcacttttcttgccatatttcatgtgctaaagtgtgtatttctcattttcagtgattttcagttttctgccatattccaggtcctacattgtgcatttctcattttttcacgtttttcagtgatttcgtcatttttcacgttgtcaagtggatgtttctcattttccatgattttcacttttcttgccatatttcatgttttacagtggacatttctaaattttccacctatttctgttttcctcgccatatttcacatcctaaagtgtgtatttctcattttccgtgattttcagttttctcgccatatgccaggtcatacagggtgcatttctcatttttcacgtttttcagtgatttcgtcatttttcacgtcgtcaagtggatgtttctcattttcaatgattttcatttttcttgccatattccacgtcctatagtggacatttctaaattttccacctttttcagttttccttgccatatttcaggtcctacagtgtgcatttctcttttttcacgtttttcagtgatttcgtcatttttcaagtggtcaagtgcatgtttctcattttccgtgattttcagttttcttgccatgttccaggtcctacagttgacgtttctaaaatttcactttttttaagttttcctcgccatatttcacttcctaaagtgtgtatttctcattttccgtgattttcagttttctcgccagattccaggtcctacagtgtgcatttttcatatttcacctttttcagtgattttgtcatttttcaagttgtcaactgcatgtttctcattttccatgattttcagttttcttgccatattccatgtcctactgtggacatttctaaattttccaactttttcagttttcctcgccatatttcatgtcctaaagtgtgtatttctcattttcagtgattttctgttttctcgccatattccaggtcctacagtgtgcatttctaatttttcacgtttttcagtgatttcgtcatttttcaagttgtcaagtggatgtttctcattttccatgattttcagttttcttgccatattccatgtcctacagtggacatttctaaattttccaactttttccattttcctcaccatatttcacgtcctaaagtgagtttttctcattttttgtgattttcagttttctcgacatattccaggtcctacagtgtgcatttctaattttttcttttttcagtgatttcgtcatttttcaagtggtcaagtgcatgtttctcattttccatgattttcagttttcttgccatattccatgtcctacaatggacatttctaaattttccaactttttcagttttcctcgccatatttcacgtcctaaagtgtgtatttctcattttccgtgattttcagttttctcgccatattccaggtcctacagtgtgcatttctcatttttcacgtttttcagtgatttcgtcatttttcaagttgtcaactgcatgtttctcattttccatgattttcagttttcttgccatattccatgtcttacagtggacatttttaaatttttcacatttttttaagttttcctccccatatttcacgttttaaagtgtgcatttctcattttcggtgattttcagttttctcgccagattccatgtcttacagtgtgcatttctcattttttcacgtttttcagtgatttcgtcatttttcaagtcgtcaagtggatgtttctcattttccatgattttcagttttcttgccatattccatgtcctacagtggaaatttctaaattttccacctttttcagttttccttgccatatttcaggtcctaaagtgtgtatttctcattttctgtgattttcagttttctcgccatattccaggtcctacagttgacatttctaaaatttccacattttttaagttttcctcgccatatttcacttcctaaagtgtgtatttctcattttccgtgattttcagttttctcgccatattccagatcctacagtgtacatttttcatttttcacgtttttcagtgattttgtcattttttagttgtcaactgcctgtttctcattttccatgattttcagttttcttgctatattccatgtcctacagtggaaatttctaaattttccacctttttcagttttcctcgccatatttcacgtcctaaagtgtgtatttctcattttccgtgattttcagttttctcgccatattccaggtcctatgtgtacatttctcatttttcacgtttttcagtgattttgtcatttttcaatttgtcaactgcatgtttctcattttccatgattttcagttttcttgccatattccatgtcctacagtggaaatttctatattttccaactttttcagttttcctcgccatatttcacgtgctaaagtgtgtatttctcatttttcgtgtttttcaggtttctcgccatattccaggtcctacagtgtgcatttctcatttttcacgtttttcagtgattttgtcatttttcaagttgtcaagtggatgtttctcattttccttgattttcagttttcttgccatattccatgtcctacagtggacatttctaaattttccacctttttcagttttccttgccatatttcatgtcctaaagtgtgtatttctcattttcagtgattttcagttttctcgccatattccaggtcctacagtgtgcatttctcattttttcaggtttttcagtgatttcgtcatttttcacgttgtcaagtggatgtttctcattttccatgattttcacttttcttgccatatttcatgtcctaaagtgtgtatttctcattttcagtgattttcagttttctcgctatattccaggtcctacagtgtgcatttctcattttttcacgtttttcagtgatttcgtcatttttcacgttgtcaagtggatgtttctcattttccatgattttcacttttcttgccatatttcatgtcctacaatggacatttctaaattttccacctttttctgttttcctcgccatatttcacatcctaaagtgtgtatttctcattttccgtgattttcagttttcttgccatattccaggtcctacagtgtgcatttctcatttttcacgtttttcagtgatttcgtcatttttcaagttgtcaagtggatgtttctcattttccttgattttcagttttcttgccatattccatgtcctactgtggacatttctaaattttccacctttttcagttttccttgccatatttcatgtcctaaagtgtgtatttctcattttcagtgattttcagttttctcgcaatattccaggtcctacagtgtgcatttctcattttttcaggtttttcagtgatttcgtcatttttcacgttgtcaagtggatgtttctcattttccatgattttcacttttcttgccatatttcatgtcctaaagtgtgtatttctcattttcagtgattttcagttttctgccatattccaggtcctacattgtgcatttctcattttttcacgtttttcagtgatttcgtcatttttcagttttctcgacatattccaggtcctacagtgtgcatttctaattttttcttttttcagtgatttcgtcatttttcaagttgtcaactgcatgtttctcattttccatgattttcagttttcttgccatattccatgtcttacagtggacatttttaaatttttcacatttttttaagttttcctccccatatttcacgttttaaagtgtgcatttctcattttcggtgattttcagttttctcgccagattccaggtcttacagtgtgcatttctcattttttcacgtttttcagtgatttcgtcatttttcaagtcgtcaagtggatgtttctcattttccatgattttcagttttcttgccatattccatgtcctacagtggaaatttctaaattttccacctttttcagttttccttgccatatttcaggtcctaaagtgtgtatttctcattttctgtgattttcagttttctcgccatattccaggtcctacagttgacatttctaaaatttccacattttttaagttttcctcgccatatttcacttcctaaagtgtgtatttctcattttccgtgattttcagttttctcgccatattccagatcctacagtgtgcatttttcatttttcacgtttttcagtgattttgtcattttttagttgtcaactgtctgtttctcattttccatgattttcagttttcttgccatattccatgtcctacactggacatttctaaattttccacctttttctgttttcctcgccatatttcacgtcctaaagtgtgtatttctcattttccgtgattttcagttttcttgccatattccaggtcctacagtgtgcatttctcatttttcacgtttttcagtgattttgtcatttttcaagttgtcaactgcatgtttctcattttctatgattttcagttttcttgctatattccatgtcctacagtggaaatttctaaattttccacctttttcagttttcctcgccatatttcacgtcctaaagtgtgtatttctcattttccgtgattttcagttttctcgccatattccaggtcctatgtgtacatttctcatttttcacgtttttcagtgattttgtcatttttcaagttgtgaagtggatgtttctcatttttcttgattttcatttttcttgccatattccatgtcctagagtggaaatttttaaattttccacctttttcagttttcctcgccatatttcacgtcctaaagtgtgaatttctcattttccgtgattttcagatttctcgccatattccaagtcctacagtgtgcatttctcatttttcacgtttttcagtgatttcgtcatttttcaagttgtcaagtggatgtttctcattttccatgattttcagctttcttgccatattcaaagtcctacagtggacatttctaaattttcgacctttatcagttttcctcgccatatttcatgtcccaaagtgtgtacttctcattttccgtgattttcagtttcctagccatattctaggtcctacagtgtgcatttctcatttttcaggtttttcagtgatttcgtcttttttcaagtcgtcaagtggatgtttctcattttccatgattttcacttttcttgccatatttcatgtcctaaagtgtgtatttctcattttcagtgattttcagttttctcgctatattccaggtcctacagtgtgcatttctcattttttcacgtttttcagtgatttcgtcatttttcacgttgtcaagtggatgtttctcattttccatgattttcacttttcttgccatatttcatgtcctacagtggacatttctaaattttccacctttttctgttttcctcgccatatttcacatcctaaagtgtgtatttctcattttccgtgattttcagttttcttgccatattccaggtcctacagtgtgcatttctcatttttcacgtttttcagtgatttcgtcatttttcaagttgtcaagtggatgtttctcattttccttgattttcagttttcttgccatattccatgtcctactgtggacatttctaaattttccacctttttcagttttccttgccatatttcatgtcctaaagtgtgtatttctcattttcagtgattttcagttttctcgcaatattccaggtcctacagtgtgcatttctcattttttcaggtttttcagtgatttcgtcatttttcacgttgtcaagtggatgtttctcattttccatgattttcacttttcttgccatatttcatgtcctaaagtgtgtatttctcattttcagtgattttcagttttctgccatattccaggtcctacattgtgcatttctcattttttcacgtttttcagtgatttcgtcatttttcacgttgtcaagtggatgtttctcattttccatgattttcacttttcttgccatatttcatgttttacagtggacatttctaaattttccacctttttctgttttcctcgccatatttcacatcctaaagtgtgtatttctcattttccgtgattttcagttttctcgccatatgccaggtcatacagggtgcatttctcatttttcacgtttttcagtgatttcgtcatttttcacgtcgtcaagtggatgtttctcattttcaatgattttcatttttcttgccatattccacgtcctatagtggacatttctaaattttccacctttttcagttttccttgccatatttcaggtcctacagtgtgcatttctcatttttcacgtttttcagtgatttcgtcatttttcaagtggtcaagtgcatgtttctcattttccgtgattttcagttttcttgccatgttccaggtcctacagttgacgtttctaaaatttcactttttttaagttttcctcgccatatttcacttcctaaagtgtgtatttctcattttccgtgattttcagttttctcgccagattccaggtcctacagtgtgcatttttcatatttcacctttttcagtgattttgtcatttttcaagttgtcaactgcatgtttctcattttccatgattttcagttttcttgccatattccatgtcctactgtggacatttctaaattttccaactttttcagttttcctcgccatatttcatgtcctaaagtgtgtatttctcattttcagtgattttctgttttctcgccatattccaggtcctacagtgtgcatttctaatttttcacgtttttcagtgatttcgtcatttttcaagttgtcaagtggatgtttctcattttccatgattttcagttttcttgccatattccatgtcctacagtggacatttctaaattttccaactttttccattttcctcaccatatttcacgtcctaaagtgtgtttttctcattttttgtgattttcagttttctcgacatattccaggtcctacagtgtgcatttctaattttttcttttttcagtgatttcgtcatttttcaagttgtcaactgcatgtttctcattttccatgattttcagttttcttgccatattccatgtcttacagtggacatttttaaatttttcacatttttttaagttttcctccccatatttcacgttttaaagtgtgcatttctcattttcggtgattttcagttttctcgccagattccaggtcttacagtgtgcatttctcattttttcacgtttttcagtgatttcgtcatttttcaagtcgtcaagtggatgtttctcattttccatgattttcagttttcttgccatattccatgtcctacagtggaaatttctaaattttccacctttttcagttttccttgccatatttcaggtcctaaagtgtgtatttctcattttctgtgattttcagttttctcgccatattccaggtcctacagttgacatttctaaaatttccacattttttaagttttcctcgccatatttcacttcctaaagtgtgtatttctcattttccgtgattttcagttttctcgccatattccagatcctacagtgtgcatttttcatttttcacgtttttcagtgattttgtcattttttagttgtcaactgtctgtttctcattttccatgattttcagttttcttgccatattccatgtcctacactggacatttctaaattttccacctttttctgttttcctcgccatatttcacgtcctaaagtgtgtatttctcattttccgtgattttcagttttcttgccatattccaggtcctacagtgtgcatttctcatttttcacgtttttcagtgattttgtcatttttcaagttgtcaactgcatgtttctcattttccatgattttcagttttcttgctatattccatgtcctacagtggaaatttctaaattttccacctttttcagttttcctcgccatatttcacgtcctaaagtgtgtatttctcattttccgtgattttcagttttctcgccatattccaggtcctatgtgtacatttctcatttttcacgtttttcagtgattttgtcatttttcaagttgtgaagtggatgtttctcatttttcttgattttcatttttcttgccatattccatgtcctagagtggaaatttttaaattttccacctttttcagttttcctcgccatatttcacgtcctaaagtgtgaatttctcattttccgtgattttcagatttctcgccatattccaagtcctacagtgtgcatttctcatttttcacgtttttcagtgatttcgtcatttttcaagttgtcaagtggatgtttctcattttccatgattttcagctttcttgccatattcaaagtcctacagtggacatttctaaattttcgacctttatcagttttcctcgccatatttcatgtcccaaagtgtgtacttctcattttccgtgattttcagtttcctcgccatattctaggtcctacagtgtgcatttctcatttttcaggtttttcagtgatttcgtcttttttcaagtcgtcaagtggatgtttctcattttccatgattttcagttttcttgccatattccatgtcctacagtggacatttctaaattttccacctttttcagttttcctcgccatatttcatgtcctaaagtgtgtatttctcattttcagtgattttcagttttctcgccatattccaggtcctacagtgtgcatttctcatttttcacgtttttcagtgatttcgtcatttttcaagttgtcaagtggatgtttctcattttccatgattttcagttttcttgccatattccatgtcccacagtggacatttctaaattttccacctttttctgttttccttgccatatttcatgtcctaaagtgtgtatttctcattttccgtgattttcagttttcttgctatattccaagtcctacagtgtgcatttctcatttttcacgtttttcagtgattttgtcatttttcaatttgtcaactgcatgtttctcattttccatgattttcagttttcttgccatattccatgtcctacagtggaaatttctatattttccaactttttcagttttcctcgccatatttcacgtgctaaagtgtgtatttctcatttttcgtgtttttcaggtttctcgccatattccaggtcctacagtgtgcatttctcatttttcacgtttttcagtgattttgtcatttttcaagttgtcaagtggatgtttctcattttccttgattttcagttttcttgccatattccatgtcctacagtggacatttctaaattttccacctttttcagttttccttgccatatttcatgtcctaaagtgtgtatttctcattttcagtgattttcagttttctcgccatattccaggtcctacagtgtgcatttctcattttttcaggtttttcagtgatttcgtcatttttcacgttgtcaagtggatgtttctcattttccatgattttcacttttcttgccatatttcatgtcctaaagtgtgtatttctcattttcagtgattttcagttttctcgctatattccaggtcctacagtgtgcatttctcattttttcacgtttttcagtgatttcgtcatttttcacgttgtcaagtggatgtttctcattttccatgattttcacttttcttgccatatttcatgtcctacagtggacatttctaaattttccacctttttctgttttcctcgccatatttcacatactaaagtgtgtatttctcattttccttgattttcagttttcttgccatattccaggtcctacagtgtgcatttctcatttttcacgtttttcagtgatttcgtcatttttcaagtcgtcaagtggatgtttctcattttccatgattttcagttttctcgccatattccaggtcctacagttgacatttctaaattttccacattttttaagtttcctcgcgatatttcacatcctaaagtgtgtatttctcattttccgtgattttcagttttcttgccatattccaggtcctacagggtgcatttctcatttttcacgtttttcagtgatttcatcaatttcaagtcgtcaactgtatgtttctcattttcaatgattttcatttttcttgccatattccatgtcctacagtggacatttctaaatttttcacctttttcagttttccttgccatatttcatgtcctaaagtgtgtatttctcattttcagtgattttcagttttctcgccatattccaggtcctacagtgtgcatttctcattttttcaggtttttcagtgatttcgtcatttttcacgttgtcaagtggatgtttctcattttccatgattttcacttttcttgccatatttcatgtcctaaagtgtgtatttctcattttcagtgattttcagttttctcgccatattccaggtcctacagtgtgcatttctcatttttcacgtttttcagtgatttcgtcatttttcaagttgtcaagtggatgtttctcattttccatgattttcacttttcttgccatattccatgtcccacagtggacatttctaaattttccacctttttctgttttcctcgccatatttcatgtcctaaagtgtgtatttctcattttccgtgattttcagttttcttgctatattccaagtcctacagtgtgcatttctcatttttcacgtttttcagtgattttgtcatttttcaatttgtcaactgcatgtttctcattttccatgattttcagttttcttgccatattccatgttctacagtggaaatttctatattttccaactttttcagttttcctcgccatatttcacgtgctaaagtgtgtatttctcatttttcgtgtttttcaggtttctcgccatattccaggtcctacagtgtgcatttctcatttttcacgtttttcagtgattttgtcatttttcaagttgtcaagtggatgtttctcattttccttgattttcagttttcttgccatattccatgtcctacagtggacatttctaaattttccacctttttcagttttccttgccatatttcatgtcctaaagtgtgtatttctcattttcagtgattttcagttttctcgccatattccaggtcctacagtgtgcatttctcattttttcaggtttttcagtgatttcgtcatttttcacgttgtcaagtggatgtttctcattttccatgattttcacttttcttgccatatttcatgtcctaaagtgtgtatttctcattttcagtgattttcagttttctcgctatattccaggtcctacagtgtgcatttctcattttttcacgttttgcagtgatttcgtcatttttcacgttgtcaagtggatgtttctcattttccatgattttcacttttcttgccatatttcatgtcctacagtggacatttctaaattttccacctttttctgttttcctcgccatatttcacatcctaaagtgtgtatttctcattttccgtgattttcagttttcttgccatattccaggtcctacagtgtgcatttctcatttttcacgtttttcagtgatttcgtcatttttcaagtcgtcaagtggatgtttctcattttccatgattttcagttttctcgccatattccaggtcctacagttgacatttctaaattttccacattttttaagtttcctcgcgatatttcacatcctaaagtgtgtatttctcattttccgtgattttcagttttcttgccatattccaggtcctacagggtgcatttctcatttttcacgtttttcagtgatttcatcaatttcaagtcgtcaactgtatgtttctcattttcaatgattttcatttttcttgccatattccatgtcctacagtggacatttctaaattttccacctttttcagttttccttgccatatttcatgtcctaaagtgtgtatttctcattttcagggattttcagttttctcgccatattccaggtcctacagtgtgcatttctcattttttcaggtttttcagtgatttcgtcatttttcacgttgtcaagtggatgtttctcattttccatgattttcacttttcttgccatatttcatgtcctaaagtgtgtatttctcattttcagtgattttcagttttctcgccatattccaggtcctacagtgtgcatttctcattttttcacgtttttcagtgatttcgtcatttttcacgttgtcaagtggatgtttctcattttccatgattttcacttttcttgccatatttcatgtcctacagtggacatttctaaattttccacctttttctgttttcctcgccatatttcacatcctaaagtgtgtatttctcattttccgtgattttcagttttcttgccatattccaggtcctacagtgtgcatttctcatttttcacgtttttcagtgatttcgtcatttttcaagtcgtcaagtggatgtttctcattttccatgattttcagttttctcgccatattccaggtcctacagttgacatttctaaattttccacattttttaagtttcctcgcgatatttcacatcctaaagtgtgtatttctcattttccgtgattttcagttttcttgccatattccaggtcctacagggtgcatttctcatttttcacgtttttcagtgatttcatcaatttcaagtcgtcaactgtatgtttctcattttcaatgattttcatttttcttgccatattccacgtcctatagtggacatttctaaattttccacctttttcagttttcttcgccatatttcacgtcccaaagtgtgtatttctcattttccgtgattttcagtttcctcgcaatattccaggtcctacagtgtgcatttctcatttttcacgtttttcagtgatttcgtcttttttcaagtcgtcaagtggatgtttctcattttccatgattttcagttttcttgccatattccatgtcctacagtggacatttctaaattttccacctttttctgttttcctcgccatatttcacgtcctaaagtgtgtatttctcattttccgtgattttcagttttcttgccatattccaggtcctacagtgtgcatttctcatttttcacgtttttcactgattttgtcattgttcaagttgtcaactgcatgtttctcattttccatgattttcaattttcttgccatattccatgtcctacagtggaaatttctatattttccaactttttcagttttcctcgccatatttcacgtgctaaagtgtgtatttctcatttttcgtgtttttcaggtttctcgccatattccaggtcctacagtgtgcatttctcatttttcacgtttttcagtgattttgtcatttttcaagttgtcaagtggttgtttctcattttccttgattttcagttttcttgccatattccatgtcctactgtggacatttctaaattttccacctttttcagttttccttgccatatttcatgtcctaaagtgtgtatttctcattttcagtgattttcagttttctcgcaatattccaggtcctacagtgtgcatttctcattttccgtgattttcagttttctcgccatatgccaggtcatacagggtgcatttctcatttttcacgtttttcagtgatttcgtcatttttcacgtcgtcaagtggatgtttctcattttcaatgattttcatttttcttgccatattccacgtcctatagtggacatttctaaattttccaactttttcagttttcttgccatatttcaggtcctacagtgtgcatttctcatttttcacgtttttcagtgatttcgtcatttttcaagtggtcaagtgcatgtttctgattttccgtgattttcagttttcttgccatgttccaggtcctacagttgacgtttctaaaatttcactttttttaagttttcctcgccatatttcacttcctaaagtgtgtatttctcattttccgtgattttcagttttctcgccagattccaggtcctacagtgtgcatttttcatatttcacctttttcagtgattttgtcatttttcaagttgtcaactgcatgtttctcattttccatgattttcagttttcttgccatattccatgtcctactgtggacatttctaaattttccaactttttcagttttcctcgccatatttcatgtcctaaagtgtgtatttctcattttcagtgtttttctgttttctcgccatattccaggtcctacagtgtgcatttctaatttttcacgtttttcagtgatttcgtcatttttcaagttgtcaagtggatgtttctcattttccatgattttcagttttcttgccatattccatgtcctacagtggacatttctaaattttccaactttttccattttcctcaccatatttcacgtcctaaagtgtgtttttctcattttttgtgattttcagttttctcgacatattccaggtcctacagtgtgcatttctaattttttcttttttcagtgatttcgtcatttttcaagtggtcaagtgcatgtttctcattttccatgattttcagttttcttgccatattccatgtcctacaatggacatttctaaattttccaactttttcagttttcctcgccatatttcacgtcctaaagtgtgtatttctcattttccgtgattttcagttttctcgccatattccaggtcctatgtgtacatttctcatttttcacgtttttcagtgattttgtcatttttcaagttgtgaagtggatgtttctcatttttcttgattttcatttttcttgccatattccatgtcctagagtggaaatttttaaattttccaactttttcagttttcctcgccatatttcacgtcctaaagtgtgtatttctcattttccgtgattttcagttttctcgccatattccaagtcctacagtgtgcatttctcatttttcacgtttttcagtgatttcgtcatttttcaagttgtcaagtggatgtttctcattttccatgattttcagctttcttgccatattcaaagtcctacagtggacatttctaaattttcgacctttatcagttttcctcgccatatttcatgtcccaaagtgtgtacttctcattttccgtgattttcagtttcctcgccatattctaggtcctacagtgtgcatttctcatttttcaggtttttcagtgatttcgtcttttttcaagtcgtcaagtggatgtttctcattttccatgattttcagttttcttgccatattccatgtcctacagtggacatttctaaattttccacctttttcagttttcctcgccatatttcatgtcctaaagtgtgtatttctcattttcagtgattttcagttttctcgccatattccaggtcctacagtgtgcatttctcatttttcacgtttttcagtgatttcgtcatttttcaagttgtcaagtggatgtttctcattttccatgattttcagttttcttgccatattccatgtcccacagtggacatttctaaattttccacctttttctgttttccttgccatatttcatgtcctaaagtgtgtatttctcattttccgtgattttcagttttcttgctatattccaagtcctacagtgtgcatttctcatttttcacgtttttaagtgattttgtcatttttcaatttgtcaactgcatgtttctcattttccatgattttcagttttcttgccatattccatgtcctacagtggaaatttctatattttccaactttttcagttttcctcgccatatttcacgtgctaaagtgtgtatttctcatttttcgtgtttttcaggtttctcgccatattccaggtcctacagtgtgcatttctcatttttcacgtttttcagtgattttgtcatttttcaagttgtcaagtggatgtttctcattttccttgattttcagttttcttgccatattccatgtcctacagtggacatttctaaattttccacctttttcagttttccttgccatatttcatgtcctaaagtgtgtatttctcattttcagtgattttcagttttctcgccatattccaggtcctacagtgtgcatttctcattttttcaggtttttcagtgatttcgtcatttttcacgttgtcaagtggatgtttctcattttccatgattttcacttttcttgccatatttcatgtcctaaagtgtgtatttctcattttcagtgattttcagttttctcgccatattccaggtcctacagtgtgcatttctcattttttcacgtttttcagtgatttcgtcatttttcacgttgtcaagtggatgtttctcattttccatgattttcacttttcttgccatatttcatgtcctacagtggacatttctaaattttccacctttttctgttttcctcgccatatttcacatcctaaagtgtgtatttctcattttccgtgattttcagttttcttgccatatttcaggtcctacagtgtgcatttctcatttttcacgtttttcagtgatttcgtcatttttcaagtcgtcaagaggatgtttctcattttccatgattttcagttttctcgccatattccaggtcctacagttgacatttctaaattttccacattttttaagtttcctcgcgatatttcacatcctaaagtgtgtatttctcattttccgtgattttcagttttcttgccatattccaggtcctacagggtgcatttctcatttttcacgtttttcagtgatttcatcaatttcaagtcgtcaactgtatgtttctcattttcaatgattttcatttttcttgccatattccacgtcctatagtggacatttctaaattttccacctttttctgttttcctcgccatatttcacgtcctaaagtgtgtatttctcattttccgtgattttcagttttcttgccatattccaggtcctacagtgtgcatttctcatttttcacgtttttcactgattttgtcattgttcaagttgtcaactgcatgtttctcattttccatgattttcagttttcttgccatattccatgtcctacagtggaaatttctatattttccacctttttcagttttcctcgccgtatttcatgtgctaaagtgtgtatttctcatttttcgtgtttttcaggtttctcgccatattccaggtcctacagtgtgcatttctcatttttcacgtttttcagtgattttgtcatttttcaagttgtcaactggatgtttctcattttccttgattttcagttttcttgccatattccatgtcctactgtggacatttctaaattttccacctttttcagttttccttgccatatttcatgtcctaaagtgtgtatttctcattttcagtgattttcagttttctcgcaatattccaggtcctacagtgtgcatttctcattttttcaggtttttcagtgatttcgtcatttttcacgttgtcaagtggatgtttctcattttccatgattttcacttttcttgccatatttcatgtcctaaagtgtgtatttctcattttcagtgattttcagttttctcgccatattccaggtcctacattgtgcatttctcattttttcacgtttttcagtgatttcgtcatttttcacgttgtcaagtggatgtttctcattttccatgattttcacttttcttgccatatttcatgttttacagtggacatttctaaattttccacctttttctgttttcctcgccatatttcacatcctaaagtgtgaatttctcattttccgtgattttcagttttcttgccatattccaggtcctacagtgtgcatttctcatttttcacgtttttcagtgatttcatcatttttcaagtcgtcaagtggatgtttctcattttccatgattttcagttttcttgccatattccatgtcctacagtggacatttctaaattttccacctttttctgttttcctcgccatatttcacgtcctaaagtgtgtatttctcattttccgtgattttcagttttcttgccatattccaggtcctacagtgtgcatttctcatttttcacgtttttcactgattttgtcatttttcaagttgtcaactgcatgtttctcattttccatgattttcagttttcttgctatattccatgtcctacagtggaaatttctaaattttccacctttttcagttttcctcgccatatttcacgtcctgaagtgtgtatttctcattttccgtgattttcagttttctcgccatattccaggtcctatgtgtacatttctcatttttcacgtttttcagtgattttgtcatttttcaagttgtgaagtggatgtttctcatttttcttgattttcatttttcttgccatattccatgtcctacagtggaaatttctaaattttccacctttttcagttttcctcgccatatttcacgtcctaaagtgtgtatttctcattttccgtgattttcagttttctcgccatattccaggtcctacagtgtgcatttctcatttttcacgtttttcagtgatttcgacatttttcaagttgtcaagtggatgtttctcattttccatgattttcagctttcttgccatattcaaagtcctacagtggacatttctaaattttcgacctttatcagttttcctcgccatatttcatgtcccaaagtgtgtacttctcattttccgtgattttcagtttcctcgccatattccaggtcctacagtgtgcatttctcatttttcacgtttttcagtgatttcgtcatttttcaagtcgtcaagtggatgtttctcattttccatgattttcagttttcttgccatattccatgtcctacagtggacatttctaaattttccacctttttctgttttcctcgccatatttcacgtcctaaagtgtgtatttctcattttccgtgattttcagttttcttgccatattccaggtcctacagtgtgcatttctcatttatcacgtttttcactgattttgtcatttttcaagttgtcaactgcatgtttctcattttccatgattttcagttttcttgctatattccatgtcctacagtggaatattctaaattttccacctttttcagttttcctcgccatatttcacgtcctgaagtgtgtatttctcattttccgtgattttcagttttctcgccatattccaggtcctatgtgtacatttctcatttttcacgtttttcagtgattttgtcatttttcaagttgtgaagtggatgtttctcatttttcttgattttcatttttcttgccatattccatgtcctacagtggaaatttctaaattttccacctttttcagttttcctcgccatatttcacgtcctaaagtgtgaatttctcattttccgtgattttcagttttctcgccatattccaggtcctacagtgtgcatttctcatttttcacgtttttcagtgatttcgacatttttcaagttgtcaagtggatgtttctcattttccatgattttcagctttcttgccatattcaaagtcctacagtggacatttctaaattttcgacctttatcagttttcctcgccatatttcatgtcccaaagtgtgtacttctcattttccgtgattttgagtttcctcgccatattccaggtcctacagtgtgcatttctcatttttcacgtttttcagtgatttcgtcttttttcaagttgtcaactgcatgtttctcattttccatgattttcagttttcttgccatattccatgtcctacagtggaaatttgtaaatttccacctttttcagttttcctcgccatatttcacgtcctaaagtatgtatttctcattttccgtgattttcagttttctcgccatattccaggtcctacagtgtgcatttctcatttttcacgtttttcagtgattttgtcattttttaagttttcaagtggatgtttctcattttccttgattttcagttttcttgccatattccatgtcctacagtggacatttctaaattttccacctttttcagttttcctcgccatatttcatgtcctaaagtgtgtatttctcattttcagtgattttcagttttctcgccatattccaggtcctacagtgtgcatttctcatttttcacgtttttcagtgatttcgtcatttttcaaggtgtcaagtggatgtttctcattttccatgattttcagttttcttgccatattccatgtcctacagtggacatttctaaattttccacctttttctgttttcctcgccatatttcatgtcctaaagtgtgtatttctcattttccgtgattttcagttttcttgctatattccaagtcctacagtgtgcatttctcatttttcacgtttttcagtgattttgtcatttttcaatttgtcaactgcatgtttctcattttccatgattttcagtttttttgccatattccatgtcctactgtggaaatttctatattttccacctttttcagttttcctcgccatatttcacgtgctaaagtgtgtatttctcatttttcgtgtttttcaggtttctcgccatattccaggtcctacagtgtgcatttctcatttttcacgtttttcagtgattttgtcatttttcaagttttcaagtggatgtttctcattttccttgattttcagttttcttgccatattccatgtcctacagtggacatttctaaattttccacctttttcagttttccttgccatatttcatgtcctaaagtgtgtatttctcattttcagtgattttcagtttccttgccatattccaggtcctacagtgtgcatttctcattttttcacgtttttcagtgatttcgtcatttttcacgttgtcaagtggatgtttctcattttccatgattttcacttttcttgccatatttcatgtcctacagtggacatttctaaattttccaactttttcaattttcctcgccatattttatgtcctaaagtgtgtatttctcatttttcgttattttcagttttcttgccatattccaggtcctacagtgtgcatttgtcatttttcacgtttttcagtgatttcgtcatttttcaagtcgtcaagtagatgtttctcatattccatgtttttcagttttctcgccatattccaggtcctacagttgacatttctaaattttctacatttttaaattttcctcgccatatttcacgtcctaaagtgtgtatttctcattttttgttattttcagttttctagccatattccaggtcctacaggatgcatttctcatttttcacgtttttcagtgatttcatcatttttcaagtcgtcaagtgtatgtttcttattttcaatgattttcatttttcttgccttattccacgtcctatagtggacatttctaaattttccacctttttcagtttttttcgccatatttcacgtcctaaagtgtgtatttctcattttctgtgattttcagttttctcaccatattccaggtcctacagtgtgcatttctcatttttcacgtttttcagtgatttcgtcatttttcaagttgtcaagtggaagtttctcattttccatgattttcagctttctagacatattccaggtcctacagtggacatttcctaattttcgacctttatcagttttcctcgtcatatttcacgtcccaaaatgtgtatttcttattttccatgattttcagtttcctcgccatattccaggtcctacagtgtgcaattctcatttttcacgtttttcagtgatttcgtcttttttcaagacgtcaagtggatgtttctcatttttcatgattttcagttttcttgccatattccatgtcctacagtggacatttctaaattttccacctttttctgttttcctcgccatatttcacgtcctaaagtgtgtatttctcattttccgtgattttcagttttcttgccatattcctggtcctacagtgtgcatttctcatttttcacgtttttcagtgattttgtcatttttcaatttgtcaactgcatgtttctcattttccattattttcagttttcttgccatattccatgtcctacagtggacatttctaaattttccacctttttctgttttcctcgccatatttcatgtcctaaagtgtgtatttctcattttccgtgattttcagttttcttgctatattccaagtcctacagtgtgcatttctcatttttcacgtttttcagtgattttgtcatttttcaatttgtcaactgcatgtttctcattttccatgattttcagtttttttgccatattccatgtcctacaggggaaatttctatattttccacctttttcagttttcctcgccatatttcatgtcctaaagtgtgtatttctcattttccgtgattttcagttttcttgccatattccaggtcctacagtgtgcatttctcatttttcacgtttttcagtgatttcgtcatttttcaagtcttcaagtagatgtttctcatattccatgtttttcagttttctcgccatattccaggtcctacagttgacatttctaaattttctacatttttaaattttcctcgccatatttcacgtcctaaagtgtgtatttctcatttttcgttattttcagttttctagccatattccaggtcctacaggatgcatttctcatttttcacgtttttcagtgatttcatcatttttcaagtcgtcaagtgtatgtttctcattttcaatgattttcatttttcttgccttattccacgtcctatagtggacatttctaaattttccacctttttcagtttttctcgccatatttcacgtcctaaagtgtgtatttctcattttctgtgattttcagttttctcaccatattccaggtcctacagtgtgcatttctcatttttcacgtttttcagtgatttcgtcatttttcaagttgtcaagtggaagtttctcattttccatgattttcagctttctagccatattccaggtcctacagtggacatttcctaattttcgacctttatcagttttcctcgccatatttcacgtcctaaagtgtgtatttctcattttccgtgattttcagttttcttgccatattccaggtcctacagtgtgcatttctcatttttcacgtttttcagtgattttgtcatttttcaatttgtcaactgcatgtttctcattttccatgatttttagttttcttgctatattccatgtcctacagtggaaatttctaaattttccacctttttcagttttcctcgccatatttcacgtcctaaagtgtgtatttctcattttccgtgattttcagttttcttgctatattccaagtcctacattgtgcatttctcatttttcacgtttttcagtgattttgtcatttttcaatttgtcaaaccacatgtttctcattttccatgattttcagtttttttgccatattccatgtcctacagtggaaatttctatattttccacctttttcagttttcctcgccatatttcacgtgctaaagtgtgtatttctcatttttcgtgtttttcaggtttctcgccatattccaggtcctacagtgtgcatttctcatttttcacgtttttcagtgattttgtcatttttcaagttgtcaagtggatgtttcccattttccttgattttcagttttcttaccatattccatgtcctacagtggacatttctaaattttccacctttttcagttttccttgccatatttcatgtcctaaagtgtgtatttctcattttcagtgattttcagtttcctcgccatattccaggtcctacagtgtgcatttctcattttttcacgtttttcagtgatttcgtcatttttcacgttgtcaagtggatgtttctcattttccatgattttcacttttcttgccatatttcatgtcctatagtggacatttctaaattttccacctttttcagtttttctcgccatatttcacgtcctaaagtgtgtatttctcattttctgtgattttcagttttctcaccatattccaggtcctacagtgtgcatttctcatttttcacgtttttcagtgatttcgtcatttttcaagtcgtcaagtagatgtttctcatattccatgtttttcagttttctcgccatattccaggtcctacagttgacatttctaaattttctacatttttaaattttcctcgccatatttcacgtcctaaagtgtgtatttctcatttttcgttattttcagttttctagccatattccaggtcctacaggatgcatttctcatttttcacgtttttcagtgatttcatcatttttcaagtcgtcaagtgtatgtttcttattttcaatgattttcatttttcttgccttattccacgtcctatagtggacatttctaaattttccaccttttttcagtttttctcgccatatttcacgtcctaaagtgtgtatttctcattttctgtgattatcagttttctcaccatattccaggtcctacagtgtgcatttctcatttttcacgtttttcagtgatttcgtcatttttcaagttgtcaagtggaagtttctcattttccatgattttcagctttctagccatattccaggtcctacagtggacatttcctaattttcgacctttatcagttttcctcgccatatttcacgtcccaaaatgtgtatttcttattttccatgattttcagtttcctcgccatattccaggtcctacagtgtgcatttctcatttttcacgtttttcagtgatttcgtcttttttcaagacgtcaagtggatgtttctcatttttcatgattttcagttttcttgccatattccatgtcctacagtggacatttctaaattttccacctttttctgttttcctcgccatatttcacgtcctaaagtgtgtatttctcattttccgtgattttcagttttcttgccatattcctggtcctacagtgtgcatttctcatttttcacgtttttcagtgattttgtcatttttcaatttgtcaactgcatgtttctcattttccatgattttcagttttcttgccatattccatgtcctacagtggacatttctaaattttccacctttttcagttttcctcgccatatttcacgtgctaaagtgtgtatttctcatttttcgtgtttttcaggtttctcgccatattccaggtcctacagtgtgcatttctcatttttcacgtttttcagtgattttgtcatttttcaagttgtcaagtggatgtttctcattttccttgattttcacttttcttgccatattccaagtcttacaggggcatttctcatttttcacgttttcagtgattttgtcattttcaatttgtcaactgcatgtttctcattttccatgattttcagtttttttgccatattccatgtcctacaggggaaatttctatattttccacctttttcagttttcctcgccatatttcatgtcctaaagtgtgtatttctcattttccgtgattttcagttttcttgccatattccaggtcctacagtgtgcatttctcatttttcacgtttttcagtgatttcgtcatttttcaagtcttcaagtagatgtttctcatattccatgtttttcagttttctcgccatattccaggtcctacagttgacatttctaaattttctacatttttaaattttcctcgccatatttcacgtcctaaagtgtgtatttctcatttttcgttattttcagttttctagccatattccaggtcctacaggatgcatttctcatttttcacgtttttcagtgatttcatcatttttcaagtcgtcaagtgtatgtttctcattttcaatgattttcatttttcttgccttattccacgtcctatagtggacatttctaaattttccacctttttcagtttttctcgccatatttcacgtcctaaagtgtgtatttctcattttctgtgattttcagttttctcaccatattccaggtcctacagtgtgcatttctcatttttcacgtttttcagtgatttcgtcatttttcaagttgtcaagtggaagtttctcattttccatgattttcagctttctagccatattccaagtcctacagtggacatttcctaattttcgacctttatcagttttcctcgccatatttcacgtcccaaaatgtgtattccttattttccatgattttcagtttcctcgccatattccaggtcctacagtgtgcatttatcatttttcacgtttttcagtgatttcgtcttttttcaagacgtcaagtggatgtttctcatttttcatgattttcagttttcttgccatattccatgtcctacagtggacatttctaaattttccacctttttctgttttcctcgccatatttcacgtcctaaagtgtgtatttctcattttccgtgattttcagttttcttgccatattcctggtcctacagtgtgcatttctcatttttcacgtttttcagtgattttgtcatttttcaagttgtcaagtggatgtttctcattttccttgattttcacttttcttgccatattccatgtcctacagtggacatttctatattttccacctttttccgttttccttgccatatttcacgtcctaaagtgtgtatttctcattttccgtgattttcaggtttctcgccatattccaggtcctacagtgtgcatttctcatttttcacgtttttcagtgattttgtcatttttcaagttgtcaagtggatgtttctcattttccttgattttcacttttcttgccatattccatgtcctacagtggacatttctaaattttccacctttttcagttttcctcgccatatttcatgtcctaaagtgtgtatttctcattttcagtgattttcagttttcttgccatattccaggtcctacagtgtgcatttctcatttttcacgtttttcagtgattttgtcatttttcaagttgtcaactgcatgtttctcattttctatgattttcagttttcttgctatattccatgtcctacagtggaaatttctaaattttccacctttttcagttttcctcgccatatttcacgtcctaaagtgtgtatttctcattttccgtgattttcagttttctcgccatattccaggtcctatgtgtacatttctcatttttcacgtttttcagtgattttgtcatttttcaagttgtgaagtggatgtttctcatttttcttgattttcatttttcttgccatattccatgtcctagagtggaaatttttaaattttccacctttttcagttttcctcgccatatttcacgtcctaaagtgtgaatttctcattttccgtgattttcagatttctcgccatattccaagtcctacagtgtgcatttctcatttttcacgtttttcagtgatttcgtcatttttcaagttgtcaagtggatgtttctcattttccatgattttcagctttcttgccatattcaaagtcctacagtggacatttctaaattttcgacctttatcagttttcctcgccatatttcatgtcccaaagtgtgtacttctcattttccgtgattttcagtttcctcgccatattctaggtcctacagtgtgcatttctcatttttcaggtttttcagtgatttcgtcttttttcaagtcgtcaagtggatgtttctcattttccatgattttcacttttcttgccatatttcatgtcctaaagtgtgtatttctcattttcagtgattttcagttttctcgctatattccaggtcctacagtgtgcatttctcattttttcacgtttttcagtgatttcgtcatttttcacgttgtcaagtggatgtttctcattttccatgattttcacttttcttgccatatttcatgtcctacagtggacatttctaaattttccacctttttctgttttcctcgccatatttcacatcctaaagtgtgtatttctcattttccgtgattttcagttttcttgccatattccaggtcctacagtgtgcatttctcatttttcacgtttttcagtgatttcgtcatttttcaagttgtcaagtggatgtttctcattttccttgattttcagttttcttgccatattccatgtcctactgtggacatttctaaattttccacctttttcagttttccttgccatatttcatgtcctaaagtgtgtatttctcattttcagtgattttcagttttctcgcaatattccaggtcctacagtgtgcatttctcattttttcaggtttttcagtgatttcgtcatttttcacgttgtcaagtggatgtttctcattttccatgattttcacttttcttgccatatttcatgtcctaaagtgtgtatttctcattttcagtgattttcagttttcctcgccatatttcacgtcccaaaatgtgtatttcttattttccatgattttcagtttcctcgccatattccaggtcctacagtgtgcatttctcatttttcacgtttttcagtgatttcgtcttttttcaagacgtcaagtggatgtttctcatttttcatgattttcagttttcttgccatattccatgtcctacagtggacatttctaaattttccacctttttctgttttcctcgccatatttcacgtcctaaagtgtgtatttctcattttccgtgattttcagttttcttgccatattcctggtcctacagtgtgcatttctcatttttcacgtttttcagtgattttgtcatttttcaatttgtcaactgcatgtttctcattttccatgattttcagttttcttgccatattccatgtcctacagtggacatttctaaattttccacctttttcagttttcctcgccatatttcacgtgctaaagtgtgtatttctcatttttcgtgtttttcaggtttctcgccatattccaggtcctacagtgtgcatttctcatttttcacgtttttcagtgattttgtcatttttcaagttgtcaagtggatgtttctcattttccttgattttcacttttcttgccatattccatgtcctacagtggacatttctaaattttccacctttttcagttttcctcgccatatttcatgtcctaaagtgtgtatttctcattttcagtgattttcagttttctcgccatattccaggtcctacagtgtgcatttctcatttttcacgtttttcagtgatttcgtcttttttcaagacgtcaagtggatgtttctcattttccatgattttcagttttcttgccatattccatgtcctacagtggacatttctaaattttccacctttttctgttttcctcgccatatttcacgtcctaaagtgtgtatttctcattttccgtgattttcagttttcttgccatattccaggtcctacagtgtgcatttctcatttttcacgtttttcagtgattttgtcatttttcaatttgtcaactgcatgtttctcattttccatgatttttagttttcttgctatattccatgtcctacagtggaaatttctaaattttccacctttttcagttttcctcgccatatttcacgtcctaaagtgtgtatttctcattttccgtgattttcagttttcttgctatattccaagtcctacattgtgcatttctcatttttcacgtttttcagtgattttgtcatttttcaatttgtcaaaccacatgtttctcattttccatgattttcagtttttttgccatattccatgtcctacagtggaaatttctatattttccacctttttcagttttcctcgccatatttcacgtgctaaagtgtgtatttctcatttttcgtgtttttcaggtttctcgccatattccaggtcctacagtgtgcatttctcatttttcacgtttttctgtgattttgtcatttttcaagttgtcaagtggatgtttctcattttccttgattttcagttttcttaccatattccatgtcctacagtggacatttctaaattttccaccttttctgttttcctcgccatatttcatgtcctaaagtgtgtatttctcattttccgtgattttcatttttcttgctatattccaagtcctacagtgtgcatttctcattttccatgattttcagttttcttgctatattccatgtcctacagtggaaatttctaaattttccacctttttcagttttcctcgccatatttcacgtcctaaagtgtgtatttctcattttccgtgattttcagttttttcgccatattacaggtcctatgtgtacatttctcatttttcacgtttttcagtgattttgtcatttttcaagttgtcaagtggatgtttctcatttttcttgattttcatttttcttgccatattccatgtcctacagtggaaatttctaaattttccacctttttcagttttcctcgccatatttcacgtcctaaagtgtgaatttctcattttccgtgattttcagttttctcgccatattccaggtctacagtgtgcatttctcatttttcacgttttcagtgattcgtcatttttcaagttgacaagtggatgtttctcattttccatgattttcagctttcttgccatattcaaagtcctacagtggacatttctaaattttcgacctttatcagttttcctcgccatatttcatgtcccaaagtgtgtacttctcattttccgtgattttcagttttcttgccatattccaagtcctacagtgtgcatttctcatttttcacgtttttcagtgattttgtcatttttcaatttgtcaactgcatgtttctcattttccatgattttcagttttcttgccatattccatgtcctacagtggaaatttctatattttccacctttttcagttttcctcgccatatttcacgtgctaaagtgtgtatttctcatttttcgtgtttttcaggtttctcgccatattccaggtcctacagtgtgcatttctcatttttcacgtttttcagtgattttgtcatttttcaagttgtcaagtggatgtttctcattttcaatgattttcatttttcttgccttattccacgtcctatagtggacatttctaaattttccacctttttcagtttttctcgccatatttcacgtcccaaaatgtgtattccttattttccatgattttcagtttcctcgccatattccaggtcctacagtgtgcatttctcatttttcacgtttttcagtgatttcgtcttttttcaagacgtcaagtggatgtttctcatttttcatgattttcagttttcttgccatattccctgtcctacagtggacatttctaaattttccacctttttctgttttcctcgccatatttcacgtcctaaagtgtgtatttctcattttccgtgattttcagttttctcgccagattccaggtcctacagtgtgcatttctcatttttcacgtttttcagtgattttgtcatttttcaatttgtcaactgcatgtttctctctttccatgattttcagttttcttgccatattccatgtcctacagtggacatttctaaattttccacctttttcagttttcctcgccatatttcacgtgctaaagtgtgtatttctcatttttcgtgtttttcaggtttctcgccatattccaggtcctacagtgtgcatttctcatttttcacgtttttcagtgattttgtcatttttcaagttgtcaagtggatgtttctcattttcaatgattttcatttttcttaccttattccacgtcctatagtggacatttctaaattttccacctttttcagtttttctcgccatatttcacgtcccaaaatgtgtattccttattttccatgattttcagtttcctcgccatattccaggtcctacagtgtgcatttctcatttttcacgtttttcagtgatttcgtcttttttcaagacgtcaagtggatgtttctcatttttcatgattttcagttttcttgccatattccctgtcctacagtggacatttctaaattttccacctttttctgttttcctcgccatatttcacgtcctaaagtgtgtatttctcattttccgtgattttcagttttctcgccagattccaggtcctacagtgtgcatttctcatttttcacgtttttcagtgatttcgtcatttttcaagtcttcaagtgtatgtttctcattttcaatgattttcatttttcttgccttattccacgtcctatagtggacatttctaaattttccacctttttcagtttttctcgccatatttcacgtcctaaagtgtgtatttctcattttctgtgattttcagttttcttaccatattccaggtcctacagtgtgcatttctcatttttcacgtttttcagtgatttcgtcatttttcaagttgtcaagtggaagtttctcattttccatgattttcagctttctagccatattccaggtattacagtggacatttccttattttcgacctttatcagttttcctcgccatatttcatgtcctaaagtgtgt	38399	1554	4%	7300	19%
9	3000001	3038400	Atcctacagtgtgcatttctcatttttcacgtttttcagtgatttcgtcatttttcaagtcatcaagtggctgtttctcattttccatgattttcagttttcttgccatattccttgtcctacagtggacatttctaaattttccacctttttcagttttccttgtcatatttcaggtcctacagtgtgtatttctcatttttcacgtttttcattgatttcgtcatttttcaagttgtcaagtgcatgtttctcattttccatgattttcagttttcttgccatattccatgtcctacaatggacatttctaaattttccaactttttcagttttcctcgccatatttcacgtcctaaagtgtgtatttctcattttccgtgattttcagttttctcgacatattccaggtcctacagtgtgcatttctcatttttcacgtttttcagtgatttcgtcatttttcacgtcgtcaagtggatgtttctcattttccatgattttcagttttcttgccatattccatgtcctacagtggacatttctaaattttccacctttttcagttttcctcgccatatttcacgtcctaaagtgtgtatttctcattttccgtgattttcagttttctcgacatattccaggtcttacagggtgcatttctcatttttcacgtttttcagtgatttcatcatttttcaagtcgtcaactgtatgtttctcattttcaatgattttcatttttcttgccatattccacgtcctatagtggacatttctaaattttccacctttttcagttttccttgccatatttcaggtcctacagtgtgcatttctcatttttcacgtttttcagtgatttcgtcatttttcaagtggtcaaatgcatgtttctcattttccatgattttcagttttcttgccatattccatgtcctacagtggacatttctaaattttccacctttttcagttttcctcgccatatttcacgtcctaaagtgtgtatttctcattttccgtgattttcagttttatcgccagattccaggtcctacggtgtgcatttttcatatttcacgtttttcagtgattttgtcatttttcaagttgtcaactgcatgtttctcattttccatgattttcagttttcttgccatattccatgtcctacagtggacatttctaaattttccacctttttcagttttcctcgccatatttcatgtcctaaagtgtgtatttctcattttcagtgattttctgttttctcgccatattccaggtcctacagtgtgcatttctcatttttcacgtttttcagtgatttcgtcatttttcaagttgtcaagtggatgtttctcattttccatgattttcagttttcttgccatattccatgtcctacaatggacatttctaaattttccacctttttcagttttcctcgccatatttcacgtcctaaagtgtgtatttctcattttccgtgattttcagttttctcgccatattccaggtcctatgtgtacatttctcatttttcacgtttttcagtgattttgtcatttttcaagttgtgaagtggatgtttctcatttttcttgattttcatttttcttgccatattccatgtcctagagtggaaatttttaaattttccacctttttcagttttcctcgccatatttcacgtcctaaagtgtgaatttctcattttccgtgattttcagttttctcgccatattccaagtcctacagtgtgcatttctcatttttcacgtttttcagtgatttcgtcatttttcaagttgtcaagtggatgtttctcattttccatgattttcagctttcttgccatattcaaagtcctacagtggacatttctaaattttcgacctttatcagttttcctcgccatatttcatgtcccaaagtgtgtacttctcattttccgtgattttcagtttcctcgccatattctaggtcctacagtgtgcatttctcatttttcaggtttttcagtgatttcgtcttttttcaagtcgtcaagtggatgtttctcattttccatgattttcagttttcttgccatattccatgtcctacagtggacatttctaaattttccaactttttcagttttcctcgccatatttcatgtcctaaagtgtgtatttctcattttcagtgattttcagttttctcgccatattccaggtcctacagtgtgcatttctcatttttcacgtttttcagtgatttcgtcatttttcaagttgtcaagtggatgtttctcatttttcatgattttcagttttcttgccatattccatgtcccacagtggacatttctaaatgttccacctttttctgttttccttgccatatttcatgtcctaaagtgtgtatttctcattttccgtgattttcagttttcttgctatattccaagtcctacagtgtgcatttctcatttttcacgtttttctgtgattttttcatttttcaatttgtcaactgcatgtttctcattttccatgattttcagttttcttgccatattccaggtcctacagtgtgcatttctcatttttcacgtttttcagtgattttgtcatttttcaagttgtcaactgcatgtttctcattttccatgattttcagttttcttgctatattccatgtcctacagtggaaatttctaaattttccacctttttcagttttcctcgccatatttcacgtcctaaagtgtgtatttctcattttccgtgattttcagttttctcgccatattccaggtcctatgtgtacatttctcatttttcacgtttttcagtgattttgtcatttttcaagttgtgaagtggatgtttctcatttttcttgattttcatttttcttgccatattccatgtcctagagtggaaatttttaaattttccacctttttcagttttcctcgccatatttcacgtcctaaattgtgaatttctcattttccgtgattttcagttttctcgccatattccaagtcctacagtgtgcatttctcatttttcacgtttttcagtgatttcgtcatttttcaagttgtcaagtggatgtttctcattttccatgattttcagctttcttgccatattcaaagtcctacagtggacatttctaaattttcgacctttatcagttttcctcgccatatttcatgtcccaaagtgtgtacttctcattttccgtgattttcagtttcctcgccatattctaggtcctacagtgtgcatttctcatttttcaggtttttcagtgatttcgtcttttttcaagtcgtcaagtggatgtttctcattttccatgattttcagttttcttgccatattccatgtcctacagtggacatttctaaattttccacctttttcagttttcctcgccatatttcatgtcctaaagtgtgtatttctcattttcagtgattttcagttttctcgccatattccaggtcctacagtgtgcatttctcatttttcacgtttttcagtgattttgtcatttttcaagttgtcaagtggatgtttctcattttccttgattttcagttttcttgccatattccatgtcctacagtggacatttctaaattttccacctttttcagttttccttgccatatttcatgtcctaaagtgtgtatttctcattttcagtgattttcagttttctcgccatattccaggtcctacagtgtgcatttctcattttttcaggtttttcagtgatttcgtcatttttcacgttgtcaagtggatgtttctcattttccatgattttcacttttcttgccatatttcatgtcctaaagtgtgtatttctcattttcagtgattttcagttttctcgccatattccaggtcctacagtgtgcatttctcattttttcacgtttttcagtgatttcgtcatttttcacgttgtcaagtggatgtttctcattttccattattttcacttttcttgccatatttcatgtcctacagtggacatttctaaattttccacctttttctgttttcctcgccatatttcacatcctaaagtgtgtatttctcattttccgtgattttcagttttcttgccatattccaggtcctacagtgtgcatttctcatttttcacgtttttcagtgatttcgtcatttttcaagtcgtcaagtggatgtttctcattttccatgattttcagttttctcgccatattccaggtcctacagttgacatttctaaattttccacattttttatgtttcctcgcgatatttcacatcctaaagtgtgtatttctcattttccgtgattttcagttttcttgccatattccaggtcctacagggtgcatttctcatttttcacgtttttcagtgatttcatcaatttcaagtcgtcaactgtatgtttctcattttcaatgattttcatttttcttgccatattccacgtcctatagtggacatttctacattttccacctttttcagttttcttcgccatatttcacgtcccaaagtgtgtatttctcattttccgtgattttcagtttcctcgccatattccaggtcctacagtgtgcatttctcatttttcacgtttttcagtgatttcgtcttttttcaagtcgtcaagtggatgtttctcattttccatgattttcagttttcttgccatattccatgtcctacagtggacatttctaaattttccacctttttctgttttcctcgccatatttcacgtcctaaagtgtgtatttctcatttaccgtgattttcagttttcttgctatattccaagtcctacagtgtgcatttctcatttttcacgtttttcactgattttgtcattgttcaagttgtcaactgcatgtttctcattttccatgattttcagttttcttgccatattccatgtcctacagtggaaatttctatattttccaactttttcagttttcctcgccatatttcacgtgctaaagtgtgtatttctcatttttcgtgtttttcaggtttctcgccatattccaggtcctacagtgtgcatttctcatttttcacgtttttcagtgattttgtaatttttcaagttgtcaagtggatgtttctcattttccttgattttcagttttcttgccatattccatgtcctactgtggacatttctaaattttccacctttttcagttttccttgccatatttcatgtcctaaagtgtgtatttctcattttcagtgattttcagttttctcgcaatattccaggtcctacagtgtgcatttctcattttttcaggtttttcagtgatttcgtcatttttcacgttgtcaagtggatgtttctcattttccatgattttcacttttcttgccatatttcatgtgctaaagtgtgtatttctcattttcagtgattttcagttttctgccatattccaggtcctacattgtgcatttctcattttttcacgtttttcagtgatttcgtcatttttcacgttgtcaagtggatgtttctcattttccatgattttcacttttcttgccatatttcatgttttacagtggacatttctaaattttccacctatttctgttttcctcgccatatttcacatcctaaagtgtgtatttctcattttccgtgattttcagttttctcgccatatgccaggtcatacagggtgcatttctcatttttcacgtttttcagtgatttcgtcatttttcacgtcgtcaagtggatgtttctcattttcaatgattttcatttttcttgccatattccacgtcctatagtggacatttctaaattttccacctttttcagttttccttgccatatttcaggtcctacagtgtgcatttctcttttttcacgtttttcagtgatttcgtcatttttcaagtggtcaagtgcatgtttctcattttccgtgattttcagttttcttgccatgttccaggtcctacagttgacgtttctaaaatttcactttttttaagttttcctcgccatatttcacttcctaaagtgtgtatttctcattttccgtgattttcagttttctcgccagattccaggtcctacagtgtgcatttttcatatttcacctttttcagtgattttgtcatttttcaagttgtcaactgcatgtttctcattttccatgattttcagttttcttgccatattccatgtcctactgtggacatttctaaattttccaactttttcagttttcctcgccatatttcatgtcctaaagtgtgtatttctcattttcagtgattttctgttttctcgccatattccaggtcctacagtgtgcatttctaatttttcacgtttttcagtgatttcgtcatttttcaagttgtcaagtggatgtttctcattttccatgattttcagttttcttgccatattccatgtcctacagtggacatttctaaattttccaactttttccattttcctcaccatatttcacgtcctaaagtgagtttttctcattttttgtgattttcagttttctcgacatattccaggtcctacagtgtgcatttctaattttttcttttttcagtgatttcgtcatttttcaagtggtcaagtgcatgtttctcattttccatgattttcagttttcttgccatattccatgtcctacaatggacatttctaaattttccaactttttcagttttcctcgccatatttcacgtcctaaagtgtgtatttctcattttccgtgattttcagttttctcgccatattccaggtcctacagtgtgcatttctcatttttcacgtttttcagtgatttcgtcatttttcaagttgtcaactgcatgtttctcattttccatgattttcagttttcttgccatattccatgtcttacagtggacatttttaaatttttcacatttttttaagttttcctccccatatttcacgttttaaagtgtgcatttctcattttcggtgattttcagttttctcgccagattccatgtcttacagtgtgcatttctcattttttcacgtttttcagtgatttcgtcatttttcaagtcgtcaagtggatgtttctcattttccatgattttcagttttcttgccatattccatgtcctacagtggaaatttctaaattttccacctttttcagttttccttgccatatttcaggtcctaaagtgtgtatttctcattttctgtgattttcagttttctcgccatattccaggtcctacagttgacatttctaaaatttccacattttttaagttttcctcgccatatttcacttcctaaagtgtgtatttctcattttccgtgattttcagttttctcgccatattccagatcctacagtgtacatttttcatttttcacgtttttcagtgattttgtcattttttagttgtcaactgcctgtttctcattttccatgattttcagttttcttgctatattccatgtcctacagtggaaatttctaaattttccacctttttcagttttcctcgccatatttcacgtcctaaagtgtgtatttctcattttccgtgattttcagttttctcgccatattccaggtcctatgtgtacatttctcatttttcacgtttttcagtgattttgtcatttttcaatttgtcaactgcatgtttctcattttccatgattttcagttttcttgccatattccatgtcctacagtggaaatttctatattttccaactttttcagttttcctcgccatatttcacgtgctaaagtgtgtatttctcatttttcgtgtttttcaggtttctcgccatattccaggtcctacagtgtgcatttctcatttttcacgtttttcagtgattttgtcatttttcaagttgtcaagtggatgtttctcattttccttgattttcagttttcttgccatattccatgtcctacagtggacatttctaaattttccacctttttcagttttccttgccatatttcatgtcctaaagtgtgtatttctcattttcagtgattttcagttttctcgccatattccaggtcctacagtgtgcatttctcattttttcaggtttttcagtgatttcgtcatttttcacgttgtcaagtggatgtttctcattttccatgattttcacttttcttgccatatttcatgtcctaaagtgtgtatttctcattttcagtgattttcagttttctcgctatattccaggtcctacagtgtgcatttctcattttttcacgtttttcagtgatttcgtcatttttcacgttgtcaagtggatgtttctcattttccatgattttcacttttcttgccatatttcatgtcctacaatggacatttctaaattttccacctttttctgttttcctcgccatatttcacatcctaaagtgtgtatttctcattttccgtgattttcagttttcttgccatattccaggtcctacagtgtgcatttctcatttttcacgtttttcagtgatttcgtcatttttcaagttgtcaagtggatgtttctcattttccttgattttcagttttcttgccatattccatgtcctactgtggacatttctaaattttccacctttttcagttttccttgccatatttcatgtcctaaagtgtgtatttctcattttcagtgattttcagttttctcgcaatattccaggtcctacagtgtgcatttctcattttttcaggtttttcagtgatttcgtcatttttcacgttgtcaagtggatgtttctcattttccatgattttcacttttcttgccatatttcatgtcctaaagtgtgtatttctcattttcagtgattttcagttttctgccatattccaggtcctacattgtgcatttctcattttttcacgtttttcagtgatttcgtcatttttcagttttctcgacatattccaggtcctacagtgtgcatttctaattttttcttttttcagtgatttcgtcatttttcaagttgtcaactgcatgtttctcattttccatgattttcagttttcttgccatattccatgtcttacagtggacatttttaaatttttcacatttttttaagttttcctccccatatttcacgttttaaagtgtgcatttctcattttcggtgattttcagttttctcgccagattccaggtcttacagtgtgcatttctcattttttcacgtttttcagtgatttcgtcatttttcaagtcgtcaagtggatgtttctcattttccatgattttcagttttcttgccatattccatgtcctacagtggaaatttctaaattttccacctttttcagttttccttgccatatttcaggtcctaaagtgtgtatttctcattttctgtgattttcagttttctcgccatattccaggtcctacagttgacatttctaaaatttccacattttttaagttttcctcgccatatttcacttcctaaagtgtgtatttctcattttccgtgattttcagttttctcgccatattccagatcctacagtgtgcatttttcatttttcacgtttttcagtgattttgtcattttttagttgtcaactgtctgtttctcattttccatgattttcagttttcttgccatattccatgtcctacactggacatttctaaattttccacctttttctgttttcctcgccatatttcacgtcctaaagtgtgtatttctcattttccgtgattttcagttttcttgccatattccaggtcctacagtgtgcatttctcatttttcacgtttttcagtgattttgtcatttttcaagttgtcaactgcatgtttctcattttctatgattttcagttttcttgctatattccatgtcctacagtggaaatttctaaattttccacctttttcagttttcctcgccatatttcacgtcctaaagtgtgtatttctcattttccgtgattttcagttttctcgccatattccaggtcctatgtgtacatttctcatttttcacgtttttcagtgattttgtcatttttcaagttgtgaagtggatgtttctcatttttcttgattttcatttttcttgccatattccatgtcctagagtggaaatttttaaattttccacctttttcagttttcctcgccatatttcacgtcctaaagtgtgaatttctcattttccgtgattttcagatttctcgccatattccaagtcctacagtgtgcatttctcatttttcacgtttttcagtgatttcgtcatttttcaagttgtcaagtggatgtttctcattttccatgattttcagctttcttgccatattcaaagtcctacagtggacatttctaaattttcgacctttatcagttttcctcgccatatttcatgtcccaaagtgtgtacttctcattttccgtgattttcagtttcctagccatattctaggtcctacagtgtgcatttctcatttttcaggtttttcagtgatttcgtcttttttcaagtcgtcaagtggatgtttctcattttccatgattttcacttttcttgccatatttcatgtcctaaagtgtgtatttctcattttcagtgattttcagttttctcgctatattccaggtcctacagtgtgcatttctcattttttcacgtttttcagtgatttcgtcatttttcacgttgtcaagtggatgtttctcattttccatgattttcacttttcttgccatatttcatgtcctacagtggacatttctaaattttccacctttttctgttttcctcgccatatttcacatcctaaagtgtgtatttctcattttccgtgattttcagttttcttgccatattccaggtcctacagtgtgcatttctcatttttcacgtttttcagtgatttcgtcatttttcaagttgtcaagtggatgtttctcattttccttgattttcagttttcttgccatattccatgtcctactgtggacatttctaaattttccacctttttcagttttccttgccatatttcatgtcctaaagtgtgtatttctcattttcagtgattttcagttttctcgcaatattccaggtcctacagtgtgcatttctcattttttcaggtttttcagtgatttcgtcatttttcacgttgtcaagtggatgtttctcattttccatgattttcacttttcttgccatatttcatgtcctaaagtgtgtatttctcattttcagtgattttcagttttctgccatattccaggtcctacattgtgcatttctcattttttcacgtttttcagtgatttcgtcatttttcacgttgtcaagtggatgtttctcattttccatgattttcacttttcttgccatatttcatgttttacagtggacatttctaaattttccacctttttctgttttcctcgccatatttcacatcctaaagtgtgtatttctcattttccgtgattttcagttttctcgccatatgccaggtcatacagggtgcatttctcatttttcacgtttttcagtgatttcgtcatttttcacgtcgtcaagtggatgtttctcattttcaatgattttcatttttcttgccatattccacgtcctatagtggacatttctaaattttccacctttttcagttttccttgccatatttcaggtcctacagtgtgcatttctcatttttcacgtttttcagtgatttcgtcatttttcaagtggtcaagtgcatgtttctcattttccgtgattttcagttttcttgccatgttccaggtcctacagttgacgtttctaaaatttcactttttttaagttttcctcgccatatttcacttcctaaagtgtgtatttctcattttccgtgattttcagttttctcgccagattccaggtcctacagtgtgcatttttcatatttcacctttttcagtgattttgtcatttttcaagttgtcaactgcatgtttctcattttccatgattttcagttttcttgccatattccatgtcctactgtggacatttctaaattttccaactttttcagttttcctcgccatatttcatgtcctaaagtgtgtatttctcattttcagtgattttctgttttctcgccatattccaggtcctacagtgtgcatttctaatttttcacgtttttcagtgatttcgtcatttttcaagttgtcaagtggatgtttctcattttccatgattttcagttttcttgccatattccatgtcctacagtggacatttctaaattttccaactttttccattttcctcaccatatttcacgtcctaaagtgtgtttttctcattttttgtgattttcagttttctcgacatattccaggtcctacagtgtgcatttctaattttttcttttttcagtgatttcgtcatttttcaagttgtcaactgcatgtttctcattttccatgattttcagttttcttgccatattccatgtcttacagtggacatttttaaatttttcacatttttttaagttttcctccccatatttcacgttttaaagtgtgcatttctcattttcggtgattttcagttttctcgccagattccaggtcttacagtgtgcatttctcattttttcacgtttttcagtgatttcgtcatttttcaagtcgtcaagtggatgtttctcattttccatgattttcagttttcttgccatattccatgtcctacagtggaaatttctaaattttccacctttttcagttttccttgccatatttcaggtcctaaagtgtgtatttctcattttctgtgattttcagttttctcgccatattccaggtcctacagttgacatttctaaaatttccacattttttaagttttcctcgccatatttcacttcctaaagtgtgtatttctcattttccgtgattttcagttttctcgccatattccagatcctacagtgtgcatttttcatttttcacgtttttcagtgattttgtcattttttagttgtcaactgtctgtttctcattttccatgattttcagttttcttgccatattccatgtcctacactggacatttctaaattttccacctttttctgttttcctcgccatatttcacgtcctaaagtgtgtatttctcattttccgtgattttcagttttcttgccatattccaggtcctacagtgtgcatttctcatttttcacgtttttcagtgattttgtcatttttcaagttgtcaactgcatgtttctcattttccatgattttcagttttcttgctatattccatgtcctacagtggaaatttctaaattttccacctttttcagttttcctcgccatatttcacgtcctaaagtgtgtatttctcattttccgtgattttcagttttctcgccatattccaggtcctatgtgtacatttctcatttttcacgtttttcagtgattttgtcatttttcaagttgtgaagtggatgtttctcatttttcttgattttcatttttcttgccatattccatgtcctagagtggaaatttttaaattttccacctttttcagttttcctcgccatatttcacgtcctaaagtgtgaatttctcattttccgtgattttcagatttctcgccatattccaagtcctacagtgtgcatttctcatttttcacgtttttcagtgatttcgtcatttttcaagttgtcaagtggatgtttctcattttccatgattttcagctttcttgccatattcaaagtcctacagtggacatttctaaattttcgacctttatcagttttcctcgccatatttcatgtcccaaagtgtgtacttctcattttccgtgattttcagtttcctcgccatattctaggtcctacagtgtgcatttctcatttttcaggtttttcagtgatttcgtcttttttcaagtcgtcaagtggatgtttctcattttccatgattttcagttttcttgccatattccatgtcctacagtggacatttctaaattttccacctttttcagttttcctcgccatatttcatgtcctaaagtgtgtatttctcattttcagtgattttcagttttctcgccatattccaggtcctacagtgtgcatttctcatttttcacgtttttcagtgatttcgtcatttttcaagttgtcaagtggatgtttctcattttccatgattttcagttttcttgccatattccatgtcccacagtggacatttctaaattttccacctttttctgttttccttgccatatttcatgtcctaaagtgtgtatttctcattttccgtgattttcagttttcttgctatattccaagtcctacagtgtgcatttctcatttttcacgtttttcagtgattttgtcatttttcaatttgtcaactgcatgtttctcattttccatgattttcagttttcttgccatattccatgtcctacagtggaaatttctatattttccaactttttcagttttcctcgccatatttcacgtgctaaagtgtgtatttctcatttttcgtgtttttcaggtttctcgccatattccaggtcctacagtgtgcatttctcatttttcacgtttttcagtgattttgtcatttttcaagttgtcaagtggatgtttctcattttccttgattttcagttttcttgccatattccatgtcctacagtggacatttctaaattttccacctttttcagttttccttgccatatttcatgtcctaaagtgtgtatttctcattttcagtgattttcagttttctcgccatattccaggtcctacagtgtgcatttctcattttttcaggtttttcagtgatttcgtcatttttcacgttgtcaagtggatgtttctcattttccatgattttcacttttcttgccatatttcatgtcctaaagtgtgtatttctcattttcagtgattttcagttttctcgctatattccaggtcctacagtgtgcatttctcattttttcacgtttttcagtgatttcgtcatttttcacgttgtcaagtggatgtttctcattttccatgattttcacttttcttgccatatttcatgtcctacagtggacatttctaaattttccacctttttctgttttcctcgccatatttcacatactaaagtgtgtatttctcattttccttgattttcagttttcttgccatattccaggtcctacagtgtgcatttctcatttttcacgtttttcagtgatttcgtcatttttcaagtcgtcaagtggatgtttctcattttccatgattttcagttttctcgccatattccaggtcctacagttgacatttctaaattttccacattttttaagtttcctcgcgatatttcacatcctaaagtgtgtatttctcattttccgtgattttcagttttcttgccatattccaggtcctacagggtgcatttctcatttttcacgtttttcagtgatttcatcaatttcaagtcgtcaactgtatgtttctcattttcaatgattttcatttttcttgccatattccatgtcctacagtggacatttctaaatttttcacctttttcagttttccttgccatatttcatgtcctaaagtgtgtatttctcattttcagtgattttcagttttctcgccatattccaggtcctacagtgtgcatttctcattttttcaggtttttcagtgatttcgtcatttttcacgttgtcaagtggatgtttctcattttccatgattttcacttttcttgccatatttcatgtcctaaagtgtgtatttctcattttcagtgattttcagttttctcgccatattccaggtcctacagtgtgcatttctcatttttcacgtttttcagtgatttcgtcatttttcaagttgtcaagtggatgtttctcattttccatgattttcacttttcttgccatattccatgtcccacagtggacatttctaaattttccacctttttctgttttcctcgccatatttcatgtcctaaagtgtgtatttctcattttccgtgattttcagttttcttgctatattccaagtcctacagtgtgcatttctcatttttcacgtttttcagtgattttgtcatttttcaatttgtcaactgcatgtttctcattttccatgattttcagttttcttgccatattccatgttctacagtggaaatttctatattttccaactttttcagttttcctcgccatatttcacgtgctaaagtgtgtatttctcatttttcgtgtttttcaggtttctcgccatattccaggtcctacagtgtgcatttctcatttttcacgtttttcagtgattttgtcatttttcaagttgtcaagtggatgtttctcattttccttgattttcagttttcttgccatattccatgtcctacagtggacatttctaaattttccacctttttcagttttccttgccatatttcatgtcctaaagtgtgtatttctcattttcagtgattttcagttttctcgccatattccaggtcctacagtgtgcatttctcattttttcaggtttttcagtgatttcgtcatttttcacgttgtcaagtggatgtttctcattttccatgattttcacttttcttgccatatttcatgtcctaaagtgtgtatttctcattttcagtgattttcagttttctcgctatattccaggtcctacagtgtgcatttctcattttttcacgttttgcagtgatttcgtcatttttcacgttgtcaagtggatgtttctcattttccatgattttcacttttcttgccatatttcatgtcctacagtggacatttctaaattttccacctttttctgttttcctcgccatatttcacatcctaaagtgtgtatttctcattttccgtgattttcagttttcttgccatattccaggtcctacagtgtgcatttctcatttttcacgtttttcagtgatttcgtcatttttcaagtcgtcaagtggatgtttctcattttccatgattttcagttttctcgccatattccaggtcctacagttgacatttctaaattttccacattttttaagtttcctcgcgatatttcacatcctaaagtgtgtatttctcattttccgtgattttcagttttcttgccatattccaggtcctacagggtgcatttctcatttttcacgtttttcagtgatttcatcaatttcaagtcgtcaactgtatgtttctcattttcaatgattttcatttttcttgccatattccatgtcctacagtggacatttctaaattttccacctttttcagttttccttgccatatttcatgtcctaaagtgtgtatttctcattttcagggattttcagttttctcgccatattccaggtcctacagtgtgcatttctcattttttcaggtttttcagtgatttcgtcatttttcacgttgtcaagtggatgtttctcattttccatgattttcacttttcttgccatatttcatgtcctaaagtgtgtatttctcattttcagtgattttcagttttctcgccatattccaggtcctacagtgtgcatttctcattttttcacgtttttcagtgatttcgtcatttttcacgttgtcaagtggatgtttctcattttccatgattttcacttttcttgccatatttcatgtcctacagtggacatttctaaattttccacctttttctgttttcctcgccatatttcacatcctaaagtgtgtatttctcattttccgtgattttcagttttcttgccatattccaggtcctacagtgtgcatttctcatttttcacgtttttcagtgatttcgtcatttttcaagtcgtcaagtggatgtttctcattttccatgattttcagttttctcgccatattccaggtcctacagttgacatttctaaattttccacattttttaagtttcctcgcgatatttcacatcctaaagtgtgtatttctcattttccgtgattttcagttttcttgccatattccaggtcctacagggtgcatttctcatttttcacgtttttcagtgatttcatcaatttcaagtcgtcaactgtatgtttctcattttcaatgattttcatttttcttgccatattccacgtcctatagtggacatttctaaattttccacctttttcagttttcttcgccatatttcacgtcccaaagtgtgtatttctcattttccgtgattttcagtttcctcgcaatattccaggtcctacagtgtgcatttctcatttttcacgtttttcagtgatttcgtcttttttcaagtcgtcaagtggatgtttctcattttccatgattttcagttttcttgccatattccatgtcctacagtggacatttctaaattttccacctttttctgttttcctcgccatatttcacgtcctaaagtgtgtatttctcattttccgtgattttcagttttcttgccatattccaggtcctacagtgtgcatttctcatttttcacgtttttcactgattttgtcattgttcaagttgtcaactgcatgtttctcattttccatgattttcaattttcttgccatattccatgtcctacagtggaaatttctatattttccaactttttcagttttcctcgccatatttcacgtgctaaagtgtgtatttctcatttttcgtgtttttcaggtttctcgccatattccaggtcctacagtgtgcatttctcatttttcacgtttttcagtgattttgtcatttttcaagttgtcaagtggttgtttctcattttccttgattttcagttttcttgccatattccatgtcctactgtggacatttctaaattttccacctttttcagttttccttgccatatttcatgtcctaaagtgtgtatttctcattttcagtgattttcagttttctcgcaatattccaggtcctacagtgtgcatttctcattttccgtgattttcagttttctcgccatatgccaggtcatacagggtgcatttctcatttttcacgtttttcagtgatttcgtcatttttcacgtcgtcaagtggatgtttctcattttcaatgattttcatttttcttgccatattccacgtcctatagtggacatttctaaattttccaactttttcagttttcttgccatatttcaggtcctacagtgtgcatttctcatttttcacgtttttcagtgatttcgtcatttttcaagtggtcaagtgcatgtttctgattttccgtgattttcagttttcttgccatgttccaggtcctacagttgacgtttctaaaatttcactttttttaagttttcctcgccatatttcacttcctaaagtgtgtatttctcattttccgtgattttcagttttctcgccagattccaggtcctacagtgtgcatttttcatatttcacctttttcagtgattttgtcatttttcaagttgtcaactgcatgtttctcattttccatgattttcagttttcttgccatattccatgtcctactgtggacatttctaaattttccaactttttcagttttcctcgccatatttcatgtcctaaagtgtgtatttctcattttcagtgtttttctgttttctcgccatattccaggtcctacagtgtgcatttctaatttttcacgtttttcagtgatttcgtcatttttcaagttgtcaagtggatgtttctcattttccatgattttcagttttcttgccatattccatgtcctacagtggacatttctaaattttccaactttttccattttcctcaccatatttcacgtcctaaagtgtgtttttctcattttttgtgattttcagttttctcgacatattccaggtcctacagtgtgcatttctaattttttcttttttcagtgatttcgtcatttttcaagtggtcaagtgcatgtttctcattttccatgattttcagttttcttgccatattccatgtcctacaatggacatttctaaattttccaactttttcagttttcctcgccatatttcacgtcctaaagtgtgtatttctcattttccgtgattttcagttttctcgccatattccaggtcctatgtgtacatttctcatttttcacgtttttcagtgattttgtcatttttcaagttgtgaagtggatgtttctcatttttcttgattttcatttttcttgccatattccatgtcctagagtggaaatttttaaattttccaactttttcagttttcctcgccatatttcacgtcctaaagtgtgtatttctcattttccgtgattttcagttttctcgccatattccaagtcctacagtgtgcatttctcatttttcacgtttttcagtgatttcgtcatttttcaagttgtcaagtggatgtttctcattttccatgattttcagctttcttgccatattcaaagtcctacagtggacatttctaaattttcgacctttatcagttttcctcgccatatttcatgtcccaaagtgtgtacttctcattttccgtgattttcagtttcctcgccatattctaggtcctacagtgtgcatttctcatttttcaggtttttcagtgatttcgtcttttttcaagtcgtcaagtggatgtttctcattttccatgattttcagttttcttgccatattccatgtcctacagtggacatttctaaattttccacctttttcagttttcctcgccatatttcatgtcctaaagtgtgtatttctcattttcagtgattttcagttttctcgccatattccaggtcctacagtgtgcatttctcatttttcacgtttttcagtgatttcgtcatttttcaagttgtcaagtggatgtttctcattttccatgattttcagttttcttgccatattccatgtcccacagtggacatttctaaattttccacctttttctgttttccttgccatatttcatgtcctaaagtgtgtatttctcattttccgtgattttcagttttcttgctatattccaagtcctacagtgtgcatttctcatttttcacgtttttaagtgattttgtcatttttcaatttgtcaactgcatgtttctcattttccatgattttcagttttcttgccatattccatgtcctacagtggaaatttctatattttccaactttttcagttttcctcgccatatttcacgtgctaaagtgtgtatttctcatttttcgtgtttttcaggtttctcgccatattccaggtcctacagtgtgcatttctcatttttcacgtttttcagtgattttgtcatttttcaagttgtcaagtggatgtttctcattttccttgattttcagttttcttgccatattccatgtcctacagtggacatttctaaattttccacctttttcagttttccttgccatatttcatgtcctaaagtgtgtatttctcattttcagtgattttcagttttctcgccatattccaggtcctacagtgtgcatttctcattttttcaggtttttcagtgatttcgtcatttttcacgttgtcaagtggatgtttctcattttccatgattttcacttttcttgccatatttcatgtcctaaagtgtgtatttctcattttcagtgattttcagttttctcgccatattccaggtcctacagtgtgcatttctcattttttcacgtttttcagtgatttcgtcatttttcacgttgtcaagtggatgtttctcattttccatgattttcacttttcttgccatatttcatgtcctacagtggacatttctaaattttccacctttttctgttttcctcgccatatttcacatcctaaagtgtgtatttctcattttccgtgattttcagttttcttgccatatttcaggtcctacagtgtgcatttctcatttttcacgtttttcagtgatttcgtcatttttcaagtcgtcaagaggatgtttctcattttccatgattttcagttttctcgccatattccaggtcctacagttgacatttctaaattttccacattttttaagtttcctcgcgatatttcacatcctaaagtgtgtatttctcattttccgtgattttcagttttcttgccatattccaggtcctacagggtgcatttctcatttttcacgtttttcagtgatttcatcaatttcaagtcgtcaactgtatgtttctcattttcaatgattttcatttttcttgccatattccacgtcctatagtggacatttctaaattttccacctttttctgttttcctcgccatatttcacgtcctaaagtgtgtatttctcattttccgtgattttcagttttcttgccatattccaggtcctacagtgtgcatttctcatttttcacgtttttcactgattttgtcattgttcaagttgtcaactgcatgtttctcattttccatgattttcagttttcttgccatattccatgtcctacagtggaaatttctatattttccacctttttcagttttcctcgccgtatttcatgtgctaaagtgtgtatttctcatttttcgtgtttttcaggtttctcgccatattccaggtcctacagtgtgcatttctcatttttcacgtttttcagtgattttgtcatttttcaagttgtcaactggatgtttctcattttccttgattttcagttttcttgccatattccatgtcctactgtggacatttctaaattttccacctttttcagttttccttgccatatttcatgtcctaaagtgtgtatttctcattttcagtgattttcagttttctcgcaatattccaggtcctacagtgtgcatttctcattttttcaggtttttcagtgatttcgtcatttttcacgttgtcaagtggatgtttctcattttccatgattttcacttttcttgccatatttcatgtcctaaagtgtgtatttctcattttcagtgattttcagttttctcgccatattccaggtcctacattgtgcatttctcattttttcacgtttttcagtgatttcgtcatttttcacgttgtcaagtggatgtttctcattttccatgattttcacttttcttgccatatttcatgttttacagtggacatttctaaattttccacctttttctgttttcctcgccatatttcacatcctaaagtgtgaatttctcattttccgtgattttcagttttcttgccatattccaggtcctacagtgtgcatttctcatttttcacgtttttcagtgatttcatcatttttcaagtcgtcaagtggatgtttctcattttccatgattttcagttttcttgccatattccatgtcctacagtggacatttctaaattttccacctttttctgttttcctcgccatatttcacgtcctaaagtgtgtatttctcattttccgtgattttcagttttcttgccatattccaggtcctacagtgtgcatttctcatttttcacgtttttcactgattttgtcatttttcaagttgtcaactgcatgtttctcattttccatgattttcagttttcttgctatattccatgtcctacagtggaaatttctaaattttccacctttttcagttttcctcgccatatttcacgtcctgaagtgtgtatttctcattttccgtgattttcagttttctcgccatattccaggtcctatgtgtacatttctcatttttcacgtttttcagtgattttgtcatttttcaagttgtgaagtggatgtttctcatttttcttgattttcatttttcttgccatattccatgtcctacagtggaaatttctaaattttccacctttttcagttttcctcgccatatttcacgtcctaaagtgtgtatttctcattttccgtgattttcagttttctcgccatattccaggtcctacagtgtgcatttctcatttttcacgtttttcagtgatttcgacatttttcaagttgtcaagtggatgtttctcattttccatgattttcagctttcttgccatattcaaagtcctacagtggacatttctaaattttcgacctttatcagttttcctcgccatatttcatgtcccaaagtgtgtacttctcattttccgtgattttcagtttcctcgccatattccaggtcctacagtgtgcatttctcatttttcacgtttttcagtgatttcgtcatttttcaagtcgtcaagtggatgtttctcattttccatgattttcagttttcttgccatattccatgtcctacagtggacatttctaaattttccacctttttctgttttcctcgccatatttcacgtcctaaagtgtgtatttctcattttccgtgattttcagttttcttgccatattccaggtcctacagtgtgcatttctcatttatcacgtttttcactgattttgtcatttttcaagttgtcaactgcatgtttctcattttccatgattttcagttttcttgctatattccatgtcctacagtggaatattctaaattttccacctttttcagttttcctcgccatatttcacgtcctgaagtgtgtatttctcattttccgtgattttcagttttctcgccatattccaggtcctatgtgtacatttctcatttttcacgtttttcagtgattttgtcatttttcaagttgtgaagtggatgtttctcatttttcttgattttcatttttcttgccatattccatgtcctacagtggaaatttctaaattttccacctttttcagttttcctcgccatatttcacgtcctaaagtgtgaatttctcattttccgtgattttcagttttctcgccatattccaggtcctacagtgtgcatttctcatttttcacgtttttcagtgatttcgacatttttcaagttgtcaagtggatgtttctcattttccatgattttcagctttcttgccatattcaaagtcctacagtggacatttctaaattttcgacctttatcagttttcctcgccatatttcatgtcccaaagtgtgtacttctcattttccgtgattttgagtttcctcgccatattccaggtcctacagtgtgcatttctcatttttcacgtttttcagtgatttcgtcttttttcaagttgtcaactgcatgtttctcattttccatgattttcagttttcttgccatattccatgtcctacagtggaaatttgtaaatttccacctttttcagttttcctcgccatatttcacgtcctaaagtatgtatttctcattttccgtgattttcagttttctcgccatattccaggtcctacagtgtgcatttctcatttttcacgtttttcagtgattttgtcattttttaagttttcaagtggatgtttctcattttccttgattttcagttttcttgccatattccatgtcctacagtggacatttctaaattttccacctttttcagttttcctcgccatatttcatgtcctaaagtgtgtatttctcattttcagtgattttcagttttctcgccatattccaggtcctacagtgtgcatttctcatttttcacgtttttcagtgatttcgtcatttttcaaggtgtcaagtggatgtttctcattttccatgattttcagttttcttgccatattccatgtcctacagtggacatttctaaattttccacctttttctgttttcctcgccatatttcatgtcctaaagtgtgtatttctcattttccgtgattttcagttttcttgctatattccaagtcctacagtgtgcatttctcatttttcacgtttttcagtgattttgtcatttttcaatttgtcaactgcatgtttctcattttccatgattttcagtttttttgccatattccatgtcctactgtggaaatttctatattttccacctttttcagttttcctcgccatatttcacgtgctaaagtgtgtatttctcatttttcgtgtttttcaggtttctcgccatattccaggtcctacagtgtgcatttctcatttttcacgtttttcagtgattttgtcatttttcaagttttcaagtggatgtttctcattttccttgattttcagttttcttgccatattccatgtcctacagtggacatttctaaattttccacctttttcagttttccttgccatatttcatgtcctaaagtgtgtatttctcattttcagtgattttcagtttccttgccatattccaggtcctacagtgtgcatttctcattttttcacgtttttcagtgatttcgtcatttttcacgttgtcaagtggatgtttctcattttccatgattttcacttttcttgccatatttcatgtcctacagtggacatttctaaattttccaactttttcaattttcctcgccatattttatgtcctaaagtgtgtatttctcatttttcgttattttcagttttcttgccatattccaggtcctacagtgtgcatttgtcatttttcacgtttttcagtgatttcgtcatttttcaagtcgtcaagtagatgtttctcatattccatgtttttcagttttctcgccatattccaggtcctacagttgacatttctaaattttctacatttttaaattttcctcgccatatttcacgtcctaaagtgtgtatttctcattttttgttattttcagttttctagccatattccaggtcctacaggatgcatttctcatttttcacgtttttcagtgatttcatcatttttcaagtcgtcaagtgtatgtttcttattttcaatgattttcatttttcttgccttattccacgtcctatagtggacatttctaaattttccacctttttcagtttttttcgccatatttcacgtcctaaagtgtgtatttctcattttctgtgattttcagttttctcaccatattccaggtcctacagtgtgcatttctcatttttcacgtttttcagtgatttcgtcatttttcaagttgtcaagtggaagtttctcattttccatgattttcagctttctagacatattccaggtcctacagtggacatttcctaattttcgacctttatcagttttcctcgtcatatttcacgtcccaaaatgtgtatttcttattttccatgattttcagtttcctcgccatattccaggtcctacagtgtgcaattctcatttttcacgtttttcagtgatttcgtcttttttcaagacgtcaagtggatgtttctcatttttcatgattttcagttttcttgccatattccatgtcctacagtggacatttctaaattttccacctttttctgttttcctcgccatatttcacgtcctaaagtgtgtatttctcattttccgtgattttcagttttcttgccatattcctggtcctacagtgtgcatttctcatttttcacgtttttcagtgattttgtcatttttcaatttgtcaactgcatgtttctcattttccattattttcagttttcttgccatattccatgtcctacagtggacatttctaaattttccacctttttctgttttcctcgccatatttcatgtcctaaagtgtgtatttctcattttccgtgattttcagttttcttgctatattccaagtcctacagtgtgcatttctcatttttcacgtttttcagtgattttgtcatttttcaatttgtcaactgcatgtttctcattttccatgattttcagtttttttgccatattccatgtcctacaggggaaatttctatattttccacctttttcagttttcctcgccatatttcatgtcctaaagtgtgtatttctcattttccgtgattttcagttttcttgccatattccaggtcctacagtgtgcatttctcatttttcacgtttttcagtgatttcgtcatttttcaagtcttcaagtagatgtttctcatattccatgtttttcagttttctcgccatattccaggtcctacagttgacatttctaaattttctacatttttaaattttcctcgccatatttcacgtcctaaagtgtgtatttctcatttttcgttattttcagttttctagccatattccaggtcctacaggatgcatttctcatttttcacgtttttcagtgatttcatcatttttcaagtcgtcaagtgtatgtttctcattttcaatgattttcatttttcttgccttattccacgtcctatagtggacatttctaaattttccacctttttcagtttttctcgccatatttcacgtcctaaagtgtgtatttctcattttctgtgattttcagttttctcaccatattccaggtcctacagtgtgcatttctcatttttcacgtttttcagtgatttcgtcatttttcaagttgtcaagtggaagtttctcattttccatgattttcagctttctagccatattccaggtcctacagtggacatttcctaattttcgacctttatcagttttcctcgccatatttcacgtcctaaagtgtgtatttctcattttccgtgattttcagttttcttgccatattccaggtcctacagtgtgcatttctcatttttcacgtttttcagtgattttgtcatttttcaatttgtcaactgcatgtttctcattttccatgatttttagttttcttgctatattccatgtcctacagtggaaatttctaaattttccacctttttcagttttcctcgccatatttcacgtcctaaagtgtgtatttctcattttccgtgattttcagttttcttgctatattccaagtcctacattgtgcatttctcatttttcacgtttttcagtgattttgtcatttttcaatttgtcaaaccacatgtttctcattttccatgattttcagtttttttgccatattccatgtcctacagtggaaatttctatattttccacctttttcagttttcctcgccatatttcacgtgctaaagtgtgtatttctcatttttcgtgtttttcaggtttctcgccatattccaggtcctacagtgtgcatttctcatttttcacgtttttcagtgattttgtcatttttcaagttgtcaagtggatgtttcccattttccttgattttcagttttcttaccatattccatgtcctacagtggacatttctaaattttccacctttttcagttttccttgccatatttcatgtcctaaagtgtgtatttctcattttcagtgattttcagtttcctcgccatattccaggtcctacagtgtgcatttctcattttttcacgtttttcagtgatttcgtcatttttcacgttgtcaagtggatgtttctcattttccatgattttcacttttcttgccatatttcatgtcctatagtggacatttctaaattttccacctttttcagtttttctcgccatatttcacgtcctaaagtgtgtatttctcattttctgtgattttcagttttctcaccatattccaggtcctacagtgtgcatttctcatttttcacgtttttcagtgatttcgtcatttttcaagtcgtcaagtagatgtttctcatattccatgtttttcagttttctcgccatattccaggtcctacagttgacatttctaaattttctacatttttaaattttcctcgccatatttcacgtcctaaagtgtgtatttctcatttttcgttattttcagttttctagccatattccaggtcctacaggatgcatttctcatttttcacgtttttcagtgatttcatcatttttcaagtcgtcaagtgtatgtttcttattttcaatgattttcatttttcttgccttattccacgtcctatagtggacatttctaaattttccaccttttttcagtttttctcgccatatttcacgtcctaaagtgtgtatttctcattttctgtgattatcagttttctcaccatattccaggtcctacagtgtgcatttctcatttttcacgtttttcagtgatttcgtcatttttcaagttgtcaagtggaagtttctcattttccatgattttcagctttctagccatattccaggtcctacagtggacatttcctaattttcgacctttatcagttttcctcgccatatttcacgtcccaaaatgtgtatttcttattttccatgattttcagtttcctcgccatattccaggtcctacagtgtgcatttctcatttttcacgtttttcagtgatttcgtcttttttcaagacgtcaagtggatgtttctcatttttcatgattttcagttttcttgccatattccatgtcctacagtggacatttctaaattttccacctttttctgttttcctcgccatatttcacgtcctaaagtgtgtatttctcattttccgtgattttcagttttcttgccatattcctggtcctacagtgtgcatttctcatttttcacgtttttcagtgattttgtcatttttcaatttgtcaactgcatgtttctcattttccatgattttcagttttcttgccatattccatgtcctacagtggacatttctaaattttccacctttttcagttttcctcgccatatttcacgtgctaaagtgtgtatttctcatttttcgtgtttttcaggtttctcgccatattccaggtcctacagtgtgcatttctcatttttcacgtttttcagtgattttgtcatttttcaagttgtcaagtggatgtttctcattttccttgattttcacttttcttgccatattccaagtcttacaggggcatttctcatttttcacgttttcagtgattttgtcattttcaatttgtcaactgcatgtttctcattttccatgattttcagtttttttgccatattccatgtcctacaggggaaatttctatattttccacctttttcagttttcctcgccatatttcatgtcctaaagtgtgtatttctcattttccgtgattttcagttttcttgccatattccaggtcctacagtgtgcatttctcatttttcacgtttttcagtgatttcgtcatttttcaagtcttcaagtagatgtttctcatattccatgtttttcagttttctcgccatattccaggtcctacagttgacatttctaaattttctacatttttaaattttcctcgccatatttcacgtcctaaagtgtgtatttctcatttttcgttattttcagttttctagccatattccaggtcctacaggatgcatttctcatttttcacgtttttcagtgatttcatcatttttcaagtcgtcaagtgtatgtttctcattttcaatgattttcatttttcttgccttattccacgtcctatagtggacatttctaaattttccacctttttcagtttttctcgccatatttcacgtcctaaagtgtgtatttctcattttctgtgattttcagttttctcaccatattccaggtcctacagtgtgcatttctcatttttcacgtttttcagtgatttcgtcatttttcaagttgtcaagtggaagtttctcattttccatgattttcagctttctagccatattccaagtcctacagtggacatttcctaattttcgacctttatcagttttcctcgccatatttcacgtcccaaaatgtgtattccttattttccatgattttcagtttcctcgccatattccaggtcctacagtgtgcatttatcatttttcacgtttttcagtgatttcgtcttttttcaagacgtcaagtggatgtttctcatttttcatgattttcagttttcttgccatattccatgtcctacagtggacatttctaaattttccacctttttctgttttcctcgccatatttcacgtcctaaagtgtgtatttctcattttccgtgattttcagttttcttgccatattcctggtcctacagtgtgcatttctcatttttcacgtttttcagtgattttgtcatttttcaagttgtcaagtggatgtttctcattttccttgattttcacttttcttgccatattccatgtcctacagtggacatttctatattttccacctttttccgttttccttgccatatttcacgtcctaaagtgtgtatttctcattttccgtgattttcaggtttctcgccatattccaggtcctacagtgtgcatttctcatttttcacgtttttcagtgattttgtcatttttcaagttgtcaagtggatgtttctcattttccttgattttcacttttcttgccatattccatgtcctacagtggacatttctaaattttccacctttttcagttttcctcgccatatttcatgtcctaaagtgtgtatttctcattttcagtgattttcagttttcttgccatattccaggtcctacagtgtgcatttctcatttttcacgtttttcagtgattttgtcatttttcaagttgtcaactgcatgtttctcattttctatgattttcagttttcttgctatattccatgtcctacagtggaaatttctaaattttccacctttttcagttttcctcgccatatttcacgtcctaaagtgtgtatttctcattttccgtgattttcagttttctcgccatattccaggtcctatgtgtacatttctcatttttcacgtttttcagtgattttgtcatttttcaagttgtgaagtggatgtttctcatttttcttgattttcatttttcttgccatattccatgtcctagagtggaaatttttaaattttccacctttttcagttttcctcgccatatttcacgtcctaaagtgtgaatttctcattttccgtgattttcagatttctcgccatattccaagtcctacagtgtgcatttctcatttttcacgtttttcagtgatttcgtcatttttcaagttgtcaagtggatgtttctcattttccatgattttcagctttcttgccatattcaaagtcctacagtggacatttctaaattttcgacctttatcagttttcctcgccatatttcatgtcccaaagtgtgtacttctcattttccgtgattttcagtttcctcgccatattctaggtcctacagtgtgcatttctcatttttcaggtttttcagtgatttcgtcttttttcaagtcgtcaagtggatgtttctcattttccatgattttcacttttcttgccatatttcatgtcctaaagtgtgtatttctcattttcagtgattttcagttttctcgctatattccaggtcctacagtgtgcatttctcattttttcacgtttttcagtgatttcgtcatttttcacgttgtcaagtggatgtttctcattttccatgattttcacttttcttgccatatttcatgtcctacagtggacatttctaaattttccacctttttctgttttcctcgccatatttcacatcctaaagtgtgtatttctcattttccgtgattttcagttttcttgccatattccaggtcctacagtgtgcatttctcatttttcacgtttttcagtgatttcgtcatttttcaagttgtcaagtggatgtttctcattttccttgattttcagttttcttgccatattccatgtcctactgtggacatttctaaattttccacctttttcagttttccttgccatatttcatgtcctaaagtgtgtatttctcattttcagtgattttcagttttctcgcaatattccaggtcctacagtgtgcatttctcattttttcaggtttttcagtgatttcgtcatttttcacgttgtcaagtggatgtttctcattttccatgattttcacttttcttgccatatttcatgtcctaaagtgtgtatttctcattttcagtgattttcagttttcctcgccatatttcacgtcccaaaatgtgtatttcttattttccatgattttcagtttcctcgccatattccaggtcctacagtgtgcatttctcatttttcacgtttttcagtgatttcgtcttttttcaagacgtcaagtggatgtttctcatttttcatgattttcagttttcttgccatattccatgtcctacagtggacatttctaaattttccacctttttctgttttcctcgccatatttcacgtcctaaagtgtgtatttctcattttccgtgattttcagttttcttgccatattcctggtcctacagtgtgcatttctcatttttcacgtttttcagtgattttgtcatttttcaatttgtcaactgcatgtttctcattttccatgattttcagttttcttgccatattccatgtcctacagtggacatttctaaattttccacctttttcagttttcctcgccatatttcacgtgctaaagtgtgtatttctcatttttcgtgtttttcaggtttctcgccatattccaggtcctacagtgtgcatttctcatttttcacgtttttcagtgattttgtcatttttcaagttgtcaagtggatgtttctcattttccttgattttcacttttcttgccatattccatgtcctacagtggacatttctaaattttccacctttttcagttttcctcgccatatttcatgtcctaaagtgtgtatttctcattttcagtgattttcagttttctcgccatattccaggtcctacagtgtgcatttctcatttttcacgtttttcagtgatttcgtcttttttcaagacgtcaagtggatgtttctcattttccatgattttcagttttcttgccatattccatgtcctacagtggacatttctaaattttccacctttttctgttttcctcgccatatttcacgtcctaaagtgtgtatttctcattttccgtgattttcagttttcttgccatattccaggtcctacagtgtgcatttctcatttttcacgtttttcagtgattttgtcatttttcaatttgtcaactgcatgtttctcattttccatgatttttagttttcttgctatattccatgtcctacagtggaaatttctaaattttccacctttttcagttttcctcgccatatttcacgtcctaaagtgtgtatttctcattttccgtgattttcagttttcttgctatattccaagtcctacattgtgcatttctcatttttcacgtttttcagtgattttgtcatttttcaatttgtcaaaccacatgtttctcattttccatgattttcagtttttttgccatattccatgtcctacagtggaaatttctatattttccacctttttcagttttcctcgccatatttcacgtgctaaagtgtgtatttctcatttttcgtgtttttcaggtttctcgccatattccaggtcctacagtgtgcatttctcatttttcacgtttttctgtgattttgtcatttttcaagttgtcaagtggatgtttctcattttccttgattttcagttttcttaccatattccatgtcctacagtggacatttctaaattttccaccttttctgttttcctcgccatatttcatgtcctaaagtgtgtatttctcattttccgtgattttcatttttcttgctatattccaagtcctacagtgtgcatttctcattttccatgattttcagttttcttgctatattccatgtcctacagtggaaatttctaaattttccacctttttcagttttcctcgccatatttcacgtcctaaagtgtgtatttctcattttccgtgattttcagttttttcgccatattacaggtcctatgtgtacatttctcatttttcacgtttttcagtgattttgtcatttttcaagttgtcaagtggatgtttctcatttttcttgattttcatttttcttgccatattccatgtcctacagtggaaatttctaaattttccacctttttcagttttcctcgccatatttcacgtcctaaagtgtgaatttctcattttccgtgattttcagttttctcgccatattccaggtctacagtgtgcatttctcatttttcacgttttcagtgattcgtcatttttcaagttgacaagtggatgtttctcattttccatgattttcagctttcttgccatattcaaagtcctacagtggacatttctaaattttcgacctttatcagttttcctcgccatatttcatgtcccaaagtgtgtacttctcattttccgtgattttcagttttcttgccatattccaagtcctacagtgtgcatttctcatttttcacgtttttcagtgattttgtcatttttcaatttgtcaactgcatgtttctcattttccatgattttcagttttcttgccatattccatgtcctacagtggaaatttctatattttccacctttttcagttttcctcgccatatttcacgtgctaaagtgtgtatttctcatttttcgtgtttttcaggtttctcgccatattccaggtcctacagtgtgcatttctcatttttcacgtttttcagtgattttgtcatttttcaagttgtcaagtggatgtttctcattttcaatgattttcatttttcttgccttattccacgtcctatagtggacatttctaaattttccacctttttcagtttttctcgccatatttcacgtcccaaaatgtgtattccttattttccatgattttcagtttcctcgccatattccaggtcctacagtgtgcatttctcatttttcacgtttttcagtgatttcgtcttttttcaagacgtcaagtggatgtttctcatttttcatgattttcagttttcttgccatattccctgtcctacagtggacatttctaaattttccacctttttctgttttcctcgccatatttcacgtcctaaagtgtgtatttctcattttccgtgattttcagttttctcgccagattccaggtcctacagtgtgcatttctcatttttcacgtttttcagtgattttgtcatttttcaatttgtcaactgcatgtttctctctttccatgattttcagttttcttgccatattccatgtcctacagtggacatttctaaattttccacctttttcagttttcctcgccatatttcacgtgctaaagtgtgtatttctcatttttcgtgtttttcaggtttctcgccatattccaggtcctacagtgtgcatttctcatttttcacgtttttcagtgattttgtcatttttcaagttgtcaagtggatgtttctcattttcaatgattttcatttttcttaccttattccacgtcctatagtggacatttctaaattttccacctttttcagtttttctcgccatatttcacgtcccaaaatgtgtattccttattttccatgattttcagtttcctcgccatattccaggtcctacagtgtgcatttctcatttttcacgtttttcagtgatttcgtcttttttcaagacgtcaagtggatgtttctcatttttcatgattttcagttttcttgccatattccctgtcctacagtggacatttctaaattttccacctttttctgttttcctcgccatatttcacgtcctaaagtgtgtatttctcattttccgtgattttcagttttctcgccagattccaggtcctacagtgtgcatttctcatttttcacgtttttcagtgatttcgtcatttttcaagtcttcaagtgtatgtttctcattttcaatgattttcatttttcttgccttattccacgtcctatagtggacatttctaaattttccacctttttcagtttttctcgccatatttcacgtcctaaagtgtgtatttctcattttctgtgattttcagttttcttaccatattccaggtcctacagtgtgcatttctcatttttcacgtttttcagtgatttcgtcatttttcaagttgtcaagtggaagtttctcattttccatgattttcagctttctagccatattccaggtattacagtggacatttccttattttcgacctttatcagttttcctcgccatatttcatgtcctaaagtgtgt	38399	1554	4%	7300	19%
9	3000001	3038400	Atcctacagtgtgcatttctcatttttcacgtttttcagtgatttcgtcatttttcaagtcatcaagtggctgtttctcattttccatgattttcagttttcttgccatattccttgtcctacagtggacatttctaaattttccacctttttcagttttccttgtcatatttcaggtcctacagtgtgtatttctcatttttcacgtttttcattgatttcgtcatttttcaagttgtcaagtgcatgtttctcattttccatgattttcagttttcttgccatattccatgtcctacaatggacatttctaaattttccaactttttcagttttcctcgccatatttcacgtcctaaagtgtgtatttctcattttccgtgattttcagttttctcgacatattccaggtcctacagtgtgcatttctcatttttcacgtttttcagtgatttcgtcatttttcacgtcgtcaagtggatgtttctcattttccatgattttcagttttcttgccatattccatgtcctacagtggacatttctaaattttccacctttttcagttttcctcgccatatttcacgtcctaaagtgtgtatttctcattttccgtgattttcagttttctcgacatattccaggtcttacagggtgcatttctcatttttcacgtttttcagtgatttcatcatttttcaagtcgtcaactgtatgtttctcattttcaatgattttcatttttcttgccatattccacgtcctatagtggacatttctaaattttccacctttttcagttttccttgccatatttcaggtcctacagtgtgcatttctcatttttcacgtttttcagtgatttcgtcatttttcaagtggtcaaatgcatgtttctcattttccatgattttcagttttcttgccatattccatgtcctacagtggacatttctaaattttccacctttttcagttttcctcgccatatttcacgtcctaaagtgtgtatttctcattttccgtgattttcagttttatcgccagattccaggtcctacggtgtgcatttttcatatttcacgtttttcagtgattttgtcatttttcaagttgtcaactgcatgtttctcattttccatgattttcagttttcttgccatattccatgtcctacagtggacatttctaaattttccacctttttcagttttcctcgccatatttcatgtcctaaagtgtgtatttctcattttcagtgattttctgttttctcgccatattccaggtcctacagtgtgcatttctcatttttcacgtttttcagtgatttcgtcatttttcaagttgtcaagtggatgtttctcattttccatgattttcagttttcttgccatattccatgtcctacaatggacatttctaaattttccacctttttcagttttcctcgccatatttcacgtcctaaagtgtgtatttctcattttccgtgattttcagttttctcgccatattccaggtcctatgtgtacatttctcatttttcacgtttttcagtgattttgtcatttttcaagttgtgaagtggatgtttctcatttttcttgattttcatttttcttgccatattccatgtcctagagtggaaatttttaaattttccacctttttcagttttcctcgccatatttcacgtcctaaagtgtgaatttctcattttccgtgattttcagttttctcgccatattccaagtcctacagtgtgcatttctcatttttcacgtttttcagtgatttcgtcatttttcaagttgtcaagtggatgtttctcattttccatgattttcagctttcttgccatattcaaagtcctacagtggacatttctaaattttcgacctttatcagttttcctcgccatatttcatgtcccaaagtgtgtacttctcattttccgtgattttcagtttcctcgccatattctaggtcctacagtgtgcatttctcatttttcaggtttttcagtgatttcgtcttttttcaagtcgtcaagtggatgtttctcattttccatgattttcagttttcttgccatattccatgtcctacagtggacatttctaaattttccaactttttcagttttcctcgccatatttcatgtcctaaagtgtgtatttctcattttcagtgattttcagttttctcgccatattccaggtcctacagtgtgcatttctcatttttcacgtttttcagtgatttcgtcatttttcaagttgtcaagtggatgtttctcatttttcatgattttcagttttcttgccatattccatgtcccacagtggacatttctaaatgttccacctttttctgttttccttgccatatttcatgtcctaaagtgtgtatttctcattttccgtgattttcagttttcttgctatattccaagtcctacagtgtgcatttctcatttttcacgtttttctgtgattttttcatttttcaatttgtcaactgcatgtttctcattttccatgattttcagttttcttgccatattccaggtcctacagtgtgcatttctcatttttcacgtttttcagtgattttgtcatttttcaagttgtcaactgcatgtttctcattttccatgattttcagttttcttgctatattccatgtcctacagtggaaatttctaaattttccacctttttcagttttcctcgccatatttcacgtcctaaagtgtgtatttctcattttccgtgattttcagttttctcgccatattccaggtcctatgtgtacatttctcatttttcacgtttttcagtgattttgtcatttttcaagttgtgaagtggatgtttctcatttttcttgattttcatttttcttgccatattccatgtcctagagtggaaatttttaaattttccacctttttcagttttcctcgccatatttcacgtcctaaattgtgaatttctcattttccgtgattttcagttttctcgccatattccaagtcctacagtgtgcatttctcatttttcacgtttttcagtgatttcgtcatttttcaagttgtcaagtggatgtttctcattttccatgattttcagctttcttgccatattcaaagtcctacagtggacatttctaaattttcgacctttatcagttttcctcgccatatttcatgtcccaaagtgtgtacttctcattttccgtgattttcagtttcctcgccatattctaggtcctacagtgtgcatttctcatttttcaggtttttcagtgatttcgtcttttttcaagtcgtcaagtggatgtttctcattttccatgattttcagttttcttgccatattccatgtcctacagtggacatttctaaattttccacctttttcagttttcctcgccatatttcatgtcctaaagtgtgtatttctcattttcagtgattttcagttttctcgccatattccaggtcctacagtgtgcatttctcatttttcacgtttttcagtgattttgtcatttttcaagttgtcaagtggatgtttctcattttccttgattttcagttttcttgccatattccatgtcctacagtggacatttctaaattttccacctttttcagttttccttgccatatttcatgtcctaaagtgtgtatttctcattttcagtgattttcagttttctcgccatattccaggtcctacagtgtgcatttctcattttttcaggtttttcagtgatttcgtcatttttcacgttgtcaagtggatgtttctcattttccatgattttcacttttcttgccatatttcatgtcctaaagtgtgtatttctcattttcagtgattttcagttttctcgccatattccaggtcctacagtgtgcatttctcattttttcacgtttttcagtgatttcgtcatttttcacgttgtcaagtggatgtttctcattttccattattttcacttttcttgccatatttcatgtcctacagtggacatttctaaattttccacctttttctgttttcctcgccatatttcacatcctaaagtgtgtatttctcattttccgtgattttcagttttcttgccatattccaggtcctacagtgtgcatttctcatttttcacgtttttcagtgatttcgtcatttttcaagtcgtcaagtggatgtttctcattttccatgattttcagttttctcgccatattccaggtcctacagttgacatttctaaattttccacattttttatgtttcctcgcgatatttcacatcctaaagtgtgtatttctcattttccgtgattttcagttttcttgccatattccaggtcctacagggtgcatttctcatttttcacgtttttcagtgatttcatcaatttcaagtcgtcaactgtatgtttctcattttcaatgattttcatttttcttgccatattccacgtcctatagtggacatttctacattttccacctttttcagttttcttcgccatatttcacgtcccaaagtgtgtatttctcattttccgtgattttcagtttcctcgccatattccaggtcctacagtgtgcatttctcatttttcacgtttttcagtgatttcgtcttttttcaagtcgtcaagtggatgtttctcattttccatgattttcagttttcttgccatattccatgtcctacagtggacatttctaaattttccacctttttctgttttcctcgccatatttcacgtcctaaagtgtgtatttctcatttaccgtgattttcagttttcttgctatattccaagtcctacagtgtgcatttctcatttttcacgtttttcactgattttgtcattgttcaagttgtcaactgcatgtttctcattttccatgattttcagttttcttgccatattccatgtcctacagtggaaatttctatattttccaactttttcagttttcctcgccatatttcacgtgctaaagtgtgtatttctcatttttcgtgtttttcaggtttctcgccatattccaggtcctacagtgtgcatttctcatttttcacgtttttcagtgattttgtaatttttcaagttgtcaagtggatgtttctcattttccttgattttcagttttcttgccatattccatgtcctactgtggacatttctaaattttccacctttttcagttttccttgccatatttcatgtcctaaagtgtgtatttctcattttcagtgattttcagttttctcgcaatattccaggtcctacagtgtgcatttctcattttttcaggtttttcagtgatttcgtcatttttcacgttgtcaagtggatgtttctcattttccatgattttcacttttcttgccatatttcatgtgctaaagtgtgtatttctcattttcagtgattttcagttttctgccatattccaggtcctacattgtgcatttctcattttttcacgtttttcagtgatttcgtcatttttcacgttgtcaagtggatgtttctcattttccatgattttcacttttcttgccatatttcatgttttacagtggacatttctaaattttccacctatttctgttttcctcgccatatttcacatcctaaagtgtgtatttctcattttccgtgattttcagttttctcgccatatgccaggtcatacagggtgcatttctcatttttcacgtttttcagtgatttcgtcatttttcacgtcgtcaagtggatgtttctcattttcaatgattttcatttttcttgccatattccacgtcctatagtggacatttctaaattttccacctttttcagttttccttgccatatttcaggtcctacagtgtgcatttctcttttttcacgtttttcagtgatttcgtcatttttcaagtggtcaagtgcatgtttctcattttccgtgattttcagttttcttgccatgttccaggtcctacagttgacgtttctaaaatttcactttttttaagttttcctcgccatatttcacttcctaaagtgtgtatttctcattttccgtgattttcagttttctcgccagattccaggtcctacagtgtgcatttttcatatttcacctttttcagtgattttgtcatttttcaagttgtcaactgcatgtttctcattttccatgattttcagttttcttgccatattccatgtcctactgtggacatttctaaattttccaactttttcagttttcctcgccatatttcatgtcctaaagtgtgtatttctcattttcagtgattttctgttttctcgccatattccaggtcctacagtgtgcatttctaatttttcacgtttttcagtgatttcgtcatttttcaagttgtcaagtggatgtttctcattttccatgattttcagttttcttgccatattccatgtcctacagtggacatttctaaattttccaactttttccattttcctcaccatatttcacgtcctaaagtgagtttttctcattttttgtgattttcagttttctcgacatattccaggtcctacagtgtgcatttctaattttttcttttttcagtgatttcgtcatttttcaagtggtcaagtgcatgtttctcattttccatgattttcagttttcttgccatattccatgtcctacaatggacatttctaaattttccaactttttcagttttcctcgccatatttcacgtcctaaagtgtgtatttctcattttccgtgattttcagttttctcgccatattccaggtcctacagtgtgcatttctcatttttcacgtttttcagtgatttcgtcatttttcaagttgtcaactgcatgtttctcattttccatgattttcagttttcttgccatattccatgtcttacagtggacatttttaaatttttcacatttttttaagttttcctccccatatttcacgttttaaagtgtgcatttctcattttcggtgattttcagttttctcgccagattccatgtcttacagtgtgcatttctcattttttcacgtttttcagtgatttcgtcatttttcaagtcgtcaagtggatgtttctcattttccatgattttcagttttcttgccatattccatgtcctacagtggaaatttctaaattttccacctttttcagttttccttgccatatttcaggtcctaaagtgtgtatttctcattttctgtgattttcagttttctcgccatattccaggtcctacagttgacatttctaaaatttccacattttttaagttttcctcgccatatttcacttcctaaagtgtgtatttctcattttccgtgattttcagttttctcgccatattccagatcctacagtgtacatttttcatttttcacgtttttcagtgattttgtcattttttagttgtcaactgcctgtttctcattttccatgattttcagttttcttgctatattccatgtcctacagtggaaatttctaaattttccacctttttcagttttcctcgccatatttcacgtcctaaagtgtgtatttctcattttccgtgattttcagttttctcgccatattccaggtcctatgtgtacatttctcatttttcacgtttttcagtgattttgtcatttttcaatttgtcaactgcatgtttctcattttccatgattttcagttttcttgccatattccatgtcctacagtggaaatttctatattttccaactttttcagttttcctcgccatatttcacgtgctaaagtgtgtatttctcatttttcgtgtttttcaggtttctcgccatattccaggtcctacagtgtgcatttctcatttttcacgtttttcagtgattttgtcatttttcaagttgtcaagtggatgtttctcattttccttgattttcagttttcttgccatattccatgtcctacagtggacatttctaaattttccacctttttcagttttccttgccatatttcatgtcctaaagtgtgtatttctcattttcagtgattttcagttttctcgccatattccaggtcctacagtgtgcatttctcattttttcaggtttttcagtgatttcgtcatttttcacgttgtcaagtggatgtttctcattttccatgattttcacttttcttgccatatttcatgtcctaaagtgtgtatttctcattttcagtgattttcagttttctcgctatattccaggtcctacagtgtgcatttctcattttttcacgtttttcagtgatttcgtcatttttcacgttgtcaagtggatgtttctcattttccatgattttcacttttcttgccatatttcatgtcctacaatggacatttctaaattttccacctttttctgttttcctcgccatatttcacatcctaaagtgtgtatttctcattttccgtgattttcagttttcttgccatattccaggtcctacagtgtgcatttctcatttttcacgtttttcagtgatttcgtcatttttcaagttgtcaagtggatgtttctcattttccttgattttcagttttcttgccatattccatgtcctactgtggacatttctaaattttccacctttttcagttttccttgccatatttcatgtcctaaagtgtgtatttctcattttcagtgattttcagttttctcgcaatattccaggtcctacagtgtgcatttctcattttttcaggtttttcagtgatttcgtcatttttcacgttgtcaagtggatgtttctcattttccatgattttcacttttcttgccatatttcatgtcctaaagtgtgtatttctcattttcagtgattttcagttttctgccatattccaggtcctacattgtgcatttctcattttttcacgtttttcagtgatttcgtcatttttcagttttctcgacatattccaggtcctacagtgtgcatttctaattttttcttttttcagtgatttcgtcatttttcaagttgtcaactgcatgtttctcattttccatgattttcagttttcttgccatattccatgtcttacagtggacatttttaaatttttcacatttttttaagttttcctccccatatttcacgttttaaagtgtgcatttctcattttcggtgattttcagttttctcgccagattccaggtcttacagtgtgcatttctcattttttcacgtttttcagtgatttcgtcatttttcaagtcgtcaagtggatgtttctcattttccatgattttcagttttcttgccatattccatgtcctacagtggaaatttctaaattttccacctttttcagttttccttgccatatttcaggtcctaaagtgtgtatttctcattttctgtgattttcagttttctcgccatattccaggtcctacagttgacatttctaaaatttccacattttttaagttttcctcgccatatttcacttcctaaagtgtgtatttctcattttccgtgattttcagttttctcgccatattccagatcctacagtgtgcatttttcatttttcacgtttttcagtgattttgtcattttttagttgtcaactgtctgtttctcattttccatgattttcagttttcttgccatattccatgtcctacactggacatttctaaattttccacctttttctgttttcctcgccatatttcacgtcctaaagtgtgtatttctcattttccgtgattttcagttttcttgccatattccaggtcctacagtgtgcatttctcatttttcacgtttttcagtgattttgtcatttttcaagttgtcaactgcatgtttctcattttctatgattttcagttttcttgctatattccatgtcctacagtggaaatttctaaattttccacctttttcagttttcctcgccatatttcacgtcctaaagtgtgtatttctcattttccgtgattttcagttttctcgccatattccaggtcctatgtgtacatttctcatttttcacgtttttcagtgattttgtcatttttcaagttgtgaagtggatgtttctcatttttcttgattttcatttttcttgccatattccatgtcctagagtggaaatttttaaattttccacctttttcagttttcctcgccatatttcacgtcctaaagtgtgaatttctcattttccgtgattttcagatttctcgccatattccaagtcctacagtgtgcatttctcatttttcacgtttttcagtgatttcgtcatttttcaagttgtcaagtggatgtttctcattttccatgattttcagctttcttgccatattcaaagtcctacagtggacatttctaaattttcgacctttatcagttttcctcgccatatttcatgtcccaaagtgtgtacttctcattttccgtgattttcagtttcctagccatattctaggtcctacagtgtgcatttctcatttttcaggtttttcagtgatttcgtcttttttcaagtcgtcaagtggatgtttctcattttccatgattttcacttttcttgccatatttcatgtcctaaagtgtgtatttctcattttcagtgattttcagttttctcgctatattccaggtcctacagtgtgcatttctcattttttcacgtttttcagtgatttcgtcatttttcacgttgtcaagtggatgtttctcattttccatgattttcacttttcttgccatatttcatgtcctacagtggacatttctaaattttccacctttttctgttttcctcgccatatttcacatcctaaagtgtgtatttctcattttccgtgattttcagttttcttgccatattccaggtcctacagtgtgcatttctcatttttcacgtttttcagtgatttcgtcatttttcaagttgtcaagtggatgtttctcattttccttgattttcagttttcttgccatattccatgtcctactgtggacatttctaaattttccacctttttcagttttccttgccatatttcatgtcctaaagtgtgtatttctcattttcagtgattttcagttttctcgcaatattccaggtcctacagtgtgcatttctcattttttcaggtttttcagtgatttcgtcatttttcacgttgtcaagtggatgtttctcattttccatgattttcacttttcttgccatatttcatgtcctaaagtgtgtatttctcattttcagtgattttcagttttctgccatattccaggtcctacattgtgcatttctcattttttcacgtttttcagtgatttcgtcatttttcacgttgtcaagtggatgtttctcattttccatgattttcacttttcttgccatatttcatgttttacagtggacatttctaaattttccacctttttctgttttcctcgccatatttcacatcctaaagtgtgtatttctcattttccgtgattttcagttttctcgccatatgccaggtcatacagggtgcatttctcatttttcacgtttttcagtgatttcgtcatttttcacgtcgtcaagtggatgtttctcattttcaatgattttcatttttcttgccatattccacgtcctatagtggacatttctaaattttccacctttttcagttttccttgccatatttcaggtcctacagtgtgcatttctcatttttcacgtttttcagtgatttcgtcatttttcaagtggtcaagtgcatgtttctcattttccgtgattttcagttttcttgccatgttccaggtcctacagttgacgtttctaaaatttcactttttttaagttttcctcgccatatttcacttcctaaagtgtgtatttctcattttccgtgattttcagttttctcgccagattccaggtcctacagtgtgcatttttcatatttcacctttttcagtgattttgtcatttttcaagttgtcaactgcatgtttctcattttccatgattttcagttttcttgccatattccatgtcctactgtggacatttctaaattttccaactttttcagttttcctcgccatatttcatgtcctaaagtgtgtatttctcattttcagtgattttctgttttctcgccatattccaggtcctacagtgtgcatttctaatttttcacgtttttcagtgatttcgtcatttttcaagttgtcaagtggatgtttctcattttccatgattttcagttttcttgccatattccatgtcctacagtggacatttctaaattttccaactttttccattttcctcaccatatttcacgtcctaaagtgtgtttttctcattttttgtgattttcagttttctcgacatattccaggtcctacagtgtgcatttctaattttttcttttttcagtgatttcgtcatttttcaagttgtcaactgcatgtttctcattttccatgattttcagttttcttgccatattccatgtcttacagtggacatttttaaatttttcacatttttttaagttttcctccccatatttcacgttttaaagtgtgcatttctcattttcggtgattttcagttttctcgccagattccaggtcttacagtgtgcatttctcattttttcacgtttttcagtgatttcgtcatttttcaagtcgtcaagtggatgtttctcattttccatgattttcagttttcttgccatattccatgtcctacagtggaaatttctaaattttccacctttttcagttttccttgccatatttcaggtcctaaagtgtgtatttctcattttctgtgattttcagttttctcgccatattccaggtcctacagttgacatttctaaaatttccacattttttaagttttcctcgccatatttcacttcctaaagtgtgtatttctcattttccgtgattttcagttttctcgccatattccagatcctacagtgtgcatttttcatttttcacgtttttcagtgattttgtcattttttagttgtcaactgtctgtttctcattttccatgattttcagttttcttgccatattccatgtcctacactggacatttctaaattttccacctttttctgttttcctcgccatatttcacgtcctaaagtgtgtatttctcattttccgtgattttcagttttcttgccatattccaggtcctacagtgtgcatttctcatttttcacgtttttcagtgattttgtcatttttcaagttgtcaactgcatgtttctcattttccatgattttcagttttcttgctatattccatgtcctacagtggaaatttctaaattttccacctttttcagttttcctcgccatatttcacgtcctaaagtgtgtatttctcattttccgtgattttcagttttctcgccatattccaggtcctatgtgtacatttctcatttttcacgtttttcagtgattttgtcatttttcaagttgtgaagtggatgtttctcatttttcttgattttcatttttcttgccatattccatgtcctagagtggaaatttttaaattttccacctttttcagttttcctcgccatatttcacgtcctaaagtgtgaatttctcattttccgtgattttcagatttctcgccatattccaagtcctacagtgtgcatttctcatttttcacgtttttcagtgatttcgtcatttttcaagttgtcaagtggatgtttctcattttccatgattttcagctttcttgccatattcaaagtcctacagtggacatttctaaattttcgacctttatcagttttcctcgccatatttcatgtcccaaagtgtgtacttctcattttccgtgattttcagtttcctcgccatattctaggtcctacagtgtgcatttctcatttttcaggtttttcagtgatttcgtcttttttcaagtcgtcaagtggatgtttctcattttccatgattttcagttttcttgccatattccatgtcctacagtggacatttctaaattttccacctttttcagttttcctcgccatatttcatgtcctaaagtgtgtatttctcattttcagtgattttcagttttctcgccatattccaggtcctacagtgtgcatttctcatttttcacgtttttcagtgatttcgtcatttttcaagttgtcaagtggatgtttctcattttccatgattttcagttttcttgccatattccatgtcccacagtggacatttctaaattttccacctttttctgttttccttgccatatttcatgtcctaaagtgtgtatttctcattttccgtgattttcagttttcttgctatattccaagtcctacagtgtgcatttctcatttttcacgtttttcagtgattttgtcatttttcaatttgtcaactgcatgtttctcattttccatgattttcagttttcttgccatattccatgtcctacagtggaaatttctatattttccaactttttcagttttcctcgccatatttcacgtgctaaagtgtgtatttctcatttttcgtgtttttcaggtttctcgccatattccaggtcctacagtgtgcatttctcatttttcacgtttttcagtgattttgtcatttttcaagttgtcaagtggatgtttctcattttccttgattttcagttttcttgccatattccatgtcctacagtggacatttctaaattttccacctttttcagttttccttgccatatttcatgtcctaaagtgtgtatttctcattttcagtgattttcagttttctcgccatattccaggtcctacagtgtgcatttctcattttttcaggtttttcagtgatttcgtcatttttcacgttgtcaagtggatgtttctcattttccatgattttcacttttcttgccatatttcatgtcctaaagtgtgtatttctcattttcagtgattttcagttttctcgctatattccaggtcctacagtgtgcatttctcattttttcacgtttttcagtgatttcgtcatttttcacgttgtcaagtggatgtttctcattttccatgattttcacttttcttgccatatttcatgtcctacagtggacatttctaaattttccacctttttctgttttcctcgccatatttcacatactaaagtgtgtatttctcattttccttgattttcagttttcttgccatattccaggtcctacagtgtgcatttctcatttttcacgtttttcagtgatttcgtcatttttcaagtcgtcaagtggatgtttctcattttccatgattttcagttttctcgccatattccaggtcctacagttgacatttctaaattttccacattttttaagtttcctcgcgatatttcacatcctaaagtgtgtatttctcattttccgtgattttcagttttcttgccatattccaggtcctacagggtgcatttctcatttttcacgtttttcagtgatttcatcaatttcaagtcgtcaactgtatgtttctcattttcaatgattttcatttttcttgccatattccatgtcctacagtggacatttctaaatttttcacctttttcagttttccttgccatatttcatgtcctaaagtgtgtatttctcattttcagtgattttcagttttctcgccatattccaggtcctacagtgtgcatttctcattttttcaggtttttcagtgatttcgtcatttttcacgttgtcaagtggatgtttctcattttccatgattttcacttttcttgccatatttcatgtcctaaagtgtgtatttctcattttcagtgattttcagttttctcgccatattccaggtcctacagtgtgcatttctcatttttcacgtttttcagtgatttcgtcatttttcaagttgtcaagtggatgtttctcattttccatgattttcacttttcttgccatattccatgtcccacagtggacatttctaaattttccacctttttctgttttcctcgccatatttcatgtcctaaagtgtgtatttctcattttccgtgattttcagttttcttgctatattccaagtcctacagtgtgcatttctcatttttcacgtttttcagtgattttgtcatttttcaatttgtcaactgcatgtttctcattttccatgattttcagttttcttgccatattccatgttctacagtggaaatttctatattttccaactttttcagttttcctcgccatatttcacgtgctaaagtgtgtatttctcatttttcgtgtttttcaggtttctcgccatattccaggtcctacagtgtgcatttctcatttttcacgtttttcagtgattttgtcatttttcaagttgtcaagtggatgtttctcattttccttgattttcagttttcttgccatattccatgtcctacagtggacatttctaaattttccacctttttcagttttccttgccatatttcatgtcctaaagtgtgtatttctcattttcagtgattttcagttttctcgccatattccaggtcctacagtgtgcatttctcattttttcaggtttttcagtgatttcgtcatttttcacgttgtcaagtggatgtttctcattttccatgattttcacttttcttgccatatttcatgtcctaaagtgtgtatttctcattttcagtgattttcagttttctcgctatattccaggtcctacagtgtgcatttctcattttttcacgttttgcagtgatttcgtcatttttcacgttgtcaagtggatgtttctcattttccatgattttcacttttcttgccatatttcatgtcctacagtggacatttctaaattttccacctttttctgttttcctcgccatatttcacatcctaaagtgtgtatttctcattttccgtgattttcagttttcttgccatattccaggtcctacagtgtgcatttctcatttttcacgtttttcagtgatttcgtcatttttcaagtcgtcaagtggatgtttctcattttccatgattttcagttttctcgccatattccaggtcctacagttgacatttctaaattttccacattttttaagtttcctcgcgatatttcacatcctaaagtgtgtatttctcattttccgtgattttcagttttcttgccatattccaggtcctacagggtgcatttctcatttttcacgtttttcagtgatttcatcaatttcaagtcgtcaactgtatgtttctcattttcaatgattttcatttttcttgccatattccatgtcctacagtggacatttctaaattttccacctttttcagttttccttgccatatttcatgtcctaaagtgtgtatttctcattttcagggattttcagttttctcgccatattccaggtcctacagtgtgcatttctcattttttcaggtttttcagtgatttcgtcatttttcacgttgtcaagtggatgtttctcattttccatgattttcacttttcttgccatatttcatgtcctaaagtgtgtatttctcattttcagtgattttcagttttctcgccatattccaggtcctacagtgtgcatttctcattttttcacgtttttcagtgatttcgtcatttttcacgttgtcaagtggatgtttctcattttccatgattttcacttttcttgccatatttcatgtcctacagtggacatttctaaattttccacctttttctgttttcctcgccatatttcacatcctaaagtgtgtatttctcattttccgtgattttcagttttcttgccatattccaggtcctacagtgtgcatttctcatttttcacgtttttcagtgatttcgtcatttttcaagtcgtcaagtggatgtttctcattttccatgattttcagttttctcgccatattccaggtcctacagttgacatttctaaattttccacattttttaagtttcctcgcgatatttcacatcctaaagtgtgtatttctcattttccgtgattttcagttttcttgccatattccaggtcctacagggtgcatttctcatttttcacgtttttcagtgatttcatcaatttcaagtcgtcaactgtatgtttctcattttcaatgattttcatttttcttgccatattccacgtcctatagtggacatttctaaattttccacctttttcagttttcttcgccatatttcacgtcccaaagtgtgtatttctcattttccgtgattttcagtttcctcgcaatattccaggtcctacagtgtgcatttctcatttttcacgtttttcagtgatttcgtcttttttcaagtcgtcaagtggatgtttctcattttccatgattttcagttttcttgccatattccatgtcctacagtggacatttctaaattttccacctttttctgttttcctcgccatatttcacgtcctaaagtgtgtatttctcattttccgtgattttcagttttcttgccatattccaggtcctacagtgtgcatttctcatttttcacgtttttcactgattttgtcattgttcaagttgtcaactgcatgtttctcattttccatgattttcaattttcttgccatattccatgtcctacagtggaaatttctatattttccaactttttcagttttcctcgccatatttcacgtgctaaagtgtgtatttctcatttttcgtgtttttcaggtttctcgccatattccaggtcctacagtgtgcatttctcatttttcacgtttttcagtgattttgtcatttttcaagttgtcaagtggttgtttctcattttccttgattttcagttttcttgccatattccatgtcctactgtggacatttctaaattttccacctttttcagttttccttgccatatttcatgtcctaaagtgtgtatttctcattttcagtgattttcagttttctcgcaatattccaggtcctacagtgtgcatttctcattttccgtgattttcagttttctcgccatatgccaggtcatacagggtgcatttctcatttttcacgtttttcagtgatttcgtcatttttcacgtcgtcaagtggatgtttctcattttcaatgattttcatttttcttgccatattccacgtcctatagtggacatttctaaattttccaactttttcagttttcttgccatatttcaggtcctacagtgtgcatttctcatttttcacgtttttcagtgatttcgtcatttttcaagtggtcaagtgcatgtttctgattttccgtgattttcagttttcttgccatgttccaggtcctacagttgacgtttctaaaatttcactttttttaagttttcctcgccatatttcacttcctaaagtgtgtatttctcattttccgtgattttcagttttctcgccagattccaggtcctacagtgtgcatttttcatatttcacctttttcagtgattttgtcatttttcaagttgtcaactgcatgtttctcattttccatgattttcagttttcttgccatattccatgtcctactgtggacatttctaaattttccaactttttcagttttcctcgccatatttcatgtcctaaagtgtgtatttctcattttcagtgtttttctgttttctcgccatattccaggtcctacagtgtgcatttctaatttttcacgtttttcagtgatttcgtcatttttcaagttgtcaagtggatgtttctcattttccatgattttcagttttcttgccatattccatgtcctacagtggacatttctaaattttccaactttttccattttcctcaccatatttcacgtcctaaagtgtgtttttctcattttttgtgattttcagttttctcgacatattccaggtcctacagtgtgcatttctaattttttcttttttcagtgatttcgtcatttttcaagtggtcaagtgcatgtttctcattttccatgattttcagttttcttgccatattccatgtcctacaatggacatttctaaattttccaactttttcagttttcctcgccatatttcacgtcctaaagtgtgtatttctcattttccgtgattttcagttttctcgccatattccaggtcctatgtgtacatttctcatttttcacgtttttcagtgattttgtcatttttcaagttgtgaagtggatgtttctcatttttcttgattttcatttttcttgccatattccatgtcctagagtggaaatttttaaattttccaactttttcagttttcctcgccatatttcacgtcctaaagtgtgtatttctcattttccgtgattttcagttttctcgccatattccaagtcctacagtgtgcatttctcatttttcacgtttttcagtgatttcgtcatttttcaagttgtcaagtggatgtttctcattttccatgattttcagctttcttgccatattcaaagtcctacagtggacatttctaaattttcgacctttatcagttttcctcgccatatttcatgtcccaaagtgtgtacttctcattttccgtgattttcagtttcctcgccatattctaggtcctacagtgtgcatttctcatttttcaggtttttcagtgatttcgtcttttttcaagtcgtcaagtggatgtttctcattttccatgattttcagttttcttgccatattccatgtcctacagtggacatttctaaattttccacctttttcagttttcctcgccatatttcatgtcctaaagtgtgtatttctcattttcagtgattttcagttttctcgccatattccaggtcctacagtgtgcatttctcatttttcacgtttttcagtgatttcgtcatttttcaagttgtcaagtggatgtttctcattttccatgattttcagttttcttgccatattccatgtcccacagtggacatttctaaattttccacctttttctgttttccttgccatatttcatgtcctaaagtgtgtatttctcattttccgtgattttcagttttcttgctatattccaagtcctacagtgtgcatttctcatttttcacgtttttaagtgattttgtcatttttcaatttgtcaactgcatgtttctcattttccatgattttcagttttcttgccatattccatgtcctacagtggaaatttctatattttccaactttttcagttttcctcgccatatttcacgtgctaaagtgtgtatttctcatttttcgtgtttttcaggtttctcgccatattccaggtcctacagtgtgcatttctcatttttcacgtttttcagtgattttgtcatttttcaagttgtcaagtggatgtttctcattttccttgattttcagttttcttgccatattccatgtcctacagtggacatttctaaattttccacctttttcagttttccttgccatatttcatgtcctaaagtgtgtatttctcattttcagtgattttcagttttctcgccatattccaggtcctacagtgtgcatttctcattttttcaggtttttcagtgatttcgtcatttttcacgttgtcaagtggatgtttctcattttccatgattttcacttttcttgccatatttcatgtcctaaagtgtgtatttctcattttcagtgattttcagttttctcgccatattccaggtcctacagtgtgcatttctcattttttcacgtttttcagtgatttcgtcatttttcacgttgtcaagtggatgtttctcattttccatgattttcacttttcttgccatatttcatgtcctacagtggacatttctaaattttccacctttttctgttttcctcgccatatttcacatcctaaagtgtgtatttctcattttccgtgattttcagttttcttgccatatttcaggtcctacagtgtgcatttctcatttttcacgtttttcagtgatttcgtcatttttcaagtcgtcaagaggatgtttctcattttccatgattttcagttttctcgccatattccaggtcctacagttgacatttctaaattttccacattttttaagtttcctcgcgatatttcacatcctaaagtgtgtatttctcattttccgtgattttcagttttcttgccatattccaggtcctacagggtgcatttctcatttttcacgtttttcagtgatttcatcaatttcaagtcgtcaactgtatgtttctcattttcaatgattttcatttttcttgccatattccacgtcctatagtggacatttctaaattttccacctttttctgttttcctcgccatatttcacgtcctaaagtgtgtatttctcattttccgtgattttcagttttcttgccatattccaggtcctacagtgtgcatttctcatttttcacgtttttcactgattttgtcattgttcaagttgtcaactgcatgtttctcattttccatgattttcagttttcttgccatattccatgtcctacagtggaaatttctatattttccacctttttcagttttcctcgccgtatttcatgtgctaaagtgtgtatttctcatttttcgtgtttttcaggtttctcgccatattccaggtcctacagtgtgcatttctcatttttcacgtttttcagtgattttgtcatttttcaagttgtcaactggatgtttctcattttccttgattttcagttttcttgccatattccatgtcctactgtggacatttctaaattttccacctttttcagttttccttgccatatttcatgtcctaaagtgtgtatttctcattttcagtgattttcagttttctcgcaatattccaggtcctacagtgtgcatttctcattttttcaggtttttcagtgatttcgtcatttttcacgttgtcaagtggatgtttctcattttccatgattttcacttttcttgccatatttcatgtcctaaagtgtgtatttctcattttcagtgattttcagttttctcgccatattccaggtcctacattgtgcatttctcattttttcacgtttttcagtgatttcgtcatttttcacgttgtcaagtggatgtttctcattttccatgattttcacttttcttgccatatttcatgttttacagtggacatttctaaattttccacctttttctgttttcctcgccatatttcacatcctaaagtgtgaatttctcattttccgtgattttcagttttcttgccatattccaggtcctacagtgtgcatttctcatttttcacgtttttcagtgatttcatcatttttcaagtcgtcaagtggatgtttctcattttccatgattttcagttttcttgccatattccatgtcctacagtggacatttctaaattttccacctttttctgttttcctcgccatatttcacgtcctaaagtgtgtatttctcattttccgtgattttcagttttcttgccatattccaggtcctacagtgtgcatttctcatttttcacgtttttcactgattttgtcatttttcaagttgtcaactgcatgtttctcattttccatgattttcagttttcttgctatattccatgtcctacagtggaaatttctaaattttccacctttttcagttttcctcgccatatttcacgtcctgaagtgtgtatttctcattttccgtgattttcagttttctcgccatattccaggtcctatgtgtacatttctcatttttcacgtttttcagtgattttgtcatttttcaagttgtgaagtggatgtttctcatttttcttgattttcatttttcttgccatattccatgtcctacagtggaaatttctaaattttccacctttttcagttttcctcgccatatttcacgtcctaaagtgtgtatttctcattttccgtgattttcagttttctcgccatattccaggtcctacagtgtgcatttctcatttttcacgtttttcagtgatttcgacatttttcaagttgtcaagtggatgtttctcattttccatgattttcagctttcttgccatattcaaagtcctacagtggacatttctaaattttcgacctttatcagttttcctcgccatatttcatgtcccaaagtgtgtacttctcattttccgtgattttcagtttcctcgccatattccaggtcctacagtgtgcatttctcatttttcacgtttttcagtgatttcgtcatttttcaagtcgtcaagtggatgtttctcattttccatgattttcagttttcttgccatattccatgtcctacagtggacatttctaaattttccacctttttctgttttcctcgccatatttcacgtcctaaagtgtgtatttctcattttccgtgattttcagttttcttgccatattccaggtcctacagtgtgcatttctcatttatcacgtttttcactgattttgtcatttttcaagttgtcaactgcatgtttctcattttccatgattttcagttttcttgctatattccatgtcctacagtggaatattctaaattttccacctttttcagttttcctcgccatatttcacgtcctgaagtgtgtatttctcattttccgtgattttcagttttctcgccatattccaggtcctatgtgtacatttctcatttttcacgtttttcagtgattttgtcatttttcaagttgtgaagtggatgtttctcatttttcttgattttcatttttcttgccatattccatgtcctacagtggaaatttctaaattttccacctttttcagttttcctcgccatatttcacgtcctaaagtgtgaatttctcattttccgtgattttcagttttctcgccatattccaggtcctacagtgtgcatttctcatttttcacgtttttcagtgatttcgacatttttcaagttgtcaagtggatgtttctcattttccatgattttcagctttcttgccatattcaaagtcctacagtggacatttctaaattttcgacctttatcagttttcctcgccatatttcatgtcccaaagtgtgtacttctcattttccgtgattttgagtttcctcgccatattccaggtcctacagtgtgcatttctcatttttcacgtttttcagtgatttcgtcttttttcaagttgtcaactgcatgtttctcattttccatgattttcagttttcttgccatattccatgtcctacagtggaaatttgtaaatttccacctttttcagttttcctcgccatatttcacgtcctaaagtatgtatttctcattttccgtgattttcagttttctcgccatattccaggtcctacagtgtgcatttctcatttttcacgtttttcagtgattttgtcattttttaagttttcaagtggatgtttctcattttccttgattttcagttttcttgccatattccatgtcctacagtggacatttctaaattttccacctttttcagttttcctcgccatatttcatgtcctaaagtgtgtatttctcattttcagtgattttcagttttctcgccatattccaggtcctacagtgtgcatttctcatttttcacgtttttcagtgatttcgtcatttttcaaggtgtcaagtggatgtttctcattttccatgattttcagttttcttgccatattccatgtcctacagtggacatttctaaattttccacctttttctgttttcctcgccatatttcatgtcctaaagtgtgtatttctcattttccgtgattttcagttttcttgctatattccaagtcctacagtgtgcatttctcatttttcacgtttttcagtgattttgtcatttttcaatttgtcaactgcatgtttctcattttccatgattttcagtttttttgccatattccatgtcctactgtggaaatttctatattttccacctttttcagttttcctcgccatatttcacgtgctaaagtgtgtatttctcatttttcgtgtttttcaggtttctcgccatattccaggtcctacagtgtgcatttctcatttttcacgtttttcagtgattttgtcatttttcaagttttcaagtggatgtttctcattttccttgattttcagttttcttgccatattccatgtcctacagtggacatttctaaattttccacctttttcagttttccttgccatatttcatgtcctaaagtgtgtatttctcattttcagtgattttcagtttccttgccatattccaggtcctacagtgtgcatttctcattttttcacgtttttcagtgatttcgtcatttttcacgttgtcaagtggatgtttctcattttccatgattttcacttttcttgccatatttcatgtcctacagtggacatttctaaattttccaactttttcaattttcctcgccatattttatgtcctaaagtgtgtatttctcatttttcgttattttcagttttcttgccatattccaggtcctacagtgtgcatttgtcatttttcacgtttttcagtgatttcgtcatttttcaagtcgtcaagtagatgtttctcatattccatgtttttcagttttctcgccatattccaggtcctacagttgacatttctaaattttctacatttttaaattttcctcgccatatttcacgtcctaaagtgtgtatttctcattttttgttattttcagttttctagccatattccaggtcctacaggatgcatttctcatttttcacgtttttcagtgatttcatcatttttcaagtcgtcaagtgtatgtttcttattttcaatgattttcatttttcttgccttattccacgtcctatagtggacatttctaaattttccacctttttcagtttttttcgccatatttcacgtcctaaagtgtgtatttctcattttctgtgattttcagttttctcaccatattccaggtcctacagtgtgcatttctcatttttcacgtttttcagtgatttcgtcatttttcaagttgtcaagtggaagtttctcattttccatgattttcagctttctagacatattccaggtcctacagtggacatttcctaattttcgacctttatcagttttcctcgtcatatttcacgtcccaaaatgtgtatttcttattttccatgattttcagtttcctcgccatattccaggtcctacagtgtgcaattctcatttttcacgtttttcagtgatttcgtcttttttcaagacgtcaagtggatgtttctcatttttcatgattttcagttttcttgccatattccatgtcctacagtggacatttctaaattttccacctttttctgttttcctcgccatatttcacgtcctaaagtgtgtatttctcattttccgtgattttcagttttcttgccatattcctggtcctacagtgtgcatttctcatttttcacgtttttcagtgattttgtcatttttcaatttgtcaactgcatgtttctcattttccattattttcagttttcttgccatattccatgtcctacagtggacatttctaaattttccacctttttctgttttcctcgccatatttcatgtcctaaagtgtgtatttctcattttccgtgattttcagttttcttgctatattccaagtcctacagtgtgcatttctcatttttcacgtttttcagtgattttgtcatttttcaatttgtcaactgcatgtttctcattttccatgattttcagtttttttgccatattccatgtcctacaggggaaatttctatattttccacctttttcagttttcctcgccatatttcatgtcctaaagtgtgtatttctcattttccgtgattttcagttttcttgccatattccaggtcctacagtgtgcatttctcatttttcacgtttttcagtgatttcgtcatttttcaagtcttcaagtagatgtttctcatattccatgtttttcagttttctcgccatattccaggtcctacagttgacatttctaaattttctacatttttaaattttcctcgccatatttcacgtcctaaagtgtgtatttctcatttttcgttattttcagttttctagccatattccaggtcctacaggatgcatttctcatttttcacgtttttcagtgatttcatcatttttcaagtcgtcaagtgtatgtttctcattttcaatgattttcatttttcttgccttattccacgtcctatagtggacatttctaaattttccacctttttcagtttttctcgccatatttcacgtcctaaagtgtgtatttctcattttctgtgattttcagttttctcaccatattccaggtcctacagtgtgcatttctcatttttcacgtttttcagtgatttcgtcatttttcaagttgtcaagtggaagtttctcattttccatgattttcagctttctagccatattccaggtcctacagtggacatttcctaattttcgacctttatcagttttcctcgccatatttcacgtcctaaagtgtgtatttctcattttccgtgattttcagttttcttgccatattccaggtcctacagtgtgcatttctcatttttcacgtttttcagtgattttgtcatttttcaatttgtcaactgcatgtttctcattttccatgatttttagttttcttgctatattccatgtcctacagtggaaatttctaaattttccacctttttcagttttcctcgccatatttcacgtcctaaagtgtgtatttctcattttccgtgattttcagttttcttgctatattccaagtcctacattgtgcatttctcatttttcacgtttttcagtgattttgtcatttttcaatttgtcaaaccacatgtttctcattttccatgattttcagtttttttgccatattccatgtcctacagtggaaatttctatattttccacctttttcagttttcctcgccatatttcacgtgctaaagtgtgtatttctcatttttcgtgtttttcaggtttctcgccatattccaggtcctacagtgtgcatttctcatttttcacgtttttcagtgattttgtcatttttcaagttgtcaagtggatgtttcccattttccttgattttcagttttcttaccatattccatgtcctacagtggacatttctaaattttccacctttttcagttttccttgccatatttcatgtcctaaagtgtgtatttctcattttcagtgattttcagtttcctcgccatattccaggtcctacagtgtgcatttctcattttttcacgtttttcagtgatttcgtcatttttcacgttgtcaagtggatgtttctcattttccatgattttcacttttcttgccatatttcatgtcctatagtggacatttctaaattttccacctttttcagtttttctcgccatatttcacgtcctaaagtgtgtatttctcattttctgtgattttcagttttctcaccatattccaggtcctacagtgtgcatttctcatttttcacgtttttcagtgatttcgtcatttttcaagtcgtcaagtagatgtttctcatattccatgtttttcagttttctcgccatattccaggtcctacagttgacatttctaaattttctacatttttaaattttcctcgccatatttcacgtcctaaagtgtgtatttctcatttttcgttattttcagttttctagccatattccaggtcctacaggatgcatttctcatttttcacgtttttcagtgatttcatcatttttcaagtcgtcaagtgtatgtttcttattttcaatgattttcatttttcttgccttattccacgtcctatagtggacatttctaaattttccaccttttttcagtttttctcgccatatttcacgtcctaaagtgtgtatttctcattttctgtgattatcagttttctcaccatattccaggtcctacagtgtgcatttctcatttttcacgtttttcagtgatttcgtcatttttcaagttgtcaagtggaagtttctcattttccatgattttcagctttctagccatattccaggtcctacagtggacatttcctaattttcgacctttatcagttttcctcgccatatttcacgtcccaaaatgtgtatttcttattttccatgattttcagtttcctcgccatattccaggtcctacagtgtgcatttctcatttttcacgtttttcagtgatttcgtcttttttcaagacgtcaagtggatgtttctcatttttcatgattttcagttttcttgccatattccatgtcctacagtggacatttctaaattttccacctttttctgttttcctcgccatatttcacgtcctaaagtgtgtatttctcattttccgtgattttcagttttcttgccatattcctggtcctacagtgtgcatttctcatttttcacgtttttcagtgattttgtcatttttcaatttgtcaactgcatgtttctcattttccatgattttcagttttcttgccatattccatgtcctacagtggacatttctaaattttccacctttttcagttttcctcgccatatttcacgtgctaaagtgtgtatttctcatttttcgtgtttttcaggtttctcgccatattccaggtcctacagtgtgcatttctcatttttcacgtttttcagtgattttgtcatttttcaagttgtcaagtggatgtttctcattttccttgattttcacttttcttgccatattccaagtcttacaggggcatttctcatttttcacgttttcagtgattttgtcattttcaatttgtcaactgcatgtttctcattttccatgattttcagtttttttgccatattccatgtcctacaggggaaatttctatattttccacctttttcagttttcctcgccatatttcatgtcctaaagtgtgtatttctcattttccgtgattttcagttttcttgccatattccaggtcctacagtgtgcatttctcatttttcacgtttttcagtgatttcgtcatttttcaagtcttcaagtagatgtttctcatattccatgtttttcagttttctcgccatattccaggtcctacagttgacatttctaaattttctacatttttaaattttcctcgccatatttcacgtcctaaagtgtgtatttctcatttttcgttattttcagttttctagccatattccaggtcctacaggatgcatttctcatttttcacgtttttcagtgatttcatcatttttcaagtcgtcaagtgtatgtttctcattttcaatgattttcatttttcttgccttattccacgtcctatagtggacatttctaaattttccacctttttcagtttttctcgccatatttcacgtcctaaagtgtgtatttctcattttctgtgattttcagttttctcaccatattccaggtcctacagtgtgcatttctcatttttcacgtttttcagtgatttcgtcatttttcaagttgtcaagtggaagtttctcattttccatgattttcagctttctagccatattccaagtcctacagtggacatttcctaattttcgacctttatcagttttcctcgccatatttcacgtcccaaaatgtgtattccttattttccatgattttcagtttcctcgccatattccaggtcctacagtgtgcatttatcatttttcacgtttttcagtgatttcgtcttttttcaagacgtcaagtggatgtttctcatttttcatgattttcagttttcttgccatattccatgtcctacagtggacatttctaaattttccacctttttctgttttcctcgccatatttcacgtcctaaagtgtgtatttctcattttccgtgattttcagttttcttgccatattcctggtcctacagtgtgcatttctcatttttcacgtttttcagtgattttgtcatttttcaagttgtcaagtggatgtttctcattttccttgattttcacttttcttgccatattccatgtcctacagtggacatttctatattttccacctttttccgttttccttgccatatttcacgtcctaaagtgtgtatttctcattttccgtgattttcaggtttctcgccatattccaggtcctacagtgtgcatttctcatttttcacgtttttcagtgattttgtcatttttcaagttgtcaagtggatgtttctcattttccttgattttcacttttcttgccatattccatgtcctacagtggacatttctaaattttccacctttttcagttttcctcgccatatttcatgtcctaaagtgtgtatttctcattttcagtgattttcagttttcttgccatattccaggtcctacagtgtgcatttctcatttttcacgtttttcagtgattttgtcatttttcaagttgtcaactgcatgtttctcattttctatgattttcagttttcttgctatattccatgtcctacagtggaaatttctaaattttccacctttttcagttttcctcgccatatttcacgtcctaaagtgtgtatttctcattttccgtgattttcagttttctcgccatattccaggtcctatgtgtacatttctcatttttcacgtttttcagtgattttgtcatttttcaagttgtgaagtggatgtttctcatttttcttgattttcatttttcttgccatattccatgtcctagagtggaaatttttaaattttccacctttttcagttttcctcgccatatttcacgtcctaaagtgtgaatttctcattttccgtgattttcagatttctcgccatattccaagtcctacagtgtgcatttctcatttttcacgtttttcagtgatttcgtcatttttcaagttgtcaagtggatgtttctcattttccatgattttcagctttcttgccatattcaaagtcctacagtggacatttctaaattttcgacctttatcagttttcctcgccatatttcatgtcccaaagtgtgtacttctcattttccgtgattttcagtttcctcgccatattctaggtcctacagtgtgcatttctcatttttcaggtttttcagtgatttcgtcttttttcaagtcgtcaagtggatgtttctcattttccatgattttcacttttcttgccatatttcatgtcctaaagtgtgtatttctcattttcagtgattttcagttttctcgctatattccaggtcctacagtgtgcatttctcattttttcacgtttttcagtgatttcgtcatttttcacgttgtcaagtggatgtttctcattttccatgattttcacttttcttgccatatttcatgtcctacagtggacatttctaaattttccacctttttctgttttcctcgccatatttcacatcctaaagtgtgtatttctcattttccgtgattttcagttttcttgccatattccaggtcctacagtgtgcatttctcatttttcacgtttttcagtgatttcgtcatttttcaagttgtcaagtggatgtttctcattttccttgattttcagttttcttgccatattccatgtcctactgtggacatttctaaattttccacctttttcagttttccttgccatatttcatgtcctaaagtgtgtatttctcattttcagtgattttcagttttctcgcaatattccaggtcctacagtgtgcatttctcattttttcaggtttttcagtgatttcgtcatttttcacgttgtcaagtggatgtttctcattttccatgattttcacttttcttgccatatttcatgtcctaaagtgtgtatttctcattttcagtgattttcagttttcctcgccatatttcacgtcccaaaatgtgtatttcttattttccatgattttcagtttcctcgccatattccaggtcctacagtgtgcatttctcatttttcacgtttttcagtgatttcgtcttttttcaagacgtcaagtggatgtttctcatttttcatgattttcagttttcttgccatattccatgtcctacagtggacatttctaaattttccacctttttctgttttcctcgccatatttcacgtcctaaagtgtgtatttctcattttccgtgattttcagttttcttgccatattcctggtcctacagtgtgcatttctcatttttcacgtttttcagtgattttgtcatttttcaatttgtcaactgcatgtttctcattttccatgattttcagttttcttgccatattccatgtcctacagtggacatttctaaattttccacctttttcagttttcctcgccatatttcacgtgctaaagtgtgtatttctcatttttcgtgtttttcaggtttctcgccatattccaggtcctacagtgtgcatttctcatttttcacgtttttcagtgattttgtcatttttcaagttgtcaagtggatgtttctcattttccttgattttcacttttcttgccatattccatgtcctacagtggacatttctaaattttccacctttttcagttttcctcgccatatttcatgtcctaaagtgtgtatttctcattttcagtgattttcagttttctcgccatattccaggtcctacagtgtgcatttctcatttttcacgtttttcagtgatttcgtcttttttcaagacgtcaagtggatgtttctcattttccatgattttcagttttcttgccatattccatgtcctacagtggacatttctaaattttccacctttttctgttttcctcgccatatttcacgtcctaaagtgtgtatttctcattttccgtgattttcagttttcttgccatattccaggtcctacagtgtgcatttctcatttttcacgtttttcagtgattttgtcatttttcaatttgtcaactgcatgtttctcattttccatgatttttagttttcttgctatattccatgtcctacagtggaaatttctaaattttccacctttttcagttttcctcgccatatttcacgtcctaaagtgtgtatttctcattttccgtgattttcagttttcttgctatattccaagtcctacattgtgcatttctcatttttcacgtttttcagtgattttgtcatttttcaatttgtcaaaccacatgtttctcattttccatgattttcagtttttttgccatattccatgtcctacagtggaaatttctatattttccacctttttcagttttcctcgccatatttcacgtgctaaagtgtgtatttctcatttttcgtgtttttcaggtttctcgccatattccaggtcctacagtgtgcatttctcatttttcacgtttttctgtgattttgtcatttttcaagttgtcaagtggatgtttctcattttccttgattttcagttttcttaccatattccatgtcctacagtggacatttctaaattttccaccttttctgttttcctcgccatatttcatgtcctaaagtgtgtatttctcattttccgtgattttcatttttcttgctatattccaagtcctacagtgtgcatttctcattttccatgattttcagttttcttgctatattccatgtcctacagtggaaatttctaaattttccacctttttcagttttcctcgccatatttcacgtcctaaagtgtgtatttctcattttccgtgattttcagttttttcgccatattacaggtcctatgtgtacatttctcatttttcacgtttttcagtgattttgtcatttttcaagttgtcaagtggatgtttctcatttttcttgattttcatttttcttgccatattccatgtcctacagtggaaatttctaaattttccacctttttcagttttcctcgccatatttcacgtcctaaagtgtgaatttctcattttccgtgattttcagttttctcgccatattccaggtctacagtgtgcatttctcatttttcacgttttcagtgattcgtcatttttcaagttgacaagtggatgtttctcattttccatgattttcagctttcttgccatattcaaagtcctacagtggacatttctaaattttcgacctttatcagttttcctcgccatatttcatgtcccaaagtgtgtacttctcattttccgtgattttcagttttcttgccatattccaagtcctacagtgtgcatttctcatttttcacgtttttcagtgattttgtcatttttcaatttgtcaactgcatgtttctcattttccatgattttcagttttcttgccatattccatgtcctacagtggaaatttctatattttccacctttttcagttttcctcgccatatttcacgtgctaaagtgtgtatttctcatttttcgtgtttttcaggtttctcgccatattccaggtcctacagtgtgcatttctcatttttcacgtttttcagtgattttgtcatttttcaagttgtcaagtggatgtttctcattttcaatgattttcatttttcttgccttattccacgtcctatagtggacatttctaaattttccacctttttcagtttttctcgccatatttcacgtcccaaaatgtgtattccttattttccatgattttcagtttcctcgccatattccaggtcctacagtgtgcatttctcatttttcacgtttttcagtgatttcgtcttttttcaagacgtcaagtggatgtttctcatttttcatgattttcagttttcttgccatattccctgtcctacagtggacatttctaaattttccacctttttctgttttcctcgccatatttcacgtcctaaagtgtgtatttctcattttccgtgattttcagttttctcgccagattccaggtcctacagtgtgcatttctcatttttcacgtttttcagtgattttgtcatttttcaatttgtcaactgcatgtttctctctttccatgattttcagttttcttgccatattccatgtcctacagtggacatttctaaattttccacctttttcagttttcctcgccatatttcacgtgctaaagtgtgtatttctcatttttcgtgtttttcaggtttctcgccatattccaggtcctacagtgtgcatttctcatttttcacgtttttcagtgattttgtcatttttcaagttgtcaagtggatgtttctcattttcaatgattttcatttttcttaccttattccacgtcctatagtggacatttctaaattttccacctttttcagtttttctcgccatatttcacgtcccaaaatgtgtattccttattttccatgattttcagtttcctcgccatattccaggtcctacagtgtgcatttctcatttttcacgtttttcagtgatttcgtcttttttcaagacgtcaagtggatgtttctcatttttcatgattttcagttttcttgccatattccctgtcctacagtggacatttctaaattttccacctttttctgttttcctcgccatatttcacgtcctaaagtgtgtatttctcattttccgtgattttcagttttctcgccagattccaggtcctacagtgtgcatttctcatttttcacgtttttcagtgatttcgtcatttttcaagtcttcaagtgtatgtttctcattttcaatgattttcatttttcttgccttattccacgtcctatagtggacatttctaaattttccacctttttcagtttttctcgccatatttcacgtcctaaagtgtgtatttctcattttctgtgattttcagttttcttaccatattccaggtcctacagtgtgcatttctcatttttcacgtttttcagtgatttcgtcatttttcaagttgtcaagtggaagtttctcattttccatgattttcagctttctagccatattccaggtattacagtggacatttccttattttcgacctttatcagttttcctcgccatatttcatgtcctaaagtgtgt	38399	1554	4%	7300	19%
9	3000001	3038400	Atcctacagtgtgcatttctcatttttcacgtttttcagtgatttcgtcatttttcaagtcatcaagtggctgtttctcattttccatgattttcagttttcttgccatattccttgtcctacagtggacatttctaaattttccacctttttcagttttccttgtcatatttcaggtcctacagtgtgtatttctcatttttcacgtttttcattgatttcgtcatttttcaagttgtcaagtgcatgtttctcattttccatgattttcagttttcttgccatattccatgtcctacaatggacatttctaaattttccaactttttcagttttcctcgccatatttcacgtcctaaagtgtgtatttctcattttccgtgattttcagttttctcgacatattccaggtcctacagtgtgcatttctcatttttcacgtttttcagtgatttcgtcatttttcacgtcgtcaagtggatgtttctcattttccatgattttcagttttcttgccatattccatgtcctacagtggacatttctaaattttccacctttttcagttttcctcgccatatttcacgtcctaaagtgtgtatttctcattttccgtgattttcagttttctcgacatattccaggtcttacagggtgcatttctcatttttcacgtttttcagtgatttcatcatttttcaagtcgtcaactgtatgtttctcattttcaatgattttcatttttcttgccatattccacgtcctatagtggacatttctaaattttccacctttttcagttttccttgccatatttcaggtcctacagtgtgcatttctcatttttcacgtttttcagtgatttcgtcatttttcaagtggtcaaatgcatgtttctcattttccatgattttcagttttcttgccatattccatgtcctacagtggacatttctaaattttccacctttttcagttttcctcgccatatttcacgtcctaaagtgtgtatttctcattttccgtgattttcagttttatcgccagattccaggtcctacggtgtgcatttttcatatttcacgtttttcagtgattttgtcatttttcaagttgtcaactgcatgtttctcattttccatgattttcagttttcttgccatattccatgtcctacagtggacatttctaaattttccacctttttcagttttcctcgccatatttcatgtcctaaagtgtgtatttctcattttcagtgattttctgttttctcgccatattccaggtcctacagtgtgcatttctcatttttcacgtttttcagtgatttcgtcatttttcaagttgtcaagtggatgtttctcattttccatgattttcagttttcttgccatattccatgtcctacaatggacatttctaaattttccacctttttcagttttcctcgccatatttcacgtcctaaagtgtgtatttctcattttccgtgattttcagttttctcgccatattccaggtcctatgtgtacatttctcatttttcacgtttttcagtgattttgtcatttttcaagttgtgaagtggatgtttctcatttttcttgattttcatttttcttgccatattccatgtcctagagtggaaatttttaaattttccacctttttcagttttcctcgccatatttcacgtcctaaagtgtgaatttctcattttccgtgattttcagttttctcgccatattccaagtcctacagtgtgcatttctcatttttcacgtttttcagtgatttcgtcatttttcaagttgtcaagtggatgtttctcattttccatgattttcagctttcttgccatattcaaagtcctacagtggacatttctaaattttcgacctttatcagttttcctcgccatatttcatgtcccaaagtgtgtacttctcattttccgtgattttcagtttcctcgccatattctaggtcctacagtgtgcatttctcatttttcaggtttttcagtgatttcgtcttttttcaagtcgtcaagtggatgtttctcattttccatgattttcagttttcttgccatattccatgtcctacagtggacatttctaaattttccaactttttcagttttcctcgccatatttcatgtcctaaagtgtgtatttctcattttcagtgattttcagttttctcgccatattccaggtcctacagtgtgcatttctcatttttcacgtttttcagtgatttcgtcatttttcaagttgtcaagtggatgtttctcatttttcatgattttcagttttcttgccatattccatgtcccacagtggacatttctaaatgttccacctttttctgttttccttgccatatttcatgtcctaaagtgtgtatttctcattttccgtgattttcagttttcttgctatattccaagtcctacagtgtgcatttctcatttttcacgtttttctgtgattttttcatttttcaatttgtcaactgcatgtttctcattttccatgattttcagttttcttgccatattccaggtcctacagtgtgcatttctcatttttcacgtttttcagtgattttgtcatttttcaagttgtcaactgcatgtttctcattttccatgattttcagttttcttgctatattccatgtcctacagtggaaatttctaaattttccacctttttcagttttcctcgccatatttcacgtcctaaagtgtgtatttctcattttccgtgattttcagttttctcgccatattccaggtcctatgtgtacatttctcatttttcacgtttttcagtgattttgtcatttttcaagttgtgaagtggatgtttctcatttttcttgattttcatttttcttgccatattccatgtcctagagtggaaatttttaaattttccacctttttcagttttcctcgccatatttcacgtcctaaattgtgaatttctcattttccgtgattttcagttttctcgccatattccaagtcctacagtgtgcatttctcatttttcacgtttttcagtgatttcgtcatttttcaagttgtcaagtggatgtttctcattttccatgattttcagctttcttgccatattcaaagtcctacagtggacatttctaaattttcgacctttatcagttttcctcgccatatttcatgtcccaaagtgtgtacttctcattttccgtgattttcagtttcctcgccatattctaggtcctacagtgtgcatttctcatttttcaggtttttcagtgatttcgtcttttttcaagtcgtcaagtggatgtttctcattttccatgattttcagttttcttgccatattccatgtcctacagtggacatttctaaattttccacctttttcagttttcctcgccatatttcatgtcctaaagtgtgtatttctcattttcagtgattttcagttttctcgccatattccaggtcctacagtgtgcatttctcatttttcacgtttttcagtgattttgtcatttttcaagttgtcaagtggatgtttctcattttccttgattttcagttttcttgccatattccatgtcctacagtggacatttctaaattttccacctttttcagttttccttgccatatttcatgtcctaaagtgtgtatttctcattttcagtgattttcagttttctcgccatattccaggtcctacagtgtgcatttctcattttttcaggtttttcagtgatttcgtcatttttcacgttgtcaagtggatgtttctcattttccatgattttcacttttcttgccatatttcatgtcctaaagtgtgtatttctcattttcagtgattttcagttttctcgccatattccaggtcctacagtgtgcatttctcattttttcacgtttttcagtgatttcgtcatttttcacgttgtcaagtggatgtttctcattttccattattttcacttttcttgccatatttcatgtcctacagtggacatttctaaattttccacctttttctgttttcctcgccatatttcacatcctaaagtgtgtatttctcattttccgtgattttcagttttcttgccatattccaggtcctacagtgtgcatttctcatttttcacgtttttcagtgatttcgtcatttttcaagtcgtcaagtggatgtttctcattttccatgattttcagttttctcgccatattccaggtcctacagttgacatttctaaattttccacattttttatgtttcctcgcgatatttcacatcctaaagtgtgtatttctcattttccgtgattttcagttttcttgccatattccaggtcctacagggtgcatttctcatttttcacgtttttcagtgatttcatcaatttcaagtcgtcaactgtatgtttctcattttcaatgattttcatttttcttgccatattccacgtcctatagtggacatttctacattttccacctttttcagttttcttcgccatatttcacgtcccaaagtgtgtatttctcattttccgtgattttcagtttcctcgccatattccaggtcctacagtgtgcatttctcatttttcacgtttttcagtgatttcgtcttttttcaagtcgtcaagtggatgtttctcattttccatgattttcagttttcttgccatattccatgtcctacagtggacatttctaaattttccacctttttctgttttcctcgccatatttcacgtcctaaagtgtgtatttctcatttaccgtgattttcagttttcttgctatattccaagtcctacagtgtgcatttctcatttttcacgtttttcactgattttgtcattgttcaagttgtcaactgcatgtttctcattttccatgattttcagttttcttgccatattccatgtcctacagtggaaatttctatattttccaactttttcagttttcctcgccatatttcacgtgctaaagtgtgtatttctcatttttcgtgtttttcaggtttctcgccatattccaggtcctacagtgtgcatttctcatttttcacgtttttcagtgattttgtaatttttcaagttgtcaagtggatgtttctcattttccttgattttcagttttcttgccatattccatgtcctactgtggacatttctaaattttccacctttttcagttttccttgccatatttcatgtcctaaagtgtgtatttctcattttcagtgattttcagttttctcgcaatattccaggtcctacagtgtgcatttctcattttttcaggtttttcagtgatttcgtcatttttcacgttgtcaagtggatgtttctcattttccatgattttcacttttcttgccatatttcatgtgctaaagtgtgtatttctcattttcagtgattttcagttttctgccatattccaggtcctacattgtgcatttctcattttttcacgtttttcagtgatttcgtcatttttcacgttgtcaagtggatgtttctcattttccatgattttcacttttcttgccatatttcatgttttacagtggacatttctaaattttccacctatttctgttttcctcgccatatttcacatcctaaagtgtgtatttctcattttccgtgattttcagttttctcgccatatgccaggtcatacagggtgcatttctcatttttcacgtttttcagtgatttcgtcatttttcacgtcgtcaagtggatgtttctcattttcaatgattttcatttttcttgccatattccacgtcctatagtggacatttctaaattttccacctttttcagttttccttgccatatttcaggtcctacagtgtgcatttctcttttttcacgtttttcagtgatttcgtcatttttcaagtggtcaagtgcatgtttctcattttccgtgattttcagttttcttgccatgttccaggtcctacagttgacgtttctaaaatttcactttttttaagttttcctcgccatatttcacttcctaaagtgtgtatttctcattttccgtgattttcagttttctcgccagattccaggtcctacagtgtgcatttttcatatttcacctttttcagtgattttgtcatttttcaagttgtcaactgcatgtttctcattttccatgattttcagttttcttgccatattccatgtcctactgtggacatttctaaattttccaactttttcagttttcctcgccatatttcatgtcctaaagtgtgtatttctcattttcagtgattttctgttttctcgccatattccaggtcctacagtgtgcatttctaatttttcacgtttttcagtgatttcgtcatttttcaagttgtcaagtggatgtttctcattttccatgattttcagttttcttgccatattccatgtcctacagtggacatttctaaattttccaactttttccattttcctcaccatatttcacgtcctaaagtgagtttttctcattttttgtgattttcagttttctcgacatattccaggtcctacagtgtgcatttctaattttttcttttttcagtgatttcgtcatttttcaagtggtcaagtgcatgtttctcattttccatgattttcagttttcttgccatattccatgtcctacaatggacatttctaaattttccaactttttcagttttcctcgccatatttcacgtcctaaagtgtgtatttctcattttccgtgattttcagttttctcgccatattccaggtcctacagtgtgcatttctcatttttcacgtttttcagtgatttcgtcatttttcaagttgtcaactgcatgtttctcattttccatgattttcagttttcttgccatattccatgtcttacagtggacatttttaaatttttcacatttttttaagttttcctccccatatttcacgttttaaagtgtgcatttctcattttcggtgattttcagttttctcgccagattccatgtcttacagtgtgcatttctcattttttcacgtttttcagtgatttcgtcatttttcaagtcgtcaagtggatgtttctcattttccatgattttcagttttcttgccatattccatgtcctacagtggaaatttctaaattttccacctttttcagttttccttgccatatttcaggtcctaaagtgtgtatttctcattttctgtgattttcagttttctcgccatattccaggtcctacagttgacatttctaaaatttccacattttttaagttttcctcgccatatttcacttcctaaagtgtgtatttctcattttccgtgattttcagttttctcgccatattccagatcctacagtgtacatttttcatttttcacgtttttcagtgattttgtcattttttagttgtcaactgcctgtttctcattttccatgattttcagttttcttgctatattccatgtcctacagtggaaatttctaaattttccacctttttcagttttcctcgccatatttcacgtcctaaagtgtgtatttctcattttccgtgattttcagttttctcgccatattccaggtcctatgtgtacatttctcatttttcacgtttttcagtgattttgtcatttttcaatttgtcaactgcatgtttctcattttccatgattttcagttttcttgccatattccatgtcctacagtggaaatttctatattttccaactttttcagttttcctcgccatatttcacgtgctaaagtgtgtatttctcatttttcgtgtttttcaggtttctcgccatattccaggtcctacagtgtgcatttctcatttttcacgtttttcagtgattttgtcatttttcaagttgtcaagtggatgtttctcattttccttgattttcagttttcttgccatattccatgtcctacagtggacatttctaaattttccacctttttcagttttccttgccatatttcatgtcctaaagtgtgtatttctcattttcagtgattttcagttttctcgccatattccaggtcctacagtgtgcatttctcattttttcaggtttttcagtgatttcgtcatttttcacgttgtcaagtggatgtttctcattttccatgattttcacttttcttgccatatttcatgtcctaaagtgtgtatttctcattttcagtgattttcagttttctcgctatattccaggtcctacagtgtgcatttctcattttttcacgtttttcagtgatttcgtcatttttcacgttgtcaagtggatgtttctcattttccatgattttcacttttcttgccatatttcatgtcctacaatggacatttctaaattttccacctttttctgttttcctcgccatatttcacatcctaaagtgtgtatttctcattttccgtgattttcagttttcttgccatattccaggtcctacagtgtgcatttctcatttttcacgtttttcagtgatttcgtcatttttcaagttgtcaagtggatgtttctcattttccttgattttcagttttcttgccatattccatgtcctactgtggacatttctaaattttccacctttttcagttttccttgccatatttcatgtcctaaagtgtgtatttctcattttcagtgattttcagttttctcgcaatattccaggtcctacagtgtgcatttctcattttttcaggtttttcagtgatttcgtcatttttcacgttgtcaagtggatgtttctcattttccatgattttcacttttcttgccatatttcatgtcctaaagtgtgtatttctcattttcagtgattttcagttttctgccatattccaggtcctacattgtgcatttctcattttttcacgtttttcagtgatttcgtcatttttcagttttctcgacatattccaggtcctacagtgtgcatttctaattttttcttttttcagtgatttcgtcatttttcaagttgtcaactgcatgtttctcattttccatgattttcagttttcttgccatattccatgtcttacagtggacatttttaaatttttcacatttttttaagttttcctccccatatttcacgttttaaagtgtgcatttctcattttcggtgattttcagttttctcgccagattccaggtcttacagtgtgcatttctcattttttcacgtttttcagtgatttcgtcatttttcaagtcgtcaagtggatgtttctcattttccatgattttcagttttcttgccatattccatgtcctacagtggaaatttctaaattttccacctttttcagttttccttgccatatttcaggtcctaaagtgtgtatttctcattttctgtgattttcagttttctcgccatattccaggtcctacagttgacatttctaaaatttccacattttttaagttttcctcgccatatttcacttcctaaagtgtgtatttctcattttccgtgattttcagttttctcgccatattccagatcctacagtgtgcatttttcatttttcacgtttttcagtgattttgtcattttttagttgtcaactgtctgtttctcattttccatgattttcagttttcttgccatattccatgtcctacactggacatttctaaattttccacctttttctgttttcctcgccatatttcacgtcctaaagtgtgtatttctcattttccgtgattttcagttttcttgccatattccaggtcctacagtgtgcatttctcatttttcacgtttttcagtgattttgtcatttttcaagttgtcaactgcatgtttctcattttctatgattttcagttttcttgctatattccatgtcctacagtggaaatttctaaattttccacctttttcagttttcctcgccatatttcacgtcctaaagtgtgtatttctcattttccgtgattttcagttttctcgccatattccaggtcctatgtgtacatttctcatttttcacgtttttcagtgattttgtcatttttcaagttgtgaagtggatgtttctcatttttcttgattttcatttttcttgccatattccatgtcctagagtggaaatttttaaattttccacctttttcagttttcctcgccatatttcacgtcctaaagtgtgaatttctcattttccgtgattttcagatttctcgccatattccaagtcctacagtgtgcatttctcatttttcacgtttttcagtgatttcgtcatttttcaagttgtcaagtggatgtttctcattttccatgattttcagctttcttgccatattcaaagtcctacagtggacatttctaaattttcgacctttatcagttttcctcgccatatttcatgtcccaaagtgtgtacttctcattttccgtgattttcagtttcctagccatattctaggtcctacagtgtgcatttctcatttttcaggtttttcagtgatttcgtcttttttcaagtcgtcaagtggatgtttctcattttccatgattttcacttttcttgccatatttcatgtcctaaagtgtgtatttctcattttcagtgattttcagttttctcgctatattccaggtcctacagtgtgcatttctcattttttcacgtttttcagtgatttcgtcatttttcacgttgtcaagtggatgtttctcattttccatgattttcacttttcttgccatatttcatgtcctacagtggacatttctaaattttccacctttttctgttttcctcgccatatttcacatcctaaagtgtgtatttctcattttccgtgattttcagttttcttgccatattccaggtcctacagtgtgcatttctcatttttcacgtttttcagtgatttcgtcatttttcaagttgtcaagtggatgtttctcattttccttgattttcagttttcttgccatattccatgtcctactgtggacatttctaaattttccacctttttcagttttccttgccatatttcatgtcctaaagtgtgtatttctcattttcagtgattttcagttttctcgcaatattccaggtcctacagtgtgcatttctcattttttcaggtttttcagtgatttcgtcatttttcacgttgtcaagtggatgtttctcattttccatgattttcacttttcttgccatatttcatgtcctaaagtgtgtatttctcattttcagtgattttcagttttctgccatattccaggtcctacattgtgcatttctcattttttcacgtttttcagtgatttcgtcatttttcacgttgtcaagtggatgtttctcattttccatgattttcacttttcttgccatatttcatgttttacagtggacatttctaaattttccacctttttctgttttcctcgccatatttcacatcctaaagtgtgtatttctcattttccgtgattttcagttttctcgccatatgccaggtcatacagggtgcatttctcatttttcacgtttttcagtgatttcgtcatttttcacgtcgtcaagtggatgtttctcattttcaatgattttcatttttcttgccatattccacgtcctatagtggacatttctaaattttccacctttttcagttttccttgccatatttcaggtcctacagtgtgcatttctcatttttcacgtttttcagtgatttcgtcatttttcaagtggtcaagtgcatgtttctcattttccgtgattttcagttttcttgccatgttccaggtcctacagttgacgtttctaaaatttcactttttttaagttttcctcgccatatttcacttcctaaagtgtgtatttctcattttccgtgattttcagttttctcgccagattccaggtcctacagtgtgcatttttcatatttcacctttttcagtgattttgtcatttttcaagttgtcaactgcatgtttctcattttccatgattttcagttttcttgccatattccatgtcctactgtggacatttctaaattttccaactttttcagttttcctcgccatatttcatgtcctaaagtgtgtatttctcattttcagtgattttctgttttctcgccatattccaggtcctacagtgtgcatttctaatttttcacgtttttcagtgatttcgtcatttttcaagttgtcaagtggatgtttctcattttccatgattttcagttttcttgccatattccatgtcctacagtggacatttctaaattttccaactttttccattttcctcaccatatttcacgtcctaaagtgtgtttttctcattttttgtgattttcagttttctcgacatattccaggtcctacagtgtgcatttctaattttttcttttttcagtgatttcgtcatttttcaagttgtcaactgcatgtttctcattttccatgattttcagttttcttgccatattccatgtcttacagtggacatttttaaatttttcacatttttttaagttttcctccccatatttcacgttttaaagtgtgcatttctcattttcggtgattttcagttttctcgccagattccaggtcttacagtgtgcatttctcattttttcacgtttttcagtgatttcgtcatttttcaagtcgtcaagtggatgtttctcattttccatgattttcagttttcttgccatattccatgtcctacagtggaaatttctaaattttccacctttttcagttttccttgccatatttcaggtcctaaagtgtgtatttctcattttctgtgattttcagttttctcgccatattccaggtcctacagttgacatttctaaaatttccacattttttaagttttcctcgccatatttcacttcctaaagtgtgtatttctcattttccgtgattttcagttttctcgccatattccagatcctacagtgtgcatttttcatttttcacgtttttcagtgattttgtcattttttagttgtcaactgtctgtttctcattttccatgattttcagttttcttgccatattccatgtcctacactggacatttctaaattttccacctttttctgttttcctcgccatatttcacgtcctaaagtgtgtatttctcattttccgtgattttcagttttcttgccatattccaggtcctacagtgtgcatttctcatttttcacgtttttcagtgattttgtcatttttcaagttgtcaactgcatgtttctcattttccatgattttcagttttcttgctatattccatgtcctacagtggaaatttctaaattttccacctttttcagttttcctcgccatatttcacgtcctaaagtgtgtatttctcattttccgtgattttcagttttctcgccatattccaggtcctatgtgtacatttctcatttttcacgtttttcagtgattttgtcatttttcaagttgtgaagtggatgtttctcatttttcttgattttcatttttcttgccatattccatgtcctagagtggaaatttttaaattttccacctttttcagttttcctcgccatatttcacgtcctaaagtgtgaatttctcattttccgtgattttcagatttctcgccatattccaagtcctacagtgtgcatttctcatttttcacgtttttcagtgatttcgtcatttttcaagttgtcaagtggatgtttctcattttccatgattttcagctttcttgccatattcaaagtcctacagtggacatttctaaattttcgacctttatcagttttcctcgccatatttcatgtcccaaagtgtgtacttctcattttccgtgattttcagtttcctcgccatattctaggtcctacagtgtgcatttctcatttttcaggtttttcagtgatttcgtcttttttcaagtcgtcaagtggatgtttctcattttccatgattttcagttttcttgccatattccatgtcctacagtggacatttctaaattttccacctttttcagttttcctcgccatatttcatgtcctaaagtgtgtatttctcattttcagtgattttcagttttctcgccatattccaggtcctacagtgtgcatttctcatttttcacgtttttcagtgatttcgtcatttttcaagttgtcaagtggatgtttctcattttccatgattttcagttttcttgccatattccatgtcccacagtggacatttctaaattttccacctttttctgttttccttgccatatttcatgtcctaaagtgtgtatttctcattttccgtgattttcagttttcttgctatattccaagtcctacagtgtgcatttctcatttttcacgtttttcagtgattttgtcatttttcaatttgtcaactgcatgtttctcattttccatgattttcagttttcttgccatattccatgtcctacagtggaaatttctatattttccaactttttcagttttcctcgccatatttcacgtgctaaagtgtgtatttctcatttttcgtgtttttcaggtttctcgccatattccaggtcctacagtgtgcatttctcatttttcacgtttttcagtgattttgtcatttttcaagttgtcaagtggatgtttctcattttccttgattttcagttttcttgccatattccatgtcctacagtggacatttctaaattttccacctttttcagttttccttgccatatttcatgtcctaaagtgtgtatttctcattttcagtgattttcagttttctcgccatattccaggtcctacagtgtgcatttctcattttttcaggtttttcagtgatttcgtcatttttcacgttgtcaagtggatgtttctcattttccatgattttcacttttcttgccatatttcatgtcctaaagtgtgtatttctcattttcagtgattttcagttttctcgctatattccaggtcctacagtgtgcatttctcattttttcacgtttttcagtgatttcgtcatttttcacgttgtcaagtggatgtttctcattttccatgattttcacttttcttgccatatttcatgtcctacagtggacatttctaaattttccacctttttctgttttcctcgccatatttcacatactaaagtgtgtatttctcattttccttgattttcagttttcttgccatattccaggtcctacagtgtgcatttctcatttttcacgtttttcagtgatttcgtcatttttcaagtcgtcaagtggatgtttctcattttccatgattttcagttttctcgccatattccaggtcctacagttgacatttctaaattttccacattttttaagtttcctcgcgatatttcacatcctaaagtgtgtatttctcattttccgtgattttcagttttcttgccatattccaggtcctacagggtgcatttctcatttttcacgtttttcagtgatttcatcaatttcaagtcgtcaactgtatgtttctcattttcaatgattttcatttttcttgccatattccatgtcctacagtggacatttctaaatttttcacctttttcagttttccttgccatatttcatgtcctaaagtgtgtatttctcattttcagtgattttcagttttctcgccatattccaggtcctacagtgtgcatttctcattttttcaggtttttcagtgatttcgtcatttttcacgttgtcaagtggatgtttctcattttccatgattttcacttttcttgccatatttcatgtcctaaagtgtgtatttctcattttcagtgattttcagttttctcgccatattccaggtcctacagtgtgcatttctcatttttcacgtttttcagtgatttcgtcatttttcaagttgtcaagtggatgtttctcattttccatgattttcacttttcttgccatattccatgtcccacagtggacatttctaaattttccacctttttctgttttcctcgccatatttcatgtcctaaagtgtgtatttctcattttccgtgattttcagttttcttgctatattccaagtcctacagtgtgcatttctcatttttcacgtttttcagtgattttgtcatttttcaatttgtcaactgcatgtttctcattttccatgattttcagttttcttgccatattccatgttctacagtggaaatttctatattttccaactttttcagttttcctcgccatatttcacgtgctaaagtgtgtatttctcatttttcgtgtttttcaggtttctcgccatattccaggtcctacagtgtgcatttctcatttttcacgtttttcagtgattttgtcatttttcaagttgtcaagtggatgtttctcattttccttgattttcagttttcttgccatattccatgtcctacagtggacatttctaaattttccacctttttcagttttccttgccatatttcatgtcctaaagtgtgtatttctcattttcagtgattttcagttttctcgccatattccaggtcctacagtgtgcatttctcattttttcaggtttttcagtgatttcgtcatttttcacgttgtcaagtggatgtttctcattttccatgattttcacttttcttgccatatttcatgtcctaaagtgtgtatttctcattttcagtgattttcagttttctcgctatattccaggtcctacagtgtgcatttctcattttttcacgttttgcagtgatttcgtcatttttcacgttgtcaagtggatgtttctcattttccatgattttcacttttcttgccatatttcatgtcctacagtggacatttctaaattttccacctttttctgttttcctcgccatatttcacatcctaaagtgtgtatttctcattttccgtgattttcagttttcttgccatattccaggtcctacagtgtgcatttctcatttttcacgtttttcagtgatttcgtcatttttcaagtcgtcaagtggatgtttctcattttccatgattttcagttttctcgccatattccaggtcctacagttgacatttctaaattttccacattttttaagtttcctcgcgatatttcacatcctaaagtgtgtatttctcattttccgtgattttcagttttcttgccatattccaggtcctacagggtgcatttctcatttttcacgtttttcagtgatttcatcaatttcaagtcgtcaactgtatgtttctcattttcaatgattttcatttttcttgccatattccatgtcctacagtggacatttctaaattttccacctttttcagttttccttgccatatttcatgtcctaaagtgtgtatttctcattttcagggattttcagttttctcgccatattccaggtcctacagtgtgcatttctcattttttcaggtttttcagtgatttcgtcatttttcacgttgtcaagtggatgtttctcattttccatgattttcacttttcttgccatatttcatgtcctaaagtgtgtatttctcattttcagtgattttcagttttctcgccatattccaggtcctacagtgtgcatttctcattttttcacgtttttcagtgatttcgtcatttttcacgttgtcaagtggatgtttctcattttccatgattttcacttttcttgccatatttcatgtcctacagtggacatttctaaattttccacctttttctgttttcctcgccatatttcacatcctaaagtgtgtatttctcattttccgtgattttcagttttcttgccatattccaggtcctacagtgtgcatttctcatttttcacgtttttcagtgatttcgtcatttttcaagtcgtcaagtggatgtttctcattttccatgattttcagttttctcgccatattccaggtcctacagttgacatttctaaattttccacattttttaagtttcctcgcgatatttcacatcctaaagtgtgtatttctcattttccgtgattttcagttttcttgccatattccaggtcctacagggtgcatttctcatttttcacgtttttcagtgatttcatcaatttcaagtcgtcaactgtatgtttctcattttcaatgattttcatttttcttgccatattccacgtcctatagtggacatttctaaattttccacctttttcagttttcttcgccatatttcacgtcccaaagtgtgtatttctcattttccgtgattttcagtttcctcgcaatattccaggtcctacagtgtgcatttctcatttttcacgtttttcagtgatttcgtcttttttcaagtcgtcaagtggatgtttctcattttccatgattttcagttttcttgccatattccatgtcctacagtggacatttctaaattttccacctttttctgttttcctcgccatatttcacgtcctaaagtgtgtatttctcattttccgtgattttcagttttcttgccatattccaggtcctacagtgtgcatttctcatttttcacgtttttcactgattttgtcattgttcaagttgtcaactgcatgtttctcattttccatgattttcaattttcttgccatattccatgtcctacagtggaaatttctatattttccaactttttcagttttcctcgccatatttcacgtgctaaagtgtgtatttctcatttttcgtgtttttcaggtttctcgccatattccaggtcctacagtgtgcatttctcatttttcacgtttttcagtgattttgtcatttttcaagttgtcaagtggttgtttctcattttccttgattttcagttttcttgccatattccatgtcctactgtggacatttctaaattttccacctttttcagttttccttgccatatttcatgtcctaaagtgtgtatttctcattttcagtgattttcagttttctcgcaatattccaggtcctacagtgtgcatttctcattttccgtgattttcagttttctcgccatatgccaggtcatacagggtgcatttctcatttttcacgtttttcagtgatttcgtcatttttcacgtcgtcaagtggatgtttctcattttcaatgattttcatttttcttgccatattccacgtcctatagtggacatttctaaattttccaactttttcagttttcttgccatatttcaggtcctacagtgtgcatttctcatttttcacgtttttcagtgatttcgtcatttttcaagtggtcaagtgcatgtttctgattttccgtgattttcagttttcttgccatgttccaggtcctacagttgacgtttctaaaatttcactttttttaagttttcctcgccatatttcacttcctaaagtgtgtatttctcattttccgtgattttcagttttctcgccagattccaggtcctacagtgtgcatttttcatatttcacctttttcagtgattttgtcatttttcaagttgtcaactgcatgtttctcattttccatgattttcagttttcttgccatattccatgtcctactgtggacatttctaaattttccaactttttcagttttcctcgccatatttcatgtcctaaagtgtgtatttctcattttcagtgtttttctgttttctcgccatattccaggtcctacagtgtgcatttctaatttttcacgtttttcagtgatttcgtcatttttcaagttgtcaagtggatgtttctcattttccatgattttcagttttcttgccatattccatgtcctacagtggacatttctaaattttccaactttttccattttcctcaccatatttcacgtcctaaagtgtgtttttctcattttttgtgattttcagttttctcgacatattccaggtcctacagtgtgcatttctaattttttcttttttcagtgatttcgtcatttttcaagtggtcaagtgcatgtttctcattttccatgattttcagttttcttgccatattccatgtcctacaatggacatttctaaattttccaactttttcagttttcctcgccatatttcacgtcctaaagtgtgtatttctcattttccgtgattttcagttttctcgccatattccaggtcctatgtgtacatttctcatttttcacgtttttcagtgattttgtcatttttcaagttgtgaagtggatgtttctcatttttcttgattttcatttttcttgccatattccatgtcctagagtggaaatttttaaattttccaactttttcagttttcctcgccatatttcacgtcctaaagtgtgtatttctcattttccgtgattttcagttttctcgccatattccaagtcctacagtgtgcatttctcatttttcacgtttttcagtgatttcgtcatttttcaagttgtcaagtggatgtttctcattttccatgattttcagctttcttgccatattcaaagtcctacagtggacatttctaaattttcgacctttatcagttttcctcgccatatttcatgtcccaaagtgtgtacttctcattttccgtgattttcagtttcctcgccatattctaggtcctacagtgtgcatttctcatttttcaggtttttcagtgatttcgtcttttttcaagtcgtcaagtggatgtttctcattttccatgattttcagttttcttgccatattccatgtcctacagtggacatttctaaattttccacctttttcagttttcctcgccatatttcatgtcctaaagtgtgtatttctcattttcagtgattttcagttttctcgccatattccaggtcctacagtgtgcatttctcatttttcacgtttttcagtgatttcgtcatttttcaagttgtcaagtggatgtttctcattttccatgattttcagttttcttgccatattccatgtcccacagtggacatttctaaattttccacctttttctgttttccttgccatatttcatgtcctaaagtgtgtatttctcattttccgtgattttcagttttcttgctatattccaagtcctacagtgtgcatttctcatttttcacgtttttaagtgattttgtcatttttcaatttgtcaactgcatgtttctcattttccatgattttcagttttcttgccatattccatgtcctacagtggaaatttctatattttccaactttttcagttttcctcgccatatttcacgtgctaaagtgtgtatttctcatttttcgtgtttttcaggtttctcgccatattccaggtcctacagtgtgcatttctcatttttcacgtttttcagtgattttgtcatttttcaagttgtcaagtggatgtttctcattttccttgattttcagttttcttgccatattccatgtcctacagtggacatttctaaattttccacctttttcagttttccttgccatatttcatgtcctaaagtgtgtatttctcattttcagtgattttcagttttctcgccatattccaggtcctacagtgtgcatttctcattttttcaggtttttcagtgatttcgtcatttttcacgttgtcaagtggatgtttctcattttccatgattttcacttttcttgccatatttcatgtcctaaagtgtgtatttctcattttcagtgattttcagttttctcgccatattccaggtcctacagtgtgcatttctcattttttcacgtttttcagtgatttcgtcatttttcacgttgtcaagtggatgtttctcattttccatgattttcacttttcttgccatatttcatgtcctacagtggacatttctaaattttccacctttttctgttttcctcgccatatttcacatcctaaagtgtgtatttctcattttccgtgattttcagttttcttgccatatttcaggtcctacagtgtgcatttctcatttttcacgtttttcagtgatttcgtcatttttcaagtcgtcaagaggatgtttctcattttccatgattttcagttttctcgccatattccaggtcctacagttgacatttctaaattttccacattttttaagtttcctcgcgatatttcacatcctaaagtgtgtatttctcattttccgtgattttcagttttcttgccatattccaggtcctacagggtgcatttctcatttttcacgtttttcagtgatttcatcaatttcaagtcgtcaactgtatgtttctcattttcaatgattttcatttttcttgccatattccacgtcctatagtggacatttctaaattttccacctttttctgttttcctcgccatatttcacgtcctaaagtgtgtatttctcattttccgtgattttcagttttcttgccatattccaggtcctacagtgtgcatttctcatttttcacgtttttcactgattttgtcattgttcaagttgtcaactgcatgtttctcattttccatgattttcagttttcttgccatattccatgtcctacagtggaaatttctatattttccacctttttcagttttcctcgccgtatttcatgtgctaaagtgtgtatttctcatttttcgtgtttttcaggtttctcgccatattccaggtcctacagtgtgcatttctcatttttcacgtttttcagtgattttgtcatttttcaagttgtcaactggatgtttctcattttccttgattttcagttttcttgccatattccatgtcctactgtggacatttctaaattttccacctttttcagttttccttgccatatttcatgtcctaaagtgtgtatttctcattttcagtgattttcagttttctcgcaatattccaggtcctacagtgtgcatttctcattttttcaggtttttcagtgatttcgtcatttttcacgttgtcaagtggatgtttctcattttccatgattttcacttttcttgccatatttcatgtcctaaagtgtgtatttctcattttcagtgattttcagttttctcgccatattccaggtcctacattgtgcatttctcattttttcacgtttttcagtgatttcgtcatttttcacgttgtcaagtggatgtttctcattttccatgattttcacttttcttgccatatttcatgttttacagtggacatttctaaattttccacctttttctgttttcctcgccatatttcacatcctaaagtgtgaatttctcattttccgtgattttcagttttcttgccatattccaggtcctacagtgtgcatttctcatttttcacgtttttcagtgatttcatcatttttcaagtcgtcaagtggatgtttctcattttccatgattttcagttttcttgccatattccatgtcctacagtggacatttctaaattttccacctttttctgttttcctcgccatatttcacgtcctaaagtgtgtatttctcattttccgtgattttcagttttcttgccatattccaggtcctacagtgtgcatttctcatttttcacgtttttcactgattttgtcatttttcaagttgtcaactgcatgtttctcattttccatgattttcagttttcttgctatattccatgtcctacagtggaaatttctaaattttccacctttttcagttttcctcgccatatttcacgtcctgaagtgtgtatttctcattttccgtgattttcagttttctcgccatattccaggtcctatgtgtacatttctcatttttcacgtttttcagtgattttgtcatttttcaagttgtgaagtggatgtttctcatttttcttgattttcatttttcttgccatattccatgtcctacagtggaaatttctaaattttccacctttttcagttttcctcgccatatttcacgtcctaaagtgtgtatttctcattttccgtgattttcagttttctcgccatattccaggtcctacagtgtgcatttctcatttttcacgtttttcagtgatttcgacatttttcaagttgtcaagtggatgtttctcattttccatgattttcagctttcttgccatattcaaagtcctacagtggacatttctaaattttcgacctttatcagttttcctcgccatatttcatgtcccaaagtgtgtacttctcattttccgtgattttcagtttcctcgccatattccaggtcctacagtgtgcatttctcatttttcacgtttttcagtgatttcgtcatttttcaagtcgtcaagtggatgtttctcattttccatgattttcagttttcttgccatattccatgtcctacagtggacatttctaaattttccacctttttctgttttcctcgccatatttcacgtcctaaagtgtgtatttctcattttccgtgattttcagttttcttgccatattccaggtcctacagtgtgcatttctcatttatcacgtttttcactgattttgtcatttttcaagttgtcaactgcatgtttctcattttccatgattttcagttttcttgctatattccatgtcctacagtggaatattctaaattttccacctttttcagttttcctcgccatatttcacgtcctgaagtgtgtatttctcattttccgtgattttcagttttctcgccatattccaggtcctatgtgtacatttctcatttttcacgtttttcagtgattttgtcatttttcaagttgtgaagtggatgtttctcatttttcttgattttcatttttcttgccatattccatgtcctacagtggaaatttctaaattttccacctttttcagttttcctcgccatatttcacgtcctaaagtgtgaatttctcattttccgtgattttcagttttctcgccatattccaggtcctacagtgtgcatttctcatttttcacgtttttcagtgatttcgacatttttcaagttgtcaagtggatgtttctcattttccatgattttcagctttcttgccatattcaaagtcctacagtggacatttctaaattttcgacctttatcagttttcctcgccatatttcatgtcccaaagtgtgtacttctcattttccgtgattttgagtttcctcgccatattccaggtcctacagtgtgcatttctcatttttcacgtttttcagtgatttcgtcttttttcaagttgtcaactgcatgtttctcattttccatgattttcagttttcttgccatattccatgtcctacagtggaaatttgtaaatttccacctttttcagttttcctcgccatatttcacgtcctaaagtatgtatttctcattttccgtgattttcagttttctcgccatattccaggtcctacagtgtgcatttctcatttttcacgtttttcagtgattttgtcattttttaagttttcaagtggatgtttctcattttccttgattttcagttttcttgccatattccatgtcctacagtggacatttctaaattttccacctttttcagttttcctcgccatatttcatgtcctaaagtgtgtatttctcattttcagtgattttcagttttctcgccatattccaggtcctacagtgtgcatttctcatttttcacgtttttcagtgatttcgtcatttttcaaggtgtcaagtggatgtttctcattttccatgattttcagttttcttgccatattccatgtcctacagtggacatttctaaattttccacctttttctgttttcctcgccatatttcatgtcctaaagtgtgtatttctcattttccgtgattttcagttttcttgctatattccaagtcctacagtgtgcatttctcatttttcacgtttttcagtgattttgtcatttttcaatttgtcaactgcatgtttctcattttccatgattttcagtttttttgccatattccatgtcctactgtggaaatttctatattttccacctttttcagttttcctcgccatatttcacgtgctaaagtgtgtatttctcatttttcgtgtttttcaggtttctcgccatattccaggtcctacagtgtgcatttctcatttttcacgtttttcagtgattttgtcatttttcaagttttcaagtggatgtttctcattttccttgattttcagttttcttgccatattccatgtcctacagtggacatttctaaattttccacctttttcagttttccttgccatatttcatgtcctaaagtgtgtatttctcattttcagtgattttcagtttccttgccatattccaggtcctacagtgtgcatttctcattttttcacgtttttcagtgatttcgtcatttttcacgttgtcaagtggatgtttctcattttccatgattttcacttttcttgccatatttcatgtcctacagtggacatttctaaattttccaactttttcaattttcctcgccatattttatgtcctaaagtgtgtatttctcatttttcgttattttcagttttcttgccatattccaggtcctacagtgtgcatttgtcatttttcacgtttttcagtgatttcgtcatttttcaagtcgtcaagtagatgtttctcatattccatgtttttcagttttctcgccatattccaggtcctacagttgacatttctaaattttctacatttttaaattttcctcgccatatttcacgtcctaaagtgtgtatttctcattttttgttattttcagttttctagccatattccaggtcctacaggatgcatttctcatttttcacgtttttcagtgatttcatcatttttcaagtcgtcaagtgtatgtttcttattttcaatgattttcatttttcttgccttattccacgtcctatagtggacatttctaaattttccacctttttcagtttttttcgccatatttcacgtcctaaagtgtgtatttctcattttctgtgattttcagttttctcaccatattccaggtcctacagtgtgcatttctcatttttcacgtttttcagtgatttcgtcatttttcaagttgtcaagtggaagtttctcattttccatgattttcagctttctagacatattccaggtcctacagtggacatttcctaattttcgacctttatcagttttcctcgtcatatttcacgtcccaaaatgtgtatttcttattttccatgattttcagtttcctcgccatattccaggtcctacagtgtgcaattctcatttttcacgtttttcagtgatttcgtcttttttcaagacgtcaagtggatgtttctcatttttcatgattttcagttttcttgccatattccatgtcctacagtggacatttctaaattttccacctttttctgttttcctcgccatatttcacgtcctaaagtgtgtatttctcattttccgtgattttcagttttcttgccatattcctggtcctacagtgtgcatttctcatttttcacgtttttcagtgattttgtcatttttcaatttgtcaactgcatgtttctcattttccattattttcagttttcttgccatattccatgtcctacagtggacatttctaaattttccacctttttctgttttcctcgccatatttcatgtcctaaagtgtgtatttctcattttccgtgattttcagttttcttgctatattccaagtcctacagtgtgcatttctcatttttcacgtttttcagtgattttgtcatttttcaatttgtcaactgcatgtttctcattttccatgattttcagtttttttgccatattccatgtcctacaggggaaatttctatattttccacctttttcagttttcctcgccatatttcatgtcctaaagtgtgtatttctcattttccgtgattttcagttttcttgccatattccaggtcctacagtgtgcatttctcatttttcacgtttttcagtgatttcgtcatttttcaagtcttcaagtagatgtttctcatattccatgtttttcagttttctcgccatattccaggtcctacagttgacatttctaaattttctacatttttaaattttcctcgccatatttcacgtcctaaagtgtgtatttctcatttttcgttattttcagttttctagccatattccaggtcctacaggatgcatttctcatttttcacgtttttcagtgatttcatcatttttcaagtcgtcaagtgtatgtttctcattttcaatgattttcatttttcttgccttattccacgtcctatagtggacatttctaaattttccacctttttcagtttttctcgccatatttcacgtcctaaagtgtgtatttctcattttctgtgattttcagttttctcaccatattccaggtcctacagtgtgcatttctcatttttcacgtttttcagtgatttcgtcatttttcaagttgtcaagtggaagtttctcattttccatgattttcagctttctagccatattccaggtcctacagtggacatttcctaattttcgacctttatcagttttcctcgccatatttcacgtcctaaagtgtgtatttctcattttccgtgattttcagttttcttgccatattccaggtcctacagtgtgcatttctcatttttcacgtttttcagtgattttgtcatttttcaatttgtcaactgcatgtttctcattttccatgatttttagttttcttgctatattccatgtcctacagtggaaatttctaaattttccacctttttcagttttcctcgccatatttcacgtcctaaagtgtgtatttctcattttccgtgattttcagttttcttgctatattccaagtcctacattgtgcatttctcatttttcacgtttttcagtgattttgtcatttttcaatttgtcaaaccacatgtttctcattttccatgattttcagtttttttgccatattccatgtcctacagtggaaatttctatattttccacctttttcagttttcctcgccatatttcacgtgctaaagtgtgtatttctcatttttcgtgtttttcaggtttctcgccatattccaggtcctacagtgtgcatttctcatttttcacgtttttcagtgattttgtcatttttcaagttgtcaagtggatgtttcccattttccttgattttcagttttcttaccatattccatgtcctacagtggacatttctaaattttccacctttttcagttttccttgccatatttcatgtcctaaagtgtgtatttctcattttcagtgattttcagtttcctcgccatattccaggtcctacagtgtgcatttctcattttttcacgtttttcagtgatttcgtcatttttcacgttgtcaagtggatgtttctcattttccatgattttcacttttcttgccatatttcatgtcctatagtggacatttctaaattttccacctttttcagtttttctcgccatatttcacgtcctaaagtgtgtatttctcattttctgtgattttcagttttctcaccatattccaggtcctacagtgtgcatttctcatttttcacgtttttcagtgatttcgtcatttttcaagtcgtcaagtagatgtttctcatattccatgtttttcagttttctcgccatattccaggtcctacagttgacatttctaaattttctacatttttaaattttcctcgccatatttcacgtcctaaagtgtgtatttctcatttttcgttattttcagttttctagccatattccaggtcctacaggatgcatttctcatttttcacgtttttcagtgatttcatcatttttcaagtcgtcaagtgtatgtttcttattttcaatgattttcatttttcttgccttattccacgtcctatagtggacatttctaaattttccaccttttttcagtttttctcgccatatttcacgtcctaaagtgtgtatttctcattttctgtgattatcagttttctcaccatattccaggtcctacagtgtgcatttctcatttttcacgtttttcagtgatttcgtcatttttcaagttgtcaagtggaagtttctcattttccatgattttcagctttctagccatattccaggtcctacagtggacatttcctaattttcgacctttatcagttttcctcgccatatttcacgtcccaaaatgtgtatttcttattttccatgattttcagtttcctcgccatattccaggtcctacagtgtgcatttctcatttttcacgtttttcagtgatttcgtcttttttcaagacgtcaagtggatgtttctcatttttcatgattttcagttttcttgccatattccatgtcctacagtggacatttctaaattttccacctttttctgttttcctcgccatatttcacgtcctaaagtgtgtatttctcattttccgtgattttcagttttcttgccatattcctggtcctacagtgtgcatttctcatttttcacgtttttcagtgattttgtcatttttcaatttgtcaactgcatgtttctcattttccatgattttcagttttcttgccatattccatgtcctacagtggacatttctaaattttccacctttttcagttttcctcgccatatttcacgtgctaaagtgtgtatttctcatttttcgtgtttttcaggtttctcgccatattccaggtcctacagtgtgcatttctcatttttcacgtttttcagtgattttgtcatttttcaagttgtcaagtggatgtttctcattttccttgattttcacttttcttgccatattccaagtcttacaggggcatttctcatttttcacgttttcagtgattttgtcattttcaatttgtcaactgcatgtttctcattttccatgattttcagtttttttgccatattccatgtcctacaggggaaatttctatattttccacctttttcagttttcctcgccatatttcatgtcctaaagtgtgtatttctcattttccgtgattttcagttttcttgccatattccaggtcctacagtgtgcatttctcatttttcacgtttttcagtgatttcgtcatttttcaagtcttcaagtagatgtttctcatattccatgtttttcagttttctcgccatattccaggtcctacagttgacatttctaaattttctacatttttaaattttcctcgccatatttcacgtcctaaagtgtgtatttctcatttttcgttattttcagttttctagccatattccaggtcctacaggatgcatttctcatttttcacgtttttcagtgatttcatcatttttcaagtcgtcaagtgtatgtttctcattttcaatgattttcatttttcttgccttattccacgtcctatagtggacatttctaaattttccacctttttcagtttttctcgccatatttcacgtcctaaagtgtgtatttctcattttctgtgattttcagttttctcaccatattccaggtcctacagtgtgcatttctcatttttcacgtttttcagtgatttcgtcatttttcaagttgtcaagtggaagtttctcattttccatgattttcagctttctagccatattccaagtcctacagtggacatttcctaattttcgacctttatcagttttcctcgccatatttcacgtcccaaaatgtgtattccttattttccatgattttcagtttcctcgccatattccaggtcctacagtgtgcatttatcatttttcacgtttttcagtgatttcgtcttttttcaagacgtcaagtggatgtttctcatttttcatgattttcagttttcttgccatattccatgtcctacagtggacatttctaaattttccacctttttctgttttcctcgccatatttcacgtcctaaagtgtgtatttctcattttccgtgattttcagttttcttgccatattcctggtcctacagtgtgcatttctcatttttcacgtttttcagtgattttgtcatttttcaagttgtcaagtggatgtttctcattttccttgattttcacttttcttgccatattccatgtcctacagtggacatttctatattttccacctttttccgttttccttgccatatttcacgtcctaaagtgtgtatttctcattttccgtgattttcaggtttctcgccatattccaggtcctacagtgtgcatttctcatttttcacgtttttcagtgattttgtcatttttcaagttgtcaagtggatgtttctcattttccttgattttcacttttcttgccatattccatgtcctacagtggacatttctaaattttccacctttttcagttttcctcgccatatttcatgtcctaaagtgtgtatttctcattttcagtgattttcagttttcttgccatattccaggtcctacagtgtgcatttctcatttttcacgtttttcagtgattttgtcatttttcaagttgtcaactgcatgtttctcattttctatgattttcagttttcttgctatattccatgtcctacagtggaaatttctaaattttccacctttttcagttttcctcgccatatttcacgtcctaaagtgtgtatttctcattttccgtgattttcagttttctcgccatattccaggtcctatgtgtacatttctcatttttcacgtttttcagtgattttgtcatttttcaagttgtgaagtggatgtttctcatttttcttgattttcatttttcttgccatattccatgtcctagagtggaaatttttaaattttccacctttttcagttttcctcgccatatttcacgtcctaaagtgtgaatttctcattttccgtgattttcagatttctcgccatattccaagtcctacagtgtgcatttctcatttttcacgtttttcagtgatttcgtcatttttcaagttgtcaagtggatgtttctcattttccatgattttcagctttcttgccatattcaaagtcctacagtggacatttctaaattttcgacctttatcagttttcctcgccatatttcatgtcccaaagtgtgtacttctcattttccgtgattttcagtttcctcgccatattctaggtcctacagtgtgcatttctcatttttcaggtttttcagtgatttcgtcttttttcaagtcgtcaagtggatgtttctcattttccatgattttcacttttcttgccatatttcatgtcctaaagtgtgtatttctcattttcagtgattttcagttttctcgctatattccaggtcctacagtgtgcatttctcattttttcacgtttttcagtgatttcgtcatttttcacgttgtcaagtggatgtttctcattttccatgattttcacttttcttgccatatttcatgtcctacagtggacatttctaaattttccacctttttctgttttcctcgccatatttcacatcctaaagtgtgtatttctcattttccgtgattttcagttttcttgccatattccaggtcctacagtgtgcatttctcatttttcacgtttttcagtgatttcgtcatttttcaagttgtcaagtggatgtttctcattttccttgattttcagttttcttgccatattccatgtcctactgtggacatttctaaattttccacctttttcagttttccttgccatatttcatgtcctaaagtgtgtatttctcattttcagtgattttcagttttctcgcaatattccaggtcctacagtgtgcatttctcattttttcaggtttttcagtgatttcgtcatttttcacgttgtcaagtggatgtttctcattttccatgattttcacttttcttgccatatttcatgtcctaaagtgtgtatttctcattttcagtgattttcagttttcctcgccatatttcacgtcccaaaatgtgtatttcttattttccatgattttcagtttcctcgccatattccaggtcctacagtgtgcatttctcatttttcacgtttttcagtgatttcgtcttttttcaagacgtcaagtggatgtttctcatttttcatgattttcagttttcttgccatattccatgtcctacagtggacatttctaaattttccacctttttctgttttcctcgccatatttcacgtcctaaagtgtgtatttctcattttccgtgattttcagttttcttgccatattcctggtcctacagtgtgcatttctcatttttcacgtttttcagtgattttgtcatttttcaatttgtcaactgcatgtttctcattttccatgattttcagttttcttgccatattccatgtcctacagtggacatttctaaattttccacctttttcagttttcctcgccatatttcacgtgctaaagtgtgtatttctcatttttcgtgtttttcaggtttctcgccatattccaggtcctacagtgtgcatttctcatttttcacgtttttcagtgattttgtcatttttcaagttgtcaagtggatgtttctcattttccttgattttcacttttcttgccatattccatgtcctacagtggacatttctaaattttccacctttttcagttttcctcgccatatttcatgtcctaaagtgtgtatttctcattttcagtgattttcagttttctcgccatattccaggtcctacagtgtgcatttctcatttttcacgtttttcagtgatttcgtcttttttcaagacgtcaagtggatgtttctcattttccatgattttcagttttcttgccatattccatgtcctacagtggacatttctaaattttccacctttttctgttttcctcgccatatttcacgtcctaaagtgtgtatttctcattttccgtgattttcagttttcttgccatattccaggtcctacagtgtgcatttctcatttttcacgtttttcagtgattttgtcatttttcaatttgtcaactgcatgtttctcattttccatgatttttagttttcttgctatattccatgtcctacagtggaaatttctaaattttccacctttttcagttttcctcgccatatttcacgtcctaaagtgtgtatttctcattttccgtgattttcagttttcttgctatattccaagtcctacattgtgcatttctcatttttcacgtttttcagtgattttgtcatttttcaatttgtcaaaccacatgtttctcattttccatgattttcagtttttttgccatattccatgtcctacagtggaaatttctatattttccacctttttcagttttcctcgccatatttcacgtgctaaagtgtgtatttctcatttttcgtgtttttcaggtttctcgccatattccaggtcctacagtgtgcatttctcatttttcacgtttttctgtgattttgtcatttttcaagttgtcaagtggatgtttctcattttccttgattttcagttttcttaccatattccatgtcctacagtggacatttctaaattttccaccttttctgttttcctcgccatatttcatgtcctaaagtgtgtatttctcattttccgtgattttcatttttcttgctatattccaagtcctacagtgtgcatttctcattttccatgattttcagttttcttgctatattccatgtcctacagtggaaatttctaaattttccacctttttcagttttcctcgccatatttcacgtcctaaagtgtgtatttctcattttccgtgattttcagttttttcgccatattacaggtcctatgtgtacatttctcatttttcacgtttttcagtgattttgtcatttttcaagttgtcaagtggatgtttctcatttttcttgattttcatttttcttgccatattccatgtcctacagtggaaatttctaaattttccacctttttcagttttcctcgccatatttcacgtcctaaagtgtgaatttctcattttccgtgattttcagttttctcgccatattccaggtctacagtgtgcatttctcatttttcacgttttcagtgattcgtcatttttcaagttgacaagtggatgtttctcattttccatgattttcagctttcttgccatattcaaagtcctacagtggacatttctaaattttcgacctttatcagttttcctcgccatatttcatgtcccaaagtgtgtacttctcattttccgtgattttcagttttcttgccatattccaagtcctacagtgtgcatttctcatttttcacgtttttcagtgattttgtcatttttcaatttgtcaactgcatgtttctcattttccatgattttcagttttcttgccatattccatgtcctacagtggaaatttctatattttccacctttttcagttttcctcgccatatttcacgtgctaaagtgtgtatttctcatttttcgtgtttttcaggtttctcgccatattccaggtcctacagtgtgcatttctcatttttcacgtttttcagtgattttgtcatttttcaagttgtcaagtggatgtttctcattttcaatgattttcatttttcttgccttattccacgtcctatagtggacatttctaaattttccacctttttcagtttttctcgccatatttcacgtcccaaaatgtgtattccttattttccatgattttcagtttcctcgccatattccaggtcctacagtgtgcatttctcatttttcacgtttttcagtgatttcgtcttttttcaagacgtcaagtggatgtttctcatttttcatgattttcagttttcttgccatattccctgtcctacagtggacatttctaaattttccacctttttctgttttcctcgccatatttcacgtcctaaagtgtgtatttctcattttccgtgattttcagttttctcgccagattccaggtcctacagtgtgcatttctcatttttcacgtttttcagtgattttgtcatttttcaatttgtcaactgcatgtttctctctttccatgattttcagttttcttgccatattccatgtcctacagtggacatttctaaattttccacctttttcagttttcctcgccatatttcacgtgctaaagtgtgtatttctcatttttcgtgtttttcaggtttctcgccatattccaggtcctacagtgtgcatttctcatttttcacgtttttcagtgattttgtcatttttcaagttgtcaagtggatgtttctcattttcaatgattttcatttttcttaccttattccacgtcctatagtggacatttctaaattttccacctttttcagtttttctcgccatatttcacgtcccaaaatgtgtattccttattttccatgattttcagtttcctcgccatattccaggtcctacagtgtgcatttctcatttttcacgtttttcagtgatttcgtcttttttcaagacgtcaagtggatgtttctcatttttcatgattttcagttttcttgccatattccctgtcctacagtggacatttctaaattttccacctttttctgttttcctcgccatatttcacgtcctaaagtgtgtatttctcattttccgtgattttcagttttctcgccagattccaggtcctacagtgtgcatttctcatttttcacgtttttcagtgatttcgtcatttttcaagtcttcaagtgtatgtttctcattttcaatgattttcatttttcttgccttattccacgtcctatagtggacatttctaaattttccacctttttcagtttttctcgccatatttcacgtcctaaagtgtgtatttctcattttctgtgattttcagttttcttaccatattccaggtcctacagtgtgcatttctcatttttcacgtttttcagtgatttcgtcatttttcaagttgtcaagtggaagtttctcattttccatgattttcagctttctagccatattccaggtattacagtggacatttccttattttcgacctttatcagttttcctcgccatatttcatgtcctaaagtgtgt	38399	1554	4%	7300	19%
9	3000001	3038400	Atcctacagtgtgcatttctcatttttcacgtttttcagtgatttcgtcatttttcaagtcatcaagtggctgtttctcattttccatgattttcagttttcttgccatattccttgtcctacagtggacatttctaaattttccacctttttcagttttccttgtcatatttcaggtcctacagtgtgtatttctcatttttcacgtttttcattgatttcgtcatttttcaagttgtcaagtgcatgtttctcattttccatgattttcagttttcttgccatattccatgtcctacaatggacatttctaaattttccaactttttcagttttcctcgccatatttcacgtcctaaagtgtgtatttctcattttccgtgattttcagttttctcgacatattccaggtcctacagtgtgcatttctcatttttcacgtttttcagtgatttcgtcatttttcacgtcgtcaagtggatgtttctcattttccatgattttcagttttcttgccatattccatgtcctacagtggacatttctaaattttccacctttttcagttttcctcgccatatttcacgtcctaaagtgtgtatttctcattttccgtgattttcagttttctcgacatattccaggtcttacagggtgcatttctcatttttcacgtttttcagtgatttcatcatttttcaagtcgtcaactgtatgtttctcattttcaatgattttcatttttcttgccatattccacgtcctatagtggacatttctaaattttccacctttttcagttttccttgccatatttcaggtcctacagtgtgcatttctcatttttcacgtttttcagtgatttcgtcatttttcaagtggtcaaatgcatgtttctcattttccatgattttcagttttcttgccatattccatgtcctacagtggacatttctaaattttccacctttttcagttttcctcgccatatttcacgtcctaaagtgtgtatttctcattttccgtgattttcagttttatcgccagattccaggtcctacggtgtgcatttttcatatttcacgtttttcagtgattttgtcatttttcaagttgtcaactgcatgtttctcattttccatgattttcagttttcttgccatattccatgtcctacagtggacatttctaaattttccacctttttcagttttcctcgccatatttcatgtcctaaagtgtgtatttctcattttcagtgattttctgttttctcgccatattccaggtcctacagtgtgcatttctcatttttcacgtttttcagtgatttcgtcatttttcaagttgtcaagtggatgtttctcattttccatgattttcagttttcttgccatattccatgtcctacaatggacatttctaaattttccacctttttcagttttcctcgccatatttcacgtcctaaagtgtgtatttctcattttccgtgattttcagttttctcgccatattccaggtcctatgtgtacatttctcatttttcacgtttttcagtgattttgtcatttttcaagttgtgaagtggatgtttctcatttttcttgattttcatttttcttgccatattccatgtcctagagtggaaatttttaaattttccacctttttcagttttcctcgccatatttcacgtcctaaagtgtgaatttctcattttccgtgattttcagttttctcgccatattccaagtcctacagtgtgcatttctcatttttcacgtttttcagtgatttcgtcatttttcaagttgtcaagtggatgtttctcattttccatgattttcagctttcttgccatattcaaagtcctacagtggacatttctaaattttcgacctttatcagttttcctcgccatatttcatgtcccaaagtgtgtacttctcattttccgtgattttcagtttcctcgccatattctaggtcctacagtgtgcatttctcatttttcaggtttttcagtgatttcgtcttttttcaagtcgtcaagtggatgtttctcattttccatgattttcagttttcttgccatattccatgtcctacagtggacatttctaaattttccaactttttcagttttcctcgccatatttcatgtcctaaagtgtgtatttctcattttcagtgattttcagttttctcgccatattccaggtcctacagtgtgcatttctcatttttcacgtttttcagtgatttcgtcatttttcaagttgtcaagtggatgtttctcatttttcatgattttcagttttcttgccatattccatgtcccacagtggacatttctaaatgttccacctttttctgttttccttgccatatttcatgtcctaaagtgtgtatttctcattttccgtgattttcagttttcttgctatattccaagtcctacagtgtgcatttctcatttttcacgtttttctgtgattttttcatttttcaatttgtcaactgcatgtttctcattttccatgattttcagttttcttgccatattccaggtcctacagtgtgcatttctcatttttcacgtttttcagtgattttgtcatttttcaagttgtcaactgcatgtttctcattttccatgattttcagttttcttgctatattccatgtcctacagtggaaatttctaaattttccacctttttcagttttcctcgccatatttcacgtcctaaagtgtgtatttctcattttccgtgattttcagttttctcgccatattccaggtcctatgtgtacatttctcatttttcacgtttttcagtgattttgtcatttttcaagttgtgaagtggatgtttctcatttttcttgattttcatttttcttgccatattccatgtcctagagtggaaatttttaaattttccacctttttcagttttcctcgccatatttcacgtcctaaattgtgaatttctcattttccgtgattttcagttttctcgccatattccaagtcctacagtgtgcatttctcatttttcacgtttttcagtgatttcgtcatttttcaagttgtcaagtggatgtttctcattttccatgattttcagctttcttgccatattcaaagtcctacagtggacatttctaaattttcgacctttatcagttttcctcgccatatttcatgtcccaaagtgtgtacttctcattttccgtgattttcagtttcctcgccatattctaggtcctacagtgtgcatttctcatttttcaggtttttcagtgatttcgtcttttttcaagtcgtcaagtggatgtttctcattttccatgattttcagttttcttgccatattccatgtcctacagtggacatttctaaattttccacctttttcagttttcctcgccatatttcatgtcctaaagtgtgtatttctcattttcagtgattttcagttttctcgccatattccaggtcctacagtgtgcatttctcatttttcacgtttttcagtgattttgtcatttttcaagttgtcaagtggatgtttctcattttccttgattttcagttttcttgccatattccatgtcctacagtggacatttctaaattttccacctttttcagttttccttgccatatttcatgtcctaaagtgtgtatttctcattttcagtgattttcagttttctcgccatattccaggtcctacagtgtgcatttctcattttttcaggtttttcagtgatttcgtcatttttcacgttgtcaagtggatgtttctcattttccatgattttcacttttcttgccatatttcatgtcctaaagtgtgtatttctcattttcagtgattttcagttttctcgccatattccaggtcctacagtgtgcatttctcattttttcacgtttttcagtgatttcgtcatttttcacgttgtcaagtggatgtttctcattttccattattttcacttttcttgccatatttcatgtcctacagtggacatttctaaattttccacctttttctgttttcctcgccatatttcacatcctaaagtgtgtatttctcattttccgtgattttcagttttcttgccatattccaggtcctacagtgtgcatttctcatttttcacgtttttcagtgatttcgtcatttttcaagtcgtcaagtggatgtttctcattttccatgattttcagttttctcgccatattccaggtcctacagttgacatttctaaattttccacattttttatgtttcctcgcgatatttcacatcctaaagtgtgtatttctcattttccgtgattttcagttttcttgccatattccaggtcctacagggtgcatttctcatttttcacgtttttcagtgatttcatcaatttcaagtcgtcaactgtatgtttctcattttcaatgattttcatttttcttgccatattccacgtcctatagtggacatttctacattttccacctttttcagttttcttcgccatatttcacgtcccaaagtgtgtatttctcattttccgtgattttcagtttcctcgccatattccaggtcctacagtgtgcatttctcatttttcacgtttttcagtgatttcgtcttttttcaagtcgtcaagtggatgtttctcattttccatgattttcagttttcttgccatattccatgtcctacagtggacatttctaaattttccacctttttctgttttcctcgccatatttcacgtcctaaagtgtgtatttctcatttaccgtgattttcagttttcttgctatattccaagtcctacagtgtgcatttctcatttttcacgtttttcactgattttgtcattgttcaagttgtcaactgcatgtttctcattttccatgattttcagttttcttgccatattccatgtcctacagtggaaatttctatattttccaactttttcagttttcctcgccatatttcacgtgctaaagtgtgtatttctcatttttcgtgtttttcaggtttctcgccatattccaggtcctacagtgtgcatttctcatttttcacgtttttcagtgattttgtaatttttcaagttgtcaagtggatgtttctcattttccttgattttcagttttcttgccatattccatgtcctactgtggacatttctaaattttccacctttttcagttttccttgccatatttcatgtcctaaagtgtgtatttctcattttcagtgattttcagttttctcgcaatattccaggtcctacagtgtgcatttctcattttttcaggtttttcagtgatttcgtcatttttcacgttgtcaagtggatgtttctcattttccatgattttcacttttcttgccatatttcatgtgctaaagtgtgtatttctcattttcagtgattttcagttttctgccatattccaggtcctacattgtgcatttctcattttttcacgtttttcagtgatttcgtcatttttcacgttgtcaagtggatgtttctcattttccatgattttcacttttcttgccatatttcatgttttacagtggacatttctaaattttccacctatttctgttttcctcgccatatttcacatcctaaagtgtgtatttctcattttccgtgattttcagttttctcgccatatgccaggtcatacagggtgcatttctcatttttcacgtttttcagtgatttcgtcatttttcacgtcgtcaagtggatgtttctcattttcaatgattttcatttttcttgccatattccacgtcctatagtggacatttctaaattttccacctttttcagttttccttgccatatttcaggtcctacagtgtgcatttctcttttttcacgtttttcagtgatttcgtcatttttcaagtggtcaagtgcatgtttctcattttccgtgattttcagttttcttgccatgttccaggtcctacagttgacgtttctaaaatttcactttttttaagttttcctcgccatatttcacttcctaaagtgtgtatttctcattttccgtgattttcagttttctcgccagattccaggtcctacagtgtgcatttttcatatttcacctttttcagtgattttgtcatttttcaagttgtcaactgcatgtttctcattttccatgattttcagttttcttgccatattccatgtcctactgtggacatttctaaattttccaactttttcagttttcctcgccatatttcatgtcctaaagtgtgtatttctcattttcagtgattttctgttttctcgccatattccaggtcctacagtgtgcatttctaatttttcacgtttttcagtgatttcgtcatttttcaagttgtcaagtggatgtttctcattttccatgattttcagttttcttgccatattccatgtcctacagtggacatttctaaattttccaactttttccattttcctcaccatatttcacgtcctaaagtgagtttttctcattttttgtgattttcagttttctcgacatattccaggtcctacagtgtgcatttctaattttttcttttttcagtgatttcgtcatttttcaagtggtcaagtgcatgtttctcattttccatgattttcagttttcttgccatattccatgtcctacaatggacatttctaaattttccaactttttcagttttcctcgccatatttcacgtcctaaagtgtgtatttctcattttccgtgattttcagttttctcgccatattccaggtcctacagtgtgcatttctcatttttcacgtttttcagtgatttcgtcatttttcaagttgtcaactgcatgtttctcattttccatgattttcagttttcttgccatattccatgtcttacagtggacatttttaaatttttcacatttttttaagttttcctccccatatttcacgttttaaagtgtgcatttctcattttcggtgattttcagttttctcgccagattccatgtcttacagtgtgcatttctcattttttcacgtttttcagtgatttcgtcatttttcaagtcgtcaagtggatgtttctcattttccatgattttcagttttcttgccatattccatgtcctacagtggaaatttctaaattttccacctttttcagttttccttgccatatttcaggtcctaaagtgtgtatttctcattttctgtgattttcagttttctcgccatattccaggtcctacagttgacatttctaaaatttccacattttttaagttttcctcgccatatttcacttcctaaagtgtgtatttctcattttccgtgattttcagttttctcgccatattccagatcctacagtgtacatttttcatttttcacgtttttcagtgattttgtcattttttagttgtcaactgcctgtttctcattttccatgattttcagttttcttgctatattccatgtcctacagtggaaatttctaaattttccacctttttcagttttcctcgccatatttcacgtcctaaagtgtgtatttctcattttccgtgattttcagttttctcgccatattccaggtcctatgtgtacatttctcatttttcacgtttttcagtgattttgtcatttttcaatttgtcaactgcatgtttctcattttccatgattttcagttttcttgccatattccatgtcctacagtggaaatttctatattttccaactttttcagttttcctcgccatatttcacgtgctaaagtgtgtatttctcatttttcgtgtttttcaggtttctcgccatattccaggtcctacagtgtgcatttctcatttttcacgtttttcagtgattttgtcatttttcaagttgtcaagtggatgtttctcattttccttgattttcagttttcttgccatattccatgtcctacagtggacatttctaaattttccacctttttcagttttccttgccatatttcatgtcctaaagtgtgtatttctcattttcagtgattttcagttttctcgccatattccaggtcctacagtgtgcatttctcattttttcaggtttttcagtgatttcgtcatttttcacgttgtcaagtggatgtttctcattttccatgattttcacttttcttgccatatttcatgtcctaaagtgtgtatttctcattttcagtgattttcagttttctcgctatattccaggtcctacagtgtgcatttctcattttttcacgtttttcagtgatttcgtcatttttcacgttgtcaagtggatgtttctcattttccatgattttcacttttcttgccatatttcatgtcctacaatggacatttctaaattttccacctttttctgttttcctcgccatatttcacatcctaaagtgtgtatttctcattttccgtgattttcagttttcttgccatattccaggtcctacagtgtgcatttctcatttttcacgtttttcagtgatttcgtcatttttcaagttgtcaagtggatgtttctcattttccttgattttcagttttcttgccatattccatgtcctactgtggacatttctaaattttccacctttttcagttttccttgccatatttcatgtcctaaagtgtgtatttctcattttcagtgattttcagttttctcgcaatattccaggtcctacagtgtgcatttctcattttttcaggtttttcagtgatttcgtcatttttcacgttgtcaagtggatgtttctcattttccatgattttcacttttcttgccatatttcatgtcctaaagtgtgtatttctcattttcagtgattttcagttttctgccatattccaggtcctacattgtgcatttctcattttttcacgtttttcagtgatttcgtcatttttcagttttctcgacatattccaggtcctacagtgtgcatttctaattttttcttttttcagtgatttcgtcatttttcaagttgtcaactgcatgtttctcattttccatgattttcagttttcttgccatattccatgtcttacagtggacatttttaaatttttcacatttttttaagttttcctccccatatttcacgttttaaagtgtgcatttctcattttcggtgattttcagttttctcgccagattccaggtcttacagtgtgcatttctcattttttcacgtttttcagtgatttcgtcatttttcaagtcgtcaagtggatgtttctcattttccatgattttcagttttcttgccatattccatgtcctacagtggaaatttctaaattttccacctttttcagttttccttgccatatttcaggtcctaaagtgtgtatttctcattttctgtgattttcagttttctcgccatattccaggtcctacagttgacatttctaaaatttccacattttttaagttttcctcgccatatttcacttcctaaagtgtgtatttctcattttccgtgattttcagttttctcgccatattccagatcctacagtgtgcatttttcatttttcacgtttttcagtgattttgtcattttttagttgtcaactgtctgtttctcattttccatgattttcagttttcttgccatattccatgtcctacactggacatttctaaattttccacctttttctgttttcctcgccatatttcacgtcctaaagtgtgtatttctcattttccgtgattttcagttttcttgccatattccaggtcctacagtgtgcatttctcatttttcacgtttttcagtgattttgtcatttttcaagttgtcaactgcatgtttctcattttctatgattttcagttttcttgctatattccatgtcctacagtggaaatttctaaattttccacctttttcagttttcctcgccatatttcacgtcctaaagtgtgtatttctcattttccgtgattttcagttttctcgccatattccaggtcctatgtgtacatttctcatttttcacgtttttcagtgattttgtcatttttcaagttgtgaagtggatgtttctcatttttcttgattttcatttttcttgccatattccatgtcctagagtggaaatttttaaattttccacctttttcagttttcctcgccatatttcacgtcctaaagtgtgaatttctcattttccgtgattttcagatttctcgccatattccaagtcctacagtgtgcatttctcatttttcacgtttttcagtgatttcgtcatttttcaagttgtcaagtggatgtttctcattttccatgattttcagctttcttgccatattcaaagtcctacagtggacatttctaaattttcgacctttatcagttttcctcgccatatttcatgtcccaaagtgtgtacttctcattttccgtgattttcagtttcctagccatattctaggtcctacagtgtgcatttctcatttttcaggtttttcagtgatttcgtcttttttcaagtcgtcaagtggatgtttctcattttccatgattttcacttttcttgccatatttcatgtcctaaagtgtgtatttctcattttcagtgattttcagttttctcgctatattccaggtcctacagtgtgcatttctcattttttcacgtttttcagtgatttcgtcatttttcacgttgtcaagtggatgtttctcattttccatgattttcacttttcttgccatatttcatgtcctacagtggacatttctaaattttccacctttttctgttttcctcgccatatttcacatcctaaagtgtgtatttctcattttccgtgattttcagttttcttgccatattccaggtcctacagtgtgcatttctcatttttcacgtttttcagtgatttcgtcatttttcaagttgtcaagtggatgtttctcattttccttgattttcagttttcttgccatattccatgtcctactgtggacatttctaaattttccacctttttcagttttccttgccatatttcatgtcctaaagtgtgtatttctcattttcagtgattttcagttttctcgcaatattccaggtcctacagtgtgcatttctcattttttcaggtttttcagtgatttcgtcatttttcacgttgtcaagtggatgtttctcattttccatgattttcacttttcttgccatatttcatgtcctaaagtgtgtatttctcattttcagtgattttcagttttctgccatattccaggtcctacattgtgcatttctcattttttcacgtttttcagtgatttcgtcatttttcacgttgtcaagtggatgtttctcattttccatgattttcacttttcttgccatatttcatgttttacagtggacatttctaaattttccacctttttctgttttcctcgccatatttcacatcctaaagtgtgtatttctcattttccgtgattttcagttttctcgccatatgccaggtcatacagggtgcatttctcatttttcacgtttttcagtgatttcgtcatttttcacgtcgtcaagtggatgtttctcattttcaatgattttcatttttcttgccatattccacgtcctatagtggacatttctaaattttccacctttttcagttttccttgccatatttcaggtcctacagtgtgcatttctcatttttcacgtttttcagtgatttcgtcatttttcaagtggtcaagtgcatgtttctcattttccgtgattttcagttttcttgccatgttccaggtcctacagttgacgtttctaaaatttcactttttttaagttttcctcgccatatttcacttcctaaagtgtgtatttctcattttccgtgattttcagttttctcgccagattccaggtcctacagtgtgcatttttcatatttcacctttttcagtgattttgtcatttttcaagttgtcaactgcatgtttctcattttccatgattttcagttttcttgccatattccatgtcctactgtggacatttctaaattttccaactttttcagttttcctcgccatatttcatgtcctaaagtgtgtatttctcattttcagtgattttctgttttctcgccatattccaggtcctacagtgtgcatttctaatttttcacgtttttcagtgatttcgtcatttttcaagttgtcaagtggatgtttctcattttccatgattttcagttttcttgccatattccatgtcctacagtggacatttctaaattttccaactttttccattttcctcaccatatttcacgtcctaaagtgtgtttttctcattttttgtgattttcagttttctcgacatattccaggtcctacagtgtgcatttctaattttttcttttttcagtgatttcgtcatttttcaagttgtcaactgcatgtttctcattttccatgattttcagttttcttgccatattccatgtcttacagtggacatttttaaatttttcacatttttttaagttttcctccccatatttcacgttttaaagtgtgcatttctcattttcggtgattttcagttttctcgccagattccaggtcttacagtgtgcatttctcattttttcacgtttttcagtgatttcgtcatttttcaagtcgtcaagtggatgtttctcattttccatgattttcagttttcttgccatattccatgtcctacagtggaaatttctaaattttccacctttttcagttttccttgccatatttcaggtcctaaagtgtgtatttctcattttctgtgattttcagttttctcgccatattccaggtcctacagttgacatttctaaaatttccacattttttaagttttcctcgccatatttcacttcctaaagtgtgtatttctcattttccgtgattttcagttttctcgccatattccagatcctacagtgtgcatttttcatttttcacgtttttcagtgattttgtcattttttagttgtcaactgtctgtttctcattttccatgattttcagttttcttgccatattccatgtcctacactggacatttctaaattttccacctttttctgttttcctcgccatatttcacgtcctaaagtgtgtatttctcattttccgtgattttcagttttcttgccatattccaggtcctacagtgtgcatttctcatttttcacgtttttcagtgattttgtcatttttcaagttgtcaactgcatgtttctcattttccatgattttcagttttcttgctatattccatgtcctacagtggaaatttctaaattttccacctttttcagttttcctcgccatatttcacgtcctaaagtgtgtatttctcattttccgtgattttcagttttctcgccatattccaggtcctatgtgtacatttctcatttttcacgtttttcagtgattttgtcatttttcaagttgtgaagtggatgtttctcatttttcttgattttcatttttcttgccatattccatgtcctagagtggaaatttttaaattttccacctttttcagttttcctcgccatatttcacgtcctaaagtgtgaatttctcattttccgtgattttcagatttctcgccatattccaagtcctacagtgtgcatttctcatttttcacgtttttcagtgatttcgtcatttttcaagttgtcaagtggatgtttctcattttccatgattttcagctttcttgccatattcaaagtcctacagtggacatttctaaattttcgacctttatcagttttcctcgccatatttcatgtcccaaagtgtgtacttctcattttccgtgattttcagtttcctcgccatattctaggtcctacagtgtgcatttctcatttttcaggtttttcagtgatttcgtcttttttcaagtcgtcaagtggatgtttctcattttccatgattttcagttttcttgccatattccatgtcctacagtggacatttctaaattttccacctttttcagttttcctcgccatatttcatgtcctaaagtgtgtatttctcattttcagtgattttcagttttctcgccatattccaggtcctacagtgtgcatttctcatttttcacgtttttcagtgatttcgtcatttttcaagttgtcaagtggatgtttctcattttccatgattttcagttttcttgccatattccatgtcccacagtggacatttctaaattttccacctttttctgttttccttgccatatttcatgtcctaaagtgtgtatttctcattttccgtgattttcagttttcttgctatattccaagtcctacagtgtgcatttctcatttttcacgtttttcagtgattttgtcatttttcaatttgtcaactgcatgtttctcattttccatgattttcagttttcttgccatattccatgtcctacagtggaaatttctatattttccaactttttcagttttcctcgccatatttcacgtgctaaagtgtgtatttctcatttttcgtgtttttcaggtttctcgccatattccaggtcctacagtgtgcatttctcatttttcacgtttttcagtgattttgtcatttttcaagttgtcaagtggatgtttctcattttccttgattttcagttttcttgccatattccatgtcctacagtggacatttctaaattttccacctttttcagttttccttgccatatttcatgtcctaaagtgtgtatttctcattttcagtgattttcagttttctcgccatattccaggtcctacagtgtgcatttctcattttttcaggtttttcagtgatttcgtcatttttcacgttgtcaagtggatgtttctcattttccatgattttcacttttcttgccatatttcatgtcctaaagtgtgtatttctcattttcagtgattttcagttttctcgctatattccaggtcctacagtgtgcatttctcattttttcacgtttttcagtgatttcgtcatttttcacgttgtcaagtggatgtttctcattttccatgattttcacttttcttgccatatttcatgtcctacagtggacatttctaaattttccacctttttctgttttcctcgccatatttcacatactaaagtgtgtatttctcattttccttgattttcagttttcttgccatattccaggtcctacagtgtgcatttctcatttttcacgtttttcagtgatttcgtcatttttcaagtcgtcaagtggatgtttctcattttccatgattttcagttttctcgccatattccaggtcctacagttgacatttctaaattttccacattttttaagtttcctcgcgatatttcacatcctaaagtgtgtatttctcattttccgtgattttcagttttcttgccatattccaggtcctacagggtgcatttctcatttttcacgtttttcagtgatttcatcaatttcaagtcgtcaactgtatgtttctcattttcaatgattttcatttttcttgccatattccatgtcctacagtggacatttctaaatttttcacctttttcagttttccttgccatatttcatgtcctaaagtgtgtatttctcattttcagtgattttcagttttctcgccatattccaggtcctacagtgtgcatttctcattttttcaggtttttcagtgatttcgtcatttttcacgttgtcaagtggatgtttctcattttccatgattttcacttttcttgccatatttcatgtcctaaagtgtgtatttctcattttcagtgattttcagttttctcgccatattccaggtcctacagtgtgcatttctcatttttcacgtttttcagtgatttcgtcatttttcaagttgtcaagtggatgtttctcattttccatgattttcacttttcttgccatattccatgtcccacagtggacatttctaaattttccacctttttctgttttcctcgccatatttcatgtcctaaagtgtgtatttctcattttccgtgattttcagttttcttgctatattccaagtcctacagtgtgcatttctcatttttcacgtttttcagtgattttgtcatttttcaatttgtcaactgcatgtttctcattttccatgattttcagttttcttgccatattccatgttctacagtggaaatttctatattttccaactttttcagttttcctcgccatatttcacgtgctaaagtgtgtatttctcatttttcgtgtttttcaggtttctcgccatattccaggtcctacagtgtgcatttctcatttttcacgtttttcagtgattttgtcatttttcaagttgtcaagtggatgtttctcattttccttgattttcagttttcttgccatattccatgtcctacagtggacatttctaaattttccacctttttcagttttccttgccatatttcatgtcctaaagtgtgtatttctcattttcagtgattttcagttttctcgccatattccaggtcctacagtgtgcatttctcattttttcaggtttttcagtgatttcgtcatttttcacgttgtcaagtggatgtttctcattttccatgattttcacttttcttgccatatttcatgtcctaaagtgtgtatttctcattttcagtgattttcagttttctcgctatattccaggtcctacagtgtgcatttctcattttttcacgttttgcagtgatttcgtcatttttcacgttgtcaagtggatgtttctcattttccatgattttcacttttcttgccatatttcatgtcctacagtggacatttctaaattttccacctttttctgttttcctcgccatatttcacatcctaaagtgtgtatttctcattttccgtgattttcagttttcttgccatattccaggtcctacagtgtgcatttctcatttttcacgtttttcagtgatttcgtcatttttcaagtcgtcaagtggatgtttctcattttccatgattttcagttttctcgccatattccaggtcctacagttgacatttctaaattttccacattttttaagtttcctcgcgatatttcacatcctaaagtgtgtatttctcattttccgtgattttcagttttcttgccatattccaggtcctacagggtgcatttctcatttttcacgtttttcagtgatttcatcaatttcaagtcgtcaactgtatgtttctcattttcaatgattttcatttttcttgccatattccatgtcctacagtggacatttctaaattttccacctttttcagttttccttgccatatttcatgtcctaaagtgtgtatttctcattttcagggattttcagttttctcgccatattccaggtcctacagtgtgcatttctcattttttcaggtttttcagtgatttcgtcatttttcacgttgtcaagtggatgtttctcattttccatgattttcacttttcttgccatatttcatgtcctaaagtgtgtatttctcattttcagtgattttcagttttctcgccatattccaggtcctacagtgtgcatttctcattttttcacgtttttcagtgatttcgtcatttttcacgttgtcaagtggatgtttctcattttccatgattttcacttttcttgccatatttcatgtcctacagtggacatttctaaattttccacctttttctgttttcctcgccatatttcacatcctaaagtgtgtatttctcattttccgtgattttcagttttcttgccatattccaggtcctacagtgtgcatttctcatttttcacgtttttcagtgatttcgtcatttttcaagtcgtcaagtggatgtttctcattttccatgattttcagttttctcgccatattccaggtcctacagttgacatttctaaattttccacattttttaagtttcctcgcgatatttcacatcctaaagtgtgtatttctcattttccgtgattttcagttttcttgccatattccaggtcctacagggtgcatttctcatttttcacgtttttcagtgatttcatcaatttcaagtcgtcaactgtatgtttctcattttcaatgattttcatttttcttgccatattccacgtcctatagtggacatttctaaattttccacctttttcagttttcttcgccatatttcacgtcccaaagtgtgtatttctcattttccgtgattttcagtttcctcgcaatattccaggtcctacagtgtgcatttctcatttttcacgtttttcagtgatttcgtcttttttcaagtcgtcaagtggatgtttctcattttccatgattttcagttttcttgccatattccatgtcctacagtggacatttctaaattttccacctttttctgttttcctcgccatatttcacgtcctaaagtgtgtatttctcattttccgtgattttcagttttcttgccatattccaggtcctacagtgtgcatttctcatttttcacgtttttcactgattttgtcattgttcaagttgtcaactgcatgtttctcattttccatgattttcaattttcttgccatattccatgtcctacagtggaaatttctatattttccaactttttcagttttcctcgccatatttcacgtgctaaagtgtgtatttctcatttttcgtgtttttcaggtttctcgccatattccaggtcctacagtgtgcatttctcatttttcacgtttttcagtgattttgtcatttttcaagttgtcaagtggttgtttctcattttccttgattttcagttttcttgccatattccatgtcctactgtggacatttctaaattttccacctttttcagttttccttgccatatttcatgtcctaaagtgtgtatttctcattttcagtgattttcagttttctcgcaatattccaggtcctacagtgtgcatttctcattttccgtgattttcagttttctcgccatatgccaggtcatacagggtgcatttctcatttttcacgtttttcagtgatttcgtcatttttcacgtcgtcaagtggatgtttctcattttcaatgattttcatttttcttgccatattccacgtcctatagtggacatttctaaattttccaactttttcagttttcttgccatatttcaggtcctacagtgtgcatttctcatttttcacgtttttcagtgatttcgtcatttttcaagtggtcaagtgcatgtttctgattttccgtgattttcagttttcttgccatgttccaggtcctacagttgacgtttctaaaatttcactttttttaagttttcctcgccatatttcacttcctaaagtgtgtatttctcattttccgtgattttcagttttctcgccagattccaggtcctacagtgtgcatttttcatatttcacctttttcagtgattttgtcatttttcaagttgtcaactgcatgtttctcattttccatgattttcagttttcttgccatattccatgtcctactgtggacatttctaaattttccaactttttcagttttcctcgccatatttcatgtcctaaagtgtgtatttctcattttcagtgtttttctgttttctcgccatattccaggtcctacagtgtgcatttctaatttttcacgtttttcagtgatttcgtcatttttcaagttgtcaagtggatgtttctcattttccatgattttcagttttcttgccatattccatgtcctacagtggacatttctaaattttccaactttttccattttcctcaccatatttcacgtcctaaagtgtgtttttctcattttttgtgattttcagttttctcgacatattccaggtcctacagtgtgcatttctaattttttcttttttcagtgatttcgtcatttttcaagtggtcaagtgcatgtttctcattttccatgattttcagttttcttgccatattccatgtcctacaatggacatttctaaattttccaactttttcagttttcctcgccatatttcacgtcctaaagtgtgtatttctcattttccgtgattttcagttttctcgccatattccaggtcctatgtgtacatttctcatttttcacgtttttcagtgattttgtcatttttcaagttgtgaagtggatgtttctcatttttcttgattttcatttttcttgccatattccatgtcctagagtggaaatttttaaattttccaactttttcagttttcctcgccatatttcacgtcctaaagtgtgtatttctcattttccgtgattttcagttttctcgccatattccaagtcctacagtgtgcatttctcatttttcacgtttttcagtgatttcgtcatttttcaagttgtcaagtggatgtttctcattttccatgattttcagctttcttgccatattcaaagtcctacagtggacatttctaaattttcgacctttatcagttttcctcgccatatttcatgtcccaaagtgtgtacttctcattttccgtgattttcagtttcctcgccatattctaggtcctacagtgtgcatttctcatttttcaggtttttcagtgatttcgtcttttttcaagtcgtcaagtggatgtttctcattttccatgattttcagttttcttgccatattccatgtcctacagtggacatttctaaattttccacctttttcagttttcctcgccatatttcatgtcctaaagtgtgtatttctcattttcagtgattttcagttttctcgccatattccaggtcctacagtgtgcatttctcatttttcacgtttttcagtgatttcgtcatttttcaagttgtcaagtggatgtttctcattttccatgattttcagttttcttgccatattccatgtcccacagtggacatttctaaattttccacctttttctgttttccttgccatatttcatgtcctaaagtgtgtatttctcattttccgtgattttcagttttcttgctatattccaagtcctacagtgtgcatttctcatttttcacgtttttaagtgattttgtcatttttcaatttgtcaactgcatgtttctcattttccatgattttcagttttcttgccatattccatgtcctacagtggaaatttctatattttccaactttttcagttttcctcgccatatttcacgtgctaaagtgtgtatttctcatttttcgtgtttttcaggtttctcgccatattccaggtcctacagtgtgcatttctcatttttcacgtttttcagtgattttgtcatttttcaagttgtcaagtggatgtttctcattttccttgattttcagttttcttgccatattccatgtcctacagtggacatttctaaattttccacctttttcagttttccttgccatatttcatgtcctaaagtgtgtatttctcattttcagtgattttcagttttctcgccatattccaggtcctacagtgtgcatttctcattttttcaggtttttcagtgatttcgtcatttttcacgttgtcaagtggatgtttctcattttccatgattttcacttttcttgccatatttcatgtcctaaagtgtgtatttctcattttcagtgattttcagttttctcgccatattccaggtcctacagtgtgcatttctcattttttcacgtttttcagtgatttcgtcatttttcacgttgtcaagtggatgtttctcattttccatgattttcacttttcttgccatatttcatgtcctacagtggacatttctaaattttccacctttttctgttttcctcgccatatttcacatcctaaagtgtgtatttctcattttccgtgattttcagttttcttgccatatttcaggtcctacagtgtgcatttctcatttttcacgtttttcagtgatttcgtcatttttcaagtcgtcaagaggatgtttctcattttccatgattttcagttttctcgccatattccaggtcctacagttgacatttctaaattttccacattttttaagtttcctcgcgatatttcacatcctaaagtgtgtatttctcattttccgtgattttcagttttcttgccatattccaggtcctacagggtgcatttctcatttttcacgtttttcagtgatttcatcaatttcaagtcgtcaactgtatgtttctcattttcaatgattttcatttttcttgccatattccacgtcctatagtggacatttctaaattttccacctttttctgttttcctcgccatatttcacgtcctaaagtgtgtatttctcattttccgtgattttcagttttcttgccatattccaggtcctacagtgtgcatttctcatttttcacgtttttcactgattttgtcattgttcaagttgtcaactgcatgtttctcattttccatgattttcagttttcttgccatattccatgtcctacagtggaaatttctatattttccacctttttcagttttcctcgccgtatttcatgtgctaaagtgtgtatttctcatttttcgtgtttttcaggtttctcgccatattccaggtcctacagtgtgcatttctcatttttcacgtttttcagtgattttgtcatttttcaagttgtcaactggatgtttctcattttccttgattttcagttttcttgccatattccatgtcctactgtggacatttctaaattttccacctttttcagttttccttgccatatttcatgtcctaaagtgtgtatttctcattttcagtgattttcagttttctcgcaatattccaggtcctacagtgtgcatttctcattttttcaggtttttcagtgatttcgtcatttttcacgttgtcaagtggatgtttctcattttccatgattttcacttttcttgccatatttcatgtcctaaagtgtgtatttctcattttcagtgattttcagttttctcgccatattccaggtcctacattgtgcatttctcattttttcacgtttttcagtgatttcgtcatttttcacgttgtcaagtggatgtttctcattttccatgattttcacttttcttgccatatttcatgttttacagtggacatttctaaattttccacctttttctgttttcctcgccatatttcacatcctaaagtgtgaatttctcattttccgtgattttcagttttcttgccatattccaggtcctacagtgtgcatttctcatttttcacgtttttcagtgatttcatcatttttcaagtcgtcaagtggatgtttctcattttccatgattttcagttttcttgccatattccatgtcctacagtggacatttctaaattttccacctttttctgttttcctcgccatatttcacgtcctaaagtgtgtatttctcattttccgtgattttcagttttcttgccatattccaggtcctacagtgtgcatttctcatttttcacgtttttcactgattttgtcatttttcaagttgtcaactgcatgtttctcattttccatgattttcagttttcttgctatattccatgtcctacagtggaaatttctaaattttccacctttttcagttttcctcgccatatttcacgtcctgaagtgtgtatttctcattttccgtgattttcagttttctcgccatattccaggtcctatgtgtacatttctcatttttcacgtttttcagtgattttgtcatttttcaagttgtgaagtggatgtttctcatttttcttgattttcatttttcttgccatattccatgtcctacagtggaaatttctaaattttccacctttttcagttttcctcgccatatttcacgtcctaaagtgtgtatttctcattttccgtgattttcagttttctcgccatattccaggtcctacagtgtgcatttctcatttttcacgtttttcagtgatttcgacatttttcaagttgtcaagtggatgtttctcattttccatgattttcagctttcttgccatattcaaagtcctacagtggacatttctaaattttcgacctttatcagttttcctcgccatatttcatgtcccaaagtgtgtacttctcattttccgtgattttcagtttcctcgccatattccaggtcctacagtgtgcatttctcatttttcacgtttttcagtgatttcgtcatttttcaagtcgtcaagtggatgtttctcattttccatgattttcagttttcttgccatattccatgtcctacagtggacatttctaaattttccacctttttctgttttcctcgccatatttcacgtcctaaagtgtgtatttctcattttccgtgattttcagttttcttgccatattccaggtcctacagtgtgcatttctcatttatcacgtttttcactgattttgtcatttttcaagttgtcaactgcatgtttctcattttccatgattttcagttttcttgctatattccatgtcctacagtggaatattctaaattttccacctttttcagttttcctcgccatatttcacgtcctgaagtgtgtatttctcattttccgtgattttcagttttctcgccatattccaggtcctatgtgtacatttctcatttttcacgtttttcagtgattttgtcatttttcaagttgtgaagtggatgtttctcatttttcttgattttcatttttcttgccatattccatgtcctacagtggaaatttctaaattttccacctttttcagttttcctcgccatatttcacgtcctaaagtgtgaatttctcattttccgtgattttcagttttctcgccatattccaggtcctacagtgtgcatttctcatttttcacgtttttcagtgatttcgacatttttcaagttgtcaagtggatgtttctcattttccatgattttcagctttcttgccatattcaaagtcctacagtggacatttctaaattttcgacctttatcagttttcctcgccatatttcatgtcccaaagtgtgtacttctcattttccgtgattttgagtttcctcgccatattccaggtcctacagtgtgcatttctcatttttcacgtttttcagtgatttcgtcttttttcaagttgtcaactgcatgtttctcattttccatgattttcagttttcttgccatattccatgtcctacagtggaaatttgtaaatttccacctttttcagttttcctcgccatatttcacgtcctaaagtatgtatttctcattttccgtgattttcagttttctcgccatattccaggtcctacagtgtgcatttctcatttttcacgtttttcagtgattttgtcattttttaagttttcaagtggatgtttctcattttccttgattttcagttttcttgccatattccatgtcctacagtggacatttctaaattttccacctttttcagttttcctcgccatatttcatgtcctaaagtgtgtatttctcattttcagtgattttcagttttctcgccatattccaggtcctacagtgtgcatttctcatttttcacgtttttcagtgatttcgtcatttttcaaggtgtcaagtggatgtttctcattttccatgattttcagttttcttgccatattccatgtcctacagtggacatttctaaattttccacctttttctgttttcctcgccatatttcatgtcctaaagtgtgtatttctcattttccgtgattttcagttttcttgctatattccaagtcctacagtgtgcatttctcatttttcacgtttttcagtgattttgtcatttttcaatttgtcaactgcatgtttctcattttccatgattttcagtttttttgccatattccatgtcctactgtggaaatttctatattttccacctttttcagttttcctcgccatatttcacgtgctaaagtgtgtatttctcatttttcgtgtttttcaggtttctcgccatattccaggtcctacagtgtgcatttctcatttttcacgtttttcagtgattttgtcatttttcaagttttcaagtggatgtttctcattttccttgattttcagttttcttgccatattccatgtcctacagtggacatttctaaattttccacctttttcagttttccttgccatatttcatgtcctaaagtgtgtatttctcattttcagtgattttcagtttccttgccatattccaggtcctacagtgtgcatttctcattttttcacgtttttcagtgatttcgtcatttttcacgttgtcaagtggatgtttctcattttccatgattttcacttttcttgccatatttcatgtcctacagtggacatttctaaattttccaactttttcaattttcctcgccatattttatgtcctaaagtgtgtatttctcatttttcgttattttcagttttcttgccatattccaggtcctacagtgtgcatttgtcatttttcacgtttttcagtgatttcgtcatttttcaagtcgtcaagtagatgtttctcatattccatgtttttcagttttctcgccatattccaggtcctacagttgacatttctaaattttctacatttttaaattttcctcgccatatttcacgtcctaaagtgtgtatttctcattttttgttattttcagttttctagccatattccaggtcctacaggatgcatttctcatttttcacgtttttcagtgatttcatcatttttcaagtcgtcaagtgtatgtttcttattttcaatgattttcatttttcttgccttattccacgtcctatagtggacatttctaaattttccacctttttcagtttttttcgccatatttcacgtcctaaagtgtgtatttctcattttctgtgattttcagttttctcaccatattccaggtcctacagtgtgcatttctcatttttcacgtttttcagtgatttcgtcatttttcaagttgtcaagtggaagtttctcattttccatgattttcagctttctagacatattccaggtcctacagtggacatttcctaattttcgacctttatcagttttcctcgtcatatttcacgtcccaaaatgtgtatttcttattttccatgattttcagtttcctcgccatattccaggtcctacagtgtgcaattctcatttttcacgtttttcagtgatttcgtcttttttcaagacgtcaagtggatgtttctcatttttcatgattttcagttttcttgccatattccatgtcctacagtggacatttctaaattttccacctttttctgttttcctcgccatatttcacgtcctaaagtgtgtatttctcattttccgtgattttcagttttcttgccatattcctggtcctacagtgtgcatttctcatttttcacgtttttcagtgattttgtcatttttcaatttgtcaactgcatgtttctcattttccattattttcagttttcttgccatattccatgtcctacagtggacatttctaaattttccacctttttctgttttcctcgccatatttcatgtcctaaagtgtgtatttctcattttccgtgattttcagttttcttgctatattccaagtcctacagtgtgcatttctcatttttcacgtttttcagtgattttgtcatttttcaatttgtcaactgcatgtttctcattttccatgattttcagtttttttgccatattccatgtcctacaggggaaatttctatattttccacctttttcagttttcctcgccatatttcatgtcctaaagtgtgtatttctcattttccgtgattttcagttttcttgccatattccaggtcctacagtgtgcatttctcatttttcacgtttttcagtgatttcgtcatttttcaagtcttcaagtagatgtttctcatattccatgtttttcagttttctcgccatattccaggtcctacagttgacatttctaaattttctacatttttaaattttcctcgccatatttcacgtcctaaagtgtgtatttctcatttttcgttattttcagttttctagccatattccaggtcctacaggatgcatttctcatttttcacgtttttcagtgatttcatcatttttcaagtcgtcaagtgtatgtttctcattttcaatgattttcatttttcttgccttattccacgtcctatagtggacatttctaaattttccacctttttcagtttttctcgccatatttcacgtcctaaagtgtgtatttctcattttctgtgattttcagttttctcaccatattccaggtcctacagtgtgcatttctcatttttcacgtttttcagtgatttcgtcatttttcaagttgtcaagtggaagtttctcattttccatgattttcagctttctagccatattccaggtcctacagtggacatttcctaattttcgacctttatcagttttcctcgccatatttcacgtcctaaagtgtgtatttctcattttccgtgattttcagttttcttgccatattccaggtcctacagtgtgcatttctcatttttcacgtttttcagtgattttgtcatttttcaatttgtcaactgcatgtttctcattttccatgatttttagttttcttgctatattccatgtcctacagtggaaatttctaaattttccacctttttcagttttcctcgccatatttcacgtcctaaagtgtgtatttctcattttccgtgattttcagttttcttgctatattccaagtcctacattgtgcatttctcatttttcacgtttttcagtgattttgtcatttttcaatttgtcaaaccacatgtttctcattttccatgattttcagtttttttgccatattccatgtcctacagtggaaatttctatattttccacctttttcagttttcctcgccatatttcacgtgctaaagtgtgtatttctcatttttcgtgtttttcaggtttctcgccatattccaggtcctacagtgtgcatttctcatttttcacgtttttcagtgattttgtcatttttcaagttgtcaagtggatgtttcccattttccttgattttcagttttcttaccatattccatgtcctacagtggacatttctaaattttccacctttttcagttttccttgccatatttcatgtcctaaagtgtgtatttctcattttcagtgattttcagtttcctcgccatattccaggtcctacagtgtgcatttctcattttttcacgtttttcagtgatttcgtcatttttcacgttgtcaagtggatgtttctcattttccatgattttcacttttcttgccatatttcatgtcctatagtggacatttctaaattttccacctttttcagtttttctcgccatatttcacgtcctaaagtgtgtatttctcattttctgtgattttcagttttctcaccatattccaggtcctacagtgtgcatttctcatttttcacgtttttcagtgatttcgtcatttttcaagtcgtcaagtagatgtttctcatattccatgtttttcagttttctcgccatattccaggtcctacagttgacatttctaaattttctacatttttaaattttcctcgccatatttcacgtcctaaagtgtgtatttctcatttttcgttattttcagttttctagccatattccaggtcctacaggatgcatttctcatttttcacgtttttcagtgatttcatcatttttcaagtcgtcaagtgtatgtttcttattttcaatgattttcatttttcttgccttattccacgtcctatagtggacatttctaaattttccaccttttttcagtttttctcgccatatttcacgtcctaaagtgtgtatttctcattttctgtgattatcagttttctcaccatattccaggtcctacagtgtgcatttctcatttttcacgtttttcagtgatttcgtcatttttcaagttgtcaagtggaagtttctcattttccatgattttcagctttctagccatattccaggtcctacagtggacatttcctaattttcgacctttatcagttttcctcgccatatttcacgtcccaaaatgtgtatttcttattttccatgattttcagtttcctcgccatattccaggtcctacagtgtgcatttctcatttttcacgtttttcagtgatttcgtcttttttcaagacgtcaagtggatgtttctcatttttcatgattttcagttttcttgccatattccatgtcctacagtggacatttctaaattttccacctttttctgttttcctcgccatatttcacgtcctaaagtgtgtatttctcattttccgtgattttcagttttcttgccatattcctggtcctacagtgtgcatttctcatttttcacgtttttcagtgattttgtcatttttcaatttgtcaactgcatgtttctcattttccatgattttcagttttcttgccatattccatgtcctacagtggacatttctaaattttccacctttttcagttttcctcgccatatttcacgtgctaaagtgtgtatttctcatttttcgtgtttttcaggtttctcgccatattccaggtcctacagtgtgcatttctcatttttcacgtttttcagtgattttgtcatttttcaagttgtcaagtggatgtttctcattttccttgattttcacttttcttgccatattccaagtcttacaggggcatttctcatttttcacgttttcagtgattttgtcattttcaatttgtcaactgcatgtttctcattttccatgattttcagtttttttgccatattccatgtcctacaggggaaatttctatattttccacctttttcagttttcctcgccatatttcatgtcctaaagtgtgtatttctcattttccgtgattttcagttttcttgccatattccaggtcctacagtgtgcatttctcatttttcacgtttttcagtgatttcgtcatttttcaagtcttcaagtagatgtttctcatattccatgtttttcagttttctcgccatattccaggtcctacagttgacatttctaaattttctacatttttaaattttcctcgccatatttcacgtcctaaagtgtgtatttctcatttttcgttattttcagttttctagccatattccaggtcctacaggatgcatttctcatttttcacgtttttcagtgatttcatcatttttcaagtcgtcaagtgtatgtttctcattttcaatgattttcatttttcttgccttattccacgtcctatagtggacatttctaaattttccacctttttcagtttttctcgccatatttcacgtcctaaagtgtgtatttctcattttctgtgattttcagttttctcaccatattccaggtcctacagtgtgcatttctcatttttcacgtttttcagtgatttcgtcatttttcaagttgtcaagtggaagtttctcattttccatgattttcagctttctagccatattccaagtcctacagtggacatttcctaattttcgacctttatcagttttcctcgccatatttcacgtcccaaaatgtgtattccttattttccatgattttcagtttcctcgccatattccaggtcctacagtgtgcatttatcatttttcacgtttttcagtgatttcgtcttttttcaagacgtcaagtggatgtttctcatttttcatgattttcagttttcttgccatattccatgtcctacagtggacatttctaaattttccacctttttctgttttcctcgccatatttcacgtcctaaagtgtgtatttctcattttccgtgattttcagttttcttgccatattcctggtcctacagtgtgcatttctcatttttcacgtttttcagtgattttgtcatttttcaagttgtcaagtggatgtttctcattttccttgattttcacttttcttgccatattccatgtcctacagtggacatttctatattttccacctttttccgttttccttgccatatttcacgtcctaaagtgtgtatttctcattttccgtgattttcaggtttctcgccatattccaggtcctacagtgtgcatttctcatttttcacgtttttcagtgattttgtcatttttcaagttgtcaagtggatgtttctcattttccttgattttcacttttcttgccatattccatgtcctacagtggacatttctaaattttccacctttttcagttttcctcgccatatttcatgtcctaaagtgtgtatttctcattttcagtgattttcagttttcttgccatattccaggtcctacagtgtgcatttctcatttttcacgtttttcagtgattttgtcatttttcaagttgtcaactgcatgtttctcattttctatgattttcagttttcttgctatattccatgtcctacagtggaaatttctaaattttccacctttttcagttttcctcgccatatttcacgtcctaaagtgtgtatttctcattttccgtgattttcagttttctcgccatattccaggtcctatgtgtacatttctcatttttcacgtttttcagtgattttgtcatttttcaagttgtgaagtggatgtttctcatttttcttgattttcatttttcttgccatattccatgtcctagagtggaaatttttaaattttccacctttttcagttttcctcgccatatttcacgtcctaaagtgtgaatttctcattttccgtgattttcagatttctcgccatattccaagtcctacagtgtgcatttctcatttttcacgtttttcagtgatttcgtcatttttcaagttgtcaagtggatgtttctcattttccatgattttcagctttcttgccatattcaaagtcctacagtggacatttctaaattttcgacctttatcagttttcctcgccatatttcatgtcccaaagtgtgtacttctcattttccgtgattttcagtttcctcgccatattctaggtcctacagtgtgcatttctcatttttcaggtttttcagtgatttcgtcttttttcaagtcgtcaagtggatgtttctcattttccatgattttcacttttcttgccatatttcatgtcctaaagtgtgtatttctcattttcagtgattttcagttttctcgctatattccaggtcctacagtgtgcatttctcattttttcacgtttttcagtgatttcgtcatttttcacgttgtcaagtggatgtttctcattttccatgattttcacttttcttgccatatttcatgtcctacagtggacatttctaaattttccacctttttctgttttcctcgccatatttcacatcctaaagtgtgtatttctcattttccgtgattttcagttttcttgccatattccaggtcctacagtgtgcatttctcatttttcacgtttttcagtgatttcgtcatttttcaagttgtcaagtggatgtttctcattttccttgattttcagttttcttgccatattccatgtcctactgtggacatttctaaattttccacctttttcagttttccttgccatatttcatgtcctaaagtgtgtatttctcattttcagtgattttcagttttctcgcaatattccaggtcctacagtgtgcatttctcattttttcaggtttttcagtgatttcgtcatttttcacgttgtcaagtggatgtttctcattttccatgattttcacttttcttgccatatttcatgtcctaaagtgtgtatttctcattttcagtgattttcagttttcctcgccatatttcacgtcccaaaatgtgtatttcttattttccatgattttcagtttcctcgccatattccaggtcctacagtgtgcatttctcatttttcacgtttttcagtgatttcgtcttttttcaagacgtcaagtggatgtttctcatttttcatgattttcagttttcttgccatattccatgtcctacagtggacatttctaaattttccacctttttctgttttcctcgccatatttcacgtcctaaagtgtgtatttctcattttccgtgattttcagttttcttgccatattcctggtcctacagtgtgcatttctcatttttcacgtttttcagtgattttgtcatttttcaatttgtcaactgcatgtttctcattttccatgattttcagttttcttgccatattccatgtcctacagtggacatttctaaattttccacctttttcagttttcctcgccatatttcacgtgctaaagtgtgtatttctcatttttcgtgtttttcaggtttctcgccatattccaggtcctacagtgtgcatttctcatttttcacgtttttcagtgattttgtcatttttcaagttgtcaagtggatgtttctcattttccttgattttcacttttcttgccatattccatgtcctacagtggacatttctaaattttccacctttttcagttttcctcgccatatttcatgtcctaaagtgtgtatttctcattttcagtgattttcagttttctcgccatattccaggtcctacagtgtgcatttctcatttttcacgtttttcagtgatttcgtcttttttcaagacgtcaagtggatgtttctcattttccatgattttcagttttcttgccatattccatgtcctacagtggacatttctaaattttccacctttttctgttttcctcgccatatttcacgtcctaaagtgtgtatttctcattttccgtgattttcagttttcttgccatattccaggtcctacagtgtgcatttctcatttttcacgtttttcagtgattttgtcatttttcaatttgtcaactgcatgtttctcattttccatgatttttagttttcttgctatattccatgtcctacagtggaaatttctaaattttccacctttttcagttttcctcgccatatttcacgtcctaaagtgtgtatttctcattttccgtgattttcagttttcttgctatattccaagtcctacattgtgcatttctcatttttcacgtttttcagtgattttgtcatttttcaatttgtcaaaccacatgtttctcattttccatgattttcagtttttttgccatattccatgtcctacagtggaaatttctatattttccacctttttcagttttcctcgccatatttcacgtgctaaagtgtgtatttctcatttttcgtgtttttcaggtttctcgccatattccaggtcctacagtgtgcatttctcatttttcacgtttttctgtgattttgtcatttttcaagttgtcaagtggatgtttctcattttccttgattttcagttttcttaccatattccatgtcctacagtggacatttctaaattttccaccttttctgttttcctcgccatatttcatgtcctaaagtgtgtatttctcattttccgtgattttcatttttcttgctatattccaagtcctacagtgtgcatttctcattttccatgattttcagttttcttgctatattccatgtcctacagtggaaatttctaaattttccacctttttcagttttcctcgccatatttcacgtcctaaagtgtgtatttctcattttccgtgattttcagttttttcgccatattacaggtcctatgtgtacatttctcatttttcacgtttttcagtgattttgtcatttttcaagttgtcaagtggatgtttctcatttttcttgattttcatttttcttgccatattccatgtcctacagtggaaatttctaaattttccacctttttcagttttcctcgccatatttcacgtcctaaagtgtgaatttctcattttccgtgattttcagttttctcgccatattccaggtctacagtgtgcatttctcatttttcacgttttcagtgattcgtcatttttcaagttgacaagtggatgtttctcattttccatgattttcagctttcttgccatattcaaagtcctacagtggacatttctaaattttcgacctttatcagttttcctcgccatatttcatgtcccaaagtgtgtacttctcattttccgtgattttcagttttcttgccatattccaagtcctacagtgtgcatttctcatttttcacgtttttcagtgattttgtcatttttcaatttgtcaactgcatgtttctcattttccatgattttcagttttcttgccatattccatgtcctacagtggaaatttctatattttccacctttttcagttttcctcgccatatttcacgtgctaaagtgtgtatttctcatttttcgtgtttttcaggtttctcgccatattccaggtcctacagtgtgcatttctcatttttcacgtttttcagtgattttgtcatttttcaagttgtcaagtggatgtttctcattttcaatgattttcatttttcttgccttattccacgtcctatagtggacatttctaaattttccacctttttcagtttttctcgccatatttcacgtcccaaaatgtgtattccttattttccatgattttcagtttcctcgccatattccaggtcctacagtgtgcatttctcatttttcacgtttttcagtgatttcgtcttttttcaagacgtcaagtggatgtttctcatttttcatgattttcagttttcttgccatattccctgtcctacagtggacatttctaaattttccacctttttctgttttcctcgccatatttcacgtcctaaagtgtgtatttctcattttccgtgattttcagttttctcgccagattccaggtcctacagtgtgcatttctcatttttcacgtttttcagtgattttgtcatttttcaatttgtcaactgcatgtttctctctttccatgattttcagttttcttgccatattccatgtcctacagtggacatttctaaattttccacctttttcagttttcctcgccatatttcacgtgctaaagtgtgtatttctcatttttcgtgtttttcaggtttctcgccatattccaggtcctacagtgtgcatttctcatttttcacgtttttcagtgattttgtcatttttcaagttgtcaagtggatgtttctcattttcaatgattttcatttttcttaccttattccacgtcctatagtggacatttctaaattttccacctttttcagtttttctcgccatatttcacgtcccaaaatgtgtattccttattttccatgattttcagtttcctcgccatattccaggtcctacagtgtgcatttctcatttttcacgtttttcagtgatttcgtcttttttcaagacgtcaagtggatgtttctcatttttcatgattttcagttttcttgccatattccctgtcctacagtggacatttctaaattttccacctttttctgttttcctcgccatatttcacgtcctaaagtgtgtatttctcattttccgtgattttcagttttctcgccagattccaggtcctacagtgtgcatttctcatttttcacgtttttcagtgatttcgtcatttttcaagtcttcaagtgtatgtttctcattttcaatgattttcatttttcttgccttattccacgtcctatagtggacatttctaaattttccacctttttcagtttttctcgccatatttcacgtcctaaagtgtgtatttctcattttctgtgattttcagttttcttaccatattccaggtcctacagtgtgcatttctcatttttcacgtttttcagtgatttcgtcatttttcaagttgtcaagtggaagtttctcattttccatgattttcagctttctagccatattccaggtattacagtggacatttccttattttcgacctttatcagttttcctcgccatatttcatgtcctaaagtgtgt	38399	1554	4%	7300	19%
9	3000001	3038400	Atcctacagtgtgcatttctcatttttcacgtttttcagtgatttcgtcatttttcaagtcatcaagtggctgtttctcattttccatgattttcagttttcttgccatattccttgtcctacagtggacatttctaaattttccacctttttcagttttccttgtcatatttcaggtcctacagtgtgtatttctcatttttcacgtttttcattgatttcgtcatttttcaagttgtcaagtgcatgtttctcattttccatgattttcagttttcttgccatattccatgtcctacaatggacatttctaaattttccaactttttcagttttcctcgccatatttcacgtcctaaagtgtgtatttctcattttccgtgattttcagttttctcgacatattccaggtcctacagtgtgcatttctcatttttcacgtttttcagtgatttcgtcatttttcacgtcgtcaagtggatgtttctcattttccatgattttcagttttcttgccatattccatgtcctacagtggacatttctaaattttccacctttttcagttttcctcgccatatttcacgtcctaaagtgtgtatttctcattttccgtgattttcagttttctcgacatattccaggtcttacagggtgcatttctcatttttcacgtttttcagtgatttcatcatttttcaagtcgtcaactgtatgtttctcattttcaatgattttcatttttcttgccatattccacgtcctatagtggacatttctaaattttccacctttttcagttttccttgccatatttcaggtcctacagtgtgcatttctcatttttcacgtttttcagtgatttcgtcatttttcaagtggtcaaatgcatgtttctcattttccatgattttcagttttcttgccatattccatgtcctacagtggacatttctaaattttccacctttttcagttttcctcgccatatttcacgtcctaaagtgtgtatttctcattttccgtgattttcagttttatcgccagattccaggtcctacggtgtgcatttttcatatttcacgtttttcagtgattttgtcatttttcaagttgtcaactgcatgtttctcattttccatgattttcagttttcttgccatattccatgtcctacagtggacatttctaaattttccacctttttcagttttcctcgccatatttcatgtcctaaagtgtgtatttctcattttcagtgattttctgttttctcgccatattccaggtcctacagtgtgcatttctcatttttcacgtttttcagtgatttcgtcatttttcaagttgtcaagtggatgtttctcattttccatgattttcagttttcttgccatattccatgtcctacaatggacatttctaaattttccacctttttcagttttcctcgccatatttcacgtcctaaagtgtgtatttctcattttccgtgattttcagttttctcgccatattccaggtcctatgtgtacatttctcatttttcacgtttttcagtgattttgtcatttttcaagttgtgaagtggatgtttctcatttttcttgattttcatttttcttgccatattccatgtcctagagtggaaatttttaaattttccacctttttcagttttcctcgccatatttcacgtcctaaagtgtgaatttctcattttccgtgattttcagttttctcgccatattccaagtcctacagtgtgcatttctcatttttcacgtttttcagtgatttcgtcatttttcaagttgtcaagtggatgtttctcattttccatgattttcagctttcttgccatattcaaagtcctacagtggacatttctaaattttcgacctttatcagttttcctcgccatatttcatgtcccaaagtgtgtacttctcattttccgtgattttcagtttcctcgccatattctaggtcctacagtgtgcatttctcatttttcaggtttttcagtgatttcgtcttttttcaagtcgtcaagtggatgtttctcattttccatgattttcagttttcttgccatattccatgtcctacagtggacatttctaaattttccaactttttcagttttcctcgccatatttcatgtcctaaagtgtgtatttctcattttcagtgattttcagttttctcgccatattccaggtcctacagtgtgcatttctcatttttcacgtttttcagtgatttcgtcatttttcaagttgtcaagtggatgtttctcatttttcatgattttcagttttcttgccatattccatgtcccacagtggacatttctaaatgttccacctttttctgttttccttgccatatttcatgtcctaaagtgtgtatttctcattttccgtgattttcagttttcttgctatattccaagtcctacagtgtgcatttctcatttttcacgtttttctgtgattttttcatttttcaatttgtcaactgcatgtttctcattttccatgattttcagttttcttgccatattccaggtcctacagtgtgcatttctcatttttcacgtttttcagtgattttgtcatttttcaagttgtcaactgcatgtttctcattttccatgattttcagttttcttgctatattccatgtcctacagtggaaatttctaaattttccacctttttcagttttcctcgccatatttcacgtcctaaagtgtgtatttctcattttccgtgattttcagttttctcgccatattccaggtcctatgtgtacatttctcatttttcacgtttttcagtgattttgtcatttttcaagttgtgaagtggatgtttctcatttttcttgattttcatttttcttgccatattccatgtcctagagtggaaatttttaaattttccacctttttcagttttcctcgccatatttcacgtcctaaattgtgaatttctcattttccgtgattttcagttttctcgccatattccaagtcctacagtgtgcatttctcatttttcacgtttttcagtgatttcgtcatttttcaagttgtcaagtggatgtttctcattttccatgattttcagctttcttgccatattcaaagtcctacagtggacatttctaaattttcgacctttatcagttttcctcgccatatttcatgtcccaaagtgtgtacttctcattttccgtgattttcagtttcctcgccatattctaggtcctacagtgtgcatttctcatttttcaggtttttcagtgatttcgtcttttttcaagtcgtcaagtggatgtttctcattttccatgattttcagttttcttgccatattccatgtcctacagtggacatttctaaattttccacctttttcagttttcctcgccatatttcatgtcctaaagtgtgtatttctcattttcagtgattttcagttttctcgccatattccaggtcctacagtgtgcatttctcatttttcacgtttttcagtgattttgtcatttttcaagttgtcaagtggatgtttctcattttccttgattttcagttttcttgccatattccatgtcctacagtggacatttctaaattttccacctttttcagttttccttgccatatttcatgtcctaaagtgtgtatttctcattttcagtgattttcagttttctcgccatattccaggtcctacagtgtgcatttctcattttttcaggtttttcagtgatttcgtcatttttcacgttgtcaagtggatgtttctcattttccatgattttcacttttcttgccatatttcatgtcctaaagtgtgtatttctcattttcagtgattttcagttttctcgccatattccaggtcctacagtgtgcatttctcattttttcacgtttttcagtgatttcgtcatttttcacgttgtcaagtggatgtttctcattttccattattttcacttttcttgccatatttcatgtcctacagtggacatttctaaattttccacctttttctgttttcctcgccatatttcacatcctaaagtgtgtatttctcattttccgtgattttcagttttcttgccatattccaggtcctacagtgtgcatttctcatttttcacgtttttcagtgatttcgtcatttttcaagtcgtcaagtggatgtttctcattttccatgattttcagttttctcgccatattccaggtcctacagttgacatttctaaattttccacattttttatgtttcctcgcgatatttcacatcctaaagtgtgtatttctcattttccgtgattttcagttttcttgccatattccaggtcctacagggtgcatttctcatttttcacgtttttcagtgatttcatcaatttcaagtcgtcaactgtatgtttctcattttcaatgattttcatttttcttgccatattccacgtcctatagtggacatttctacattttccacctttttcagttttcttcgccatatttcacgtcccaaagtgtgtatttctcattttccgtgattttcagtttcctcgccatattccaggtcctacagtgtgcatttctcatttttcacgtttttcagtgatttcgtcttttttcaagtcgtcaagtggatgtttctcattttccatgattttcagttttcttgccatattccatgtcctacagtggacatttctaaattttccacctttttctgttttcctcgccatatttcacgtcctaaagtgtgtatttctcatttaccgtgattttcagttttcttgctatattccaagtcctacagtgtgcatttctcatttttcacgtttttcactgattttgtcattgttcaagttgtcaactgcatgtttctcattttccatgattttcagttttcttgccatattccatgtcctacagtggaaatttctatattttccaactttttcagttttcctcgccatatttcacgtgctaaagtgtgtatttctcatttttcgtgtttttcaggtttctcgccatattccaggtcctacagtgtgcatttctcatttttcacgtttttcagtgattttgtaatttttcaagttgtcaagtggatgtttctcattttccttgattttcagttttcttgccatattccatgtcctactgtggacatttctaaattttccacctttttcagttttccttgccatatttcatgtcctaaagtgtgtatttctcattttcagtgattttcagttttctcgcaatattccaggtcctacagtgtgcatttctcattttttcaggtttttcagtgatttcgtcatttttcacgttgtcaagtggatgtttctcattttccatgattttcacttttcttgccatatttcatgtgctaaagtgtgtatttctcattttcagtgattttcagttttctgccatattccaggtcctacattgtgcatttctcattttttcacgtttttcagtgatttcgtcatttttcacgttgtcaagtggatgtttctcattttccatgattttcacttttcttgccatatttcatgttttacagtggacatttctaaattttccacctatttctgttttcctcgccatatttcacatcctaaagtgtgtatttctcattttccgtgattttcagttttctcgccatatgccaggtcatacagggtgcatttctcatttttcacgtttttcagtgatttcgtcatttttcacgtcgtcaagtggatgtttctcattttcaatgattttcatttttcttgccatattccacgtcctatagtggacatttctaaattttccacctttttcagttttccttgccatatttcaggtcctacagtgtgcatttctcttttttcacgtttttcagtgatttcgtcatttttcaagtggtcaagtgcatgtttctcattttccgtgattttcagttttcttgccatgttccaggtcctacagttgacgtttctaaaatttcactttttttaagttttcctcgccatatttcacttcctaaagtgtgtatttctcattttccgtgattttcagttttctcgccagattccaggtcctacagtgtgcatttttcatatttcacctttttcagtgattttgtcatttttcaagttgtcaactgcatgtttctcattttccatgattttcagttttcttgccatattccatgtcctactgtggacatttctaaattttccaactttttcagttttcctcgccatatttcatgtcctaaagtgtgtatttctcattttcagtgattttctgttttctcgccatattccaggtcctacagtgtgcatttctaatttttcacgtttttcagtgatttcgtcatttttcaagttgtcaagtggatgtttctcattttccatgattttcagttttcttgccatattccatgtcctacagtggacatttctaaattttccaactttttccattttcctcaccatatttcacgtcctaaagtgagtttttctcattttttgtgattttcagttttctcgacatattccaggtcctacagtgtgcatttctaattttttcttttttcagtgatttcgtcatttttcaagtggtcaagtgcatgtttctcattttccatgattttcagttttcttgccatattccatgtcctacaatggacatttctaaattttccaactttttcagttttcctcgccatatttcacgtcctaaagtgtgtatttctcattttccgtgattttcagttttctcgccatattccaggtcctacagtgtgcatttctcatttttcacgtttttcagtgatttcgtcatttttcaagttgtcaactgcatgtttctcattttccatgattttcagttttcttgccatattccatgtcttacagtggacatttttaaatttttcacatttttttaagttttcctccccatatttcacgttttaaagtgtgcatttctcattttcggtgattttcagttttctcgccagattccatgtcttacagtgtgcatttctcattttttcacgtttttcagtgatttcgtcatttttcaagtcgtcaagtggatgtttctcattttccatgattttcagttttcttgccatattccatgtcctacagtggaaatttctaaattttccacctttttcagttttccttgccatatttcaggtcctaaagtgtgtatttctcattttctgtgattttcagttttctcgccatattccaggtcctacagttgacatttctaaaatttccacattttttaagttttcctcgccatatttcacttcctaaagtgtgtatttctcattttccgtgattttcagttttctcgccatattccagatcctacagtgtacatttttcatttttcacgtttttcagtgattttgtcattttttagttgtcaactgcctgtttctcattttccatgattttcagttttcttgctatattccatgtcctacagtggaaatttctaaattttccacctttttcagttttcctcgccatatttcacgtcctaaagtgtgtatttctcattttccgtgattttcagttttctcgccatattccaggtcctatgtgtacatttctcatttttcacgtttttcagtgattttgtcatttttcaatttgtcaactgcatgtttctcattttccatgattttcagttttcttgccatattccatgtcctacagtggaaatttctatattttccaactttttcagttttcctcgccatatttcacgtgctaaagtgtgtatttctcatttttcgtgtttttcaggtttctcgccatattccaggtcctacagtgtgcatttctcatttttcacgtttttcagtgattttgtcatttttcaagttgtcaagtggatgtttctcattttccttgattttcagttttcttgccatattccatgtcctacagtggacatttctaaattttccacctttttcagttttccttgccatatttcatgtcctaaagtgtgtatttctcattttcagtgattttcagttttctcgccatattccaggtcctacagtgtgcatttctcattttttcaggtttttcagtgatttcgtcatttttcacgttgtcaagtggatgtttctcattttccatgattttcacttttcttgccatatttcatgtcctaaagtgtgtatttctcattttcagtgattttcagttttctcgctatattccaggtcctacagtgtgcatttctcattttttcacgtttttcagtgatttcgtcatttttcacgttgtcaagtggatgtttctcattttccatgattttcacttttcttgccatatttcatgtcctacaatggacatttctaaattttccacctttttctgttttcctcgccatatttcacatcctaaagtgtgtatttctcattttccgtgattttcagttttcttgccatattccaggtcctacagtgtgcatttctcatttttcacgtttttcagtgatttcgtcatttttcaagttgtcaagtggatgtttctcattttccttgattttcagttttcttgccatattccatgtcctactgtggacatttctaaattttccacctttttcagttttccttgccatatttcatgtcctaaagtgtgtatttctcattttcagtgattttcagttttctcgcaatattccaggtcctacagtgtgcatttctcattttttcaggtttttcagtgatttcgtcatttttcacgttgtcaagtggatgtttctcattttccatgattttcacttttcttgccatatttcatgtcctaaagtgtgtatttctcattttcagtgattttcagttttctgccatattccaggtcctacattgtgcatttctcattttttcacgtttttcagtgatttcgtcatttttcagttttctcgacatattccaggtcctacagtgtgcatttctaattttttcttttttcagtgatttcgtcatttttcaagttgtcaactgcatgtttctcattttccatgattttcagttttcttgccatattccatgtcttacagtggacatttttaaatttttcacatttttttaagttttcctccccatatttcacgttttaaagtgtgcatttctcattttcggtgattttcagttttctcgccagattccaggtcttacagtgtgcatttctcattttttcacgtttttcagtgatttcgtcatttttcaagtcgtcaagtggatgtttctcattttccatgattttcagttttcttgccatattccatgtcctacagtggaaatttctaaattttccacctttttcagttttccttgccatatttcaggtcctaaagtgtgtatttctcattttctgtgattttcagttttctcgccatattccaggtcctacagttgacatttctaaaatttccacattttttaagttttcctcgccatatttcacttcctaaagtgtgtatttctcattttccgtgattttcagttttctcgccatattccagatcctacagtgtgcatttttcatttttcacgtttttcagtgattttgtcattttttagttgtcaactgtctgtttctcattttccatgattttcagttttcttgccatattccatgtcctacactggacatttctaaattttccacctttttctgttttcctcgccatatttcacgtcctaaagtgtgtatttctcattttccgtgattttcagttttcttgccatattccaggtcctacagtgtgcatttctcatttttcacgtttttcagtgattttgtcatttttcaagttgtcaactgcatgtttctcattttctatgattttcagttttcttgctatattccatgtcctacagtggaaatttctaaattttccacctttttcagttttcctcgccatatttcacgtcctaaagtgtgtatttctcattttccgtgattttcagttttctcgccatattccaggtcctatgtgtacatttctcatttttcacgtttttcagtgattttgtcatttttcaagttgtgaagtggatgtttctcatttttcttgattttcatttttcttgccatattccatgtcctagagtggaaatttttaaattttccacctttttcagttttcctcgccatatttcacgtcctaaagtgtgaatttctcattttccgtgattttcagatttctcgccatattccaagtcctacagtgtgcatttctcatttttcacgtttttcagtgatttcgtcatttttcaagttgtcaagtggatgtttctcattttccatgattttcagctttcttgccatattcaaagtcctacagtggacatttctaaattttcgacctttatcagttttcctcgccatatttcatgtcccaaagtgtgtacttctcattttccgtgattttcagtttcctagccatattctaggtcctacagtgtgcatttctcatttttcaggtttttcagtgatttcgtcttttttcaagtcgtcaagtggatgtttctcattttccatgattttcacttttcttgccatatttcatgtcctaaagtgtgtatttctcattttcagtgattttcagttttctcgctatattccaggtcctacagtgtgcatttctcattttttcacgtttttcagtgatttcgtcatttttcacgttgtcaagtggatgtttctcattttccatgattttcacttttcttgccatatttcatgtcctacagtggacatttctaaattttccacctttttctgttttcctcgccatatttcacatcctaaagtgtgtatttctcattttccgtgattttcagttttcttgccatattccaggtcctacagtgtgcatttctcatttttcacgtttttcagtgatttcgtcatttttcaagttgtcaagtggatgtttctcattttccttgattttcagttttcttgccatattccatgtcctactgtggacatttctaaattttccacctttttcagttttccttgccatatttcatgtcctaaagtgtgtatttctcattttcagtgattttcagttttctcgcaatattccaggtcctacagtgtgcatttctcattttttcaggtttttcagtgatttcgtcatttttcacgttgtcaagtggatgtttctcattttccatgattttcacttttcttgccatatttcatgtcctaaagtgtgtatttctcattttcagtgattttcagttttctgccatattccaggtcctacattgtgcatttctcattttttcacgtttttcagtgatttcgtcatttttcacgttgtcaagtggatgtttctcattttccatgattttcacttttcttgccatatttcatgttttacagtggacatttctaaattttccacctttttctgttttcctcgccatatttcacatcctaaagtgtgtatttctcattttccgtgattttcagttttctcgccatatgccaggtcatacagggtgcatttctcatttttcacgtttttcagtgatttcgtcatttttcacgtcgtcaagtggatgtttctcattttcaatgattttcatttttcttgccatattccacgtcctatagtggacatttctaaattttccacctttttcagttttccttgccatatttcaggtcctacagtgtgcatttctcatttttcacgtttttcagtgatttcgtcatttttcaagtggtcaagtgcatgtttctcattttccgtgattttcagttttcttgccatgttccaggtcctacagttgacgtttctaaaatttcactttttttaagttttcctcgccatatttcacttcctaaagtgtgtatttctcattttccgtgattttcagttttctcgccagattccaggtcctacagtgtgcatttttcatatttcacctttttcagtgattttgtcatttttcaagttgtcaactgcatgtttctcattttccatgattttcagttttcttgccatattccatgtcctactgtggacatttctaaattttccaactttttcagttttcctcgccatatttcatgtcctaaagtgtgtatttctcattttcagtgattttctgttttctcgccatattccaggtcctacagtgtgcatttctaatttttcacgtttttcagtgatttcgtcatttttcaagttgtcaagtggatgtttctcattttccatgattttcagttttcttgccatattccatgtcctacagtggacatttctaaattttccaactttttccattttcctcaccatatttcacgtcctaaagtgtgtttttctcattttttgtgattttcagttttctcgacatattccaggtcctacagtgtgcatttctaattttttcttttttcagtgatttcgtcatttttcaagttgtcaactgcatgtttctcattttccatgattttcagttttcttgccatattccatgtcttacagtggacatttttaaatttttcacatttttttaagttttcctccccatatttcacgttttaaagtgtgcatttctcattttcggtgattttcagttttctcgccagattccaggtcttacagtgtgcatttctcattttttcacgtttttcagtgatttcgtcatttttcaagtcgtcaagtggatgtttctcattttccatgattttcagttttcttgccatattccatgtcctacagtggaaatttctaaattttccacctttttcagttttccttgccatatttcaggtcctaaagtgtgtatttctcattttctgtgattttcagttttctcgccatattccaggtcctacagttgacatttctaaaatttccacattttttaagttttcctcgccatatttcacttcctaaagtgtgtatttctcattttccgtgattttcagttttctcgccatattccagatcctacagtgtgcatttttcatttttcacgtttttcagtgattttgtcattttttagttgtcaactgtctgtttctcattttccatgattttcagttttcttgccatattccatgtcctacactggacatttctaaattttccacctttttctgttttcctcgccatatttcacgtcctaaagtgtgtatttctcattttccgtgattttcagttttcttgccatattccaggtcctacagtgtgcatttctcatttttcacgtttttcagtgattttgtcatttttcaagttgtcaactgcatgtttctcattttccatgattttcagttttcttgctatattccatgtcctacagtggaaatttctaaattttccacctttttcagttttcctcgccatatttcacgtcctaaagtgtgtatttctcattttccgtgattttcagttttctcgccatattccaggtcctatgtgtacatttctcatttttcacgtttttcagtgattttgtcatttttcaagttgtgaagtggatgtttctcatttttcttgattttcatttttcttgccatattccatgtcctagagtggaaatttttaaattttccacctttttcagttttcctcgccatatttcacgtcctaaagtgtgaatttctcattttccgtgattttcagatttctcgccatattccaagtcctacagtgtgcatttctcatttttcacgtttttcagtgatttcgtcatttttcaagttgtcaagtggatgtttctcattttccatgattttcagctttcttgccatattcaaagtcctacagtggacatttctaaattttcgacctttatcagttttcctcgccatatttcatgtcccaaagtgtgtacttctcattttccgtgattttcagtttcctcgccatattctaggtcctacagtgtgcatttctcatttttcaggtttttcagtgatttcgtcttttttcaagtcgtcaagtggatgtttctcattttccatgattttcagttttcttgccatattccatgtcctacagtggacatttctaaattttccacctttttcagttttcctcgccatatttcatgtcctaaagtgtgtatttctcattttcagtgattttcagttttctcgccatattccaggtcctacagtgtgcatttctcatttttcacgtttttcagtgatttcgtcatttttcaagttgtcaagtggatgtttctcattttccatgattttcagttttcttgccatattccatgtcccacagtggacatttctaaattttccacctttttctgttttccttgccatatttcatgtcctaaagtgtgtatttctcattttccgtgattttcagttttcttgctatattccaagtcctacagtgtgcatttctcatttttcacgtttttcagtgattttgtcatttttcaatttgtcaactgcatgtttctcattttccatgattttcagttttcttgccatattccatgtcctacagtggaaatttctatattttccaactttttcagttttcctcgccatatttcacgtgctaaagtgtgtatttctcatttttcgtgtttttcaggtttctcgccatattccaggtcctacagtgtgcatttctcatttttcacgtttttcagtgattttgtcatttttcaagttgtcaagtggatgtttctcattttccttgattttcagttttcttgccatattccatgtcctacagtggacatttctaaattttccacctttttcagttttccttgccatatttcatgtcctaaagtgtgtatttctcattttcagtgattttcagttttctcgccatattccaggtcctacagtgtgcatttctcattttttcaggtttttcagtgatttcgtcatttttcacgttgtcaagtggatgtttctcattttccatgattttcacttttcttgccatatttcatgtcctaaagtgtgtatttctcattttcagtgattttcagttttctcgctatattccaggtcctacagtgtgcatttctcattttttcacgtttttcagtgatttcgtcatttttcacgttgtcaagtggatgtttctcattttccatgattttcacttttcttgccatatttcatgtcctacagtggacatttctaaattttccacctttttctgttttcctcgccatatttcacatactaaagtgtgtatttctcattttccttgattttcagttttcttgccatattccaggtcctacagtgtgcatttctcatttttcacgtttttcagtgatttcgtcatttttcaagtcgtcaagtggatgtttctcattttccatgattttcagttttctcgccatattccaggtcctacagttgacatttctaaattttccacattttttaagtttcctcgcgatatttcacatcctaaagtgtgtatttctcattttccgtgattttcagttttcttgccatattccaggtcctacagggtgcatttctcatttttcacgtttttcagtgatttcatcaatttcaagtcgtcaactgtatgtttctcattttcaatgattttcatttttcttgccatattccatgtcctacagtggacatttctaaatttttcacctttttcagttttccttgccatatttcatgtcctaaagtgtgtatttctcattttcagtgattttcagttttctcgccatattccaggtcctacagtgtgcatttctcattttttcaggtttttcagtgatttcgtcatttttcacgttgtcaagtggatgtttctcattttccatgattttcacttttcttgccatatttcatgtcctaaagtgtgtatttctcattttcagtgattttcagttttctcgccatattccaggtcctacagtgtgcatttctcatttttcacgtttttcagtgatttcgtcatttttcaagttgtcaagtggatgtttctcattttccatgattttcacttttcttgccatattccatgtcccacagtggacatttctaaattttccacctttttctgttttcctcgccatatttcatgtcctaaagtgtgtatttctcattttccgtgattttcagttttcttgctatattccaagtcctacagtgtgcatttctcatttttcacgtttttcagtgattttgtcatttttcaatttgtcaactgcatgtttctcattttccatgattttcagttttcttgccatattccatgttctacagtggaaatttctatattttccaactttttcagttttcctcgccatatttcacgtgctaaagtgtgtatttctcatttttcgtgtttttcaggtttctcgccatattccaggtcctacagtgtgcatttctcatttttcacgtttttcagtgattttgtcatttttcaagttgtcaagtggatgtttctcattttccttgattttcagttttcttgccatattccatgtcctacagtggacatttctaaattttccacctttttcagttttccttgccatatttcatgtcctaaagtgtgtatttctcattttcagtgattttcagttttctcgccatattccaggtcctacagtgtgcatttctcattttttcaggtttttcagtgatttcgtcatttttcacgttgtcaagtggatgtttctcattttccatgattttcacttttcttgccatatttcatgtcctaaagtgtgtatttctcattttcagtgattttcagttttctcgctatattccaggtcctacagtgtgcatttctcattttttcacgttttgcagtgatttcgtcatttttcacgttgtcaagtggatgtttctcattttccatgattttcacttttcttgccatatttcatgtcctacagtggacatttctaaattttccacctttttctgttttcctcgccatatttcacatcctaaagtgtgtatttctcattttccgtgattttcagttttcttgccatattccaggtcctacagtgtgcatttctcatttttcacgtttttcagtgatttcgtcatttttcaagtcgtcaagtggatgtttctcattttccatgattttcagttttctcgccatattccaggtcctacagttgacatttctaaattttccacattttttaagtttcctcgcgatatttcacatcctaaagtgtgtatttctcattttccgtgattttcagttttcttgccatattccaggtcctacagggtgcatttctcatttttcacgtttttcagtgatttcatcaatttcaagtcgtcaactgtatgtttctcattttcaatgattttcatttttcttgccatattccatgtcctacagtggacatttctaaattttccacctttttcagttttccttgccatatttcatgtcctaaagtgtgtatttctcattttcagggattttcagttttctcgccatattccaggtcctacagtgtgcatttctcattttttcaggtttttcagtgatttcgtcatttttcacgttgtcaagtggatgtttctcattttccatgattttcacttttcttgccatatttcatgtcctaaagtgtgtatttctcattttcagtgattttcagttttctcgccatattccaggtcctacagtgtgcatttctcattttttcacgtttttcagtgatttcgtcatttttcacgttgtcaagtggatgtttctcattttccatgattttcacttttcttgccatatttcatgtcctacagtggacatttctaaattttccacctttttctgttttcctcgccatatttcacatcctaaagtgtgtatttctcattttccgtgattttcagttttcttgccatattccaggtcctacagtgtgcatttctcatttttcacgtttttcagtgatttcgtcatttttcaagtcgtcaagtggatgtttctcattttccatgattttcagttttctcgccatattccaggtcctacagttgacatttctaaattttccacattttttaagtttcctcgcgatatttcacatcctaaagtgtgtatttctcattttccgtgattttcagttttcttgccatattccaggtcctacagggtgcatttctcatttttcacgtttttcagtgatttcatcaatttcaagtcgtcaactgtatgtttctcattttcaatgattttcatttttcttgccatattccacgtcctatagtggacatttctaaattttccacctttttcagttttcttcgccatatttcacgtcccaaagtgtgtatttctcattttccgtgattttcagtttcctcgcaatattccaggtcctacagtgtgcatttctcatttttcacgtttttcagtgatttcgtcttttttcaagtcgtcaagtggatgtttctcattttccatgattttcagttttcttgccatattccatgtcctacagtggacatttctaaattttccacctttttctgttttcctcgccatatttcacgtcctaaagtgtgtatttctcattttccgtgattttcagttttcttgccatattccaggtcctacagtgtgcatttctcatttttcacgtttttcactgattttgtcattgttcaagttgtcaactgcatgtttctcattttccatgattttcaattttcttgccatattccatgtcctacagtggaaatttctatattttccaactttttcagttttcctcgccatatttcacgtgctaaagtgtgtatttctcatttttcgtgtttttcaggtttctcgccatattccaggtcctacagtgtgcatttctcatttttcacgtttttcagtgattttgtcatttttcaagttgtcaagtggttgtttctcattttccttgattttcagttttcttgccatattccatgtcctactgtggacatttctaaattttccacctttttcagttttccttgccatatttcatgtcctaaagtgtgtatttctcattttcagtgattttcagttttctcgcaatattccaggtcctacagtgtgcatttctcattttccgtgattttcagttttctcgccatatgccaggtcatacagggtgcatttctcatttttcacgtttttcagtgatttcgtcatttttcacgtcgtcaagtggatgtttctcattttcaatgattttcatttttcttgccatattccacgtcctatagtggacatttctaaattttccaactttttcagttttcttgccatatttcaggtcctacagtgtgcatttctcatttttcacgtttttcagtgatttcgtcatttttcaagtggtcaagtgcatgtttctgattttccgtgattttcagttttcttgccatgttccaggtcctacagttgacgtttctaaaatttcactttttttaagttttcctcgccatatttcacttcctaaagtgtgtatttctcattttccgtgattttcagttttctcgccagattccaggtcctacagtgtgcatttttcatatttcacctttttcagtgattttgtcatttttcaagttgtcaactgcatgtttctcattttccatgattttcagttttcttgccatattccatgtcctactgtggacatttctaaattttccaactttttcagttttcctcgccatatttcatgtcctaaagtgtgtatttctcattttcagtgtttttctgttttctcgccatattccaggtcctacagtgtgcatttctaatttttcacgtttttcagtgatttcgtcatttttcaagttgtcaagtggatgtttctcattttccatgattttcagttttcttgccatattccatgtcctacagtggacatttctaaattttccaactttttccattttcctcaccatatttcacgtcctaaagtgtgtttttctcattttttgtgattttcagttttctcgacatattccaggtcctacagtgtgcatttctaattttttcttttttcagtgatttcgtcatttttcaagtggtcaagtgcatgtttctcattttccatgattttcagttttcttgccatattccatgtcctacaatggacatttctaaattttccaactttttcagttttcctcgccatatttcacgtcctaaagtgtgtatttctcattttccgtgattttcagttttctcgccatattccaggtcctatgtgtacatttctcatttttcacgtttttcagtgattttgtcatttttcaagttgtgaagtggatgtttctcatttttcttgattttcatttttcttgccatattccatgtcctagagtggaaatttttaaattttccaactttttcagttttcctcgccatatttcacgtcctaaagtgtgtatttctcattttccgtgattttcagttttctcgccatattccaagtcctacagtgtgcatttctcatttttcacgtttttcagtgatttcgtcatttttcaagttgtcaagtggatgtttctcattttccatgattttcagctttcttgccatattcaaagtcctacagtggacatttctaaattttcgacctttatcagttttcctcgccatatttcatgtcccaaagtgtgtacttctcattttccgtgattttcagtttcctcgccatattctaggtcctacagtgtgcatttctcatttttcaggtttttcagtgatttcgtcttttttcaagtcgtcaagtggatgtttctcattttccatgattttcagttttcttgccatattccatgtcctacagtggacatttctaaattttccacctttttcagttttcctcgccatatttcatgtcctaaagtgtgtatttctcattttcagtgattttcagttttctcgccatattccaggtcctacagtgtgcatttctcatttttcacgtttttcagtgatttcgtcatttttcaagttgtcaagtggatgtttctcattttccatgattttcagttttcttgccatattccatgtcccacagtggacatttctaaattttccacctttttctgttttccttgccatatttcatgtcctaaagtgtgtatttctcattttccgtgattttcagttttcttgctatattccaagtcctacagtgtgcatttctcatttttcacgtttttaagtgattttgtcatttttcaatttgtcaactgcatgtttctcattttccatgattttcagttttcttgccatattccatgtcctacagtggaaatttctatattttccaactttttcagttttcctcgccatatttcacgtgctaaagtgtgtatttctcatttttcgtgtttttcaggtttctcgccatattccaggtcctacagtgtgcatttctcatttttcacgtttttcagtgattttgtcatttttcaagttgtcaagtggatgtttctcattttccttgattttcagttttcttgccatattccatgtcctacagtggacatttctaaattttccacctttttcagttttccttgccatatttcatgtcctaaagtgtgtatttctcattttcagtgattttcagttttctcgccatattccaggtcctacagtgtgcatttctcattttttcaggtttttcagtgatttcgtcatttttcacgttgtcaagtggatgtttctcattttccatgattttcacttttcttgccatatttcatgtcctaaagtgtgtatttctcattttcagtgattttcagttttctcgccatattccaggtcctacagtgtgcatttctcattttttcacgtttttcagtgatttcgtcatttttcacgttgtcaagtggatgtttctcattttccatgattttcacttttcttgccatatttcatgtcctacagtggacatttctaaattttccacctttttctgttttcctcgccatatttcacatcctaaagtgtgtatttctcattttccgtgattttcagttttcttgccatatttcaggtcctacagtgtgcatttctcatttttcacgtttttcagtgatttcgtcatttttcaagtcgtcaagaggatgtttctcattttccatgattttcagttttctcgccatattccaggtcctacagttgacatttctaaattttccacattttttaagtttcctcgcgatatttcacatcctaaagtgtgtatttctcattttccgtgattttcagttttcttgccatattccaggtcctacagggtgcatttctcatttttcacgtttttcagtgatttcatcaatttcaagtcgtcaactgtatgtttctcattttcaatgattttcatttttcttgccatattccacgtcctatagtggacatttctaaattttccacctttttctgttttcctcgccatatttcacgtcctaaagtgtgtatttctcattttccgtgattttcagttttcttgccatattccaggtcctacagtgtgcatttctcatttttcacgtttttcactgattttgtcattgttcaagttgtcaactgcatgtttctcattttccatgattttcagttttcttgccatattccatgtcctacagtggaaatttctatattttccacctttttcagttttcctcgccgtatttcatgtgctaaagtgtgtatttctcatttttcgtgtttttcaggtttctcgccatattccaggtcctacagtgtgcatttctcatttttcacgtttttcagtgattttgtcatttttcaagttgtcaactggatgtttctcattttccttgattttcagttttcttgccatattccatgtcctactgtggacatttctaaattttccacctttttcagttttccttgccatatttcatgtcctaaagtgtgtatttctcattttcagtgattttcagttttctcgcaatattccaggtcctacagtgtgcatttctcattttttcaggtttttcagtgatttcgtcatttttcacgttgtcaagtggatgtttctcattttccatgattttcacttttcttgccatatttcatgtcctaaagtgtgtatttctcattttcagtgattttcagttttctcgccatattccaggtcctacattgtgcatttctcattttttcacgtttttcagtgatttcgtcatttttcacgttgtcaagtggatgtttctcattttccatgattttcacttttcttgccatatttcatgttttacagtggacatttctaaattttccacctttttctgttttcctcgccatatttcacatcctaaagtgtgaatttctcattttccgtgattttcagttttcttgccatattccaggtcctacagtgtgcatttctcatttttcacgtttttcagtgatttcatcatttttcaagtcgtcaagtggatgtttctcattttccatgattttcagttttcttgccatattccatgtcctacagtggacatttctaaattttccacctttttctgttttcctcgccatatttcacgtcctaaagtgtgtatttctcattttccgtgattttcagttttcttgccatattccaggtcctacagtgtgcatttctcatttttcacgtttttcactgattttgtcatttttcaagttgtcaactgcatgtttctcattttccatgattttcagttttcttgctatattccatgtcctacagtggaaatttctaaattttccacctttttcagttttcctcgccatatttcacgtcctgaagtgtgtatttctcattttccgtgattttcagttttctcgccatattccaggtcctatgtgtacatttctcatttttcacgtttttcagtgattttgtcatttttcaagttgtgaagtggatgtttctcatttttcttgattttcatttttcttgccatattccatgtcctacagtggaaatttctaaattttccacctttttcagttttcctcgccatatttcacgtcctaaagtgtgtatttctcattttccgtgattttcagttttctcgccatattccaggtcctacagtgtgcatttctcatttttcacgtttttcagtgatttcgacatttttcaagttgtcaagtggatgtttctcattttccatgattttcagctttcttgccatattcaaagtcctacagtggacatttctaaattttcgacctttatcagttttcctcgccatatttcatgtcccaaagtgtgtacttctcattttccgtgattttcagtttcctcgccatattccaggtcctacagtgtgcatttctcatttttcacgtttttcagtgatttcgtcatttttcaagtcgtcaagtggatgtttctcattttccatgattttcagttttcttgccatattccatgtcctacagtggacatttctaaattttccacctttttctgttttcctcgccatatttcacgtcctaaagtgtgtatttctcattttccgtgattttcagttttcttgccatattccaggtcctacagtgtgcatttctcatttatcacgtttttcactgattttgtcatttttcaagttgtcaactgcatgtttctcattttccatgattttcagttttcttgctatattccatgtcctacagtggaatattctaaattttccacctttttcagttttcctcgccatatttcacgtcctgaagtgtgtatttctcattttccgtgattttcagttttctcgccatattccaggtcctatgtgtacatttctcatttttcacgtttttcagtgattttgtcatttttcaagttgtgaagtggatgtttctcatttttcttgattttcatttttcttgccatattccatgtcctacagtggaaatttctaaattttccacctttttcagttttcctcgccatatttcacgtcctaaagtgtgaatttctcattttccgtgattttcagttttctcgccatattccaggtcctacagtgtgcatttctcatttttcacgtttttcagtgatttcgacatttttcaagttgtcaagtggatgtttctcattttccatgattttcagctttcttgccatattcaaagtcctacagtggacatttctaaattttcgacctttatcagttttcctcgccatatttcatgtcccaaagtgtgtacttctcattttccgtgattttgagtttcctcgccatattccaggtcctacagtgtgcatttctcatttttcacgtttttcagtgatttcgtcttttttcaagttgtcaactgcatgtttctcattttccatgattttcagttttcttgccatattccatgtcctacagtggaaatttgtaaatttccacctttttcagttttcctcgccatatttcacgtcctaaagtatgtatttctcattttccgtgattttcagttttctcgccatattccaggtcctacagtgtgcatttctcatttttcacgtttttcagtgattttgtcattttttaagttttcaagtggatgtttctcattttccttgattttcagttttcttgccatattccatgtcctacagtggacatttctaaattttccacctttttcagttttcctcgccatatttcatgtcctaaagtgtgtatttctcattttcagtgattttcagttttctcgccatattccaggtcctacagtgtgcatttctcatttttcacgtttttcagtgatttcgtcatttttcaaggtgtcaagtggatgtttctcattttccatgattttcagttttcttgccatattccatgtcctacagtggacatttctaaattttccacctttttctgttttcctcgccatatttcatgtcctaaagtgtgtatttctcattttccgtgattttcagttttcttgctatattccaagtcctacagtgtgcatttctcatttttcacgtttttcagtgattttgtcatttttcaatttgtcaactgcatgtttctcattttccatgattttcagtttttttgccatattccatgtcctactgtggaaatttctatattttccacctttttcagttttcctcgccatatttcacgtgctaaagtgtgtatttctcatttttcgtgtttttcaggtttctcgccatattccaggtcctacagtgtgcatttctcatttttcacgtttttcagtgattttgtcatttttcaagttttcaagtggatgtttctcattttccttgattttcagttttcttgccatattccatgtcctacagtggacatttctaaattttccacctttttcagttttccttgccatatttcatgtcctaaagtgtgtatttctcattttcagtgattttcagtttccttgccatattccaggtcctacagtgtgcatttctcattttttcacgtttttcagtgatttcgtcatttttcacgttgtcaagtggatgtttctcattttccatgattttcacttttcttgccatatttcatgtcctacagtggacatttctaaattttccaactttttcaattttcctcgccatattttatgtcctaaagtgtgtatttctcatttttcgttattttcagttttcttgccatattccaggtcctacagtgtgcatttgtcatttttcacgtttttcagtgatttcgtcatttttcaagtcgtcaagtagatgtttctcatattccatgtttttcagttttctcgccatattccaggtcctacagttgacatttctaaattttctacatttttaaattttcctcgccatatttcacgtcctaaagtgtgtatttctcattttttgttattttcagttttctagccatattccaggtcctacaggatgcatttctcatttttcacgtttttcagtgatttcatcatttttcaagtcgtcaagtgtatgtttcttattttcaatgattttcatttttcttgccttattccacgtcctatagtggacatttctaaattttccacctttttcagtttttttcgccatatttcacgtcctaaagtgtgtatttctcattttctgtgattttcagttttctcaccatattccaggtcctacagtgtgcatttctcatttttcacgtttttcagtgatttcgtcatttttcaagttgtcaagtggaagtttctcattttccatgattttcagctttctagacatattccaggtcctacagtggacatttcctaattttcgacctttatcagttttcctcgtcatatttcacgtcccaaaatgtgtatttcttattttccatgattttcagtttcctcgccatattccaggtcctacagtgtgcaattctcatttttcacgtttttcagtgatttcgtcttttttcaagacgtcaagtggatgtttctcatttttcatgattttcagttttcttgccatattccatgtcctacagtggacatttctaaattttccacctttttctgttttcctcgccatatttcacgtcctaaagtgtgtatttctcattttccgtgattttcagttttcttgccatattcctggtcctacagtgtgcatttctcatttttcacgtttttcagtgattttgtcatttttcaatttgtcaactgcatgtttctcattttccattattttcagttttcttgccatattccatgtcctacagtggacatttctaaattttccacctttttctgttttcctcgccatatttcatgtcctaaagtgtgtatttctcattttccgtgattttcagttttcttgctatattccaagtcctacagtgtgcatttctcatttttcacgtttttcagtgattttgtcatttttcaatttgtcaactgcatgtttctcattttccatgattttcagtttttttgccatattccatgtcctacaggggaaatttctatattttccacctttttcagttttcctcgccatatttcatgtcctaaagtgtgtatttctcattttccgtgattttcagttttcttgccatattccaggtcctacagtgtgcatttctcatttttcacgtttttcagtgatttcgtcatttttcaagtcttcaagtagatgtttctcatattccatgtttttcagttttctcgccatattccaggtcctacagttgacatttctaaattttctacatttttaaattttcctcgccatatttcacgtcctaaagtgtgtatttctcatttttcgttattttcagttttctagccatattccaggtcctacaggatgcatttctcatttttcacgtttttcagtgatttcatcatttttcaagtcgtcaagtgtatgtttctcattttcaatgattttcatttttcttgccttattccacgtcctatagtggacatttctaaattttccacctttttcagtttttctcgccatatttcacgtcctaaagtgtgtatttctcattttctgtgattttcagttttctcaccatattccaggtcctacagtgtgcatttctcatttttcacgtttttcagtgatttcgtcatttttcaagttgtcaagtggaagtttctcattttccatgattttcagctttctagccatattccaggtcctacagtggacatttcctaattttcgacctttatcagttttcctcgccatatttcacgtcctaaagtgtgtatttctcattttccgtgattttcagttttcttgccatattccaggtcctacagtgtgcatttctcatttttcacgtttttcagtgattttgtcatttttcaatttgtcaactgcatgtttctcattttccatgatttttagttttcttgctatattccatgtcctacagtggaaatttctaaattttccacctttttcagttttcctcgccatatttcacgtcctaaagtgtgtatttctcattttccgtgattttcagttttcttgctatattccaagtcctacattgtgcatttctcatttttcacgtttttcagtgattttgtcatttttcaatttgtcaaaccacatgtttctcattttccatgattttcagtttttttgccatattccatgtcctacagtggaaatttctatattttccacctttttcagttttcctcgccatatttcacgtgctaaagtgtgtatttctcatttttcgtgtttttcaggtttctcgccatattccaggtcctacagtgtgcatttctcatttttcacgtttttcagtgattttgtcatttttcaagttgtcaagtggatgtttcccattttccttgattttcagttttcttaccatattccatgtcctacagtggacatttctaaattttccacctttttcagttttccttgccatatttcatgtcctaaagtgtgtatttctcattttcagtgattttcagtttcctcgccatattccaggtcctacagtgtgcatttctcattttttcacgtttttcagtgatttcgtcatttttcacgttgtcaagtggatgtttctcattttccatgattttcacttttcttgccatatttcatgtcctatagtggacatttctaaattttccacctttttcagtttttctcgccatatttcacgtcctaaagtgtgtatttctcattttctgtgattttcagttttctcaccatattccaggtcctacagtgtgcatttctcatttttcacgtttttcagtgatttcgtcatttttcaagtcgtcaagtagatgtttctcatattccatgtttttcagttttctcgccatattccaggtcctacagttgacatttctaaattttctacatttttaaattttcctcgccatatttcacgtcctaaagtgtgtatttctcatttttcgttattttcagttttctagccatattccaggtcctacaggatgcatttctcatttttcacgtttttcagtgatttcatcatttttcaagtcgtcaagtgtatgtttcttattttcaatgattttcatttttcttgccttattccacgtcctatagtggacatttctaaattttccaccttttttcagtttttctcgccatatttcacgtcctaaagtgtgtatttctcattttctgtgattatcagttttctcaccatattccaggtcctacagtgtgcatttctcatttttcacgtttttcagtgatttcgtcatttttcaagttgtcaagtggaagtttctcattttccatgattttcagctttctagccatattccaggtcctacagtggacatttcctaattttcgacctttatcagttttcctcgccatatttcacgtcccaaaatgtgtatttcttattttccatgattttcagtttcctcgccatattccaggtcctacagtgtgcatttctcatttttcacgtttttcagtgatttcgtcttttttcaagacgtcaagtggatgtttctcatttttcatgattttcagttttcttgccatattccatgtcctacagtggacatttctaaattttccacctttttctgttttcctcgccatatttcacgtcctaaagtgtgtatttctcattttccgtgattttcagttttcttgccatattcctggtcctacagtgtgcatttctcatttttcacgtttttcagtgattttgtcatttttcaatttgtcaactgcatgtttctcattttccatgattttcagttttcttgccatattccatgtcctacagtggacatttctaaattttccacctttttcagttttcctcgccatatttcacgtgctaaagtgtgtatttctcatttttcgtgtttttcaggtttctcgccatattccaggtcctacagtgtgcatttctcatttttcacgtttttcagtgattttgtcatttttcaagttgtcaagtggatgtttctcattttccttgattttcacttttcttgccatattccaagtcttacaggggcatttctcatttttcacgttttcagtgattttgtcattttcaatttgtcaactgcatgtttctcattttccatgattttcagtttttttgccatattccatgtcctacaggggaaatttctatattttccacctttttcagttttcctcgccatatttcatgtcctaaagtgtgtatttctcattttccgtgattttcagttttcttgccatattccaggtcctacagtgtgcatttctcatttttcacgtttttcagtgatttcgtcatttttcaagtcttcaagtagatgtttctcatattccatgtttttcagttttctcgccatattccaggtcctacagttgacatttctaaattttctacatttttaaattttcctcgccatatttcacgtcctaaagtgtgtatttctcatttttcgttattttcagttttctagccatattccaggtcctacaggatgcatttctcatttttcacgtttttcagtgatttcatcatttttcaagtcgtcaagtgtatgtttctcattttcaatgattttcatttttcttgccttattccacgtcctatagtggacatttctaaattttccacctttttcagtttttctcgccatatttcacgtcctaaagtgtgtatttctcattttctgtgattttcagttttctcaccatattccaggtcctacagtgtgcatttctcatttttcacgtttttcagtgatttcgtcatttttcaagttgtcaagtggaagtttctcattttccatgattttcagctttctagccatattccaagtcctacagtggacatttcctaattttcgacctttatcagttttcctcgccatatttcacgtcccaaaatgtgtattccttattttccatgattttcagtttcctcgccatattccaggtcctacagtgtgcatttatcatttttcacgtttttcagtgatttcgtcttttttcaagacgtcaagtggatgtttctcatttttcatgattttcagttttcttgccatattccatgtcctacagtggacatttctaaattttccacctttttctgttttcctcgccatatttcacgtcctaaagtgtgtatttctcattttccgtgattttcagttttcttgccatattcctggtcctacagtgtgcatttctcatttttcacgtttttcagtgattttgtcatttttcaagttgtcaagtggatgtttctcattttccttgattttcacttttcttgccatattccatgtcctacagtggacatttctatattttccacctttttccgttttccttgccatatttcacgtcctaaagtgtgtatttctcattttccgtgattttcaggtttctcgccatattccaggtcctacagtgtgcatttctcatttttcacgtttttcagtgattttgtcatttttcaagttgtcaagtggatgtttctcattttccttgattttcacttttcttgccatattccatgtcctacagtggacatttctaaattttccacctttttcagttttcctcgccatatttcatgtcctaaagtgtgtatttctcattttcagtgattttcagttttcttgccatattccaggtcctacagtgtgcatttctcatttttcacgtttttcagtgattttgtcatttttcaagttgtcaactgcatgtttctcattttctatgattttcagttttcttgctatattccatgtcctacagtggaaatttctaaattttccacctttttcagttttcctcgccatatttcacgtcctaaagtgtgtatttctcattttccgtgattttcagttttctcgccatattccaggtcctatgtgtacatttctcatttttcacgtttttcagtgattttgtcatttttcaagttgtgaagtggatgtttctcatttttcttgattttcatttttcttgccatattccatgtcctagagtggaaatttttaaattttccacctttttcagttttcctcgccatatttcacgtcctaaagtgtgaatttctcattttccgtgattttcagatttctcgccatattccaagtcctacagtgtgcatttctcatttttcacgtttttcagtgatttcgtcatttttcaagttgtcaagtggatgtttctcattttccatgattttcagctttcttgccatattcaaagtcctacagtggacatttctaaattttcgacctttatcagttttcctcgccatatttcatgtcccaaagtgtgtacttctcattttccgtgattttcagtttcctcgccatattctaggtcctacagtgtgcatttctcatttttcaggtttttcagtgatttcgtcttttttcaagtcgtcaagtggatgtttctcattttccatgattttcacttttcttgccatatttcatgtcctaaagtgtgtatttctcattttcagtgattttcagttttctcgctatattccaggtcctacagtgtgcatttctcattttttcacgtttttcagtgatttcgtcatttttcacgttgtcaagtggatgtttctcattttccatgattttcacttttcttgccatatttcatgtcctacagtggacatttctaaattttccacctttttctgttttcctcgccatatttcacatcctaaagtgtgtatttctcattttccgtgattttcagttttcttgccatattccaggtcctacagtgtgcatttctcatttttcacgtttttcagtgatttcgtcatttttcaagttgtcaagtggatgtttctcattttccttgattttcagttttcttgccatattccatgtcctactgtggacatttctaaattttccacctttttcagttttccttgccatatttcatgtcctaaagtgtgtatttctcattttcagtgattttcagttttctcgcaatattccaggtcctacagtgtgcatttctcattttttcaggtttttcagtgatttcgtcatttttcacgttgtcaagtggatgtttctcattttccatgattttcacttttcttgccatatttcatgtcctaaagtgtgtatttctcattttcagtgattttcagttttcctcgccatatttcacgtcccaaaatgtgtatttcttattttccatgattttcagtttcctcgccatattccaggtcctacagtgtgcatttctcatttttcacgtttttcagtgatttcgtcttttttcaagacgtcaagtggatgtttctcatttttcatgattttcagttttcttgccatattccatgtcctacagtggacatttctaaattttccacctttttctgttttcctcgccatatttcacgtcctaaagtgtgtatttctcattttccgtgattttcagttttcttgccatattcctggtcctacagtgtgcatttctcatttttcacgtttttcagtgattttgtcatttttcaatttgtcaactgcatgtttctcattttccatgattttcagttttcttgccatattccatgtcctacagtggacatttctaaattttccacctttttcagttttcctcgccatatttcacgtgctaaagtgtgtatttctcatttttcgtgtttttcaggtttctcgccatattccaggtcctacagtgtgcatttctcatttttcacgtttttcagtgattttgtcatttttcaagttgtcaagtggatgtttctcattttccttgattttcacttttcttgccatattccatgtcctacagtggacatttctaaattttccacctttttcagttttcctcgccatatttcatgtcctaaagtgtgtatttctcattttcagtgattttcagttttctcgccatattccaggtcctacagtgtgcatttctcatttttcacgtttttcagtgatttcgtcttttttcaagacgtcaagtggatgtttctcattttccatgattttcagttttcttgccatattccatgtcctacagtggacatttctaaattttccacctttttctgttttcctcgccatatttcacgtcctaaagtgtgtatttctcattttccgtgattttcagttttcttgccatattccaggtcctacagtgtgcatttctcatttttcacgtttttcagtgattttgtcatttttcaatttgtcaactgcatgtttctcattttccatgatttttagttttcttgctatattccatgtcctacagtggaaatttctaaattttccacctttttcagttttcctcgccatatttcacgtcctaaagtgtgtatttctcattttccgtgattttcagttttcttgctatattccaagtcctacattgtgcatttctcatttttcacgtttttcagtgattttgtcatttttcaatttgtcaaaccacatgtttctcattttccatgattttcagtttttttgccatattccatgtcctacagtggaaatttctatattttccacctttttcagttttcctcgccatatttcacgtgctaaagtgtgtatttctcatttttcgtgtttttcaggtttctcgccatattccaggtcctacagtgtgcatttctcatttttcacgtttttctgtgattttgtcatttttcaagttgtcaagtggatgtttctcattttccttgattttcagttttcttaccatattccatgtcctacagtggacatttctaaattttccaccttttctgttttcctcgccatatttcatgtcctaaagtgtgtatttctcattttccgtgattttcatttttcttgctatattccaagtcctacagtgtgcatttctcattttccatgattttcagttttcttgctatattccatgtcctacagtggaaatttctaaattttccacctttttcagttttcctcgccatatttcacgtcctaaagtgtgtatttctcattttccgtgattttcagttttttcgccatattacaggtcctatgtgtacatttctcatttttcacgtttttcagtgattttgtcatttttcaagttgtcaagtggatgtttctcatttttcttgattttcatttttcttgccatattccatgtcctacagtggaaatttctaaattttccacctttttcagttttcctcgccatatttcacgtcctaaagtgtgaatttctcattttccgtgattttcagttttctcgccatattccaggtctacagtgtgcatttctcatttttcacgttttcagtgattcgtcatttttcaagttgacaagtggatgtttctcattttccatgattttcagctttcttgccatattcaaagtcctacagtggacatttctaaattttcgacctttatcagttttcctcgccatatttcatgtcccaaagtgtgtacttctcattttccgtgattttcagttttcttgccatattccaagtcctacagtgtgcatttctcatttttcacgtttttcagtgattttgtcatttttcaatttgtcaactgcatgtttctcattttccatgattttcagttttcttgccatattccatgtcctacagtggaaatttctatattttccacctttttcagttttcctcgccatatttcacgtgctaaagtgtgtatttctcatttttcgtgtttttcaggtttctcgccatattccaggtcctacagtgtgcatttctcatttttcacgtttttcagtgattttgtcatttttcaagttgtcaagtggatgtttctcattttcaatgattttcatttttcttgccttattccacgtcctatagtggacatttctaaattttccacctttttcagtttttctcgccatatttcacgtcccaaaatgtgtattccttattttccatgattttcagtttcctcgccatattccaggtcctacagtgtgcatttctcatttttcacgtttttcagtgatttcgtcttttttcaagacgtcaagtggatgtttctcatttttcatgattttcagttttcttgccatattccctgtcctacagtggacatttctaaattttccacctttttctgttttcctcgccatatttcacgtcctaaagtgtgtatttctcattttccgtgattttcagttttctcgccagattccaggtcctacagtgtgcatttctcatttttcacgtttttcagtgattttgtcatttttcaatttgtcaactgcatgtttctctctttccatgattttcagttttcttgccatattccatgtcctacagtggacatttctaaattttccacctttttcagttttcctcgccatatttcacgtgctaaagtgtgtatttctcatttttcgtgtttttcaggtttctcgccatattccaggtcctacagtgtgcatttctcatttttcacgtttttcagtgattttgtcatttttcaagttgtcaagtggatgtttctcattttcaatgattttcatttttcttaccttattccacgtcctatagtggacatttctaaattttccacctttttcagtttttctcgccatatttcacgtcccaaaatgtgtattccttattttccatgattttcagtttcctcgccatattccaggtcctacagtgtgcatttctcatttttcacgtttttcagtgatttcgtcttttttcaagacgtcaagtggatgtttctcatttttcatgattttcagttttcttgccatattccctgtcctacagtggacatttctaaattttccacctttttctgttttcctcgccatatttcacgtcctaaagtgtgtatttctcattttccgtgattttcagttttctcgccagattccaggtcctacagtgtgcatttctcatttttcacgtttttcagtgatttcgtcatttttcaagtcttcaagtgtatgtttctcattttcaatgattttcatttttcttgccttattccacgtcctatagtggacatttctaaattttccacctttttcagtttttctcgccatatttcacgtcctaaagtgtgtatttctcattttctgtgattttcagttttcttaccatattccaggtcctacagtgtgcatttctcatttttcacgtttttcagtgatttcgtcatttttcaagttgtcaagtggaagtttctcattttccatgattttcagctttctagccatattccaggtattacagtggacatttccttattttcgacctttatcagttttcctcgccatatttcatgtcctaaagtgtgt	38399	1554	4%	7300	19%
9	3000001	3038400	Atcctacagtgtgcatttctcatttttcacgtttttcagtgatttcgtcatttttcaagtcatcaagtggctgtttctcattttccatgattttcagttttcttgccatattccttgtcctacagtggacatttctaaattttccacctttttcagttttccttgtcatatttcaggtcctacagtgtgtatttctcatttttcacgtttttcattgatttcgtcatttttcaagttgtcaagtgcatgtttctcattttccatgattttcagttttcttgccatattccatgtcctacaatggacatttctaaattttccaactttttcagttttcctcgccatatttcacgtcctaaagtgtgtatttctcattttccgtgattttcagttttctcgacatattccaggtcctacagtgtgcatttctcatttttcacgtttttcagtgatttcgtcatttttcacgtcgtcaagtggatgtttctcattttccatgattttcagttttcttgccatattccatgtcctacagtggacatttctaaattttccacctttttcagttttcctcgccatatttcacgtcctaaagtgtgtatttctcattttccgtgattttcagttttctcgacatattccaggtcttacagggtgcatttctcatttttcacgtttttcagtgatttcatcatttttcaagtcgtcaactgtatgtttctcattttcaatgattttcatttttcttgccatattccacgtcctatagtggacatttctaaattttccacctttttcagttttccttgccatatttcaggtcctacagtgtgcatttctcatttttcacgtttttcagtgatttcgtcatttttcaagtggtcaaatgcatgtttctcattttccatgattttcagttttcttgccatattccatgtcctacagtggacatttctaaattttccacctttttcagttttcctcgccatatttcacgtcctaaagtgtgtatttctcattttccgtgattttcagttttatcgccagattccaggtcctacggtgtgcatttttcatatttcacgtttttcagtgattttgtcatttttcaagttgtcaactgcatgtttctcattttccatgattttcagttttcttgccatattccatgtcctacagtggacatttctaaattttccacctttttcagttttcctcgccatatttcatgtcctaaagtgtgtatttctcattttcagtgattttctgttttctcgccatattccaggtcctacagtgtgcatttctcatttttcacgtttttcagtgatttcgtcatttttcaagttgtcaagtggatgtttctcattttccatgattttcagttttcttgccatattccatgtcctacaatggacatttctaaattttccacctttttcagttttcctcgccatatttcacgtcctaaagtgtgtatttctcattttccgtgattttcagttttctcgccatattccaggtcctatgtgtacatttctcatttttcacgtttttcagtgattttgtcatttttcaagttgtgaagtggatgtttctcatttttcttgattttcatttttcttgccatattccatgtcctagagtggaaatttttaaattttccacctttttcagttttcctcgccatatttcacgtcctaaagtgtgaatttctcattttccgtgattttcagttttctcgccatattccaagtcctacagtgtgcatttctcatttttcacgtttttcagtgatttcgtcatttttcaagttgtcaagtggatgtttctcattttccatgattttcagctttcttgccatattcaaagtcctacagtggacatttctaaattttcgacctttatcagttttcctcgccatatttcatgtcccaaagtgtgtacttctcattttccgtgattttcagtttcctcgccatattctaggtcctacagtgtgcatttctcatttttcaggtttttcagtgatttcgtcttttttcaagtcgtcaagtggatgtttctcattttccatgattttcagttttcttgccatattccatgtcctacagtggacatttctaaattttccaactttttcagttttcctcgccatatttcatgtcctaaagtgtgtatttctcattttcagtgattttcagttttctcgccatattccaggtcctacagtgtgcatttctcatttttcacgtttttcagtgatttcgtcatttttcaagttgtcaagtggatgtttctcatttttcatgattttcagttttcttgccatattccatgtcccacagtggacatttctaaatgttccacctttttctgttttccttgccatatttcatgtcctaaagtgtgtatttctcattttccgtgattttcagttttcttgctatattccaagtcctacagtgtgcatttctcatttttcacgtttttctgtgattttttcatttttcaatttgtcaactgcatgtttctcattttccatgattttcagttttcttgccatattccaggtcctacagtgtgcatttctcatttttcacgtttttcagtgattttgtcatttttcaagttgtcaactgcatgtttctcattttccatgattttcagttttcttgctatattccatgtcctacagtggaaatttctaaattttccacctttttcagttttcctcgccatatttcacgtcctaaagtgtgtatttctcattttccgtgattttcagttttctcgccatattccaggtcctatgtgtacatttctcatttttcacgtttttcagtgattttgtcatttttcaagttgtgaagtggatgtttctcatttttcttgattttcatttttcttgccatattccatgtcctagagtggaaatttttaaattttccacctttttcagttttcctcgccatatttcacgtcctaaattgtgaatttctcattttccgtgattttcagttttctcgccatattccaagtcctacagtgtgcatttctcatttttcacgtttttcagtgatttcgtcatttttcaagttgtcaagtggatgtttctcattttccatgattttcagctttcttgccatattcaaagtcctacagtggacatttctaaattttcgacctttatcagttttcctcgccatatttcatgtcccaaagtgtgtacttctcattttccgtgattttcagtttcctcgccatattctaggtcctacagtgtgcatttctcatttttcaggtttttcagtgatttcgtcttttttcaagtcgtcaagtggatgtttctcattttccatgattttcagttttcttgccatattccatgtcctacagtggacatttctaaattttccacctttttcagttttcctcgccatatttcatgtcctaaagtgtgtatttctcattttcagtgattttcagttttctcgccatattccaggtcctacagtgtgcatttctcatttttcacgtttttcagtgattttgtcatttttcaagttgtcaagtggatgtttctcattttccttgattttcagttttcttgccatattccatgtcctacagtggacatttctaaattttccacctttttcagttttccttgccatatttcatgtcctaaagtgtgtatttctcattttcagtgattttcagttttctcgccatattccaggtcctacagtgtgcatttctcattttttcaggtttttcagtgatttcgtcatttttcacgttgtcaagtggatgtttctcattttccatgattttcacttttcttgccatatttcatgtcctaaagtgtgtatttctcattttcagtgattttcagttttctcgccatattccaggtcctacagtgtgcatttctcattttttcacgtttttcagtgatttcgtcatttttcacgttgtcaagtggatgtttctcattttccattattttcacttttcttgccatatttcatgtcctacagtggacatttctaaattttccacctttttctgttttcctcgccatatttcacatcctaaagtgtgtatttctcattttccgtgattttcagttttcttgccatattccaggtcctacagtgtgcatttctcatttttcacgtttttcagtgatttcgtcatttttcaagtcgtcaagtggatgtttctcattttccatgattttcagttttctcgccatattccaggtcctacagttgacatttctaaattttccacattttttatgtttcctcgcgatatttcacatcctaaagtgtgtatttctcattttccgtgattttcagttttcttgccatattccaggtcctacagggtgcatttctcatttttcacgtttttcagtgatttcatcaatttcaagtcgtcaactgtatgtttctcattttcaatgattttcatttttcttgccatattccacgtcctatagtggacatttctacattttccacctttttcagttttcttcgccatatttcacgtcccaaagtgtgtatttctcattttccgtgattttcagtttcctcgccatattccaggtcctacagtgtgcatttctcatttttcacgtttttcagtgatttcgtcttttttcaagtcgtcaagtggatgtttctcattttccatgattttcagttttcttgccatattccatgtcctacagtggacatttctaaattttccacctttttctgttttcctcgccatatttcacgtcctaaagtgtgtatttctcatttaccgtgattttcagttttcttgctatattccaagtcctacagtgtgcatttctcatttttcacgtttttcactgattttgtcattgttcaagttgtcaactgcatgtttctcattttccatgattttcagttttcttgccatattccatgtcctacagtggaaatttctatattttccaactttttcagttttcctcgccatatttcacgtgctaaagtgtgtatttctcatttttcgtgtttttcaggtttctcgccatattccaggtcctacagtgtgcatttctcatttttcacgtttttcagtgattttgtaatttttcaagttgtcaagtggatgtttctcattttccttgattttcagttttcttgccatattccatgtcctactgtggacatttctaaattttccacctttttcagttttccttgccatatttcatgtcctaaagtgtgtatttctcattttcagtgattttcagttttctcgcaatattccaggtcctacagtgtgcatttctcattttttcaggtttttcagtgatttcgtcatttttcacgttgtcaagtggatgtttctcattttccatgattttcacttttcttgccatatttcatgtgctaaagtgtgtatttctcattttcagtgattttcagttttctgccatattccaggtcctacattgtgcatttctcattttttcacgtttttcagtgatttcgtcatttttcacgttgtcaagtggatgtttctcattttccatgattttcacttttcttgccatatttcatgttttacagtggacatttctaaattttccacctatttctgttttcctcgccatatttcacatcctaaagtgtgtatttctcattttccgtgattttcagttttctcgccatatgccaggtcatacagggtgcatttctcatttttcacgtttttcagtgatttcgtcatttttcacgtcgtcaagtggatgtttctcattttcaatgattttcatttttcttgccatattccacgtcctatagtggacatttctaaattttccacctttttcagttttccttgccatatttcaggtcctacagtgtgcatttctcttttttcacgtttttcagtgatttcgtcatttttcaagtggtcaagtgcatgtttctcattttccgtgattttcagttttcttgccatgttccaggtcctacagttgacgtttctaaaatttcactttttttaagttttcctcgccatatttcacttcctaaagtgtgtatttctcattttccgtgattttcagttttctcgccagattccaggtcctacagtgtgcatttttcatatttcacctttttcagtgattttgtcatttttcaagttgtcaactgcatgtttctcattttccatgattttcagttttcttgccatattccatgtcctactgtggacatttctaaattttccaactttttcagttttcctcgccatatttcatgtcctaaagtgtgtatttctcattttcagtgattttctgttttctcgccatattccaggtcctacagtgtgcatttctaatttttcacgtttttcagtgatttcgtcatttttcaagttgtcaagtggatgtttctcattttccatgattttcagttttcttgccatattccatgtcctacagtggacatttctaaattttccaactttttccattttcctcaccatatttcacgtcctaaagtgagtttttctcattttttgtgattttcagttttctcgacatattccaggtcctacagtgtgcatttctaattttttcttttttcagtgatttcgtcatttttcaagtggtcaagtgcatgtttctcattttccatgattttcagttttcttgccatattccatgtcctacaatggacatttctaaattttccaactttttcagttttcctcgccatatttcacgtcctaaagtgtgtatttctcattttccgtgattttcagttttctcgccatattccaggtcctacagtgtgcatttctcatttttcacgtttttcagtgatttcgtcatttttcaagttgtcaactgcatgtttctcattttccatgattttcagttttcttgccatattccatgtcttacagtggacatttttaaatttttcacatttttttaagttttcctccccatatttcacgttttaaagtgtgcatttctcattttcggtgattttcagttttctcgccagattccatgtcttacagtgtgcatttctcattttttcacgtttttcagtgatttcgtcatttttcaagtcgtcaagtggatgtttctcattttccatgattttcagttttcttgccatattccatgtcctacagtggaaatttctaaattttccacctttttcagttttccttgccatatttcaggtcctaaagtgtgtatttctcattttctgtgattttcagttttctcgccatattccaggtcctacagttgacatttctaaaatttccacattttttaagttttcctcgccatatttcacttcctaaagtgtgtatttctcattttccgtgattttcagttttctcgccatattccagatcctacagtgtacatttttcatttttcacgtttttcagtgattttgtcattttttagttgtcaactgcctgtttctcattttccatgattttcagttttcttgctatattccatgtcctacagtggaaatttctaaattttccacctttttcagttttcctcgccatatttcacgtcctaaagtgtgtatttctcattttccgtgattttcagttttctcgccatattccaggtcctatgtgtacatttctcatttttcacgtttttcagtgattttgtcatttttcaatttgtcaactgcatgtttctcattttccatgattttcagttttcttgccatattccatgtcctacagtggaaatttctatattttccaactttttcagttttcctcgccatatttcacgtgctaaagtgtgtatttctcatttttcgtgtttttcaggtttctcgccatattccaggtcctacagtgtgcatttctcatttttcacgtttttcagtgattttgtcatttttcaagttgtcaagtggatgtttctcattttccttgattttcagttttcttgccatattccatgtcctacagtggacatttctaaattttccacctttttcagttttccttgccatatttcatgtcctaaagtgtgtatttctcattttcagtgattttcagttttctcgccatattccaggtcctacagtgtgcatttctcattttttcaggtttttcagtgatttcgtcatttttcacgttgtcaagtggatgtttctcattttccatgattttcacttttcttgccatatttcatgtcctaaagtgtgtatttctcattttcagtgattttcagttttctcgctatattccaggtcctacagtgtgcatttctcattttttcacgtttttcagtgatttcgtcatttttcacgttgtcaagtggatgtttctcattttccatgattttcacttttcttgccatatttcatgtcctacaatggacatttctaaattttccacctttttctgttttcctcgccatatttcacatcctaaagtgtgtatttctcattttccgtgattttcagttttcttgccatattccaggtcctacagtgtgcatttctcatttttcacgtttttcagtgatttcgtcatttttcaagttgtcaagtggatgtttctcattttccttgattttcagttttcttgccatattccatgtcctactgtggacatttctaaattttccacctttttcagttttccttgccatatttcatgtcctaaagtgtgtatttctcattttcagtgattttcagttttctcgcaatattccaggtcctacagtgtgcatttctcattttttcaggtttttcagtgatttcgtcatttttcacgttgtcaagtggatgtttctcattttccatgattttcacttttcttgccatatttcatgtcctaaagtgtgtatttctcattttcagtgattttcagttttctgccatattccaggtcctacattgtgcatttctcattttttcacgtttttcagtgatttcgtcatttttcagttttctcgacatattccaggtcctacagtgtgcatttctaattttttcttttttcagtgatttcgtcatttttcaagttgtcaactgcatgtttctcattttccatgattttcagttttcttgccatattccatgtcttacagtggacatttttaaatttttcacatttttttaagttttcctccccatatttcacgttttaaagtgtgcatttctcattttcggtgattttcagttttctcgccagattccaggtcttacagtgtgcatttctcattttttcacgtttttcagtgatttcgtcatttttcaagtcgtcaagtggatgtttctcattttccatgattttcagttttcttgccatattccatgtcctacagtggaaatttctaaattttccacctttttcagttttccttgccatatttcaggtcctaaagtgtgtatttctcattttctgtgattttcagttttctcgccatattccaggtcctacagttgacatttctaaaatttccacattttttaagttttcctcgccatatttcacttcctaaagtgtgtatttctcattttccgtgattttcagttttctcgccatattccagatcctacagtgtgcatttttcatttttcacgtttttcagtgattttgtcattttttagttgtcaactgtctgtttctcattttccatgattttcagttttcttgccatattccatgtcctacactggacatttctaaattttccacctttttctgttttcctcgccatatttcacgtcctaaagtgtgtatttctcattttccgtgattttcagttttcttgccatattccaggtcctacagtgtgcatttctcatttttcacgtttttcagtgattttgtcatttttcaagttgtcaactgcatgtttctcattttctatgattttcagttttcttgctatattccatgtcctacagtggaaatttctaaattttccacctttttcagttttcctcgccatatttcacgtcctaaagtgtgtatttctcattttccgtgattttcagttttctcgccatattccaggtcctatgtgtacatttctcatttttcacgtttttcagtgattttgtcatttttcaagttgtgaagtggatgtttctcatttttcttgattttcatttttcttgccatattccatgtcctagagtggaaatttttaaattttccacctttttcagttttcctcgccatatttcacgtcctaaagtgtgaatttctcattttccgtgattttcagatttctcgccatattccaagtcctacagtgtgcatttctcatttttcacgtttttcagtgatttcgtcatttttcaagttgtcaagtggatgtttctcattttccatgattttcagctttcttgccatattcaaagtcctacagtggacatttctaaattttcgacctttatcagttttcctcgccatatttcatgtcccaaagtgtgtacttctcattttccgtgattttcagtttcctagccatattctaggtcctacagtgtgcatttctcatttttcaggtttttcagtgatttcgtcttttttcaagtcgtcaagtggatgtttctcattttccatgattttcacttttcttgccatatttcatgtcctaaagtgtgtatttctcattttcagtgattttcagttttctcgctatattccaggtcctacagtgtgcatttctcattttttcacgtttttcagtgatttcgtcatttttcacgttgtcaagtggatgtttctcattttccatgattttcacttttcttgccatatttcatgtcctacagtggacatttctaaattttccacctttttctgttttcctcgccatatttcacatcctaaagtgtgtatttctcattttccgtgattttcagttttcttgccatattccaggtcctacagtgtgcatttctcatttttcacgtttttcagtgatttcgtcatttttcaagttgtcaagtggatgtttctcattttccttgattttcagttttcttgccatattccatgtcctactgtggacatttctaaattttccacctttttcagttttccttgccatatttcatgtcctaaagtgtgtatttctcattttcagtgattttcagttttctcgcaatattccaggtcctacagtgtgcatttctcattttttcaggtttttcagtgatttcgtcatttttcacgttgtcaagtggatgtttctcattttccatgattttcacttttcttgccatatttcatgtcctaaagtgtgtatttctcattttcagtgattttcagttttctgccatattccaggtcctacattgtgcatttctcattttttcacgtttttcagtgatttcgtcatttttcacgttgtcaagtggatgtttctcattttccatgattttcacttttcttgccatatttcatgttttacagtggacatttctaaattttccacctttttctgttttcctcgccatatttcacatcctaaagtgtgtatttctcattttccgtgattttcagttttctcgccatatgccaggtcatacagggtgcatttctcatttttcacgtttttcagtgatttcgtcatttttcacgtcgtcaagtggatgtttctcattttcaatgattttcatttttcttgccatattccacgtcctatagtggacatttctaaattttccacctttttcagttttccttgccatatttcaggtcctacagtgtgcatttctcatttttcacgtttttcagtgatttcgtcatttttcaagtggtcaagtgcatgtttctcattttccgtgattttcagttttcttgccatgttccaggtcctacagttgacgtttctaaaatttcactttttttaagttttcctcgccatatttcacttcctaaagtgtgtatttctcattttccgtgattttcagttttctcgccagattccaggtcctacagtgtgcatttttcatatttcacctttttcagtgattttgtcatttttcaagttgtcaactgcatgtttctcattttccatgattttcagttttcttgccatattccatgtcctactgtggacatttctaaattttccaactttttcagttttcctcgccatatttcatgtcctaaagtgtgtatttctcattttcagtgattttctgttttctcgccatattccaggtcctacagtgtgcatttctaatttttcacgtttttcagtgatttcgtcatttttcaagttgtcaagtggatgtttctcattttccatgattttcagttttcttgccatattccatgtcctacagtggacatttctaaattttccaactttttccattttcctcaccatatttcacgtcctaaagtgtgtttttctcattttttgtgattttcagttttctcgacatattccaggtcctacagtgtgcatttctaattttttcttttttcagtgatttcgtcatttttcaagttgtcaactgcatgtttctcattttccatgattttcagttttcttgccatattccatgtcttacagtggacatttttaaatttttcacatttttttaagttttcctccccatatttcacgttttaaagtgtgcatttctcattttcggtgattttcagttttctcgccagattccaggtcttacagtgtgcatttctcattttttcacgtttttcagtgatttcgtcatttttcaagtcgtcaagtggatgtttctcattttccatgattttcagttttcttgccatattccatgtcctacagtggaaatttctaaattttccacctttttcagttttccttgccatatttcaggtcctaaagtgtgtatttctcattttctgtgattttcagttttctcgccatattccaggtcctacagttgacatttctaaaatttccacattttttaagttttcctcgccatatttcacttcctaaagtgtgtatttctcattttccgtgattttcagttttctcgccatattccagatcctacagtgtgcatttttcatttttcacgtttttcagtgattttgtcattttttagttgtcaactgtctgtttctcattttccatgattttcagttttcttgccatattccatgtcctacactggacatttctaaattttccacctttttctgttttcctcgccatatttcacgtcctaaagtgtgtatttctcattttccgtgattttcagttttcttgccatattccaggtcctacagtgtgcatttctcatttttcacgtttttcagtgattttgtcatttttcaagttgtcaactgcatgtttctcattttccatgattttcagttttcttgctatattccatgtcctacagtggaaatttctaaattttccacctttttcagttttcctcgccatatttcacgtcctaaagtgtgtatttctcattttccgtgattttcagttttctcgccatattccaggtcctatgtgtacatttctcatttttcacgtttttcagtgattttgtcatttttcaagttgtgaagtggatgtttctcatttttcttgattttcatttttcttgccatattccatgtcctagagtggaaatttttaaattttccacctttttcagttttcctcgccatatttcacgtcctaaagtgtgaatttctcattttccgtgattttcagatttctcgccatattccaagtcctacagtgtgcatttctcatttttcacgtttttcagtgatttcgtcatttttcaagttgtcaagtggatgtttctcattttccatgattttcagctttcttgccatattcaaagtcctacagtggacatttctaaattttcgacctttatcagttttcctcgccatatttcatgtcccaaagtgtgtacttctcattttccgtgattttcagtttcctcgccatattctaggtcctacagtgtgcatttctcatttttcaggtttttcagtgatttcgtcttttttcaagtcgtcaagtggatgtttctcattttccatgattttcagttttcttgccatattccatgtcctacagtggacatttctaaattttccacctttttcagttttcctcgccatatttcatgtcctaaagtgtgtatttctcattttcagtgattttcagttttctcgccatattccaggtcctacagtgtgcatttctcatttttcacgtttttcagtgatttcgtcatttttcaagttgtcaagtggatgtttctcattttccatgattttcagttttcttgccatattccatgtcccacagtggacatttctaaattttccacctttttctgttttccttgccatatttcatgtcctaaagtgtgtatttctcattttccgtgattttcagttttcttgctatattccaagtcctacagtgtgcatttctcatttttcacgtttttcagtgattttgtcatttttcaatttgtcaactgcatgtttctcattttccatgattttcagttttcttgccatattccatgtcctacagtggaaatttctatattttccaactttttcagttttcctcgccatatttcacgtgctaaagtgtgtatttctcatttttcgtgtttttcaggtttctcgccatattccaggtcctacagtgtgcatttctcatttttcacgtttttcagtgattttgtcatttttcaagttgtcaagtggatgtttctcattttccttgattttcagttttcttgccatattccatgtcctacagtggacatttctaaattttccacctttttcagttttccttgccatatttcatgtcctaaagtgtgtatttctcattttcagtgattttcagttttctcgccatattccaggtcctacagtgtgcatttctcattttttcaggtttttcagtgatttcgtcatttttcacgttgtcaagtggatgtttctcattttccatgattttcacttttcttgccatatttcatgtcctaaagtgtgtatttctcattttcagtgattttcagttttctcgctatattccaggtcctacagtgtgcatttctcattttttcacgtttttcagtgatttcgtcatttttcacgttgtcaagtggatgtttctcattttccatgattttcacttttcttgccatatttcatgtcctacagtggacatttctaaattttccacctttttctgttttcctcgccatatttcacatactaaagtgtgtatttctcattttccttgattttcagttttcttgccatattccaggtcctacagtgtgcatttctcatttttcacgtttttcagtgatttcgtcatttttcaagtcgtcaagtggatgtttctcattttccatgattttcagttttctcgccatattccaggtcctacagttgacatttctaaattttccacattttttaagtttcctcgcgatatttcacatcctaaagtgtgtatttctcattttccgtgattttcagttttcttgccatattccaggtcctacagggtgcatttctcatttttcacgtttttcagtgatttcatcaatttcaagtcgtcaactgtatgtttctcattttcaatgattttcatttttcttgccatattccatgtcctacagtggacatttctaaatttttcacctttttcagttttccttgccatatttcatgtcctaaagtgtgtatttctcattttcagtgattttcagttttctcgccatattccaggtcctacagtgtgcatttctcattttttcaggtttttcagtgatttcgtcatttttcacgttgtcaagtggatgtttctcattttccatgattttcacttttcttgccatatttcatgtcctaaagtgtgtatttctcattttcagtgattttcagttttctcgccatattccaggtcctacagtgtgcatttctcatttttcacgtttttcagtgatttcgtcatttttcaagttgtcaagtggatgtttctcattttccatgattttcacttttcttgccatattccatgtcccacagtggacatttctaaattttccacctttttctgttttcctcgccatatttcatgtcctaaagtgtgtatttctcattttccgtgattttcagttttcttgctatattccaagtcctacagtgtgcatttctcatttttcacgtttttcagtgattttgtcatttttcaatttgtcaactgcatgtttctcattttccatgattttcagttttcttgccatattccatgttctacagtggaaatttctatattttccaactttttcagttttcctcgccatatttcacgtgctaaagtgtgtatttctcatttttcgtgtttttcaggtttctcgccatattccaggtcctacagtgtgcatttctcatttttcacgtttttcagtgattttgtcatttttcaagttgtcaagtggatgtttctcattttccttgattttcagttttcttgccatattccatgtcctacagtggacatttctaaattttccacctttttcagttttccttgccatatttcatgtcctaaagtgtgtatttctcattttcagtgattttcagttttctcgccatattccaggtcctacagtgtgcatttctcattttttcaggtttttcagtgatttcgtcatttttcacgttgtcaagtggatgtttctcattttccatgattttcacttttcttgccatatttcatgtcctaaagtgtgtatttctcattttcagtgattttcagttttctcgctatattccaggtcctacagtgtgcatttctcattttttcacgttttgcagtgatttcgtcatttttcacgttgtcaagtggatgtttctcattttccatgattttcacttttcttgccatatttcatgtcctacagtggacatttctaaattttccacctttttctgttttcctcgccatatttcacatcctaaagtgtgtatttctcattttccgtgattttcagttttcttgccatattccaggtcctacagtgtgcatttctcatttttcacgtttttcagtgatttcgtcatttttcaagtcgtcaagtggatgtttctcattttccatgattttcagttttctcgccatattccaggtcctacagttgacatttctaaattttccacattttttaagtttcctcgcgatatttcacatcctaaagtgtgtatttctcattttccgtgattttcagttttcttgccatattccaggtcctacagggtgcatttctcatttttcacgtttttcagtgatttcatcaatttcaagtcgtcaactgtatgtttctcattttcaatgattttcatttttcttgccatattccatgtcctacagtggacatttctaaattttccacctttttcagttttccttgccatatttcatgtcctaaagtgtgtatttctcattttcagggattttcagttttctcgccatattccaggtcctacagtgtgcatttctcattttttcaggtttttcagtgatttcgtcatttttcacgttgtcaagtggatgtttctcattttccatgattttcacttttcttgccatatttcatgtcctaaagtgtgtatttctcattttcagtgattttcagttttctcgccatattccaggtcctacagtgtgcatttctcattttttcacgtttttcagtgatttcgtcatttttcacgttgtcaagtggatgtttctcattttccatgattttcacttttcttgccatatttcatgtcctacagtggacatttctaaattttccacctttttctgttttcctcgccatatttcacatcctaaagtgtgtatttctcattttccgtgattttcagttttcttgccatattccaggtcctacagtgtgcatttctcatttttcacgtttttcagtgatttcgtcatttttcaagtcgtcaagtggatgtttctcattttccatgattttcagttttctcgccatattccaggtcctacagttgacatttctaaattttccacattttttaagtttcctcgcgatatttcacatcctaaagtgtgtatttctcattttccgtgattttcagttttcttgccatattccaggtcctacagggtgcatttctcatttttcacgtttttcagtgatttcatcaatttcaagtcgtcaactgtatgtttctcattttcaatgattttcatttttcttgccatattccacgtcctatagtggacatttctaaattttccacctttttcagttttcttcgccatatttcacgtcccaaagtgtgtatttctcattttccgtgattttcagtttcctcgcaatattccaggtcctacagtgtgcatttctcatttttcacgtttttcagtgatttcgtcttttttcaagtcgtcaagtggatgtttctcattttccatgattttcagttttcttgccatattccatgtcctacagtggacatttctaaattttccacctttttctgttttcctcgccatatttcacgtcctaaagtgtgtatttctcattttccgtgattttcagttttcttgccatattccaggtcctacagtgtgcatttctcatttttcacgtttttcactgattttgtcattgttcaagttgtcaactgcatgtttctcattttccatgattttcaattttcttgccatattccatgtcctacagtggaaatttctatattttccaactttttcagttttcctcgccatatttcacgtgctaaagtgtgtatttctcatttttcgtgtttttcaggtttctcgccatattccaggtcctacagtgtgcatttctcatttttcacgtttttcagtgattttgtcatttttcaagttgtcaagtggttgtttctcattttccttgattttcagttttcttgccatattccatgtcctactgtggacatttctaaattttccacctttttcagttttccttgccatatttcatgtcctaaagtgtgtatttctcattttcagtgattttcagttttctcgcaatattccaggtcctacagtgtgcatttctcattttccgtgattttcagttttctcgccatatgccaggtcatacagggtgcatttctcatttttcacgtttttcagtgatttcgtcatttttcacgtcgtcaagtggatgtttctcattttcaatgattttcatttttcttgccatattccacgtcctatagtggacatttctaaattttccaactttttcagttttcttgccatatttcaggtcctacagtgtgcatttctcatttttcacgtttttcagtgatttcgtcatttttcaagtggtcaagtgcatgtttctgattttccgtgattttcagttttcttgccatgttccaggtcctacagttgacgtttctaaaatttcactttttttaagttttcctcgccatatttcacttcctaaagtgtgtatttctcattttccgtgattttcagttttctcgccagattccaggtcctacagtgtgcatttttcatatttcacctttttcagtgattttgtcatttttcaagttgtcaactgcatgtttctcattttccatgattttcagttttcttgccatattccatgtcctactgtggacatttctaaattttccaactttttcagttttcctcgccatatttcatgtcctaaagtgtgtatttctcattttcagtgtttttctgttttctcgccatattccaggtcctacagtgtgcatttctaatttttcacgtttttcagtgatttcgtcatttttcaagttgtcaagtggatgtttctcattttccatgattttcagttttcttgccatattccatgtcctacagtggacatttctaaattttccaactttttccattttcctcaccatatttcacgtcctaaagtgtgtttttctcattttttgtgattttcagttttctcgacatattccaggtcctacagtgtgcatttctaattttttcttttttcagtgatttcgtcatttttcaagtggtcaagtgcatgtttctcattttccatgattttcagttttcttgccatattccatgtcctacaatggacatttctaaattttccaactttttcagttttcctcgccatatttcacgtcctaaagtgtgtatttctcattttccgtgattttcagttttctcgccatattccaggtcctatgtgtacatttctcatttttcacgtttttcagtgattttgtcatttttcaagttgtgaagtggatgtttctcatttttcttgattttcatttttcttgccatattccatgtcctagagtggaaatttttaaattttccaactttttcagttttcctcgccatatttcacgtcctaaagtgtgtatttctcattttccgtgattttcagttttctcgccatattccaagtcctacagtgtgcatttctcatttttcacgtttttcagtgatttcgtcatttttcaagttgtcaagtggatgtttctcattttccatgattttcagctttcttgccatattcaaagtcctacagtggacatttctaaattttcgacctttatcagttttcctcgccatatttcatgtcccaaagtgtgtacttctcattttccgtgattttcagtttcctcgccatattctaggtcctacagtgtgcatttctcatttttcaggtttttcagtgatttcgtcttttttcaagtcgtcaagtggatgtttctcattttccatgattttcagttttcttgccatattccatgtcctacagtggacatttctaaattttccacctttttcagttttcctcgccatatttcatgtcctaaagtgtgtatttctcattttcagtgattttcagttttctcgccatattccaggtcctacagtgtgcatttctcatttttcacgtttttcagtgatttcgtcatttttcaagttgtcaagtggatgtttctcattttccatgattttcagttttcttgccatattccatgtcccacagtggacatttctaaattttccacctttttctgttttccttgccatatttcatgtcctaaagtgtgtatttctcattttccgtgattttcagttttcttgctatattccaagtcctacagtgtgcatttctcatttttcacgtttttaagtgattttgtcatttttcaatttgtcaactgcatgtttctcattttccatgattttcagttttcttgccatattccatgtcctacagtggaaatttctatattttccaactttttcagttttcctcgccatatttcacgtgctaaagtgtgtatttctcatttttcgtgtttttcaggtttctcgccatattccaggtcctacagtgtgcatttctcatttttcacgtttttcagtgattttgtcatttttcaagttgtcaagtggatgtttctcattttccttgattttcagttttcttgccatattccatgtcctacagtggacatttctaaattttccacctttttcagttttccttgccatatttcatgtcctaaagtgtgtatttctcattttcagtgattttcagttttctcgccatattccaggtcctacagtgtgcatttctcattttttcaggtttttcagtgatttcgtcatttttcacgttgtcaagtggatgtttctcattttccatgattttcacttttcttgccatatttcatgtcctaaagtgtgtatttctcattttcagtgattttcagttttctcgccatattccaggtcctacagtgtgcatttctcattttttcacgtttttcagtgatttcgtcatttttcacgttgtcaagtggatgtttctcattttccatgattttcacttttcttgccatatttcatgtcctacagtggacatttctaaattttccacctttttctgttttcctcgccatatttcacatcctaaagtgtgtatttctcattttccgtgattttcagttttcttgccatatttcaggtcctacagtgtgcatttctcatttttcacgtttttcagtgatttcgtcatttttcaagtcgtcaagaggatgtttctcattttccatgattttcagttttctcgccatattccaggtcctacagttgacatttctaaattttccacattttttaagtttcctcgcgatatttcacatcctaaagtgtgtatttctcattttccgtgattttcagttttcttgccatattccaggtcctacagggtgcatttctcatttttcacgtttttcagtgatttcatcaatttcaagtcgtcaactgtatgtttctcattttcaatgattttcatttttcttgccatattccacgtcctatagtggacatttctaaattttccacctttttctgttttcctcgccatatttcacgtcctaaagtgtgtatttctcattttccgtgattttcagttttcttgccatattccaggtcctacagtgtgcatttctcatttttcacgtttttcactgattttgtcattgttcaagttgtcaactgcatgtttctcattttccatgattttcagttttcttgccatattccatgtcctacagtggaaatttctatattttccacctttttcagttttcctcgccgtatttcatgtgctaaagtgtgtatttctcatttttcgtgtttttcaggtttctcgccatattccaggtcctacagtgtgcatttctcatttttcacgtttttcagtgattttgtcatttttcaagttgtcaactggatgtttctcattttccttgattttcagttttcttgccatattccatgtcctactgtggacatttctaaattttccacctttttcagttttccttgccatatttcatgtcctaaagtgtgtatttctcattttcagtgattttcagttttctcgcaatattccaggtcctacagtgtgcatttctcattttttcaggtttttcagtgatttcgtcatttttcacgttgtcaagtggatgtttctcattttccatgattttcacttttcttgccatatttcatgtcctaaagtgtgtatttctcattttcagtgattttcagttttctcgccatattccaggtcctacattgtgcatttctcattttttcacgtttttcagtgatttcgtcatttttcacgttgtcaagtggatgtttctcattttccatgattttcacttttcttgccatatttcatgttttacagtggacatttctaaattttccacctttttctgttttcctcgccatatttcacatcctaaagtgtgaatttctcattttccgtgattttcagttttcttgccatattccaggtcctacagtgtgcatttctcatttttcacgtttttcagtgatttcatcatttttcaagtcgtcaagtggatgtttctcattttccatgattttcagttttcttgccatattccatgtcctacagtggacatttctaaattttccacctttttctgttttcctcgccatatttcacgtcctaaagtgtgtatttctcattttccgtgattttcagttttcttgccatattccaggtcctacagtgtgcatttctcatttttcacgtttttcactgattttgtcatttttcaagttgtcaactgcatgtttctcattttccatgattttcagttttcttgctatattccatgtcctacagtggaaatttctaaattttccacctttttcagttttcctcgccatatttcacgtcctgaagtgtgtatttctcattttccgtgattttcagttttctcgccatattccaggtcctatgtgtacatttctcatttttcacgtttttcagtgattttgtcatttttcaagttgtgaagtggatgtttctcatttttcttgattttcatttttcttgccatattccatgtcctacagtggaaatttctaaattttccacctttttcagttttcctcgccatatttcacgtcctaaagtgtgtatttctcattttccgtgattttcagttttctcgccatattccaggtcctacagtgtgcatttctcatttttcacgtttttcagtgatttcgacatttttcaagttgtcaagtggatgtttctcattttccatgattttcagctttcttgccatattcaaagtcctacagtggacatttctaaattttcgacctttatcagttttcctcgccatatttcatgtcccaaagtgtgtacttctcattttccgtgattttcagtttcctcgccatattccaggtcctacagtgtgcatttctcatttttcacgtttttcagtgatttcgtcatttttcaagtcgtcaagtggatgtttctcattttccatgattttcagttttcttgccatattccatgtcctacagtggacatttctaaattttccacctttttctgttttcctcgccatatttcacgtcctaaagtgtgtatttctcattttccgtgattttcagttttcttgccatattccaggtcctacagtgtgcatttctcatttatcacgtttttcactgattttgtcatttttcaagttgtcaactgcatgtttctcattttccatgattttcagttttcttgctatattccatgtcctacagtggaatattctaaattttccacctttttcagttttcctcgccatatttcacgtcctgaagtgtgtatttctcattttccgtgattttcagttttctcgccatattccaggtcctatgtgtacatttctcatttttcacgtttttcagtgattttgtcatttttcaagttgtgaagtggatgtttctcatttttcttgattttcatttttcttgccatattccatgtcctacagtggaaatttctaaattttccacctttttcagttttcctcgccatatttcacgtcctaaagtgtgaatttctcattttccgtgattttcagttttctcgccatattccaggtcctacagtgtgcatttctcatttttcacgtttttcagtgatttcgacatttttcaagttgtcaagtggatgtttctcattttccatgattttcagctttcttgccatattcaaagtcctacagtggacatttctaaattttcgacctttatcagttttcctcgccatatttcatgtcccaaagtgtgtacttctcattttccgtgattttgagtttcctcgccatattccaggtcctacagtgtgcatttctcatttttcacgtttttcagtgatttcgtcttttttcaagttgtcaactgcatgtttctcattttccatgattttcagttttcttgccatattccatgtcctacagtggaaatttgtaaatttccacctttttcagttttcctcgccatatttcacgtcctaaagtatgtatttctcattttccgtgattttcagttttctcgccatattccaggtcctacagtgtgcatttctcatttttcacgtttttcagtgattttgtcattttttaagttttcaagtggatgtttctcattttccttgattttcagttttcttgccatattccatgtcctacagtggacatttctaaattttccacctttttcagttttcctcgccatatttcatgtcctaaagtgtgtatttctcattttcagtgattttcagttttctcgccatattccaggtcctacagtgtgcatttctcatttttcacgtttttcagtgatttcgtcatttttcaaggtgtcaagtggatgtttctcattttccatgattttcagttttcttgccatattccatgtcctacagtggacatttctaaattttccacctttttctgttttcctcgccatatttcatgtcctaaagtgtgtatttctcattttccgtgattttcagttttcttgctatattccaagtcctacagtgtgcatttctcatttttcacgtttttcagtgattttgtcatttttcaatttgtcaactgcatgtttctcattttccatgattttcagtttttttgccatattccatgtcctactgtggaaatttctatattttccacctttttcagttttcctcgccatatttcacgtgctaaagtgtgtatttctcatttttcgtgtttttcaggtttctcgccatattccaggtcctacagtgtgcatttctcatttttcacgtttttcagtgattttgtcatttttcaagttttcaagtggatgtttctcattttccttgattttcagttttcttgccatattccatgtcctacagtggacatttctaaattttccacctttttcagttttccttgccatatttcatgtcctaaagtgtgtatttctcattttcagtgattttcagtttccttgccatattccaggtcctacagtgtgcatttctcattttttcacgtttttcagtgatttcgtcatttttcacgttgtcaagtggatgtttctcattttccatgattttcacttttcttgccatatttcatgtcctacagtggacatttctaaattttccaactttttcaattttcctcgccatattttatgtcctaaagtgtgtatttctcatttttcgttattttcagttttcttgccatattccaggtcctacagtgtgcatttgtcatttttcacgtttttcagtgatttcgtcatttttcaagtcgtcaagtagatgtttctcatattccatgtttttcagttttctcgccatattccaggtcctacagttgacatttctaaattttctacatttttaaattttcctcgccatatttcacgtcctaaagtgtgtatttctcattttttgttattttcagttttctagccatattccaggtcctacaggatgcatttctcatttttcacgtttttcagtgatttcatcatttttcaagtcgtcaagtgtatgtttcttattttcaatgattttcatttttcttgccttattccacgtcctatagtggacatttctaaattttccacctttttcagtttttttcgccatatttcacgtcctaaagtgtgtatttctcattttctgtgattttcagttttctcaccatattccaggtcctacagtgtgcatttctcatttttcacgtttttcagtgatttcgtcatttttcaagttgtcaagtggaagtttctcattttccatgattttcagctttctagacatattccaggtcctacagtggacatttcctaattttcgacctttatcagttttcctcgtcatatttcacgtcccaaaatgtgtatttcttattttccatgattttcagtttcctcgccatattccaggtcctacagtgtgcaattctcatttttcacgtttttcagtgatttcgtcttttttcaagacgtcaagtggatgtttctcatttttcatgattttcagttttcttgccatattccatgtcctacagtggacatttctaaattttccacctttttctgttttcctcgccatatttcacgtcctaaagtgtgtatttctcattttccgtgattttcagttttcttgccatattcctggtcctacagtgtgcatttctcatttttcacgtttttcagtgattttgtcatttttcaatttgtcaactgcatgtttctcattttccattattttcagttttcttgccatattccatgtcctacagtggacatttctaaattttccacctttttctgttttcctcgccatatttcatgtcctaaagtgtgtatttctcattttccgtgattttcagttttcttgctatattccaagtcctacagtgtgcatttctcatttttcacgtttttcagtgattttgtcatttttcaatttgtcaactgcatgtttctcattttccatgattttcagtttttttgccatattccatgtcctacaggggaaatttctatattttccacctttttcagttttcctcgccatatttcatgtcctaaagtgtgtatttctcattttccgtgattttcagttttcttgccatattccaggtcctacagtgtgcatttctcatttttcacgtttttcagtgatttcgtcatttttcaagtcttcaagtagatgtttctcatattccatgtttttcagttttctcgccatattccaggtcctacagttgacatttctaaattttctacatttttaaattttcctcgccatatttcacgtcctaaagtgtgtatttctcatttttcgttattttcagttttctagccatattccaggtcctacaggatgcatttctcatttttcacgtttttcagtgatttcatcatttttcaagtcgtcaagtgtatgtttctcattttcaatgattttcatttttcttgccttattccacgtcctatagtggacatttctaaattttccacctttttcagtttttctcgccatatttcacgtcctaaagtgtgtatttctcattttctgtgattttcagttttctcaccatattccaggtcctacagtgtgcatttctcatttttcacgtttttcagtgatttcgtcatttttcaagttgtcaagtggaagtttctcattttccatgattttcagctttctagccatattccaggtcctacagtggacatttcctaattttcgacctttatcagttttcctcgccatatttcacgtcctaaagtgtgtatttctcattttccgtgattttcagttttcttgccatattccaggtcctacagtgtgcatttctcatttttcacgtttttcagtgattttgtcatttttcaatttgtcaactgcatgtttctcattttccatgatttttagttttcttgctatattccatgtcctacagtggaaatttctaaattttccacctttttcagttttcctcgccatatttcacgtcctaaagtgtgtatttctcattttccgtgattttcagttttcttgctatattccaagtcctacattgtgcatttctcatttttcacgtttttcagtgattttgtcatttttcaatttgtcaaaccacatgtttctcattttccatgattttcagtttttttgccatattccatgtcctacagtggaaatttctatattttccacctttttcagttttcctcgccatatttcacgtgctaaagtgtgtatttctcatttttcgtgtttttcaggtttctcgccatattccaggtcctacagtgtgcatttctcatttttcacgtttttcagtgattttgtcatttttcaagttgtcaagtggatgtttcccattttccttgattttcagttttcttaccatattccatgtcctacagtggacatttctaaattttccacctttttcagttttccttgccatatttcatgtcctaaagtgtgtatttctcattttcagtgattttcagtttcctcgccatattccaggtcctacagtgtgcatttctcattttttcacgtttttcagtgatttcgtcatttttcacgttgtcaagtggatgtttctcattttccatgattttcacttttcttgccatatttcatgtcctatagtggacatttctaaattttccacctttttcagtttttctcgccatatttcacgtcctaaagtgtgtatttctcattttctgtgattttcagttttctcaccatattccaggtcctacagtgtgcatttctcatttttcacgtttttcagtgatttcgtcatttttcaagtcgtcaagtagatgtttctcatattccatgtttttcagttttctcgccatattccaggtcctacagttgacatttctaaattttctacatttttaaattttcctcgccatatttcacgtcctaaagtgtgtatttctcatttttcgttattttcagttttctagccatattccaggtcctacaggatgcatttctcatttttcacgtttttcagtgatttcatcatttttcaagtcgtcaagtgtatgtttcttattttcaatgattttcatttttcttgccttattccacgtcctatagtggacatttctaaattttccaccttttttcagtttttctcgccatatttcacgtcctaaagtgtgtatttctcattttctgtgattatcagttttctcaccatattccaggtcctacagtgtgcatttctcatttttcacgtttttcagtgatttcgtcatttttcaagttgtcaagtggaagtttctcattttccatgattttcagctttctagccatattccaggtcctacagtggacatttcctaattttcgacctttatcagttttcctcgccatatttcacgtcccaaaatgtgtatttcttattttccatgattttcagtttcctcgccatattccaggtcctacagtgtgcatttctcatttttcacgtttttcagtgatttcgtcttttttcaagacgtcaagtggatgtttctcatttttcatgattttcagttttcttgccatattccatgtcctacagtggacatttctaaattttccacctttttctgttttcctcgccatatttcacgtcctaaagtgtgtatttctcattttccgtgattttcagttttcttgccatattcctggtcctacagtgtgcatttctcatttttcacgtttttcagtgattttgtcatttttcaatttgtcaactgcatgtttctcattttccatgattttcagttttcttgccatattccatgtcctacagtggacatttctaaattttccacctttttcagttttcctcgccatatttcacgtgctaaagtgtgtatttctcatttttcgtgtttttcaggtttctcgccatattccaggtcctacagtgtgcatttctcatttttcacgtttttcagtgattttgtcatttttcaagttgtcaagtggatgtttctcattttccttgattttcacttttcttgccatattccaagtcttacaggggcatttctcatttttcacgttttcagtgattttgtcattttcaatttgtcaactgcatgtttctcattttccatgattttcagtttttttgccatattccatgtcctacaggggaaatttctatattttccacctttttcagttttcctcgccatatttcatgtcctaaagtgtgtatttctcattttccgtgattttcagttttcttgccatattccaggtcctacagtgtgcatttctcatttttcacgtttttcagtgatttcgtcatttttcaagtcttcaagtagatgtttctcatattccatgtttttcagttttctcgccatattccaggtcctacagttgacatttctaaattttctacatttttaaattttcctcgccatatttcacgtcctaaagtgtgtatttctcatttttcgttattttcagttttctagccatattccaggtcctacaggatgcatttctcatttttcacgtttttcagtgatttcatcatttttcaagtcgtcaagtgtatgtttctcattttcaatgattttcatttttcttgccttattccacgtcctatagtggacatttctaaattttccacctttttcagtttttctcgccatatttcacgtcctaaagtgtgtatttctcattttctgtgattttcagttttctcaccatattccaggtcctacagtgtgcatttctcatttttcacgtttttcagtgatttcgtcatttttcaagttgtcaagtggaagtttctcattttccatgattttcagctttctagccatattccaagtcctacagtggacatttcctaattttcgacctttatcagttttcctcgccatatttcacgtcccaaaatgtgtattccttattttccatgattttcagtttcctcgccatattccaggtcctacagtgtgcatttatcatttttcacgtttttcagtgatttcgtcttttttcaagacgtcaagtggatgtttctcatttttcatgattttcagttttcttgccatattccatgtcctacagtggacatttctaaattttccacctttttctgttttcctcgccatatttcacgtcctaaagtgtgtatttctcattttccgtgattttcagttttcttgccatattcctggtcctacagtgtgcatttctcatttttcacgtttttcagtgattttgtcatttttcaagttgtcaagtggatgtttctcattttccttgattttcacttttcttgccatattccatgtcctacagtggacatttctatattttccacctttttccgttttccttgccatatttcacgtcctaaagtgtgtatttctcattttccgtgattttcaggtttctcgccatattccaggtcctacagtgtgcatttctcatttttcacgtttttcagtgattttgtcatttttcaagttgtcaagtggatgtttctcattttccttgattttcacttttcttgccatattccatgtcctacagtggacatttctaaattttccacctttttcagttttcctcgccatatttcatgtcctaaagtgtgtatttctcattttcagtgattttcagttttcttgccatattccaggtcctacagtgtgcatttctcatttttcacgtttttcagtgattttgtcatttttcaagttgtcaactgcatgtttctcattttctatgattttcagttttcttgctatattccatgtcctacagtggaaatttctaaattttccacctttttcagttttcctcgccatatttcacgtcctaaagtgtgtatttctcattttccgtgattttcagttttctcgccatattccaggtcctatgtgtacatttctcatttttcacgtttttcagtgattttgtcatttttcaagttgtgaagtggatgtttctcatttttcttgattttcatttttcttgccatattccatgtcctagagtggaaatttttaaattttccacctttttcagttttcctcgccatatttcacgtcctaaagtgtgaatttctcattttccgtgattttcagatttctcgccatattccaagtcctacagtgtgcatttctcatttttcacgtttttcagtgatttcgtcatttttcaagttgtcaagtggatgtttctcattttccatgattttcagctttcttgccatattcaaagtcctacagtggacatttctaaattttcgacctttatcagttttcctcgccatatttcatgtcccaaagtgtgtacttctcattttccgtgattttcagtttcctcgccatattctaggtcctacagtgtgcatttctcatttttcaggtttttcagtgatttcgtcttttttcaagtcgtcaagtggatgtttctcattttccatgattttcacttttcttgccatatttcatgtcctaaagtgtgtatttctcattttcagtgattttcagttttctcgctatattccaggtcctacagtgtgcatttctcattttttcacgtttttcagtgatttcgtcatttttcacgttgtcaagtggatgtttctcattttccatgattttcacttttcttgccatatttcatgtcctacagtggacatttctaaattttccacctttttctgttttcctcgccatatttcacatcctaaagtgtgtatttctcattttccgtgattttcagttttcttgccatattccaggtcctacagtgtgcatttctcatttttcacgtttttcagtgatttcgtcatttttcaagttgtcaagtggatgtttctcattttccttgattttcagttttcttgccatattccatgtcctactgtggacatttctaaattttccacctttttcagttttccttgccatatttcatgtcctaaagtgtgtatttctcattttcagtgattttcagttttctcgcaatattccaggtcctacagtgtgcatttctcattttttcaggtttttcagtgatttcgtcatttttcacgttgtcaagtggatgtttctcattttccatgattttcacttttcttgccatatttcatgtcctaaagtgtgtatttctcattttcagtgattttcagttttcctcgccatatttcacgtcccaaaatgtgtatttcttattttccatgattttcagtttcctcgccatattccaggtcctacagtgtgcatttctcatttttcacgtttttcagtgatttcgtcttttttcaagacgtcaagtggatgtttctcatttttcatgattttcagttttcttgccatattccatgtcctacagtggacatttctaaattttccacctttttctgttttcctcgccatatttcacgtcctaaagtgtgtatttctcattttccgtgattttcagttttcttgccatattcctggtcctacagtgtgcatttctcatttttcacgtttttcagtgattttgtcatttttcaatttgtcaactgcatgtttctcattttccatgattttcagttttcttgccatattccatgtcctacagtggacatttctaaattttccacctttttcagttttcctcgccatatttcacgtgctaaagtgtgtatttctcatttttcgtgtttttcaggtttctcgccatattccaggtcctacagtgtgcatttctcatttttcacgtttttcagtgattttgtcatttttcaagttgtcaagtggatgtttctcattttccttgattttcacttttcttgccatattccatgtcctacagtggacatttctaaattttccacctttttcagttttcctcgccatatttcatgtcctaaagtgtgtatttctcattttcagtgattttcagttttctcgccatattccaggtcctacagtgtgcatttctcatttttcacgtttttcagtgatttcgtcttttttcaagacgtcaagtggatgtttctcattttccatgattttcagttttcttgccatattccatgtcctacagtggacatttctaaattttccacctttttctgttttcctcgccatatttcacgtcctaaagtgtgtatttctcattttccgtgattttcagttttcttgccatattccaggtcctacagtgtgcatttctcatttttcacgtttttcagtgattttgtcatttttcaatttgtcaactgcatgtttctcattttccatgatttttagttttcttgctatattccatgtcctacagtggaaatttctaaattttccacctttttcagttttcctcgccatatttcacgtcctaaagtgtgtatttctcattttccgtgattttcagttttcttgctatattccaagtcctacattgtgcatttctcatttttcacgtttttcagtgattttgtcatttttcaatttgtcaaaccacatgtttctcattttccatgattttcagtttttttgccatattccatgtcctacagtggaaatttctatattttccacctttttcagttttcctcgccatatttcacgtgctaaagtgtgtatttctcatttttcgtgtttttcaggtttctcgccatattccaggtcctacagtgtgcatttctcatttttcacgtttttctgtgattttgtcatttttcaagttgtcaagtggatgtttctcattttccttgattttcagttttcttaccatattccatgtcctacagtggacatttctaaattttccaccttttctgttttcctcgccatatttcatgtcctaaagtgtgtatttctcattttccgtgattttcatttttcttgctatattccaagtcctacagtgtgcatttctcattttccatgattttcagttttcttgctatattccatgtcctacagtggaaatttctaaattttccacctttttcagttttcctcgccatatttcacgtcctaaagtgtgtatttctcattttccgtgattttcagttttttcgccatattacaggtcctatgtgtacatttctcatttttcacgtttttcagtgattttgtcatttttcaagttgtcaagtggatgtttctcatttttcttgattttcatttttcttgccatattccatgtcctacagtggaaatttctaaattttccacctttttcagttttcctcgccatatttcacgtcctaaagtgtgaatttctcattttccgtgattttcagttttctcgccatattccaggtctacagtgtgcatttctcatttttcacgttttcagtgattcgtcatttttcaagttgacaagtggatgtttctcattttccatgattttcagctttcttgccatattcaaagtcctacagtggacatttctaaattttcgacctttatcagttttcctcgccatatttcatgtcccaaagtgtgtacttctcattttccgtgattttcagttttcttgccatattccaagtcctacagtgtgcatttctcatttttcacgtttttcagtgattttgtcatttttcaatttgtcaactgcatgtttctcattttccatgattttcagttttcttgccatattccatgtcctacagtggaaatttctatattttccacctttttcagttttcctcgccatatttcacgtgctaaagtgtgtatttctcatttttcgtgtttttcaggtttctcgccatattccaggtcctacagtgtgcatttctcatttttcacgtttttcagtgattttgtcatttttcaagttgtcaagtggatgtttctcattttcaatgattttcatttttcttgccttattccacgtcctatagtggacatttctaaattttccacctttttcagtttttctcgccatatttcacgtcccaaaatgtgtattccttattttccatgattttcagtttcctcgccatattccaggtcctacagtgtgcatttctcatttttcacgtttttcagtgatttcgtcttttttcaagacgtcaagtggatgtttctcatttttcatgattttcagttttcttgccatattccctgtcctacagtggacatttctaaattttccacctttttctgttttcctcgccatatttcacgtcctaaagtgtgtatttctcattttccgtgattttcagttttctcgccagattccaggtcctacagtgtgcatttctcatttttcacgtttttcagtgattttgtcatttttcaatttgtcaactgcatgtttctctctttccatgattttcagttttcttgccatattccatgtcctacagtggacatttctaaattttccacctttttcagttttcctcgccatatttcacgtgctaaagtgtgtatttctcatttttcgtgtttttcaggtttctcgccatattccaggtcctacagtgtgcatttctcatttttcacgtttttcagtgattttgtcatttttcaagttgtcaagtggatgtttctcattttcaatgattttcatttttcttaccttattccacgtcctatagtggacatttctaaattttccacctttttcagtttttctcgccatatttcacgtcccaaaatgtgtattccttattttccatgattttcagtttcctcgccatattccaggtcctacagtgtgcatttctcatttttcacgtttttcagtgatttcgtcttttttcaagacgtcaagtggatgtttctcatttttcatgattttcagttttcttgccatattccctgtcctacagtggacatttctaaattttccacctttttctgttttcctcgccatatttcacgtcctaaagtgtgtatttctcattttccgtgattttcagttttctcgccagattccaggtcctacagtgtgcatttctcatttttcacgtttttcagtgatttcgtcatttttcaagtcttcaagtgtatgtttctcattttcaatgattttcatttttcttgccttattccacgtcctatagtggacatttctaaattttccacctttttcagtttttctcgccatatttcacgtcctaaagtgtgtatttctcattttctgtgattttcagttttcttaccatattccaggtcctacagtgtgcatttctcatttttcacgtttttcagtgatttcgtcatttttcaagttgtcaagtggaagtttctcattttccatgattttcagctttctagccatattccaggtattacagtggacatttccttattttcgacctttatcagttttcctcgccatatttcatgtcctaaagtgtgt	38399	1554	4%	7300	19%
9	3000001	3038400	Atcctacagtgtgcatttctcatttttcacgtttttcagtgatttcgtcatttttcaagtcatcaagtggctgtttctcattttccatgattttcagttttcttgccatattccttgtcctacagtggacatttctaaattttccacctttttcagttttccttgtcatatttcaggtcctacagtgtgtatttctcatttttcacgtttttcattgatttcgtcatttttcaagttgtcaagtgcatgtttctcattttccatgattttcagttttcttgccatattccatgtcctacaatggacatttctaaattttccaactttttcagttttcctcgccatatttcacgtcctaaagtgtgtatttctcattttccgtgattttcagttttctcgacatattccaggtcctacagtgtgcatttctcatttttcacgtttttcagtgatttcgtcatttttcacgtcgtcaagtggatgtttctcattttccatgattttcagttttcttgccatattccatgtcctacagtggacatttctaaattttccacctttttcagttttcctcgccatatttcacgtcctaaagtgtgtatttctcattttccgtgattttcagttttctcgacatattccaggtcttacagggtgcatttctcatttttcacgtttttcagtgatttcatcatttttcaagtcgtcaactgtatgtttctcattttcaatgattttcatttttcttgccatattccacgtcctatagtggacatttctaaattttccacctttttcagttttccttgccatatttcaggtcctacagtgtgcatttctcatttttcacgtttttcagtgatttcgtcatttttcaagtggtcaaatgcatgtttctcattttccatgattttcagttttcttgccatattccatgtcctacagtggacatttctaaattttccacctttttcagttttcctcgccatatttcacgtcctaaagtgtgtatttctcattttccgtgattttcagttttatcgccagattccaggtcctacggtgtgcatttttcatatttcacgtttttcagtgattttgtcatttttcaagttgtcaactgcatgtttctcattttccatgattttcagttttcttgccatattccatgtcctacagtggacatttctaaattttccacctttttcagttttcctcgccatatttcatgtcctaaagtgtgtatttctcattttcagtgattttctgttttctcgccatattccaggtcctacagtgtgcatttctcatttttcacgtttttcagtgatttcgtcatttttcaagttgtcaagtggatgtttctcattttccatgattttcagttttcttgccatattccatgtcctacaatggacatttctaaattttccacctttttcagttttcctcgccatatttcacgtcctaaagtgtgtatttctcattttccgtgattttcagttttctcgccatattccaggtcctatgtgtacatttctcatttttcacgtttttcagtgattttgtcatttttcaagttgtgaagtggatgtttctcatttttcttgattttcatttttcttgccatattccatgtcctagagtggaaatttttaaattttccacctttttcagttttcctcgccatatttcacgtcctaaagtgtgaatttctcattttccgtgattttcagttttctcgccatattccaagtcctacagtgtgcatttctcatttttcacgtttttcagtgatttcgtcatttttcaagttgtcaagtggatgtttctcattttccatgattttcagctttcttgccatattcaaagtcctacagtggacatttctaaattttcgacctttatcagttttcctcgccatatttcatgtcccaaagtgtgtacttctcattttccgtgattttcagtttcctcgccatattctaggtcctacagtgtgcatttctcatttttcaggtttttcagtgatttcgtcttttttcaagtcgtcaagtggatgtttctcattttccatgattttcagttttcttgccatattccatgtcctacagtggacatttctaaattttccaactttttcagttttcctcgccatatttcatgtcctaaagtgtgtatttctcattttcagtgattttcagttttctcgccatattccaggtcctacagtgtgcatttctcatttttcacgtttttcagtgatttcgtcatttttcaagttgtcaagtggatgtttctcatttttcatgattttcagttttcttgccatattccatgtcccacagtggacatttctaaatgttccacctttttctgttttccttgccatatttcatgtcctaaagtgtgtatttctcattttccgtgattttcagttttcttgctatattccaagtcctacagtgtgcatttctcatttttcacgtttttctgtgattttttcatttttcaatttgtcaactgcatgtttctcattttccatgattttcagttttcttgccatattccaggtcctacagtgtgcatttctcatttttcacgtttttcagtgattttgtcatttttcaagttgtcaactgcatgtttctcattttccatgattttcagttttcttgctatattccatgtcctacagtggaaatttctaaattttccacctttttcagttttcctcgccatatttcacgtcctaaagtgtgtatttctcattttccgtgattttcagttttctcgccatattccaggtcctatgtgtacatttctcatttttcacgtttttcagtgattttgtcatttttcaagttgtgaagtggatgtttctcatttttcttgattttcatttttcttgccatattccatgtcctagagtggaaatttttaaattttccacctttttcagttttcctcgccatatttcacgtcctaaattgtgaatttctcattttccgtgattttcagttttctcgccatattccaagtcctacagtgtgcatttctcatttttcacgtttttcagtgatttcgtcatttttcaagttgtcaagtggatgtttctcattttccatgattttcagctttcttgccatattcaaagtcctacagtggacatttctaaattttcgacctttatcagttttcctcgccatatttcatgtcccaaagtgtgtacttctcattttccgtgattttcagtttcctcgccatattctaggtcctacagtgtgcatttctcatttttcaggtttttcagtgatttcgtcttttttcaagtcgtcaagtggatgtttctcattttccatgattttcagttttcttgccatattccatgtcctacagtggacatttctaaattttccacctttttcagttttcctcgccatatttcatgtcctaaagtgtgtatttctcattttcagtgattttcagttttctcgccatattccaggtcctacagtgtgcatttctcatttttcacgtttttcagtgattttgtcatttttcaagttgtcaagtggatgtttctcattttccttgattttcagttttcttgccatattccatgtcctacagtggacatttctaaattttccacctttttcagttttccttgccatatttcatgtcctaaagtgtgtatttctcattttcagtgattttcagttttctcgccatattccaggtcctacagtgtgcatttctcattttttcaggtttttcagtgatttcgtcatttttcacgttgtcaagtggatgtttctcattttccatgattttcacttttcttgccatatttcatgtcctaaagtgtgtatttctcattttcagtgattttcagttttctcgccatattccaggtcctacagtgtgcatttctcattttttcacgtttttcagtgatttcgtcatttttcacgttgtcaagtggatgtttctcattttccattattttcacttttcttgccatatttcatgtcctacagtggacatttctaaattttccacctttttctgttttcctcgccatatttcacatcctaaagtgtgtatttctcattttccgtgattttcagttttcttgccatattccaggtcctacagtgtgcatttctcatttttcacgtttttcagtgatttcgtcatttttcaagtcgtcaagtggatgtttctcattttccatgattttcagttttctcgccatattccaggtcctacagttgacatttctaaattttccacattttttatgtttcctcgcgatatttcacatcctaaagtgtgtatttctcattttccgtgattttcagttttcttgccatattccaggtcctacagggtgcatttctcatttttcacgtttttcagtgatttcatcaatttcaagtcgtcaactgtatgtttctcattttcaatgattttcatttttcttgccatattccacgtcctatagtggacatttctacattttccacctttttcagttttcttcgccatatttcacgtcccaaagtgtgtatttctcattttccgtgattttcagtttcctcgccatattccaggtcctacagtgtgcatttctcatttttcacgtttttcagtgatttcgtcttttttcaagtcgtcaagtggatgtttctcattttccatgattttcagttttcttgccatattccatgtcctacagtggacatttctaaattttccacctttttctgttttcctcgccatatttcacgtcctaaagtgtgtatttctcatttaccgtgattttcagttttcttgctatattccaagtcctacagtgtgcatttctcatttttcacgtttttcactgattttgtcattgttcaagttgtcaactgcatgtttctcattttccatgattttcagttttcttgccatattccatgtcctacagtggaaatttctatattttccaactttttcagttttcctcgccatatttcacgtgctaaagtgtgtatttctcatttttcgtgtttttcaggtttctcgccatattccaggtcctacagtgtgcatttctcatttttcacgtttttcagtgattttgtaatttttcaagttgtcaagtggatgtttctcattttccttgattttcagttttcttgccatattccatgtcctactgtggacatttctaaattttccacctttttcagttttccttgccatatttcatgtcctaaagtgtgtatttctcattttcagtgattttcagttttctcgcaatattccaggtcctacagtgtgcatttctcattttttcaggtttttcagtgatttcgtcatttttcacgttgtcaagtggatgtttctcattttccatgattttcacttttcttgccatatttcatgtgctaaagtgtgtatttctcattttcagtgattttcagttttctgccatattccaggtcctacattgtgcatttctcattttttcacgtttttcagtgatttcgtcatttttcacgttgtcaagtggatgtttctcattttccatgattttcacttttcttgccatatttcatgttttacagtggacatttctaaattttccacctatttctgttttcctcgccatatttcacatcctaaagtgtgtatttctcattttccgtgattttcagttttctcgccatatgccaggtcatacagggtgcatttctcatttttcacgtttttcagtgatttcgtcatttttcacgtcgtcaagtggatgtttctcattttcaatgattttcatttttcttgccatattccacgtcctatagtggacatttctaaattttccacctttttcagttttccttgccatatttcaggtcctacagtgtgcatttctcttttttcacgtttttcagtgatttcgtcatttttcaagtggtcaagtgcatgtttctcattttccgtgattttcagttttcttgccatgttccaggtcctacagttgacgtttctaaaatttcactttttttaagttttcctcgccatatttcacttcctaaagtgtgtatttctcattttccgtgattttcagttttctcgccagattccaggtcctacagtgtgcatttttcatatttcacctttttcagtgattttgtcatttttcaagttgtcaactgcatgtttctcattttccatgattttcagttttcttgccatattccatgtcctactgtggacatttctaaattttccaactttttcagttttcctcgccatatttcatgtcctaaagtgtgtatttctcattttcagtgattttctgttttctcgccatattccaggtcctacagtgtgcatttctaatttttcacgtttttcagtgatttcgtcatttttcaagttgtcaagtggatgtttctcattttccatgattttcagttttcttgccatattccatgtcctacagtggacatttctaaattttccaactttttccattttcctcaccatatttcacgtcctaaagtgagtttttctcattttttgtgattttcagttttctcgacatattccaggtcctacagtgtgcatttctaattttttcttttttcagtgatttcgtcatttttcaagtggtcaagtgcatgtttctcattttccatgattttcagttttcttgccatattccatgtcctacaatggacatttctaaattttccaactttttcagttttcctcgccatatttcacgtcctaaagtgtgtatttctcattttccgtgattttcagttttctcgccatattccaggtcctacagtgtgcatttctcatttttcacgtttttcagtgatttcgtcatttttcaagttgtcaactgcatgtttctcattttccatgattttcagttttcttgccatattccatgtcttacagtggacatttttaaatttttcacatttttttaagttttcctccccatatttcacgttttaaagtgtgcatttctcattttcggtgattttcagttttctcgccagattccatgtcttacagtgtgcatttctcattttttcacgtttttcagtgatttcgtcatttttcaagtcgtcaagtggatgtttctcattttccatgattttcagttttcttgccatattccatgtcctacagtggaaatttctaaattttccacctttttcagttttccttgccatatttcaggtcctaaagtgtgtatttctcattttctgtgattttcagttttctcgccatattccaggtcctacagttgacatttctaaaatttccacattttttaagttttcctcgccatatttcacttcctaaagtgtgtatttctcattttccgtgattttcagttttctcgccatattccagatcctacagtgtacatttttcatttttcacgtttttcagtgattttgtcattttttagttgtcaactgcctgtttctcattttccatgattttcagttttcttgctatattccatgtcctacagtggaaatttctaaattttccacctttttcagttttcctcgccatatttcacgtcctaaagtgtgtatttctcattttccgtgattttcagttttctcgccatattccaggtcctatgtgtacatttctcatttttcacgtttttcagtgattttgtcatttttcaatttgtcaactgcatgtttctcattttccatgattttcagttttcttgccatattccatgtcctacagtggaaatttctatattttccaactttttcagttttcctcgccatatttcacgtgctaaagtgtgtatttctcatttttcgtgtttttcaggtttctcgccatattccaggtcctacagtgtgcatttctcatttttcacgtttttcagtgattttgtcatttttcaagttgtcaagtggatgtttctcattttccttgattttcagttttcttgccatattccatgtcctacagtggacatttctaaattttccacctttttcagttttccttgccatatttcatgtcctaaagtgtgtatttctcattttcagtgattttcagttttctcgccatattccaggtcctacagtgtgcatttctcattttttcaggtttttcagtgatttcgtcatttttcacgttgtcaagtggatgtttctcattttccatgattttcacttttcttgccatatttcatgtcctaaagtgtgtatttctcattttcagtgattttcagttttctcgctatattccaggtcctacagtgtgcatttctcattttttcacgtttttcagtgatttcgtcatttttcacgttgtcaagtggatgtttctcattttccatgattttcacttttcttgccatatttcatgtcctacaatggacatttctaaattttccacctttttctgttttcctcgccatatttcacatcctaaagtgtgtatttctcattttccgtgattttcagttttcttgccatattccaggtcctacagtgtgcatttctcatttttcacgtttttcagtgatttcgtcatttttcaagttgtcaagtggatgtttctcattttccttgattttcagttttcttgccatattccatgtcctactgtggacatttctaaattttccacctttttcagttttccttgccatatttcatgtcctaaagtgtgtatttctcattttcagtgattttcagttttctcgcaatattccaggtcctacagtgtgcatttctcattttttcaggtttttcagtgatttcgtcatttttcacgttgtcaagtggatgtttctcattttccatgattttcacttttcttgccatatttcatgtcctaaagtgtgtatttctcattttcagtgattttcagttttctgccatattccaggtcctacattgtgcatttctcattttttcacgtttttcagtgatttcgtcatttttcagttttctcgacatattccaggtcctacagtgtgcatttctaattttttcttttttcagtgatttcgtcatttttcaagttgtcaactgcatgtttctcattttccatgattttcagttttcttgccatattccatgtcttacagtggacatttttaaatttttcacatttttttaagttttcctccccatatttcacgttttaaagtgtgcatttctcattttcggtgattttcagttttctcgccagattccaggtcttacagtgtgcatttctcattttttcacgtttttcagtgatttcgtcatttttcaagtcgtcaagtggatgtttctcattttccatgattttcagttttcttgccatattccatgtcctacagtggaaatttctaaattttccacctttttcagttttccttgccatatttcaggtcctaaagtgtgtatttctcattttctgtgattttcagttttctcgccatattccaggtcctacagttgacatttctaaaatttccacattttttaagttttcctcgccatatttcacttcctaaagtgtgtatttctcattttccgtgattttcagttttctcgccatattccagatcctacagtgtgcatttttcatttttcacgtttttcagtgattttgtcattttttagttgtcaactgtctgtttctcattttccatgattttcagttttcttgccatattccatgtcctacactggacatttctaaattttccacctttttctgttttcctcgccatatttcacgtcctaaagtgtgtatttctcattttccgtgattttcagttttcttgccatattccaggtcctacagtgtgcatttctcatttttcacgtttttcagtgattttgtcatttttcaagttgtcaactgcatgtttctcattttctatgattttcagttttcttgctatattccatgtcctacagtggaaatttctaaattttccacctttttcagttttcctcgccatatttcacgtcctaaagtgtgtatttctcattttccgtgattttcagttttctcgccatattccaggtcctatgtgtacatttctcatttttcacgtttttcagtgattttgtcatttttcaagttgtgaagtggatgtttctcatttttcttgattttcatttttcttgccatattccatgtcctagagtggaaatttttaaattttccacctttttcagttttcctcgccatatttcacgtcctaaagtgtgaatttctcattttccgtgattttcagatttctcgccatattccaagtcctacagtgtgcatttctcatttttcacgtttttcagtgatttcgtcatttttcaagttgtcaagtggatgtttctcattttccatgattttcagctttcttgccatattcaaagtcctacagtggacatttctaaattttcgacctttatcagttttcctcgccatatttcatgtcccaaagtgtgtacttctcattttccgtgattttcagtttcctagccatattctaggtcctacagtgtgcatttctcatttttcaggtttttcagtgatttcgtcttttttcaagtcgtcaagtggatgtttctcattttccatgattttcacttttcttgccatatttcatgtcctaaagtgtgtatttctcattttcagtgattttcagttttctcgctatattccaggtcctacagtgtgcatttctcattttttcacgtttttcagtgatttcgtcatttttcacgttgtcaagtggatgtttctcattttccatgattttcacttttcttgccatatttcatgtcctacagtggacatttctaaattttccacctttttctgttttcctcgccatatttcacatcctaaagtgtgtatttctcattttccgtgattttcagttttcttgccatattccaggtcctacagtgtgcatttctcatttttcacgtttttcagtgatttcgtcatttttcaagttgtcaagtggatgtttctcattttccttgattttcagttttcttgccatattccatgtcctactgtggacatttctaaattttccacctttttcagttttccttgccatatttcatgtcctaaagtgtgtatttctcattttcagtgattttcagttttctcgcaatattccaggtcctacagtgtgcatttctcattttttcaggtttttcagtgatttcgtcatttttcacgttgtcaagtggatgtttctcattttccatgattttcacttttcttgccatatttcatgtcctaaagtgtgtatttctcattttcagtgattttcagttttctgccatattccaggtcctacattgtgcatttctcattttttcacgtttttcagtgatttcgtcatttttcacgttgtcaagtggatgtttctcattttccatgattttcacttttcttgccatatttcatgttttacagtggacatttctaaattttccacctttttctgttttcctcgccatatttcacatcctaaagtgtgtatttctcattttccgtgattttcagttttctcgccatatgccaggtcatacagggtgcatttctcatttttcacgtttttcagtgatttcgtcatttttcacgtcgtcaagtggatgtttctcattttcaatgattttcatttttcttgccatattccacgtcctatagtggacatttctaaattttccacctttttcagttttccttgccatatttcaggtcctacagtgtgcatttctcatttttcacgtttttcagtgatttcgtcatttttcaagtggtcaagtgcatgtttctcattttccgtgattttcagttttcttgccatgttccaggtcctacagttgacgtttctaaaatttcactttttttaagttttcctcgccatatttcacttcctaaagtgtgtatttctcattttccgtgattttcagttttctcgccagattccaggtcctacagtgtgcatttttcatatttcacctttttcagtgattttgtcatttttcaagttgtcaactgcatgtttctcattttccatgattttcagttttcttgccatattccatgtcctactgtggacatttctaaattttccaactttttcagttttcctcgccatatttcatgtcctaaagtgtgtatttctcattttcagtgattttctgttttctcgccatattccaggtcctacagtgtgcatttctaatttttcacgtttttcagtgatttcgtcatttttcaagttgtcaagtggatgtttctcattttccatgattttcagttttcttgccatattccatgtcctacagtggacatttctaaattttccaactttttccattttcctcaccatatttcacgtcctaaagtgtgtttttctcattttttgtgattttcagttttctcgacatattccaggtcctacagtgtgcatttctaattttttcttttttcagtgatttcgtcatttttcaagttgtcaactgcatgtttctcattttccatgattttcagttttcttgccatattccatgtcttacagtggacatttttaaatttttcacatttttttaagttttcctccccatatttcacgttttaaagtgtgcatttctcattttcggtgattttcagttttctcgccagattccaggtcttacagtgtgcatttctcattttttcacgtttttcagtgatttcgtcatttttcaagtcgtcaagtggatgtttctcattttccatgattttcagttttcttgccatattccatgtcctacagtggaaatttctaaattttccacctttttcagttttccttgccatatttcaggtcctaaagtgtgtatttctcattttctgtgattttcagttttctcgccatattccaggtcctacagttgacatttctaaaatttccacattttttaagttttcctcgccatatttcacttcctaaagtgtgtatttctcattttccgtgattttcagttttctcgccatattccagatcctacagtgtgcatttttcatttttcacgtttttcagtgattttgtcattttttagttgtcaactgtctgtttctcattttccatgattttcagttttcttgccatattccatgtcctacactggacatttctaaattttccacctttttctgttttcctcgccatatttcacgtcctaaagtgtgtatttctcattttccgtgattttcagttttcttgccatattccaggtcctacagtgtgcatttctcatttttcacgtttttcagtgattttgtcatttttcaagttgtcaactgcatgtttctcattttccatgattttcagttttcttgctatattccatgtcctacagtggaaatttctaaattttccacctttttcagttttcctcgccatatttcacgtcctaaagtgtgtatttctcattttccgtgattttcagttttctcgccatattccaggtcctatgtgtacatttctcatttttcacgtttttcagtgattttgtcatttttcaagttgtgaagtggatgtttctcatttttcttgattttcatttttcttgccatattccatgtcctagagtggaaatttttaaattttccacctttttcagttttcctcgccatatttcacgtcctaaagtgtgaatttctcattttccgtgattttcagatttctcgccatattccaagtcctacagtgtgcatttctcatttttcacgtttttcagtgatttcgtcatttttcaagttgtcaagtggatgtttctcattttccatgattttcagctttcttgccatattcaaagtcctacagtggacatttctaaattttcgacctttatcagttttcctcgccatatttcatgtcccaaagtgtgtacttctcattttccgtgattttcagtttcctcgccatattctaggtcctacagtgtgcatttctcatttttcaggtttttcagtgatttcgtcttttttcaagtcgtcaagtggatgtttctcattttccatgattttcagttttcttgccatattccatgtcctacagtggacatttctaaattttccacctttttcagttttcctcgccatatttcatgtcctaaagtgtgtatttctcattttcagtgattttcagttttctcgccatattccaggtcctacagtgtgcatttctcatttttcacgtttttcagtgatttcgtcatttttcaagttgtcaagtggatgtttctcattttccatgattttcagttttcttgccatattccatgtcccacagtggacatttctaaattttccacctttttctgttttccttgccatatttcatgtcctaaagtgtgtatttctcattttccgtgattttcagttttcttgctatattccaagtcctacagtgtgcatttctcatttttcacgtttttcagtgattttgtcatttttcaatttgtcaactgcatgtttctcattttccatgattttcagttttcttgccatattccatgtcctacagtggaaatttctatattttccaactttttcagttttcctcgccatatttcacgtgctaaagtgtgtatttctcatttttcgtgtttttcaggtttctcgccatattccaggtcctacagtgtgcatttctcatttttcacgtttttcagtgattttgtcatttttcaagttgtcaagtggatgtttctcattttccttgattttcagttttcttgccatattccatgtcctacagtggacatttctaaattttccacctttttcagttttccttgccatatttcatgtcctaaagtgtgtatttctcattttcagtgattttcagttttctcgccatattccaggtcctacagtgtgcatttctcattttttcaggtttttcagtgatttcgtcatttttcacgttgtcaagtggatgtttctcattttccatgattttcacttttcttgccatatttcatgtcctaaagtgtgtatttctcattttcagtgattttcagttttctcgctatattccaggtcctacagtgtgcatttctcattttttcacgtttttcagtgatttcgtcatttttcacgttgtcaagtggatgtttctcattttccatgattttcacttttcttgccatatttcatgtcctacagtggacatttctaaattttccacctttttctgttttcctcgccatatttcacatactaaagtgtgtatttctcattttccttgattttcagttttcttgccatattccaggtcctacagtgtgcatttctcatttttcacgtttttcagtgatttcgtcatttttcaagtcgtcaagtggatgtttctcattttccatgattttcagttttctcgccatattccaggtcctacagttgacatttctaaattttccacattttttaagtttcctcgcgatatttcacatcctaaagtgtgtatttctcattttccgtgattttcagttttcttgccatattccaggtcctacagggtgcatttctcatttttcacgtttttcagtgatttcatcaatttcaagtcgtcaactgtatgtttctcattttcaatgattttcatttttcttgccatattccatgtcctacagtggacatttctaaatttttcacctttttcagttttccttgccatatttcatgtcctaaagtgtgtatttctcattttcagtgattttcagttttctcgccatattccaggtcctacagtgtgcatttctcattttttcaggtttttcagtgatttcgtcatttttcacgttgtcaagtggatgtttctcattttccatgattttcacttttcttgccatatttcatgtcctaaagtgtgtatttctcattttcagtgattttcagttttctcgccatattccaggtcctacagtgtgcatttctcatttttcacgtttttcagtgatttcgtcatttttcaagttgtcaagtggatgtttctcattttccatgattttcacttttcttgccatattccatgtcccacagtggacatttctaaattttccacctttttctgttttcctcgccatatttcatgtcctaaagtgtgtatttctcattttccgtgattttcagttttcttgctatattccaagtcctacagtgtgcatttctcatttttcacgtttttcagtgattttgtcatttttcaatttgtcaactgcatgtttctcattttccatgattttcagttttcttgccatattccatgttctacagtggaaatttctatattttccaactttttcagttttcctcgccatatttcacgtgctaaagtgtgtatttctcatttttcgtgtttttcaggtttctcgccatattccaggtcctacagtgtgcatttctcatttttcacgtttttcagtgattttgtcatttttcaagttgtcaagtggatgtttctcattttccttgattttcagttttcttgccatattccatgtcctacagtggacatttctaaattttccacctttttcagttttccttgccatatttcatgtcctaaagtgtgtatttctcattttcagtgattttcagttttctcgccatattccaggtcctacagtgtgcatttctcattttttcaggtttttcagtgatttcgtcatttttcacgttgtcaagtggatgtttctcattttccatgattttcacttttcttgccatatttcatgtcctaaagtgtgtatttctcattttcagtgattttcagttttctcgctatattccaggtcctacagtgtgcatttctcattttttcacgttttgcagtgatttcgtcatttttcacgttgtcaagtggatgtttctcattttccatgattttcacttttcttgccatatttcatgtcctacagtggacatttctaaattttccacctttttctgttttcctcgccatatttcacatcctaaagtgtgtatttctcattttccgtgattttcagttttcttgccatattccaggtcctacagtgtgcatttctcatttttcacgtttttcagtgatttcgtcatttttcaagtcgtcaagtggatgtttctcattttccatgattttcagttttctcgccatattccaggtcctacagttgacatttctaaattttccacattttttaagtttcctcgcgatatttcacatcctaaagtgtgtatttctcattttccgtgattttcagttttcttgccatattccaggtcctacagggtgcatttctcatttttcacgtttttcagtgatttcatcaatttcaagtcgtcaactgtatgtttctcattttcaatgattttcatttttcttgccatattccatgtcctacagtggacatttctaaattttccacctttttcagttttccttgccatatttcatgtcctaaagtgtgtatttctcattttcagggattttcagttttctcgccatattccaggtcctacagtgtgcatttctcattttttcaggtttttcagtgatttcgtcatttttcacgttgtcaagtggatgtttctcattttccatgattttcacttttcttgccatatttcatgtcctaaagtgtgtatttctcattttcagtgattttcagttttctcgccatattccaggtcctacagtgtgcatttctcattttttcacgtttttcagtgatttcgtcatttttcacgttgtcaagtggatgtttctcattttccatgattttcacttttcttgccatatttcatgtcctacagtggacatttctaaattttccacctttttctgttttcctcgccatatttcacatcctaaagtgtgtatttctcattttccgtgattttcagttttcttgccatattccaggtcctacagtgtgcatttctcatttttcacgtttttcagtgatttcgtcatttttcaagtcgtcaagtggatgtttctcattttccatgattttcagttttctcgccatattccaggtcctacagttgacatttctaaattttccacattttttaagtttcctcgcgatatttcacatcctaaagtgtgtatttctcattttccgtgattttcagttttcttgccatattccaggtcctacagggtgcatttctcatttttcacgtttttcagtgatttcatcaatttcaagtcgtcaactgtatgtttctcattttcaatgattttcatttttcttgccatattccacgtcctatagtggacatttctaaattttccacctttttcagttttcttcgccatatttcacgtcccaaagtgtgtatttctcattttccgtgattttcagtttcctcgcaatattccaggtcctacagtgtgcatttctcatttttcacgtttttcagtgatttcgtcttttttcaagtcgtcaagtggatgtttctcattttccatgattttcagttttcttgccatattccatgtcctacagtggacatttctaaattttccacctttttctgttttcctcgccatatttcacgtcctaaagtgtgtatttctcattttccgtgattttcagttttcttgccatattccaggtcctacagtgtgcatttctcatttttcacgtttttcactgattttgtcattgttcaagttgtcaactgcatgtttctcattttccatgattttcaattttcttgccatattccatgtcctacagtggaaatttctatattttccaactttttcagttttcctcgccatatttcacgtgctaaagtgtgtatttctcatttttcgtgtttttcaggtttctcgccatattccaggtcctacagtgtgcatttctcatttttcacgtttttcagtgattttgtcatttttcaagttgtcaagtggttgtttctcattttccttgattttcagttttcttgccatattccatgtcctactgtggacatttctaaattttccacctttttcagttttccttgccatatttcatgtcctaaagtgtgtatttctcattttcagtgattttcagttttctcgcaatattccaggtcctacagtgtgcatttctcattttccgtgattttcagttttctcgccatatgccaggtcatacagggtgcatttctcatttttcacgtttttcagtgatttcgtcatttttcacgtcgtcaagtggatgtttctcattttcaatgattttcatttttcttgccatattccacgtcctatagtggacatttctaaattttccaactttttcagttttcttgccatatttcaggtcctacagtgtgcatttctcatttttcacgtttttcagtgatttcgtcatttttcaagtggtcaagtgcatgtttctgattttccgtgattttcagttttcttgccatgttccaggtcctacagttgacgtttctaaaatttcactttttttaagttttcctcgccatatttcacttcctaaagtgtgtatttctcattttccgtgattttcagttttctcgccagattccaggtcctacagtgtgcatttttcatatttcacctttttcagtgattttgtcatttttcaagttgtcaactgcatgtttctcattttccatgattttcagttttcttgccatattccatgtcctactgtggacatttctaaattttccaactttttcagttttcctcgccatatttcatgtcctaaagtgtgtatttctcattttcagtgtttttctgttttctcgccatattccaggtcctacagtgtgcatttctaatttttcacgtttttcagtgatttcgtcatttttcaagttgtcaagtggatgtttctcattttccatgattttcagttttcttgccatattccatgtcctacagtggacatttctaaattttccaactttttccattttcctcaccatatttcacgtcctaaagtgtgtttttctcattttttgtgattttcagttttctcgacatattccaggtcctacagtgtgcatttctaattttttcttttttcagtgatttcgtcatttttcaagtggtcaagtgcatgtttctcattttccatgattttcagttttcttgccatattccatgtcctacaatggacatttctaaattttccaactttttcagttttcctcgccatatttcacgtcctaaagtgtgtatttctcattttccgtgattttcagttttctcgccatattccaggtcctatgtgtacatttctcatttttcacgtttttcagtgattttgtcatttttcaagttgtgaagtggatgtttctcatttttcttgattttcatttttcttgccatattccatgtcctagagtggaaatttttaaattttccaactttttcagttttcctcgccatatttcacgtcctaaagtgtgtatttctcattttccgtgattttcagttttctcgccatattccaagtcctacagtgtgcatttctcatttttcacgtttttcagtgatttcgtcatttttcaagttgtcaagtggatgtttctcattttccatgattttcagctttcttgccatattcaaagtcctacagtggacatttctaaattttcgacctttatcagttttcctcgccatatttcatgtcccaaagtgtgtacttctcattttccgtgattttcagtttcctcgccatattctaggtcctacagtgtgcatttctcatttttcaggtttttcagtgatttcgtcttttttcaagtcgtcaagtggatgtttctcattttccatgattttcagttttcttgccatattccatgtcctacagtggacatttctaaattttccacctttttcagttttcctcgccatatttcatgtcctaaagtgtgtatttctcattttcagtgattttcagttttctcgccatattccaggtcctacagtgtgcatttctcatttttcacgtttttcagtgatttcgtcatttttcaagttgtcaagtggatgtttctcattttccatgattttcagttttcttgccatattccatgtcccacagtggacatttctaaattttccacctttttctgttttccttgccatatttcatgtcctaaagtgtgtatttctcattttccgtgattttcagttttcttgctatattccaagtcctacagtgtgcatttctcatttttcacgtttttaagtgattttgtcatttttcaatttgtcaactgcatgtttctcattttccatgattttcagttttcttgccatattccatgtcctacagtggaaatttctatattttccaactttttcagttttcctcgccatatttcacgtgctaaagtgtgtatttctcatttttcgtgtttttcaggtttctcgccatattccaggtcctacagtgtgcatttctcatttttcacgtttttcagtgattttgtcatttttcaagttgtcaagtggatgtttctcattttccttgattttcagttttcttgccatattccatgtcctacagtggacatttctaaattttccacctttttcagttttccttgccatatttcatgtcctaaagtgtgtatttctcattttcagtgattttcagttttctcgccatattccaggtcctacagtgtgcatttctcattttttcaggtttttcagtgatttcgtcatttttcacgttgtcaagtggatgtttctcattttccatgattttcacttttcttgccatatttcatgtcctaaagtgtgtatttctcattttcagtgattttcagttttctcgccatattccaggtcctacagtgtgcatttctcattttttcacgtttttcagtgatttcgtcatttttcacgttgtcaagtggatgtttctcattttccatgattttcacttttcttgccatatttcatgtcctacagtggacatttctaaattttccacctttttctgttttcctcgccatatttcacatcctaaagtgtgtatttctcattttccgtgattttcagttttcttgccatatttcaggtcctacagtgtgcatttctcatttttcacgtttttcagtgatttcgtcatttttcaagtcgtcaagaggatgtttctcattttccatgattttcagttttctcgccatattccaggtcctacagttgacatttctaaattttccacattttttaagtttcctcgcgatatttcacatcctaaagtgtgtatttctcattttccgtgattttcagttttcttgccatattccaggtcctacagggtgcatttctcatttttcacgtttttcagtgatttcatcaatttcaagtcgtcaactgtatgtttctcattttcaatgattttcatttttcttgccatattccacgtcctatagtggacatttctaaattttccacctttttctgttttcctcgccatatttcacgtcctaaagtgtgtatttctcattttccgtgattttcagttttcttgccatattccaggtcctacagtgtgcatttctcatttttcacgtttttcactgattttgtcattgttcaagttgtcaactgcatgtttctcattttccatgattttcagttttcttgccatattccatgtcctacagtggaaatttctatattttccacctttttcagttttcctcgccgtatttcatgtgctaaagtgtgtatttctcatttttcgtgtttttcaggtttctcgccatattccaggtcctacagtgtgcatttctcatttttcacgtttttcagtgattttgtcatttttcaagttgtcaactggatgtttctcattttccttgattttcagttttcttgccatattccatgtcctactgtggacatttctaaattttccacctttttcagttttccttgccatatttcatgtcctaaagtgtgtatttctcattttcagtgattttcagttttctcgcaatattccaggtcctacagtgtgcatttctcattttttcaggtttttcagtgatttcgtcatttttcacgttgtcaagtggatgtttctcattttccatgattttcacttttcttgccatatttcatgtcctaaagtgtgtatttctcattttcagtgattttcagttttctcgccatattccaggtcctacattgtgcatttctcattttttcacgtttttcagtgatttcgtcatttttcacgttgtcaagtggatgtttctcattttccatgattttcacttttcttgccatatttcatgttttacagtggacatttctaaattttccacctttttctgttttcctcgccatatttcacatcctaaagtgtgaatttctcattttccgtgattttcagttttcttgccatattccaggtcctacagtgtgcatttctcatttttcacgtttttcagtgatttcatcatttttcaagtcgtcaagtggatgtttctcattttccatgattttcagttttcttgccatattccatgtcctacagtggacatttctaaattttccacctttttctgttttcctcgccatatttcacgtcctaaagtgtgtatttctcattttccgtgattttcagttttcttgccatattccaggtcctacagtgtgcatttctcatttttcacgtttttcactgattttgtcatttttcaagttgtcaactgcatgtttctcattttccatgattttcagttttcttgctatattccatgtcctacagtggaaatttctaaattttccacctttttcagttttcctcgccatatttcacgtcctgaagtgtgtatttctcattttccgtgattttcagttttctcgccatattccaggtcctatgtgtacatttctcatttttcacgtttttcagtgattttgtcatttttcaagttgtgaagtggatgtttctcatttttcttgattttcatttttcttgccatattccatgtcctacagtggaaatttctaaattttccacctttttcagttttcctcgccatatttcacgtcctaaagtgtgtatttctcattttccgtgattttcagttttctcgccatattccaggtcctacagtgtgcatttctcatttttcacgtttttcagtgatttcgacatttttcaagttgtcaagtggatgtttctcattttccatgattttcagctttcttgccatattcaaagtcctacagtggacatttctaaattttcgacctttatcagttttcctcgccatatttcatgtcccaaagtgtgtacttctcattttccgtgattttcagtttcctcgccatattccaggtcctacagtgtgcatttctcatttttcacgtttttcagtgatttcgtcatttttcaagtcgtcaagtggatgtttctcattttccatgattttcagttttcttgccatattccatgtcctacagtggacatttctaaattttccacctttttctgttttcctcgccatatttcacgtcctaaagtgtgtatttctcattttccgtgattttcagttttcttgccatattccaggtcctacagtgtgcatttctcatttatcacgtttttcactgattttgtcatttttcaagttgtcaactgcatgtttctcattttccatgattttcagttttcttgctatattccatgtcctacagtggaatattctaaattttccacctttttcagttttcctcgccatatttcacgtcctgaagtgtgtatttctcattttccgtgattttcagttttctcgccatattccaggtcctatgtgtacatttctcatttttcacgtttttcagtgattttgtcatttttcaagttgtgaagtggatgtttctcatttttcttgattttcatttttcttgccatattccatgtcctacagtggaaatttctaaattttccacctttttcagttttcctcgccatatttcacgtcctaaagtgtgaatttctcattttccgtgattttcagttttctcgccatattccaggtcctacagtgtgcatttctcatttttcacgtttttcagtgatttcgacatttttcaagttgtcaagtggatgtttctcattttccatgattttcagctttcttgccatattcaaagtcctacagtggacatttctaaattttcgacctttatcagttttcctcgccatatttcatgtcccaaagtgtgtacttctcattttccgtgattttgagtttcctcgccatattccaggtcctacagtgtgcatttctcatttttcacgtttttcagtgatttcgtcttttttcaagttgtcaactgcatgtttctcattttccatgattttcagttttcttgccatattccatgtcctacagtggaaatttgtaaatttccacctttttcagttttcctcgccatatttcacgtcctaaagtatgtatttctcattttccgtgattttcagttttctcgccatattccaggtcctacagtgtgcatttctcatttttcacgtttttcagtgattttgtcattttttaagttttcaagtggatgtttctcattttccttgattttcagttttcttgccatattccatgtcctacagtggacatttctaaattttccacctttttcagttttcctcgccatatttcatgtcctaaagtgtgtatttctcattttcagtgattttcagttttctcgccatattccaggtcctacagtgtgcatttctcatttttcacgtttttcagtgatttcgtcatttttcaaggtgtcaagtggatgtttctcattttccatgattttcagttttcttgccatattccatgtcctacagtggacatttctaaattttccacctttttctgttttcctcgccatatttcatgtcctaaagtgtgtatttctcattttccgtgattttcagttttcttgctatattccaagtcctacagtgtgcatttctcatttttcacgtttttcagtgattttgtcatttttcaatttgtcaactgcatgtttctcattttccatgattttcagtttttttgccatattccatgtcctactgtggaaatttctatattttccacctttttcagttttcctcgccatatttcacgtgctaaagtgtgtatttctcatttttcgtgtttttcaggtttctcgccatattccaggtcctacagtgtgcatttctcatttttcacgtttttcagtgattttgtcatttttcaagttttcaagtggatgtttctcattttccttgattttcagttttcttgccatattccatgtcctacagtggacatttctaaattttccacctttttcagttttccttgccatatttcatgtcctaaagtgtgtatttctcattttcagtgattttcagtttccttgccatattccaggtcctacagtgtgcatttctcattttttcacgtttttcagtgatttcgtcatttttcacgttgtcaagtggatgtttctcattttccatgattttcacttttcttgccatatttcatgtcctacagtggacatttctaaattttccaactttttcaattttcctcgccatattttatgtcctaaagtgtgtatttctcatttttcgttattttcagttttcttgccatattccaggtcctacagtgtgcatttgtcatttttcacgtttttcagtgatttcgtcatttttcaagtcgtcaagtagatgtttctcatattccatgtttttcagttttctcgccatattccaggtcctacagttgacatttctaaattttctacatttttaaattttcctcgccatatttcacgtcctaaagtgtgtatttctcattttttgttattttcagttttctagccatattccaggtcctacaggatgcatttctcatttttcacgtttttcagtgatttcatcatttttcaagtcgtcaagtgtatgtttcttattttcaatgattttcatttttcttgccttattccacgtcctatagtggacatttctaaattttccacctttttcagtttttttcgccatatttcacgtcctaaagtgtgtatttctcattttctgtgattttcagttttctcaccatattccaggtcctacagtgtgcatttctcatttttcacgtttttcagtgatttcgtcatttttcaagttgtcaagtggaagtttctcattttccatgattttcagctttctagacatattccaggtcctacagtggacatttcctaattttcgacctttatcagttttcctcgtcatatttcacgtcccaaaatgtgtatttcttattttccatgattttcagtttcctcgccatattccaggtcctacagtgtgcaattctcatttttcacgtttttcagtgatttcgtcttttttcaagacgtcaagtggatgtttctcatttttcatgattttcagttttcttgccatattccatgtcctacagtggacatttctaaattttccacctttttctgttttcctcgccatatttcacgtcctaaagtgtgtatttctcattttccgtgattttcagttttcttgccatattcctggtcctacagtgtgcatttctcatttttcacgtttttcagtgattttgtcatttttcaatttgtcaactgcatgtttctcattttccattattttcagttttcttgccatattccatgtcctacagtggacatttctaaattttccacctttttctgttttcctcgccatatttcatgtcctaaagtgtgtatttctcattttccgtgattttcagttttcttgctatattccaagtcctacagtgtgcatttctcatttttcacgtttttcagtgattttgtcatttttcaatttgtcaactgcatgtttctcattttccatgattttcagtttttttgccatattccatgtcctacaggggaaatttctatattttccacctttttcagttttcctcgccatatttcatgtcctaaagtgtgtatttctcattttccgtgattttcagttttcttgccatattccaggtcctacagtgtgcatttctcatttttcacgtttttcagtgatttcgtcatttttcaagtcttcaagtagatgtttctcatattccatgtttttcagttttctcgccatattccaggtcctacagttgacatttctaaattttctacatttttaaattttcctcgccatatttcacgtcctaaagtgtgtatttctcatttttcgttattttcagttttctagccatattccaggtcctacaggatgcatttctcatttttcacgtttttcagtgatttcatcatttttcaagtcgtcaagtgtatgtttctcattttcaatgattttcatttttcttgccttattccacgtcctatagtggacatttctaaattttccacctttttcagtttttctcgccatatttcacgtcctaaagtgtgtatttctcattttctgtgattttcagttttctcaccatattccaggtcctacagtgtgcatttctcatttttcacgtttttcagtgatttcgtcatttttcaagttgtcaagtggaagtttctcattttccatgattttcagctttctagccatattccaggtcctacagtggacatttcctaattttcgacctttatcagttttcctcgccatatttcacgtcctaaagtgtgtatttctcattttccgtgattttcagttttcttgccatattccaggtcctacagtgtgcatttctcatttttcacgtttttcagtgattttgtcatttttcaatttgtcaactgcatgtttctcattttccatgatttttagttttcttgctatattccatgtcctacagtggaaatttctaaattttccacctttttcagttttcctcgccatatttcacgtcctaaagtgtgtatttctcattttccgtgattttcagttttcttgctatattccaagtcctacattgtgcatttctcatttttcacgtttttcagtgattttgtcatttttcaatttgtcaaaccacatgtttctcattttccatgattttcagtttttttgccatattccatgtcctacagtggaaatttctatattttccacctttttcagttttcctcgccatatttcacgtgctaaagtgtgtatttctcatttttcgtgtttttcaggtttctcgccatattccaggtcctacagtgtgcatttctcatttttcacgtttttcagtgattttgtcatttttcaagttgtcaagtggatgtttcccattttccttgattttcagttttcttaccatattccatgtcctacagtggacatttctaaattttccacctttttcagttttccttgccatatttcatgtcctaaagtgtgtatttctcattttcagtgattttcagtttcctcgccatattccaggtcctacagtgtgcatttctcattttttcacgtttttcagtgatttcgtcatttttcacgttgtcaagtggatgtttctcattttccatgattttcacttttcttgccatatttcatgtcctatagtggacatttctaaattttccacctttttcagtttttctcgccatatttcacgtcctaaagtgtgtatttctcattttctgtgattttcagttttctcaccatattccaggtcctacagtgtgcatttctcatttttcacgtttttcagtgatttcgtcatttttcaagtcgtcaagtagatgtttctcatattccatgtttttcagttttctcgccatattccaggtcctacagttgacatttctaaattttctacatttttaaattttcctcgccatatttcacgtcctaaagtgtgtatttctcatttttcgttattttcagttttctagccatattccaggtcctacaggatgcatttctcatttttcacgtttttcagtgatttcatcatttttcaagtcgtcaagtgtatgtttcttattttcaatgattttcatttttcttgccttattccacgtcctatagtggacatttctaaattttccaccttttttcagtttttctcgccatatttcacgtcctaaagtgtgtatttctcattttctgtgattatcagttttctcaccatattccaggtcctacagtgtgcatttctcatttttcacgtttttcagtgatttcgtcatttttcaagttgtcaagtggaagtttctcattttccatgattttcagctttctagccatattccaggtcctacagtggacatttcctaattttcgacctttatcagttttcctcgccatatttcacgtcccaaaatgtgtatttcttattttccatgattttcagtttcctcgccatattccaggtcctacagtgtgcatttctcatttttcacgtttttcagtgatttcgtcttttttcaagacgtcaagtggatgtttctcatttttcatgattttcagttttcttgccatattccatgtcctacagtggacatttctaaattttccacctttttctgttttcctcgccatatttcacgtcctaaagtgtgtatttctcattttccgtgattttcagttttcttgccatattcctggtcctacagtgtgcatttctcatttttcacgtttttcagtgattttgtcatttttcaatttgtcaactgcatgtttctcattttccatgattttcagttttcttgccatattccatgtcctacagtggacatttctaaattttccacctttttcagttttcctcgccatatttcacgtgctaaagtgtgtatttctcatttttcgtgtttttcaggtttctcgccatattccaggtcctacagtgtgcatttctcatttttcacgtttttcagtgattttgtcatttttcaagttgtcaagtggatgtttctcattttccttgattttcacttttcttgccatattccaagtcttacaggggcatttctcatttttcacgttttcagtgattttgtcattttcaatttgtcaactgcatgtttctcattttccatgattttcagtttttttgccatattccatgtcctacaggggaaatttctatattttccacctttttcagttttcctcgccatatttcatgtcctaaagtgtgtatttctcattttccgtgattttcagttttcttgccatattccaggtcctacagtgtgcatttctcatttttcacgtttttcagtgatttcgtcatttttcaagtcttcaagtagatgtttctcatattccatgtttttcagttttctcgccatattccaggtcctacagttgacatttctaaattttctacatttttaaattttcctcgccatatttcacgtcctaaagtgtgtatttctcatttttcgttattttcagttttctagccatattccaggtcctacaggatgcatttctcatttttcacgtttttcagtgatttcatcatttttcaagtcgtcaagtgtatgtttctcattttcaatgattttcatttttcttgccttattccacgtcctatagtggacatttctaaattttccacctttttcagtttttctcgccatatttcacgtcctaaagtgtgtatttctcattttctgtgattttcagttttctcaccatattccaggtcctacagtgtgcatttctcatttttcacgtttttcagtgatttcgtcatttttcaagttgtcaagtggaagtttctcattttccatgattttcagctttctagccatattccaagtcctacagtggacatttcctaattttcgacctttatcagttttcctcgccatatttcacgtcccaaaatgtgtattccttattttccatgattttcagtttcctcgccatattccaggtcctacagtgtgcatttatcatttttcacgtttttcagtgatttcgtcttttttcaagacgtcaagtggatgtttctcatttttcatgattttcagttttcttgccatattccatgtcctacagtggacatttctaaattttccacctttttctgttttcctcgccatatttcacgtcctaaagtgtgtatttctcattttccgtgattttcagttttcttgccatattcctggtcctacagtgtgcatttctcatttttcacgtttttcagtgattttgtcatttttcaagttgtcaagtggatgtttctcattttccttgattttcacttttcttgccatattccatgtcctacagtggacatttctatattttccacctttttccgttttccttgccatatttcacgtcctaaagtgtgtatttctcattttccgtgattttcaggtttctcgccatattccaggtcctacagtgtgcatttctcatttttcacgtttttcagtgattttgtcatttttcaagttgtcaagtggatgtttctcattttccttgattttcacttttcttgccatattccatgtcctacagtggacatttctaaattttccacctttttcagttttcctcgccatatttcatgtcctaaagtgtgtatttctcattttcagtgattttcagttttcttgccatattccaggtcctacagtgtgcatttctcatttttcacgtttttcagtgattttgtcatttttcaagttgtcaactgcatgtttctcattttctatgattttcagttttcttgctatattccatgtcctacagtggaaatttctaaattttccacctttttcagttttcctcgccatatttcacgtcctaaagtgtgtatttctcattttccgtgattttcagttttctcgccatattccaggtcctatgtgtacatttctcatttttcacgtttttcagtgattttgtcatttttcaagttgtgaagtggatgtttctcatttttcttgattttcatttttcttgccatattccatgtcctagagtggaaatttttaaattttccacctttttcagttttcctcgccatatttcacgtcctaaagtgtgaatttctcattttccgtgattttcagatttctcgccatattccaagtcctacagtgtgcatttctcatttttcacgtttttcagtgatttcgtcatttttcaagttgtcaagtggatgtttctcattttccatgattttcagctttcttgccatattcaaagtcctacagtggacatttctaaattttcgacctttatcagttttcctcgccatatttcatgtcccaaagtgtgtacttctcattttccgtgattttcagtttcctcgccatattctaggtcctacagtgtgcatttctcatttttcaggtttttcagtgatttcgtcttttttcaagtcgtcaagtggatgtttctcattttccatgattttcacttttcttgccatatttcatgtcctaaagtgtgtatttctcattttcagtgattttcagttttctcgctatattccaggtcctacagtgtgcatttctcattttttcacgtttttcagtgatttcgtcatttttcacgttgtcaagtggatgtttctcattttccatgattttcacttttcttgccatatttcatgtcctacagtggacatttctaaattttccacctttttctgttttcctcgccatatttcacatcctaaagtgtgtatttctcattttccgtgattttcagttttcttgccatattccaggtcctacagtgtgcatttctcatttttcacgtttttcagtgatttcgtcatttttcaagttgtcaagtggatgtttctcattttccttgattttcagttttcttgccatattccatgtcctactgtggacatttctaaattttccacctttttcagttttccttgccatatttcatgtcctaaagtgtgtatttctcattttcagtgattttcagttttctcgcaatattccaggtcctacagtgtgcatttctcattttttcaggtttttcagtgatttcgtcatttttcacgttgtcaagtggatgtttctcattttccatgattttcacttttcttgccatatttcatgtcctaaagtgtgtatttctcattttcagtgattttcagttttcctcgccatatttcacgtcccaaaatgtgtatttcttattttccatgattttcagtttcctcgccatattccaggtcctacagtgtgcatttctcatttttcacgtttttcagtgatttcgtcttttttcaagacgtcaagtggatgtttctcatttttcatgattttcagttttcttgccatattccatgtcctacagtggacatttctaaattttccacctttttctgttttcctcgccatatttcacgtcctaaagtgtgtatttctcattttccgtgattttcagttttcttgccatattcctggtcctacagtgtgcatttctcatttttcacgtttttcagtgattttgtcatttttcaatttgtcaactgcatgtttctcattttccatgattttcagttttcttgccatattccatgtcctacagtggacatttctaaattttccacctttttcagttttcctcgccatatttcacgtgctaaagtgtgtatttctcatttttcgtgtttttcaggtttctcgccatattccaggtcctacagtgtgcatttctcatttttcacgtttttcagtgattttgtcatttttcaagttgtcaagtggatgtttctcattttccttgattttcacttttcttgccatattccatgtcctacagtggacatttctaaattttccacctttttcagttttcctcgccatatttcatgtcctaaagtgtgtatttctcattttcagtgattttcagttttctcgccatattccaggtcctacagtgtgcatttctcatttttcacgtttttcagtgatttcgtcttttttcaagacgtcaagtggatgtttctcattttccatgattttcagttttcttgccatattccatgtcctacagtggacatttctaaattttccacctttttctgttttcctcgccatatttcacgtcctaaagtgtgtatttctcattttccgtgattttcagttttcttgccatattccaggtcctacagtgtgcatttctcatttttcacgtttttcagtgattttgtcatttttcaatttgtcaactgcatgtttctcattttccatgatttttagttttcttgctatattccatgtcctacagtggaaatttctaaattttccacctttttcagttttcctcgccatatttcacgtcctaaagtgtgtatttctcattttccgtgattttcagttttcttgctatattccaagtcctacattgtgcatttctcatttttcacgtttttcagtgattttgtcatttttcaatttgtcaaaccacatgtttctcattttccatgattttcagtttttttgccatattccatgtcctacagtggaaatttctatattttccacctttttcagttttcctcgccatatttcacgtgctaaagtgtgtatttctcatttttcgtgtttttcaggtttctcgccatattccaggtcctacagtgtgcatttctcatttttcacgtttttctgtgattttgtcatttttcaagttgtcaagtggatgtttctcattttccttgattttcagttttcttaccatattccatgtcctacagtggacatttctaaattttccaccttttctgttttcctcgccatatttcatgtcctaaagtgtgtatttctcattttccgtgattttcatttttcttgctatattccaagtcctacagtgtgcatttctcattttccatgattttcagttttcttgctatattccatgtcctacagtggaaatttctaaattttccacctttttcagttttcctcgccatatttcacgtcctaaagtgtgtatttctcattttccgtgattttcagttttttcgccatattacaggtcctatgtgtacatttctcatttttcacgtttttcagtgattttgtcatttttcaagttgtcaagtggatgtttctcatttttcttgattttcatttttcttgccatattccatgtcctacagtggaaatttctaaattttccacctttttcagttttcctcgccatatttcacgtcctaaagtgtgaatttctcattttccgtgattttcagttttctcgccatattccaggtctacagtgtgcatttctcatttttcacgttttcagtgattcgtcatttttcaagttgacaagtggatgtttctcattttccatgattttcagctttcttgccatattcaaagtcctacagtggacatttctaaattttcgacctttatcagttttcctcgccatatttcatgtcccaaagtgtgtacttctcattttccgtgattttcagttttcttgccatattccaagtcctacagtgtgcatttctcatttttcacgtttttcagtgattttgtcatttttcaatttgtcaactgcatgtttctcattttccatgattttcagttttcttgccatattccatgtcctacagtggaaatttctatattttccacctttttcagttttcctcgccatatttcacgtgctaaagtgtgtatttctcatttttcgtgtttttcaggtttctcgccatattccaggtcctacagtgtgcatttctcatttttcacgtttttcagtgattttgtcatttttcaagttgtcaagtggatgtttctcattttcaatgattttcatttttcttgccttattccacgtcctatagtggacatttctaaattttccacctttttcagtttttctcgccatatttcacgtcccaaaatgtgtattccttattttccatgattttcagtttcctcgccatattccaggtcctacagtgtgcatttctcatttttcacgtttttcagtgatttcgtcttttttcaagacgtcaagtggatgtttctcatttttcatgattttcagttttcttgccatattccctgtcctacagtggacatttctaaattttccacctttttctgttttcctcgccatatttcacgtcctaaagtgtgtatttctcattttccgtgattttcagttttctcgccagattccaggtcctacagtgtgcatttctcatttttcacgtttttcagtgattttgtcatttttcaatttgtcaactgcatgtttctctctttccatgattttcagttttcttgccatattccatgtcctacagtggacatttctaaattttccacctttttcagttttcctcgccatatttcacgtgctaaagtgtgtatttctcatttttcgtgtttttcaggtttctcgccatattccaggtcctacagtgtgcatttctcatttttcacgtttttcagtgattttgtcatttttcaagttgtcaagtggatgtttctcattttcaatgattttcatttttcttaccttattccacgtcctatagtggacatttctaaattttccacctttttcagtttttctcgccatatttcacgtcccaaaatgtgtattccttattttccatgattttcagtttcctcgccatattccaggtcctacagtgtgcatttctcatttttcacgtttttcagtgatttcgtcttttttcaagacgtcaagtggatgtttctcatttttcatgattttcagttttcttgccatattccctgtcctacagtggacatttctaaattttccacctttttctgttttcctcgccatatttcacgtcctaaagtgtgtatttctcattttccgtgattttcagttttctcgccagattccaggtcctacagtgtgcatttctcatttttcacgtttttcagtgatttcgtcatttttcaagtcttcaagtgtatgtttctcattttcaatgattttcatttttcttgccttattccacgtcctatagtggacatttctaaattttccacctttttcagtttttctcgccatatttcacgtcctaaagtgtgtatttctcattttctgtgattttcagttttcttaccatattccaggtcctacagtgtgcatttctcatttttcacgtttttcagtgatttcgtcatttttcaagttgtcaagtggaagtttctcattttccatgattttcagctttctagccatattccaggtattacagtggacatttccttattttcgacctttatcagttttcctcgccatatttcatgtcctaaagtgtgt	38399	1554	4%	7300	19%
9	3000001	3038400	Atcctacagtgtgcatttctcatttttcacgtttttcagtgatttcgtcatttttcaagtcatcaagtggctgtttctcattttccatgattttcagttttcttgccatattccttgtcctacagtggacatttctaaattttccacctttttcagttttccttgtcatatttcaggtcctacagtgtgtatttctcatttttcacgtttttcattgatttcgtcatttttcaagttgtcaagtgcatgtttctcattttccatgattttcagttttcttgccatattccatgtcctacaatggacatttctaaattttccaactttttcagttttcctcgccatatttcacgtcctaaagtgtgtatttctcattttccgtgattttcagttttctcgacatattccaggtcctacagtgtgcatttctcatttttcacgtttttcagtgatttcgtcatttttcacgtcgtcaagtggatgtttctcattttccatgattttcagttttcttgccatattccatgtcctacagtggacatttctaaattttccacctttttcagttttcctcgccatatttcacgtcctaaagtgtgtatttctcattttccgtgattttcagttttctcgacatattccaggtcttacagggtgcatttctcatttttcacgtttttcagtgatttcatcatttttcaagtcgtcaactgtatgtttctcattttcaatgattttcatttttcttgccatattccacgtcctatagtggacatttctaaattttccacctttttcagttttccttgccatatttcaggtcctacagtgtgcatttctcatttttcacgtttttcagtgatttcgtcatttttcaagtggtcaaatgcatgtttctcattttccatgattttcagttttcttgccatattccatgtcctacagtggacatttctaaattttccacctttttcagttttcctcgccatatttcacgtcctaaagtgtgtatttctcattttccgtgattttcagttttatcgccagattccaggtcctacggtgtgcatttttcatatttcacgtttttcagtgattttgtcatttttcaagttgtcaactgcatgtttctcattttccatgattttcagttttcttgccatattccatgtcctacagtggacatttctaaattttccacctttttcagttttcctcgccatatttcatgtcctaaagtgtgtatttctcattttcagtgattttctgttttctcgccatattccaggtcctacagtgtgcatttctcatttttcacgtttttcagtgatttcgtcatttttcaagttgtcaagtggatgtttctcattttccatgattttcagttttcttgccatattccatgtcctacaatggacatttctaaattttccacctttttcagttttcctcgccatatttcacgtcctaaagtgtgtatttctcattttccgtgattttcagttttctcgccatattccaggtcctatgtgtacatttctcatttttcacgtttttcagtgattttgtcatttttcaagttgtgaagtggatgtttctcatttttcttgattttcatttttcttgccatattccatgtcctagagtggaaatttttaaattttccacctttttcagttttcctcgccatatttcacgtcctaaagtgtgaatttctcattttccgtgattttcagttttctcgccatattccaagtcctacagtgtgcatttctcatttttcacgtttttcagtgatttcgtcatttttcaagttgtcaagtggatgtttctcattttccatgattttcagctttcttgccatattcaaagtcctacagtggacatttctaaattttcgacctttatcagttttcctcgccatatttcatgtcccaaagtgtgtacttctcattttccgtgattttcagtttcctcgccatattctaggtcctacagtgtgcatttctcatttttcaggtttttcagtgatttcgtcttttttcaagtcgtcaagtggatgtttctcattttccatgattttcagttttcttgccatattccatgtcctacagtggacatttctaaattttccaactttttcagttttcctcgccatatttcatgtcctaaagtgtgtatttctcattttcagtgattttcagttttctcgccatattccaggtcctacagtgtgcatttctcatttttcacgtttttcagtgatttcgtcatttttcaagttgtcaagtggatgtttctcatttttcatgattttcagttttcttgccatattccatgtcccacagtggacatttctaaatgttccacctttttctgttttccttgccatatttcatgtcctaaagtgtgtatttctcattttccgtgattttcagttttcttgctatattccaagtcctacagtgtgcatttctcatttttcacgtttttctgtgattttttcatttttcaatttgtcaactgcatgtttctcattttccatgattttcagttttcttgccatattccaggtcctacagtgtgcatttctcatttttcacgtttttcagtgattttgtcatttttcaagttgtcaactgcatgtttctcattttccatgattttcagttttcttgctatattccatgtcctacagtggaaatttctaaattttccacctttttcagttttcctcgccatatttcacgtcctaaagtgtgtatttctcattttccgtgattttcagttttctcgccatattccaggtcctatgtgtacatttctcatttttcacgtttttcagtgattttgtcatttttcaagttgtgaagtggatgtttctcatttttcttgattttcatttttcttgccatattccatgtcctagagtggaaatttttaaattttccacctttttcagttttcctcgccatatttcacgtcctaaattgtgaatttctcattttccgtgattttcagttttctcgccatattccaagtcctacagtgtgcatttctcatttttcacgtttttcagtgatttcgtcatttttcaagttgtcaagtggatgtttctcattttccatgattttcagctttcttgccatattcaaagtcctacagtggacatttctaaattttcgacctttatcagttttcctcgccatatttcatgtcccaaagtgtgtacttctcattttccgtgattttcagtttcctcgccatattctaggtcctacagtgtgcatttctcatttttcaggtttttcagtgatttcgtcttttttcaagtcgtcaagtggatgtttctcattttccatgattttcagttttcttgccatattccatgtcctacagtggacatttctaaattttccacctttttcagttttcctcgccatatttcatgtcctaaagtgtgtatttctcattttcagtgattttcagttttctcgccatattccaggtcctacagtgtgcatttctcatttttcacgtttttcagtgattttgtcatttttcaagttgtcaagtggatgtttctcattttccttgattttcagttttcttgccatattccatgtcctacagtggacatttctaaattttccacctttttcagttttccttgccatatttcatgtcctaaagtgtgtatttctcattttcagtgattttcagttttctcgccatattccaggtcctacagtgtgcatttctcattttttcaggtttttcagtgatttcgtcatttttcacgttgtcaagtggatgtttctcattttccatgattttcacttttcttgccatatttcatgtcctaaagtgtgtatttctcattttcagtgattttcagttttctcgccatattccaggtcctacagtgtgcatttctcattttttcacgtttttcagtgatttcgtcatttttcacgttgtcaagtggatgtttctcattttccattattttcacttttcttgccatatttcatgtcctacagtggacatttctaaattttccacctttttctgttttcctcgccatatttcacatcctaaagtgtgtatttctcattttccgtgattttcagttttcttgccatattccaggtcctacagtgtgcatttctcatttttcacgtttttcagtgatttcgtcatttttcaagtcgtcaagtggatgtttctcattttccatgattttcagttttctcgccatattccaggtcctacagttgacatttctaaattttccacattttttatgtttcctcgcgatatttcacatcctaaagtgtgtatttctcattttccgtgattttcagttttcttgccatattccaggtcctacagggtgcatttctcatttttcacgtttttcagtgatttcatcaatttcaagtcgtcaactgtatgtttctcattttcaatgattttcatttttcttgccatattccacgtcctatagtggacatttctacattttccacctttttcagttttcttcgccatatttcacgtcccaaagtgtgtatttctcattttccgtgattttcagtttcctcgccatattccaggtcctacagtgtgcatttctcatttttcacgtttttcagtgatttcgtcttttttcaagtcgtcaagtggatgtttctcattttccatgattttcagttttcttgccatattccatgtcctacagtggacatttctaaattttccacctttttctgttttcctcgccatatttcacgtcctaaagtgtgtatttctcatttaccgtgattttcagttttcttgctatattccaagtcctacagtgtgcatttctcatttttcacgtttttcactgattttgtcattgttcaagttgtcaactgcatgtttctcattttccatgattttcagttttcttgccatattccatgtcctacagtggaaatttctatattttccaactttttcagttttcctcgccatatttcacgtgctaaagtgtgtatttctcatttttcgtgtttttcaggtttctcgccatattccaggtcctacagtgtgcatttctcatttttcacgtttttcagtgattttgtaatttttcaagttgtcaagtggatgtttctcattttccttgattttcagttttcttgccatattccatgtcctactgtggacatttctaaattttccacctttttcagttttccttgccatatttcatgtcctaaagtgtgtatttctcattttcagtgattttcagttttctcgcaatattccaggtcctacagtgtgcatttctcattttttcaggtttttcagtgatttcgtcatttttcacgttgtcaagtggatgtttctcattttccatgattttcacttttcttgccatatttcatgtgctaaagtgtgtatttctcattttcagtgattttcagttttctgccatattccaggtcctacattgtgcatttctcattttttcacgtttttcagtgatttcgtcatttttcacgttgtcaagtggatgtttctcattttccatgattttcacttttcttgccatatttcatgttttacagtggacatttctaaattttccacctatttctgttttcctcgccatatttcacatcctaaagtgtgtatttctcattttccgtgattttcagttttctcgccatatgccaggtcatacagggtgcatttctcatttttcacgtttttcagtgatttcgtcatttttcacgtcgtcaagtggatgtttctcattttcaatgattttcatttttcttgccatattccacgtcctatagtggacatttctaaattttccacctttttcagttttccttgccatatttcaggtcctacagtgtgcatttctcttttttcacgtttttcagtgatttcgtcatttttcaagtggtcaagtgcatgtttctcattttccgtgattttcagttttcttgccatgttccaggtcctacagttgacgtttctaaaatttcactttttttaagttttcctcgccatatttcacttcctaaagtgtgtatttctcattttccgtgattttcagttttctcgccagattccaggtcctacagtgtgcatttttcatatttcacctttttcagtgattttgtcatttttcaagttgtcaactgcatgtttctcattttccatgattttcagttttcttgccatattccatgtcctactgtggacatttctaaattttccaactttttcagttttcctcgccatatttcatgtcctaaagtgtgtatttctcattttcagtgattttctgttttctcgccatattccaggtcctacagtgtgcatttctaatttttcacgtttttcagtgatttcgtcatttttcaagttgtcaagtggatgtttctcattttccatgattttcagttttcttgccatattccatgtcctacagtggacatttctaaattttccaactttttccattttcctcaccatatttcacgtcctaaagtgagtttttctcattttttgtgattttcagttttctcgacatattccaggtcctacagtgtgcatttctaattttttcttttttcagtgatttcgtcatttttcaagtggtcaagtgcatgtttctcattttccatgattttcagttttcttgccatattccatgtcctacaatggacatttctaaattttccaactttttcagttttcctcgccatatttcacgtcctaaagtgtgtatttctcattttccgtgattttcagttttctcgccatattccaggtcctacagtgtgcatttctcatttttcacgtttttcagtgatttcgtcatttttcaagttgtcaactgcatgtttctcattttccatgattttcagttttcttgccatattccatgtcttacagtggacatttttaaatttttcacatttttttaagttttcctccccatatttcacgttttaaagtgtgcatttctcattttcggtgattttcagttttctcgccagattccatgtcttacagtgtgcatttctcattttttcacgtttttcagtgatttcgtcatttttcaagtcgtcaagtggatgtttctcattttccatgattttcagttttcttgccatattccatgtcctacagtggaaatttctaaattttccacctttttcagttttccttgccatatttcaggtcctaaagtgtgtatttctcattttctgtgattttcagttttctcgccatattccaggtcctacagttgacatttctaaaatttccacattttttaagttttcctcgccatatttcacttcctaaagtgtgtatttctcattttccgtgattttcagttttctcgccatattccagatcctacagtgtacatttttcatttttcacgtttttcagtgattttgtcattttttagttgtcaactgcctgtttctcattttccatgattttcagttttcttgctatattccatgtcctacagtggaaatttctaaattttccacctttttcagttttcctcgccatatttcacgtcctaaagtgtgtatttctcattttccgtgattttcagttttctcgccatattccaggtcctatgtgtacatttctcatttttcacgtttttcagtgattttgtcatttttcaatttgtcaactgcatgtttctcattttccatgattttcagttttcttgccatattccatgtcctacagtggaaatttctatattttccaactttttcagttttcctcgccatatttcacgtgctaaagtgtgtatttctcatttttcgtgtttttcaggtttctcgccatattccaggtcctacagtgtgcatttctcatttttcacgtttttcagtgattttgtcatttttcaagttgtcaagtggatgtttctcattttccttgattttcagttttcttgccatattccatgtcctacagtggacatttctaaattttccacctttttcagttttccttgccatatttcatgtcctaaagtgtgtatttctcattttcagtgattttcagttttctcgccatattccaggtcctacagtgtgcatttctcattttttcaggtttttcagtgatttcgtcatttttcacgttgtcaagtggatgtttctcattttccatgattttcacttttcttgccatatttcatgtcctaaagtgtgtatttctcattttcagtgattttcagttttctcgctatattccaggtcctacagtgtgcatttctcattttttcacgtttttcagtgatttcgtcatttttcacgttgtcaagtggatgtttctcattttccatgattttcacttttcttgccatatttcatgtcctacaatggacatttctaaattttccacctttttctgttttcctcgccatatttcacatcctaaagtgtgtatttctcattttccgtgattttcagttttcttgccatattccaggtcctacagtgtgcatttctcatttttcacgtttttcagtgatttcgtcatttttcaagttgtcaagtggatgtttctcattttccttgattttcagttttcttgccatattccatgtcctactgtggacatttctaaattttccacctttttcagttttccttgccatatttcatgtcctaaagtgtgtatttctcattttcagtgattttcagttttctcgcaatattccaggtcctacagtgtgcatttctcattttttcaggtttttcagtgatttcgtcatttttcacgttgtcaagtggatgtttctcattttccatgattttcacttttcttgccatatttcatgtcctaaagtgtgtatttctcattttcagtgattttcagttttctgccatattccaggtcctacattgtgcatttctcattttttcacgtttttcagtgatttcgtcatttttcagttttctcgacatattccaggtcctacagtgtgcatttctaattttttcttttttcagtgatttcgtcatttttcaagttgtcaactgcatgtttctcattttccatgattttcagttttcttgccatattccatgtcttacagtggacatttttaaatttttcacatttttttaagttttcctccccatatttcacgttttaaagtgtgcatttctcattttcggtgattttcagttttctcgccagattccaggtcttacagtgtgcatttctcattttttcacgtttttcagtgatttcgtcatttttcaagtcgtcaagtggatgtttctcattttccatgattttcagttttcttgccatattccatgtcctacagtggaaatttctaaattttccacctttttcagttttccttgccatatttcaggtcctaaagtgtgtatttctcattttctgtgattttcagttttctcgccatattccaggtcctacagttgacatttctaaaatttccacattttttaagttttcctcgccatatttcacttcctaaagtgtgtatttctcattttccgtgattttcagttttctcgccatattccagatcctacagtgtgcatttttcatttttcacgtttttcagtgattttgtcattttttagttgtcaactgtctgtttctcattttccatgattttcagttttcttgccatattccatgtcctacactggacatttctaaattttccacctttttctgttttcctcgccatatttcacgtcctaaagtgtgtatttctcattttccgtgattttcagttttcttgccatattccaggtcctacagtgtgcatttctcatttttcacgtttttcagtgattttgtcatttttcaagttgtcaactgcatgtttctcattttctatgattttcagttttcttgctatattccatgtcctacagtggaaatttctaaattttccacctttttcagttttcctcgccatatttcacgtcctaaagtgtgtatttctcattttccgtgattttcagttttctcgccatattccaggtcctatgtgtacatttctcatttttcacgtttttcagtgattttgtcatttttcaagttgtgaagtggatgtttctcatttttcttgattttcatttttcttgccatattccatgtcctagagtggaaatttttaaattttccacctttttcagttttcctcgccatatttcacgtcctaaagtgtgaatttctcattttccgtgattttcagatttctcgccatattccaagtcctacagtgtgcatttctcatttttcacgtttttcagtgatttcgtcatttttcaagttgtcaagtggatgtttctcattttccatgattttcagctttcttgccatattcaaagtcctacagtggacatttctaaattttcgacctttatcagttttcctcgccatatttcatgtcccaaagtgtgtacttctcattttccgtgattttcagtttcctagccatattctaggtcctacagtgtgcatttctcatttttcaggtttttcagtgatttcgtcttttttcaagtcgtcaagtggatgtttctcattttccatgattttcacttttcttgccatatttcatgtcctaaagtgtgtatttctcattttcagtgattttcagttttctcgctatattccaggtcctacagtgtgcatttctcattttttcacgtttttcagtgatttcgtcatttttcacgttgtcaagtggatgtttctcattttccatgattttcacttttcttgccatatttcatgtcctacagtggacatttctaaattttccacctttttctgttttcctcgccatatttcacatcctaaagtgtgtatttctcattttccgtgattttcagttttcttgccatattccaggtcctacagtgtgcatttctcatttttcacgtttttcagtgatttcgtcatttttcaagttgtcaagtggatgtttctcattttccttgattttcagttttcttgccatattccatgtcctactgtggacatttctaaattttccacctttttcagttttccttgccatatttcatgtcctaaagtgtgtatttctcattttcagtgattttcagttttctcgcaatattccaggtcctacagtgtgcatttctcattttttcaggtttttcagtgatttcgtcatttttcacgttgtcaagtggatgtttctcattttccatgattttcacttttcttgccatatttcatgtcctaaagtgtgtatttctcattttcagtgattttcagttttctgccatattccaggtcctacattgtgcatttctcattttttcacgtttttcagtgatttcgtcatttttcacgttgtcaagtggatgtttctcattttccatgattttcacttttcttgccatatttcatgttttacagtggacatttctaaattttccacctttttctgttttcctcgccatatttcacatcctaaagtgtgtatttctcattttccgtgattttcagttttctcgccatatgccaggtcatacagggtgcatttctcatttttcacgtttttcagtgatttcgtcatttttcacgtcgtcaagtggatgtttctcattttcaatgattttcatttttcttgccatattccacgtcctatagtggacatttctaaattttccacctttttcagttttccttgccatatttcaggtcctacagtgtgcatttctcatttttcacgtttttcagtgatttcgtcatttttcaagtggtcaagtgcatgtttctcattttccgtgattttcagttttcttgccatgttccaggtcctacagttgacgtttctaaaatttcactttttttaagttttcctcgccatatttcacttcctaaagtgtgtatttctcattttccgtgattttcagttttctcgccagattccaggtcctacagtgtgcatttttcatatttcacctttttcagtgattttgtcatttttcaagttgtcaactgcatgtttctcattttccatgattttcagttttcttgccatattccatgtcctactgtggacatttctaaattttccaactttttcagttttcctcgccatatttcatgtcctaaagtgtgtatttctcattttcagtgattttctgttttctcgccatattccaggtcctacagtgtgcatttctaatttttcacgtttttcagtgatttcgtcatttttcaagttgtcaagtggatgtttctcattttccatgattttcagttttcttgccatattccatgtcctacagtggacatttctaaattttccaactttttccattttcctcaccatatttcacgtcctaaagtgtgtttttctcattttttgtgattttcagttttctcgacatattccaggtcctacagtgtgcatttctaattttttcttttttcagtgatttcgtcatttttcaagttgtcaactgcatgtttctcattttccatgattttcagttttcttgccatattccatgtcttacagtggacatttttaaatttttcacatttttttaagttttcctccccatatttcacgttttaaagtgtgcatttctcattttcggtgattttcagttttctcgccagattccaggtcttacagtgtgcatttctcattttttcacgtttttcagtgatttcgtcatttttcaagtcgtcaagtggatgtttctcattttccatgattttcagttttcttgccatattccatgtcctacagtggaaatttctaaattttccacctttttcagttttccttgccatatttcaggtcctaaagtgtgtatttctcattttctgtgattttcagttttctcgccatattccaggtcctacagttgacatttctaaaatttccacattttttaagttttcctcgccatatttcacttcctaaagtgtgtatttctcattttccgtgattttcagttttctcgccatattccagatcctacagtgtgcatttttcatttttcacgtttttcagtgattttgtcattttttagttgtcaactgtctgtttctcattttccatgattttcagttttcttgccatattccatgtcctacactggacatttctaaattttccacctttttctgttttcctcgccatatttcacgtcctaaagtgtgtatttctcattttccgtgattttcagttttcttgccatattccaggtcctacagtgtgcatttctcatttttcacgtttttcagtgattttgtcatttttcaagttgtcaactgcatgtttctcattttccatgattttcagttttcttgctatattccatgtcctacagtggaaatttctaaattttccacctttttcagttttcctcgccatatttcacgtcctaaagtgtgtatttctcattttccgtgattttcagttttctcgccatattccaggtcctatgtgtacatttctcatttttcacgtttttcagtgattttgtcatttttcaagttgtgaagtggatgtttctcatttttcttgattttcatttttcttgccatattccatgtcctagagtggaaatttttaaattttccacctttttcagttttcctcgccatatttcacgtcctaaagtgtgaatttctcattttccgtgattttcagatttctcgccatattccaagtcctacagtgtgcatttctcatttttcacgtttttcagtgatttcgtcatttttcaagttgtcaagtggatgtttctcattttccatgattttcagctttcttgccatattcaaagtcctacagtggacatttctaaattttcgacctttatcagttttcctcgccatatttcatgtcccaaagtgtgtacttctcattttccgtgattttcagtttcctcgccatattctaggtcctacagtgtgcatttctcatttttcaggtttttcagtgatttcgtcttttttcaagtcgtcaagtggatgtttctcattttccatgattttcagttttcttgccatattccatgtcctacagtggacatttctaaattttccacctttttcagttttcctcgccatatttcatgtcctaaagtgtgtatttctcattttcagtgattttcagttttctcgccatattccaggtcctacagtgtgcatttctcatttttcacgtttttcagtgatttcgtcatttttcaagttgtcaagtggatgtttctcattttccatgattttcagttttcttgccatattccatgtcccacagtggacatttctaaattttccacctttttctgttttccttgccatatttcatgtcctaaagtgtgtatttctcattttccgtgattttcagttttcttgctatattccaagtcctacagtgtgcatttctcatttttcacgtttttcagtgattttgtcatttttcaatttgtcaactgcatgtttctcattttccatgattttcagttttcttgccatattccatgtcctacagtggaaatttctatattttccaactttttcagttttcctcgccatatttcacgtgctaaagtgtgtatttctcatttttcgtgtttttcaggtttctcgccatattccaggtcctacagtgtgcatttctcatttttcacgtttttcagtgattttgtcatttttcaagttgtcaagtggatgtttctcattttccttgattttcagttttcttgccatattccatgtcctacagtggacatttctaaattttccacctttttcagttttccttgccatatttcatgtcctaaagtgtgtatttctcattttcagtgattttcagttttctcgccatattccaggtcctacagtgtgcatttctcattttttcaggtttttcagtgatttcgtcatttttcacgttgtcaagtggatgtttctcattttccatgattttcacttttcttgccatatttcatgtcctaaagtgtgtatttctcattttcagtgattttcagttttctcgctatattccaggtcctacagtgtgcatttctcattttttcacgtttttcagtgatttcgtcatttttcacgttgtcaagtggatgtttctcattttccatgattttcacttttcttgccatatttcatgtcctacagtggacatttctaaattttccacctttttctgttttcctcgccatatttcacatactaaagtgtgtatttctcattttccttgattttcagttttcttgccatattccaggtcctacagtgtgcatttctcatttttcacgtttttcagtgatttcgtcatttttcaagtcgtcaagtggatgtttctcattttccatgattttcagttttctcgccatattccaggtcctacagttgacatttctaaattttccacattttttaagtttcctcgcgatatttcacatcctaaagtgtgtatttctcattttccgtgattttcagttttcttgccatattccaggtcctacagggtgcatttctcatttttcacgtttttcagtgatttcatcaatttcaagtcgtcaactgtatgtttctcattttcaatgattttcatttttcttgccatattccatgtcctacagtggacatttctaaatttttcacctttttcagttttccttgccatatttcatgtcctaaagtgtgtatttctcattttcagtgattttcagttttctcgccatattccaggtcctacagtgtgcatttctcattttttcaggtttttcagtgatttcgtcatttttcacgttgtcaagtggatgtttctcattttccatgattttcacttttcttgccatatttcatgtcctaaagtgtgtatttctcattttcagtgattttcagttttctcgccatattccaggtcctacagtgtgcatttctcatttttcacgtttttcagtgatttcgtcatttttcaagttgtcaagtggatgtttctcattttccatgattttcacttttcttgccatattccatgtcccacagtggacatttctaaattttccacctttttctgttttcctcgccatatttcatgtcctaaagtgtgtatttctcattttccgtgattttcagttttcttgctatattccaagtcctacagtgtgcatttctcatttttcacgtttttcagtgattttgtcatttttcaatttgtcaactgcatgtttctcattttccatgattttcagttttcttgccatattccatgttctacagtggaaatttctatattttccaactttttcagttttcctcgccatatttcacgtgctaaagtgtgtatttctcatttttcgtgtttttcaggtttctcgccatattccaggtcctacagtgtgcatttctcatttttcacgtttttcagtgattttgtcatttttcaagttgtcaagtggatgtttctcattttccttgattttcagttttcttgccatattccatgtcctacagtggacatttctaaattttccacctttttcagttttccttgccatatttcatgtcctaaagtgtgtatttctcattttcagtgattttcagttttctcgccatattccaggtcctacagtgtgcatttctcattttttcaggtttttcagtgatttcgtcatttttcacgttgtcaagtggatgtttctcattttccatgattttcacttttcttgccatatttcatgtcctaaagtgtgtatttctcattttcagtgattttcagttttctcgctatattccaggtcctacagtgtgcatttctcattttttcacgttttgcagtgatttcgtcatttttcacgttgtcaagtggatgtttctcattttccatgattttcacttttcttgccatatttcatgtcctacagtggacatttctaaattttccacctttttctgttttcctcgccatatttcacatcctaaagtgtgtatttctcattttccgtgattttcagttttcttgccatattccaggtcctacagtgtgcatttctcatttttcacgtttttcagtgatttcgtcatttttcaagtcgtcaagtggatgtttctcattttccatgattttcagttttctcgccatattccaggtcctacagttgacatttctaaattttccacattttttaagtttcctcgcgatatttcacatcctaaagtgtgtatttctcattttccgtgattttcagttttcttgccatattccaggtcctacagggtgcatttctcatttttcacgtttttcagtgatttcatcaatttcaagtcgtcaactgtatgtttctcattttcaatgattttcatttttcttgccatattccatgtcctacagtggacatttctaaattttccacctttttcagttttccttgccatatttcatgtcctaaagtgtgtatttctcattttcagggattttcagttttctcgccatattccaggtcctacagtgtgcatttctcattttttcaggtttttcagtgatttcgtcatttttcacgttgtcaagtggatgtttctcattttccatgattttcacttttcttgccatatttcatgtcctaaagtgtgtatttctcattttcagtgattttcagttttctcgccatattccaggtcctacagtgtgcatttctcattttttcacgtttttcagtgatttcgtcatttttcacgttgtcaagtggatgtttctcattttccatgattttcacttttcttgccatatttcatgtcctacagtggacatttctaaattttccacctttttctgttttcctcgccatatttcacatcctaaagtgtgtatttctcattttccgtgattttcagttttcttgccatattccaggtcctacagtgtgcatttctcatttttcacgtttttcagtgatttcgtcatttttcaagtcgtcaagtggatgtttctcattttccatgattttcagttttctcgccatattccaggtcctacagttgacatttctaaattttccacattttttaagtttcctcgcgatatttcacatcctaaagtgtgtatttctcattttccgtgattttcagttttcttgccatattccaggtcctacagggtgcatttctcatttttcacgtttttcagtgatttcatcaatttcaagtcgtcaactgtatgtttctcattttcaatgattttcatttttcttgccatattccacgtcctatagtggacatttctaaattttccacctttttcagttttcttcgccatatttcacgtcccaaagtgtgtatttctcattttccgtgattttcagtttcctcgcaatattccaggtcctacagtgtgcatttctcatttttcacgtttttcagtgatttcgtcttttttcaagtcgtcaagtggatgtttctcattttccatgattttcagttttcttgccatattccatgtcctacagtggacatttctaaattttccacctttttctgttttcctcgccatatttcacgtcctaaagtgtgtatttctcattttccgtgattttcagttttcttgccatattccaggtcctacagtgtgcatttctcatttttcacgtttttcactgattttgtcattgttcaagttgtcaactgcatgtttctcattttccatgattttcaattttcttgccatattccatgtcctacagtggaaatttctatattttccaactttttcagttttcctcgccatatttcacgtgctaaagtgtgtatttctcatttttcgtgtttttcaggtttctcgccatattccaggtcctacagtgtgcatttctcatttttcacgtttttcagtgattttgtcatttttcaagttgtcaagtggttgtttctcattttccttgattttcagttttcttgccatattccatgtcctactgtggacatttctaaattttccacctttttcagttttccttgccatatttcatgtcctaaagtgtgtatttctcattttcagtgattttcagttttctcgcaatattccaggtcctacagtgtgcatttctcattttccgtgattttcagttttctcgccatatgccaggtcatacagggtgcatttctcatttttcacgtttttcagtgatttcgtcatttttcacgtcgtcaagtggatgtttctcattttcaatgattttcatttttcttgccatattccacgtcctatagtggacatttctaaattttccaactttttcagttttcttgccatatttcaggtcctacagtgtgcatttctcatttttcacgtttttcagtgatttcgtcatttttcaagtggtcaagtgcatgtttctgattttccgtgattttcagttttcttgccatgttccaggtcctacagttgacgtttctaaaatttcactttttttaagttttcctcgccatatttcacttcctaaagtgtgtatttctcattttccgtgattttcagttttctcgccagattccaggtcctacagtgtgcatttttcatatttcacctttttcagtgattttgtcatttttcaagttgtcaactgcatgtttctcattttccatgattttcagttttcttgccatattccatgtcctactgtggacatttctaaattttccaactttttcagttttcctcgccatatttcatgtcctaaagtgtgtatttctcattttcagtgtttttctgttttctcgccatattccaggtcctacagtgtgcatttctaatttttcacgtttttcagtgatttcgtcatttttcaagttgtcaagtggatgtttctcattttccatgattttcagttttcttgccatattccatgtcctacagtggacatttctaaattttccaactttttccattttcctcaccatatttcacgtcctaaagtgtgtttttctcattttttgtgattttcagttttctcgacatattccaggtcctacagtgtgcatttctaattttttcttttttcagtgatttcgtcatttttcaagtggtcaagtgcatgtttctcattttccatgattttcagttttcttgccatattccatgtcctacaatggacatttctaaattttccaactttttcagttttcctcgccatatttcacgtcctaaagtgtgtatttctcattttccgtgattttcagttttctcgccatattccaggtcctatgtgtacatttctcatttttcacgtttttcagtgattttgtcatttttcaagttgtgaagtggatgtttctcatttttcttgattttcatttttcttgccatattccatgtcctagagtggaaatttttaaattttccaactttttcagttttcctcgccatatttcacgtcctaaagtgtgtatttctcattttccgtgattttcagttttctcgccatattccaagtcctacagtgtgcatttctcatttttcacgtttttcagtgatttcgtcatttttcaagttgtcaagtggatgtttctcattttccatgattttcagctttcttgccatattcaaagtcctacagtggacatttctaaattttcgacctttatcagttttcctcgccatatttcatgtcccaaagtgtgtacttctcattttccgtgattttcagtttcctcgccatattctaggtcctacagtgtgcatttctcatttttcaggtttttcagtgatttcgtcttttttcaagtcgtcaagtggatgtttctcattttccatgattttcagttttcttgccatattccatgtcctacagtggacatttctaaattttccacctttttcagttttcctcgccatatttcatgtcctaaagtgtgtatttctcattttcagtgattttcagttttctcgccatattccaggtcctacagtgtgcatttctcatttttcacgtttttcagtgatttcgtcatttttcaagttgtcaagtggatgtttctcattttccatgattttcagttttcttgccatattccatgtcccacagtggacatttctaaattttccacctttttctgttttccttgccatatttcatgtcctaaagtgtgtatttctcattttccgtgattttcagttttcttgctatattccaagtcctacagtgtgcatttctcatttttcacgtttttaagtgattttgtcatttttcaatttgtcaactgcatgtttctcattttccatgattttcagttttcttgccatattccatgtcctacagtggaaatttctatattttccaactttttcagttttcctcgccatatttcacgtgctaaagtgtgtatttctcatttttcgtgtttttcaggtttctcgccatattccaggtcctacagtgtgcatttctcatttttcacgtttttcagtgattttgtcatttttcaagttgtcaagtggatgtttctcattttccttgattttcagttttcttgccatattccatgtcctacagtggacatttctaaattttccacctttttcagttttccttgccatatttcatgtcctaaagtgtgtatttctcattttcagtgattttcagttttctcgccatattccaggtcctacagtgtgcatttctcattttttcaggtttttcagtgatttcgtcatttttcacgttgtcaagtggatgtttctcattttccatgattttcacttttcttgccatatttcatgtcctaaagtgtgtatttctcattttcagtgattttcagttttctcgccatattccaggtcctacagtgtgcatttctcattttttcacgtttttcagtgatttcgtcatttttcacgttgtcaagtggatgtttctcattttccatgattttcacttttcttgccatatttcatgtcctacagtggacatttctaaattttccacctttttctgttttcctcgccatatttcacatcctaaagtgtgtatttctcattttccgtgattttcagttttcttgccatatttcaggtcctacagtgtgcatttctcatttttcacgtttttcagtgatttcgtcatttttcaagtcgtcaagaggatgtttctcattttccatgattttcagttttctcgccatattccaggtcctacagttgacatttctaaattttccacattttttaagtttcctcgcgatatttcacatcctaaagtgtgtatttctcattttccgtgattttcagttttcttgccatattccaggtcctacagggtgcatttctcatttttcacgtttttcagtgatttcatcaatttcaagtcgtcaactgtatgtttctcattttcaatgattttcatttttcttgccatattccacgtcctatagtggacatttctaaattttccacctttttctgttttcctcgccatatttcacgtcctaaagtgtgtatttctcattttccgtgattttcagttttcttgccatattccaggtcctacagtgtgcatttctcatttttcacgtttttcactgattttgtcattgttcaagttgtcaactgcatgtttctcattttccatgattttcagttttcttgccatattccatgtcctacagtggaaatttctatattttccacctttttcagttttcctcgccgtatttcatgtgctaaagtgtgtatttctcatttttcgtgtttttcaggtttctcgccatattccaggtcctacagtgtgcatttctcatttttcacgtttttcagtgattttgtcatttttcaagttgtcaactggatgtttctcattttccttgattttcagttttcttgccatattccatgtcctactgtggacatttctaaattttccacctttttcagttttccttgccatatttcatgtcctaaagtgtgtatttctcattttcagtgattttcagttttctcgcaatattccaggtcctacagtgtgcatttctcattttttcaggtttttcagtgatttcgtcatttttcacgttgtcaagtggatgtttctcattttccatgattttcacttttcttgccatatttcatgtcctaaagtgtgtatttctcattttcagtgattttcagttttctcgccatattccaggtcctacattgtgcatttctcattttttcacgtttttcagtgatttcgtcatttttcacgttgtcaagtggatgtttctcattttccatgattttcacttttcttgccatatttcatgttttacagtggacatttctaaattttccacctttttctgttttcctcgccatatttcacatcctaaagtgtgaatttctcattttccgtgattttcagttttcttgccatattccaggtcctacagtgtgcatttctcatttttcacgtttttcagtgatttcatcatttttcaagtcgtcaagtggatgtttctcattttccatgattttcagttttcttgccatattccatgtcctacagtggacatttctaaattttccacctttttctgttttcctcgccatatttcacgtcctaaagtgtgtatttctcattttccgtgattttcagttttcttgccatattccaggtcctacagtgtgcatttctcatttttcacgtttttcactgattttgtcatttttcaagttgtcaactgcatgtttctcattttccatgattttcagttttcttgctatattccatgtcctacagtggaaatttctaaattttccacctttttcagttttcctcgccatatttcacgtcctgaagtgtgtatttctcattttccgtgattttcagttttctcgccatattccaggtcctatgtgtacatttctcatttttcacgtttttcagtgattttgtcatttttcaagttgtgaagtggatgtttctcatttttcttgattttcatttttcttgccatattccatgtcctacagtggaaatttctaaattttccacctttttcagttttcctcgccatatttcacgtcctaaagtgtgtatttctcattttccgtgattttcagttttctcgccatattccaggtcctacagtgtgcatttctcatttttcacgtttttcagtgatttcgacatttttcaagttgtcaagtggatgtttctcattttccatgattttcagctttcttgccatattcaaagtcctacagtggacatttctaaattttcgacctttatcagttttcctcgccatatttcatgtcccaaagtgtgtacttctcattttccgtgattttcagtttcctcgccatattccaggtcctacagtgtgcatttctcatttttcacgtttttcagtgatttcgtcatttttcaagtcgtcaagtggatgtttctcattttccatgattttcagttttcttgccatattccatgtcctacagtggacatttctaaattttccacctttttctgttttcctcgccatatttcacgtcctaaagtgtgtatttctcattttccgtgattttcagttttcttgccatattccaggtcctacagtgtgcatttctcatttatcacgtttttcactgattttgtcatttttcaagttgtcaactgcatgtttctcattttccatgattttcagttttcttgctatattccatgtcctacagtggaatattctaaattttccacctttttcagttttcctcgccatatttcacgtcctgaagtgtgtatttctcattttccgtgattttcagttttctcgccatattccaggtcctatgtgtacatttctcatttttcacgtttttcagtgattttgtcatttttcaagttgtgaagtggatgtttctcatttttcttgattttcatttttcttgccatattccatgtcctacagtggaaatttctaaattttccacctttttcagttttcctcgccatatttcacgtcctaaagtgtgaatttctcattttccgtgattttcagttttctcgccatattccaggtcctacagtgtgcatttctcatttttcacgtttttcagtgatttcgacatttttcaagttgtcaagtggatgtttctcattttccatgattttcagctttcttgccatattcaaagtcctacagtggacatttctaaattttcgacctttatcagttttcctcgccatatttcatgtcccaaagtgtgtacttctcattttccgtgattttgagtttcctcgccatattccaggtcctacagtgtgcatttctcatttttcacgtttttcagtgatttcgtcttttttcaagttgtcaactgcatgtttctcattttccatgattttcagttttcttgccatattccatgtcctacagtggaaatttgtaaatttccacctttttcagttttcctcgccatatttcacgtcctaaagtatgtatttctcattttccgtgattttcagttttctcgccatattccaggtcctacagtgtgcatttctcatttttcacgtttttcagtgattttgtcattttttaagttttcaagtggatgtttctcattttccttgattttcagttttcttgccatattccatgtcctacagtggacatttctaaattttccacctttttcagttttcctcgccatatttcatgtcctaaagtgtgtatttctcattttcagtgattttcagttttctcgccatattccaggtcctacagtgtgcatttctcatttttcacgtttttcagtgatttcgtcatttttcaaggtgtcaagtggatgtttctcattttccatgattttcagttttcttgccatattccatgtcctacagtggacatttctaaattttccacctttttctgttttcctcgccatatttcatgtcctaaagtgtgtatttctcattttccgtgattttcagttttcttgctatattccaagtcctacagtgtgcatttctcatttttcacgtttttcagtgattttgtcatttttcaatttgtcaactgcatgtttctcattttccatgattttcagtttttttgccatattccatgtcctactgtggaaatttctatattttccacctttttcagttttcctcgccatatttcacgtgctaaagtgtgtatttctcatttttcgtgtttttcaggtttctcgccatattccaggtcctacagtgtgcatttctcatttttcacgtttttcagtgattttgtcatttttcaagttttcaagtggatgtttctcattttccttgattttcagttttcttgccatattccatgtcctacagtggacatttctaaattttccacctttttcagttttccttgccatatttcatgtcctaaagtgtgtatttctcattttcagtgattttcagtttccttgccatattccaggtcctacagtgtgcatttctcattttttcacgtttttcagtgatttcgtcatttttcacgttgtcaagtggatgtttctcattttccatgattttcacttttcttgccatatttcatgtcctacagtggacatttctaaattttccaactttttcaattttcctcgccatattttatgtcctaaagtgtgtatttctcatttttcgttattttcagttttcttgccatattccaggtcctacagtgtgcatttgtcatttttcacgtttttcagtgatttcgtcatttttcaagtcgtcaagtagatgtttctcatattccatgtttttcagttttctcgccatattccaggtcctacagttgacatttctaaattttctacatttttaaattttcctcgccatatttcacgtcctaaagtgtgtatttctcattttttgttattttcagttttctagccatattccaggtcctacaggatgcatttctcatttttcacgtttttcagtgatttcatcatttttcaagtcgtcaagtgtatgtttcttattttcaatgattttcatttttcttgccttattccacgtcctatagtggacatttctaaattttccacctttttcagtttttttcgccatatttcacgtcctaaagtgtgtatttctcattttctgtgattttcagttttctcaccatattccaggtcctacagtgtgcatttctcatttttcacgtttttcagtgatttcgtcatttttcaagttgtcaagtggaagtttctcattttccatgattttcagctttctagacatattccaggtcctacagtggacatttcctaattttcgacctttatcagttttcctcgtcatatttcacgtcccaaaatgtgtatttcttattttccatgattttcagtttcctcgccatattccaggtcctacagtgtgcaattctcatttttcacgtttttcagtgatttcgtcttttttcaagacgtcaagtggatgtttctcatttttcatgattttcagttttcttgccatattccatgtcctacagtggacatttctaaattttccacctttttctgttttcctcgccatatttcacgtcctaaagtgtgtatttctcattttccgtgattttcagttttcttgccatattcctggtcctacagtgtgcatttctcatttttcacgtttttcagtgattttgtcatttttcaatttgtcaactgcatgtttctcattttccattattttcagttttcttgccatattccatgtcctacagtggacatttctaaattttccacctttttctgttttcctcgccatatttcatgtcctaaagtgtgtatttctcattttccgtgattttcagttttcttgctatattccaagtcctacagtgtgcatttctcatttttcacgtttttcagtgattttgtcatttttcaatttgtcaactgcatgtttctcattttccatgattttcagtttttttgccatattccatgtcctacaggggaaatttctatattttccacctttttcagttttcctcgccatatttcatgtcctaaagtgtgtatttctcattttccgtgattttcagttttcttgccatattccaggtcctacagtgtgcatttctcatttttcacgtttttcagtgatttcgtcatttttcaagtcttcaagtagatgtttctcatattccatgtttttcagttttctcgccatattccaggtcctacagttgacatttctaaattttctacatttttaaattttcctcgccatatttcacgtcctaaagtgtgtatttctcatttttcgttattttcagttttctagccatattccaggtcctacaggatgcatttctcatttttcacgtttttcagtgatttcatcatttttcaagtcgtcaagtgtatgtttctcattttcaatgattttcatttttcttgccttattccacgtcctatagtggacatttctaaattttccacctttttcagtttttctcgccatatttcacgtcctaaagtgtgtatttctcattttctgtgattttcagttttctcaccatattccaggtcctacagtgtgcatttctcatttttcacgtttttcagtgatttcgtcatttttcaagttgtcaagtggaagtttctcattttccatgattttcagctttctagccatattccaggtcctacagtggacatttcctaattttcgacctttatcagttttcctcgccatatttcacgtcctaaagtgtgtatttctcattttccgtgattttcagttttcttgccatattccaggtcctacagtgtgcatttctcatttttcacgtttttcagtgattttgtcatttttcaatttgtcaactgcatgtttctcattttccatgatttttagttttcttgctatattccatgtcctacagtggaaatttctaaattttccacctttttcagttttcctcgccatatttcacgtcctaaagtgtgtatttctcattttccgtgattttcagttttcttgctatattccaagtcctacattgtgcatttctcatttttcacgtttttcagtgattttgtcatttttcaatttgtcaaaccacatgtttctcattttccatgattttcagtttttttgccatattccatgtcctacagtggaaatttctatattttccacctttttcagttttcctcgccatatttcacgtgctaaagtgtgtatttctcatttttcgtgtttttcaggtttctcgccatattccaggtcctacagtgtgcatttctcatttttcacgtttttcagtgattttgtcatttttcaagttgtcaagtggatgtttcccattttccttgattttcagttttcttaccatattccatgtcctacagtggacatttctaaattttccacctttttcagttttccttgccatatttcatgtcctaaagtgtgtatttctcattttcagtgattttcagtttcctcgccatattccaggtcctacagtgtgcatttctcattttttcacgtttttcagtgatttcgtcatttttcacgttgtcaagtggatgtttctcattttccatgattttcacttttcttgccatatttcatgtcctatagtggacatttctaaattttccacctttttcagtttttctcgccatatttcacgtcctaaagtgtgtatttctcattttctgtgattttcagttttctcaccatattccaggtcctacagtgtgcatttctcatttttcacgtttttcagtgatttcgtcatttttcaagtcgtcaagtagatgtttctcatattccatgtttttcagttttctcgccatattccaggtcctacagttgacatttctaaattttctacatttttaaattttcctcgccatatttcacgtcctaaagtgtgtatttctcatttttcgttattttcagttttctagccatattccaggtcctacaggatgcatttctcatttttcacgtttttcagtgatttcatcatttttcaagtcgtcaagtgtatgtttcttattttcaatgattttcatttttcttgccttattccacgtcctatagtggacatttctaaattttccaccttttttcagtttttctcgccatatttcacgtcctaaagtgtgtatttctcattttctgtgattatcagttttctcaccatattccaggtcctacagtgtgcatttctcatttttcacgtttttcagtgatttcgtcatttttcaagttgtcaagtggaagtttctcattttccatgattttcagctttctagccatattccaggtcctacagtggacatttcctaattttcgacctttatcagttttcctcgccatatttcacgtcccaaaatgtgtatttcttattttccatgattttcagtttcctcgccatattccaggtcctacagtgtgcatttctcatttttcacgtttttcagtgatttcgtcttttttcaagacgtcaagtggatgtttctcatttttcatgattttcagttttcttgccatattccatgtcctacagtggacatttctaaattttccacctttttctgttttcctcgccatatttcacgtcctaaagtgtgtatttctcattttccgtgattttcagttttcttgccatattcctggtcctacagtgtgcatttctcatttttcacgtttttcagtgattttgtcatttttcaatttgtcaactgcatgtttctcattttccatgattttcagttttcttgccatattccatgtcctacagtggacatttctaaattttccacctttttcagttttcctcgccatatttcacgtgctaaagtgtgtatttctcatttttcgtgtttttcaggtttctcgccatattccaggtcctacagtgtgcatttctcatttttcacgtttttcagtgattttgtcatttttcaagttgtcaagtggatgtttctcattttccttgattttcacttttcttgccatattccaagtcttacaggggcatttctcatttttcacgttttcagtgattttgtcattttcaatttgtcaactgcatgtttctcattttccatgattttcagtttttttgccatattccatgtcctacaggggaaatttctatattttccacctttttcagttttcctcgccatatttcatgtcctaaagtgtgtatttctcattttccgtgattttcagttttcttgccatattccaggtcctacagtgtgcatttctcatttttcacgtttttcagtgatttcgtcatttttcaagtcttcaagtagatgtttctcatattccatgtttttcagttttctcgccatattccaggtcctacagttgacatttctaaattttctacatttttaaattttcctcgccatatttcacgtcctaaagtgtgtatttctcatttttcgttattttcagttttctagccatattccaggtcctacaggatgcatttctcatttttcacgtttttcagtgatttcatcatttttcaagtcgtcaagtgtatgtttctcattttcaatgattttcatttttcttgccttattccacgtcctatagtggacatttctaaattttccacctttttcagtttttctcgccatatttcacgtcctaaagtgtgtatttctcattttctgtgattttcagttttctcaccatattccaggtcctacagtgtgcatttctcatttttcacgtttttcagtgatttcgtcatttttcaagttgtcaagtggaagtttctcattttccatgattttcagctttctagccatattccaagtcctacagtggacatttcctaattttcgacctttatcagttttcctcgccatatttcacgtcccaaaatgtgtattccttattttccatgattttcagtttcctcgccatattccaggtcctacagtgtgcatttatcatttttcacgtttttcagtgatttcgtcttttttcaagacgtcaagtggatgtttctcatttttcatgattttcagttttcttgccatattccatgtcctacagtggacatttctaaattttccacctttttctgttttcctcgccatatttcacgtcctaaagtgtgtatttctcattttccgtgattttcagttttcttgccatattcctggtcctacagtgtgcatttctcatttttcacgtttttcagtgattttgtcatttttcaagttgtcaagtggatgtttctcattttccttgattttcacttttcttgccatattccatgtcctacagtggacatttctatattttccacctttttccgttttccttgccatatttcacgtcctaaagtgtgtatttctcattttccgtgattttcaggtttctcgccatattccaggtcctacagtgtgcatttctcatttttcacgtttttcagtgattttgtcatttttcaagttgtcaagtggatgtttctcattttccttgattttcacttttcttgccatattccatgtcctacagtggacatttctaaattttccacctttttcagttttcctcgccatatttcatgtcctaaagtgtgtatttctcattttcagtgattttcagttttcttgccatattccaggtcctacagtgtgcatttctcatttttcacgtttttcagtgattttgtcatttttcaagttgtcaactgcatgtttctcattttctatgattttcagttttcttgctatattccatgtcctacagtggaaatttctaaattttccacctttttcagttttcctcgccatatttcacgtcctaaagtgtgtatttctcattttccgtgattttcagttttctcgccatattccaggtcctatgtgtacatttctcatttttcacgtttttcagtgattttgtcatttttcaagttgtgaagtggatgtttctcatttttcttgattttcatttttcttgccatattccatgtcctagagtggaaatttttaaattttccacctttttcagttttcctcgccatatttcacgtcctaaagtgtgaatttctcattttccgtgattttcagatttctcgccatattccaagtcctacagtgtgcatttctcatttttcacgtttttcagtgatttcgtcatttttcaagttgtcaagtggatgtttctcattttccatgattttcagctttcttgccatattcaaagtcctacagtggacatttctaaattttcgacctttatcagttttcctcgccatatttcatgtcccaaagtgtgtacttctcattttccgtgattttcagtttcctcgccatattctaggtcctacagtgtgcatttctcatttttcaggtttttcagtgatttcgtcttttttcaagtcgtcaagtggatgtttctcattttccatgattttcacttttcttgccatatttcatgtcctaaagtgtgtatttctcattttcagtgattttcagttttctcgctatattccaggtcctacagtgtgcatttctcattttttcacgtttttcagtgatttcgtcatttttcacgttgtcaagtggatgtttctcattttccatgattttcacttttcttgccatatttcatgtcctacagtggacatttctaaattttccacctttttctgttttcctcgccatatttcacatcctaaagtgtgtatttctcattttccgtgattttcagttttcttgccatattccaggtcctacagtgtgcatttctcatttttcacgtttttcagtgatttcgtcatttttcaagttgtcaagtggatgtttctcattttccttgattttcagttttcttgccatattccatgtcctactgtggacatttctaaattttccacctttttcagttttccttgccatatttcatgtcctaaagtgtgtatttctcattttcagtgattttcagttttctcgcaatattccaggtcctacagtgtgcatttctcattttttcaggtttttcagtgatttcgtcatttttcacgttgtcaagtggatgtttctcattttccatgattttcacttttcttgccatatttcatgtcctaaagtgtgtatttctcattttcagtgattttcagttttcctcgccatatttcacgtcccaaaatgtgtatttcttattttccatgattttcagtttcctcgccatattccaggtcctacagtgtgcatttctcatttttcacgtttttcagtgatttcgtcttttttcaagacgtcaagtggatgtttctcatttttcatgattttcagttttcttgccatattccatgtcctacagtggacatttctaaattttccacctttttctgttttcctcgccatatttcacgtcctaaagtgtgtatttctcattttccgtgattttcagttttcttgccatattcctggtcctacagtgtgcatttctcatttttcacgtttttcagtgattttgtcatttttcaatttgtcaactgcatgtttctcattttccatgattttcagttttcttgccatattccatgtcctacagtggacatttctaaattttccacctttttcagttttcctcgccatatttcacgtgctaaagtgtgtatttctcatttttcgtgtttttcaggtttctcgccatattccaggtcctacagtgtgcatttctcatttttcacgtttttcagtgattttgtcatttttcaagttgtcaagtggatgtttctcattttccttgattttcacttttcttgccatattccatgtcctacagtggacatttctaaattttccacctttttcagttttcctcgccatatttcatgtcctaaagtgtgtatttctcattttcagtgattttcagttttctcgccatattccaggtcctacagtgtgcatttctcatttttcacgtttttcagtgatttcgtcttttttcaagacgtcaagtggatgtttctcattttccatgattttcagttttcttgccatattccatgtcctacagtggacatttctaaattttccacctttttctgttttcctcgccatatttcacgtcctaaagtgtgtatttctcattttccgtgattttcagttttcttgccatattccaggtcctacagtgtgcatttctcatttttcacgtttttcagtgattttgtcatttttcaatttgtcaactgcatgtttctcattttccatgatttttagttttcttgctatattccatgtcctacagtggaaatttctaaattttccacctttttcagttttcctcgccatatttcacgtcctaaagtgtgtatttctcattttccgtgattttcagttttcttgctatattccaagtcctacattgtgcatttctcatttttcacgtttttcagtgattttgtcatttttcaatttgtcaaaccacatgtttctcattttccatgattttcagtttttttgccatattccatgtcctacagtggaaatttctatattttccacctttttcagttttcctcgccatatttcacgtgctaaagtgtgtatttctcatttttcgtgtttttcaggtttctcgccatattccaggtcctacagtgtgcatttctcatttttcacgtttttctgtgattttgtcatttttcaagttgtcaagtggatgtttctcattttccttgattttcagttttcttaccatattccatgtcctacagtggacatttctaaattttccaccttttctgttttcctcgccatatttcatgtcctaaagtgtgtatttctcattttccgtgattttcatttttcttgctatattccaagtcctacagtgtgcatttctcattttccatgattttcagttttcttgctatattccatgtcctacagtggaaatttctaaattttccacctttttcagttttcctcgccatatttcacgtcctaaagtgtgtatttctcattttccgtgattttcagttttttcgccatattacaggtcctatgtgtacatttctcatttttcacgtttttcagtgattttgtcatttttcaagttgtcaagtggatgtttctcatttttcttgattttcatttttcttgccatattccatgtcctacagtggaaatttctaaattttccacctttttcagttttcctcgccatatttcacgtcctaaagtgtgaatttctcattttccgtgattttcagttttctcgccatattccaggtctacagtgtgcatttctcatttttcacgttttcagtgattcgtcatttttcaagttgacaagtggatgtttctcattttccatgattttcagctttcttgccatattcaaagtcctacagtggacatttctaaattttcgacctttatcagttttcctcgccatatttcatgtcccaaagtgtgtacttctcattttccgtgattttcagttttcttgccatattccaagtcctacagtgtgcatttctcatttttcacgtttttcagtgattttgtcatttttcaatttgtcaactgcatgtttctcattttccatgattttcagttttcttgccatattccatgtcctacagtggaaatttctatattttccacctttttcagttttcctcgccatatttcacgtgctaaagtgtgtatttctcatttttcgtgtttttcaggtttctcgccatattccaggtcctacagtgtgcatttctcatttttcacgtttttcagtgattttgtcatttttcaagttgtcaagtggatgtttctcattttcaatgattttcatttttcttgccttattccacgtcctatagtggacatttctaaattttccacctttttcagtttttctcgccatatttcacgtcccaaaatgtgtattccttattttccatgattttcagtttcctcgccatattccaggtcctacagtgtgcatttctcatttttcacgtttttcagtgatttcgtcttttttcaagacgtcaagtggatgtttctcatttttcatgattttcagttttcttgccatattccctgtcctacagtggacatttctaaattttccacctttttctgttttcctcgccatatttcacgtcctaaagtgtgtatttctcattttccgtgattttcagttttctcgccagattccaggtcctacagtgtgcatttctcatttttcacgtttttcagtgattttgtcatttttcaatttgtcaactgcatgtttctctctttccatgattttcagttttcttgccatattccatgtcctacagtggacatttctaaattttccacctttttcagttttcctcgccatatttcacgtgctaaagtgtgtatttctcatttttcgtgtttttcaggtttctcgccatattccaggtcctacagtgtgcatttctcatttttcacgtttttcagtgattttgtcatttttcaagttgtcaagtggatgtttctcattttcaatgattttcatttttcttaccttattccacgtcctatagtggacatttctaaattttccacctttttcagtttttctcgccatatttcacgtcccaaaatgtgtattccttattttccatgattttcagtttcctcgccatattccaggtcctacagtgtgcatttctcatttttcacgtttttcagtgatttcgtcttttttcaagacgtcaagtggatgtttctcatttttcatgattttcagttttcttgccatattccctgtcctacagtggacatttctaaattttccacctttttctgttttcctcgccatatttcacgtcctaaagtgtgtatttctcattttccgtgattttcagttttctcgccagattccaggtcctacagtgtgcatttctcatttttcacgtttttcagtgatttcgtcatttttcaagtcttcaagtgtatgtttctcattttcaatgattttcatttttcttgccttattccacgtcctatagtggacatttctaaattttccacctttttcagtttttctcgccatatttcacgtcctaaagtgtgtatttctcattttctgtgattttcagttttcttaccatattccaggtcctacagtgtgcatttctcatttttcacgtttttcagtgatttcgtcatttttcaagttgtcaagtggaagtttctcattttccatgattttcagctttctagccatattccaggtattacagtggacatttccttattttcgacctttatcagttttcctcgccatatttcatgtcctaaagtgtgt	38399	1554	4%	7300	19%
9	3000001	3038400	Atcctacagtgtgcatttctcatttttcacgtttttcagtgatttcgtcatttttcaagtcatcaagtggctgtttctcattttccatgattttcagttttcttgccatattccttgtcctacagtggacatttctaaattttccacctttttcagttttccttgtcatatttcaggtcctacagtgtgtatttctcatttttcacgtttttcattgatttcgtcatttttcaagttgtcaagtgcatgtttctcattttccatgattttcagttttcttgccatattccatgtcctacaatggacatttctaaattttccaactttttcagttttcctcgccatatttcacgtcctaaagtgtgtatttctcattttccgtgattttcagttttctcgacatattccaggtcctacagtgtgcatttctcatttttcacgtttttcagtgatttcgtcatttttcacgtcgtcaagtggatgtttctcattttccatgattttcagttttcttgccatattccatgtcctacagtggacatttctaaattttccacctttttcagttttcctcgccatatttcacgtcctaaagtgtgtatttctcattttccgtgattttcagttttctcgacatattccaggtcttacagggtgcatttctcatttttcacgtttttcagtgatttcatcatttttcaagtcgtcaactgtatgtttctcattttcaatgattttcatttttcttgccatattccacgtcctatagtggacatttctaaattttccacctttttcagttttccttgccatatttcaggtcctacagtgtgcatttctcatttttcacgtttttcagtgatttcgtcatttttcaagtggtcaaatgcatgtttctcattttccatgattttcagttttcttgccatattccatgtcctacagtggacatttctaaattttccacctttttcagttttcctcgccatatttcacgtcctaaagtgtgtatttctcattttccgtgattttcagttttatcgccagattccaggtcctacggtgtgcatttttcatatttcacgtttttcagtgattttgtcatttttcaagttgtcaactgcatgtttctcattttccatgattttcagttttcttgccatattccatgtcctacagtggacatttctaaattttccacctttttcagttttcctcgccatatttcatgtcctaaagtgtgtatttctcattttcagtgattttctgttttctcgccatattccaggtcctacagtgtgcatttctcatttttcacgtttttcagtgatttcgtcatttttcaagttgtcaagtggatgtttctcattttccatgattttcagttttcttgccatattccatgtcctacaatggacatttctaaattttccacctttttcagttttcctcgccatatttcacgtcctaaagtgtgtatttctcattttccgtgattttcagttttctcgccatattccaggtcctatgtgtacatttctcatttttcacgtttttcagtgattttgtcatttttcaagttgtgaagtggatgtttctcatttttcttgattttcatttttcttgccatattccatgtcctagagtggaaatttttaaattttccacctttttcagttttcctcgccatatttcacgtcctaaagtgtgaatttctcattttccgtgattttcagttttctcgccatattccaagtcctacagtgtgcatttctcatttttcacgtttttcagtgatttcgtcatttttcaagttgtcaagtggatgtttctcattttccatgattttcagctttcttgccatattcaaagtcctacagtggacatttctaaattttcgacctttatcagttttcctcgccatatttcatgtcccaaagtgtgtacttctcattttccgtgattttcagtttcctcgccatattctaggtcctacagtgtgcatttctcatttttcaggtttttcagtgatttcgtcttttttcaagtcgtcaagtggatgtttctcattttccatgattttcagttttcttgccatattccatgtcctacagtggacatttctaaattttccaactttttcagttttcctcgccatatttcatgtcctaaagtgtgtatttctcattttcagtgattttcagttttctcgccatattccaggtcctacagtgtgcatttctcatttttcacgtttttcagtgatttcgtcatttttcaagttgtcaagtggatgtttctcatttttcatgattttcagttttcttgccatattccatgtcccacagtggacatttctaaatgttccacctttttctgttttccttgccatatttcatgtcctaaagtgtgtatttctcattttccgtgattttcagttttcttgctatattccaagtcctacagtgtgcatttctcatttttcacgtttttctgtgattttttcatttttcaatttgtcaactgcatgtttctcattttccatgattttcagttttcttgccatattccaggtcctacagtgtgcatttctcatttttcacgtttttcagtgattttgtcatttttcaagttgtcaactgcatgtttctcattttccatgattttcagttttcttgctatattccatgtcctacagtggaaatttctaaattttccacctttttcagttttcctcgccatatttcacgtcctaaagtgtgtatttctcattttccgtgattttcagttttctcgccatattccaggtcctatgtgtacatttctcatttttcacgtttttcagtgattttgtcatttttcaagttgtgaagtggatgtttctcatttttcttgattttcatttttcttgccatattccatgtcctagagtggaaatttttaaattttccacctttttcagttttcctcgccatatttcacgtcctaaattgtgaatttctcattttccgtgattttcagttttctcgccatattccaagtcctacagtgtgcatttctcatttttcacgtttttcagtgatttcgtcatttttcaagttgtcaagtggatgtttctcattttccatgattttcagctttcttgccatattcaaagtcctacagtggacatttctaaattttcgacctttatcagttttcctcgccatatttcatgtcccaaagtgtgtacttctcattttccgtgattttcagtttcctcgccatattctaggtcctacagtgtgcatttctcatttttcaggtttttcagtgatttcgtcttttttcaagtcgtcaagtggatgtttctcattttccatgattttcagttttcttgccatattccatgtcctacagtggacatttctaaattttccacctttttcagttttcctcgccatatttcatgtcctaaagtgtgtatttctcattttcagtgattttcagttttctcgccatattccaggtcctacagtgtgcatttctcatttttcacgtttttcagtgattttgtcatttttcaagttgtcaagtggatgtttctcattttccttgattttcagttttcttgccatattccatgtcctacagtggacatttctaaattttccacctttttcagttttccttgccatatttcatgtcctaaagtgtgtatttctcattttcagtgattttcagttttctcgccatattccaggtcctacagtgtgcatttctcattttttcaggtttttcagtgatttcgtcatttttcacgttgtcaagtggatgtttctcattttccatgattttcacttttcttgccatatttcatgtcctaaagtgtgtatttctcattttcagtgattttcagttttctcgccatattccaggtcctacagtgtgcatttctcattttttcacgtttttcagtgatttcgtcatttttcacgttgtcaagtggatgtttctcattttccattattttcacttttcttgccatatttcatgtcctacagtggacatttctaaattttccacctttttctgttttcctcgccatatttcacatcctaaagtgtgtatttctcattttccgtgattttcagttttcttgccatattccaggtcctacagtgtgcatttctcatttttcacgtttttcagtgatttcgtcatttttcaagtcgtcaagtggatgtttctcattttccatgattttcagttttctcgccatattccaggtcctacagttgacatttctaaattttccacattttttatgtttcctcgcgatatttcacatcctaaagtgtgtatttctcattttccgtgattttcagttttcttgccatattccaggtcctacagggtgcatttctcatttttcacgtttttcagtgatttcatcaatttcaagtcgtcaactgtatgtttctcattttcaatgattttcatttttcttgccatattccacgtcctatagtggacatttctacattttccacctttttcagttttcttcgccatatttcacgtcccaaagtgtgtatttctcattttccgtgattttcagtttcctcgccatattccaggtcctacagtgtgcatttctcatttttcacgtttttcagtgatttcgtcttttttcaagtcgtcaagtggatgtttctcattttccatgattttcagttttcttgccatattccatgtcctacagtggacatttctaaattttccacctttttctgttttcctcgccatatttcacgtcctaaagtgtgtatttctcatttaccgtgattttcagttttcttgctatattccaagtcctacagtgtgcatttctcatttttcacgtttttcactgattttgtcattgttcaagttgtcaactgcatgtttctcattttccatgattttcagttttcttgccatattccatgtcctacagtggaaatttctatattttccaactttttcagttttcctcgccatatttcacgtgctaaagtgtgtatttctcatttttcgtgtttttcaggtttctcgccatattccaggtcctacagtgtgcatttctcatttttcacgtttttcagtgattttgtaatttttcaagttgtcaagtggatgtttctcattttccttgattttcagttttcttgccatattccatgtcctactgtggacatttctaaattttccacctttttcagttttccttgccatatttcatgtcctaaagtgtgtatttctcattttcagtgattttcagttttctcgcaatattccaggtcctacagtgtgcatttctcattttttcaggtttttcagtgatttcgtcatttttcacgttgtcaagtggatgtttctcattttccatgattttcacttttcttgccatatttcatgtgctaaagtgtgtatttctcattttcagtgattttcagttttctgccatattccaggtcctacattgtgcatttctcattttttcacgtttttcagtgatttcgtcatttttcacgttgtcaagtggatgtttctcattttccatgattttcacttttcttgccatatttcatgttttacagtggacatttctaaattttccacctatttctgttttcctcgccatatttcacatcctaaagtgtgtatttctcattttccgtgattttcagttttctcgccatatgccaggtcatacagggtgcatttctcatttttcacgtttttcagtgatttcgtcatttttcacgtcgtcaagtggatgtttctcattttcaatgattttcatttttcttgccatattccacgtcctatagtggacatttctaaattttccacctttttcagttttccttgccatatttcaggtcctacagtgtgcatttctcttttttcacgtttttcagtgatttcgtcatttttcaagtggtcaagtgcatgtttctcattttccgtgattttcagttttcttgccatgttccaggtcctacagttgacgtttctaaaatttcactttttttaagttttcctcgccatatttcacttcctaaagtgtgtatttctcattttccgtgattttcagttttctcgccagattccaggtcctacagtgtgcatttttcatatttcacctttttcagtgattttgtcatttttcaagttgtcaactgcatgtttctcattttccatgattttcagttttcttgccatattccatgtcctactgtggacatttctaaattttccaactttttcagttttcctcgccatatttcatgtcctaaagtgtgtatttctcattttcagtgattttctgttttctcgccatattccaggtcctacagtgtgcatttctaatttttcacgtttttcagtgatttcgtcatttttcaagttgtcaagtggatgtttctcattttccatgattttcagttttcttgccatattccatgtcctacagtggacatttctaaattttccaactttttccattttcctcaccatatttcacgtcctaaagtgagtttttctcattttttgtgattttcagttttctcgacatattccaggtcctacagtgtgcatttctaattttttcttttttcagtgatttcgtcatttttcaagtggtcaagtgcatgtttctcattttccatgattttcagttttcttgccatattccatgtcctacaatggacatttctaaattttccaactttttcagttttcctcgccatatttcacgtcctaaagtgtgtatttctcattttccgtgattttcagttttctcgccatattccaggtcctacagtgtgcatttctcatttttcacgtttttcagtgatttcgtcatttttcaagttgtcaactgcatgtttctcattttccatgattttcagttttcttgccatattccatgtcttacagtggacatttttaaatttttcacatttttttaagttttcctccccatatttcacgttttaaagtgtgcatttctcattttcggtgattttcagttttctcgccagattccatgtcttacagtgtgcatttctcattttttcacgtttttcagtgatttcgtcatttttcaagtcgtcaagtggatgtttctcattttccatgattttcagttttcttgccatattccatgtcctacagtggaaatttctaaattttccacctttttcagttttccttgccatatttcaggtcctaaagtgtgtatttctcattttctgtgattttcagttttctcgccatattccaggtcctacagttgacatttctaaaatttccacattttttaagttttcctcgccatatttcacttcctaaagtgtgtatttctcattttccgtgattttcagttttctcgccatattccagatcctacagtgtacatttttcatttttcacgtttttcagtgattttgtcattttttagttgtcaactgcctgtttctcattttccatgattttcagttttcttgctatattccatgtcctacagtggaaatttctaaattttccacctttttcagttttcctcgccatatttcacgtcctaaagtgtgtatttctcattttccgtgattttcagttttctcgccatattccaggtcctatgtgtacatttctcatttttcacgtttttcagtgattttgtcatttttcaatttgtcaactgcatgtttctcattttccatgattttcagttttcttgccatattccatgtcctacagtggaaatttctatattttccaactttttcagttttcctcgccatatttcacgtgctaaagtgtgtatttctcatttttcgtgtttttcaggtttctcgccatattccaggtcctacagtgtgcatttctcatttttcacgtttttcagtgattttgtcatttttcaagttgtcaagtggatgtttctcattttccttgattttcagttttcttgccatattccatgtcctacagtggacatttctaaattttccacctttttcagttttccttgccatatttcatgtcctaaagtgtgtatttctcattttcagtgattttcagttttctcgccatattccaggtcctacagtgtgcatttctcattttttcaggtttttcagtgatttcgtcatttttcacgttgtcaagtggatgtttctcattttccatgattttcacttttcttgccatatttcatgtcctaaagtgtgtatttctcattttcagtgattttcagttttctcgctatattccaggtcctacagtgtgcatttctcattttttcacgtttttcagtgatttcgtcatttttcacgttgtcaagtggatgtttctcattttccatgattttcacttttcttgccatatttcatgtcctacaatggacatttctaaattttccacctttttctgttttcctcgccatatttcacatcctaaagtgtgtatttctcattttccgtgattttcagttttcttgccatattccaggtcctacagtgtgcatttctcatttttcacgtttttcagtgatttcgtcatttttcaagttgtcaagtggatgtttctcattttccttgattttcagttttcttgccatattccatgtcctactgtggacatttctaaattttccacctttttcagttttccttgccatatttcatgtcctaaagtgtgtatttctcattttcagtgattttcagttttctcgcaatattccaggtcctacagtgtgcatttctcattttttcaggtttttcagtgatttcgtcatttttcacgttgtcaagtggatgtttctcattttccatgattttcacttttcttgccatatttcatgtcctaaagtgtgtatttctcattttcagtgattttcagttttctgccatattccaggtcctacattgtgcatttctcattttttcacgtttttcagtgatttcgtcatttttcagttttctcgacatattccaggtcctacagtgtgcatttctaattttttcttttttcagtgatttcgtcatttttcaagttgtcaactgcatgtttctcattttccatgattttcagttttcttgccatattccatgtcttacagtggacatttttaaatttttcacatttttttaagttttcctccccatatttcacgttttaaagtgtgcatttctcattttcggtgattttcagttttctcgccagattccaggtcttacagtgtgcatttctcattttttcacgtttttcagtgatttcgtcatttttcaagtcgtcaagtggatgtttctcattttccatgattttcagttttcttgccatattccatgtcctacagtggaaatttctaaattttccacctttttcagttttccttgccatatttcaggtcctaaagtgtgtatttctcattttctgtgattttcagttttctcgccatattccaggtcctacagttgacatttctaaaatttccacattttttaagttttcctcgccatatttcacttcctaaagtgtgtatttctcattttccgtgattttcagttttctcgccatattccagatcctacagtgtgcatttttcatttttcacgtttttcagtgattttgtcattttttagttgtcaactgtctgtttctcattttccatgattttcagttttcttgccatattccatgtcctacactggacatttctaaattttccacctttttctgttttcctcgccatatttcacgtcctaaagtgtgtatttctcattttccgtgattttcagttttcttgccatattccaggtcctacagtgtgcatttctcatttttcacgtttttcagtgattttgtcatttttcaagttgtcaactgcatgtttctcattttctatgattttcagttttcttgctatattccatgtcctacagtggaaatttctaaattttccacctttttcagttttcctcgccatatttcacgtcctaaagtgtgtatttctcattttccgtgattttcagttttctcgccatattccaggtcctatgtgtacatttctcatttttcacgtttttcagtgattttgtcatttttcaagttgtgaagtggatgtttctcatttttcttgattttcatttttcttgccatattccatgtcctagagtggaaatttttaaattttccacctttttcagttttcctcgccatatttcacgtcctaaagtgtgaatttctcattttccgtgattttcagatttctcgccatattccaagtcctacagtgtgcatttctcatttttcacgtttttcagtgatttcgtcatttttcaagttgtcaagtggatgtttctcattttccatgattttcagctttcttgccatattcaaagtcctacagtggacatttctaaattttcgacctttatcagttttcctcgccatatttcatgtcccaaagtgtgtacttctcattttccgtgattttcagtttcctagccatattctaggtcctacagtgtgcatttctcatttttcaggtttttcagtgatttcgtcttttttcaagtcgtcaagtggatgtttctcattttccatgattttcacttttcttgccatatttcatgtcctaaagtgtgtatttctcattttcagtgattttcagttttctcgctatattccaggtcctacagtgtgcatttctcattttttcacgtttttcagtgatttcgtcatttttcacgttgtcaagtggatgtttctcattttccatgattttcacttttcttgccatatttcatgtcctacagtggacatttctaaattttccacctttttctgttttcctcgccatatttcacatcctaaagtgtgtatttctcattttccgtgattttcagttttcttgccatattccaggtcctacagtgtgcatttctcatttttcacgtttttcagtgatttcgtcatttttcaagttgtcaagtggatgtttctcattttccttgattttcagttttcttgccatattccatgtcctactgtggacatttctaaattttccacctttttcagttttccttgccatatttcatgtcctaaagtgtgtatttctcattttcagtgattttcagttttctcgcaatattccaggtcctacagtgtgcatttctcattttttcaggtttttcagtgatttcgtcatttttcacgttgtcaagtggatgtttctcattttccatgattttcacttttcttgccatatttcatgtcctaaagtgtgtatttctcattttcagtgattttcagttttctgccatattccaggtcctacattgtgcatttctcattttttcacgtttttcagtgatttcgtcatttttcacgttgtcaagtggatgtttctcattttccatgattttcacttttcttgccatatttcatgttttacagtggacatttctaaattttccacctttttctgttttcctcgccatatttcacatcctaaagtgtgtatttctcattttccgtgattttcagttttctcgccatatgccaggtcatacagggtgcatttctcatttttcacgtttttcagtgatttcgtcatttttcacgtcgtcaagtggatgtttctcattttcaatgattttcatttttcttgccatattccacgtcctatagtggacatttctaaattttccacctttttcagttttccttgccatatttcaggtcctacagtgtgcatttctcatttttcacgtttttcagtgatttcgtcatttttcaagtggtcaagtgcatgtttctcattttccgtgattttcagttttcttgccatgttccaggtcctacagttgacgtttctaaaatttcactttttttaagttttcctcgccatatttcacttcctaaagtgtgtatttctcattttccgtgattttcagttttctcgccagattccaggtcctacagtgtgcatttttcatatttcacctttttcagtgattttgtcatttttcaagttgtcaactgcatgtttctcattttccatgattttcagttttcttgccatattccatgtcctactgtggacatttctaaattttccaactttttcagttttcctcgccatatttcatgtcctaaagtgtgtatttctcattttcagtgattttctgttttctcgccatattccaggtcctacagtgtgcatttctaatttttcacgtttttcagtgatttcgtcatttttcaagttgtcaagtggatgtttctcattttccatgattttcagttttcttgccatattccatgtcctacagtggacatttctaaattttccaactttttccattttcctcaccatatttcacgtcctaaagtgtgtttttctcattttttgtgattttcagttttctcgacatattccaggtcctacagtgtgcatttctaattttttcttttttcagtgatttcgtcatttttcaagttgtcaactgcatgtttctcattttccatgattttcagttttcttgccatattccatgtcttacagtggacatttttaaatttttcacatttttttaagttttcctccccatatttcacgttttaaagtgtgcatttctcattttcggtgattttcagttttctcgccagattccaggtcttacagtgtgcatttctcattttttcacgtttttcagtgatttcgtcatttttcaagtcgtcaagtggatgtttctcattttccatgattttcagttttcttgccatattccatgtcctacagtggaaatttctaaattttccacctttttcagttttccttgccatatttcaggtcctaaagtgtgtatttctcattttctgtgattttcagttttctcgccatattccaggtcctacagttgacatttctaaaatttccacattttttaagttttcctcgccatatttcacttcctaaagtgtgtatttctcattttccgtgattttcagttttctcgccatattccagatcctacagtgtgcatttttcatttttcacgtttttcagtgattttgtcattttttagttgtcaactgtctgtttctcattttccatgattttcagttttcttgccatattccatgtcctacactggacatttctaaattttccacctttttctgttttcctcgccatatttcacgtcctaaagtgtgtatttctcattttccgtgattttcagttttcttgccatattccaggtcctacagtgtgcatttctcatttttcacgtttttcagtgattttgtcatttttcaagttgtcaactgcatgtttctcattttccatgattttcagttttcttgctatattccatgtcctacagtggaaatttctaaattttccacctttttcagttttcctcgccatatttcacgtcctaaagtgtgtatttctcattttccgtgattttcagttttctcgccatattccaggtcctatgtgtacatttctcatttttcacgtttttcagtgattttgtcatttttcaagttgtgaagtggatgtttctcatttttcttgattttcatttttcttgccatattccatgtcctagagtggaaatttttaaattttccacctttttcagttttcctcgccatatttcacgtcctaaagtgtgaatttctcattttccgtgattttcagatttctcgccatattccaagtcctacagtgtgcatttctcatttttcacgtttttcagtgatttcgtcatttttcaagttgtcaagtggatgtttctcattttccatgattttcagctttcttgccatattcaaagtcctacagtggacatttctaaattttcgacctttatcagttttcctcgccatatttcatgtcccaaagtgtgtacttctcattttccgtgattttcagtttcctcgccatattctaggtcctacagtgtgcatttctcatttttcaggtttttcagtgatttcgtcttttttcaagtcgtcaagtggatgtttctcattttccatgattttcagttttcttgccatattccatgtcctacagtggacatttctaaattttccacctttttcagttttcctcgccatatttcatgtcctaaagtgtgtatttctcattttcagtgattttcagttttctcgccatattccaggtcctacagtgtgcatttctcatttttcacgtttttcagtgatttcgtcatttttcaagttgtcaagtggatgtttctcattttccatgattttcagttttcttgccatattccatgtcccacagtggacatttctaaattttccacctttttctgttttccttgccatatttcatgtcctaaagtgtgtatttctcattttccgtgattttcagttttcttgctatattccaagtcctacagtgtgcatttctcatttttcacgtttttcagtgattttgtcatttttcaatttgtcaactgcatgtttctcattttccatgattttcagttttcttgccatattccatgtcctacagtggaaatttctatattttccaactttttcagttttcctcgccatatttcacgtgctaaagtgtgtatttctcatttttcgtgtttttcaggtttctcgccatattccaggtcctacagtgtgcatttctcatttttcacgtttttcagtgattttgtcatttttcaagttgtcaagtggatgtttctcattttccttgattttcagttttcttgccatattccatgtcctacagtggacatttctaaattttccacctttttcagttttccttgccatatttcatgtcctaaagtgtgtatttctcattttcagtgattttcagttttctcgccatattccaggtcctacagtgtgcatttctcattttttcaggtttttcagtgatttcgtcatttttcacgttgtcaagtggatgtttctcattttccatgattttcacttttcttgccatatttcatgtcctaaagtgtgtatttctcattttcagtgattttcagttttctcgctatattccaggtcctacagtgtgcatttctcattttttcacgtttttcagtgatttcgtcatttttcacgttgtcaagtggatgtttctcattttccatgattttcacttttcttgccatatttcatgtcctacagtggacatttctaaattttccacctttttctgttttcctcgccatatttcacatactaaagtgtgtatttctcattttccttgattttcagttttcttgccatattccaggtcctacagtgtgcatttctcatttttcacgtttttcagtgatttcgtcatttttcaagtcgtcaagtggatgtttctcattttccatgattttcagttttctcgccatattccaggtcctacagttgacatttctaaattttccacattttttaagtttcctcgcgatatttcacatcctaaagtgtgtatttctcattttccgtgattttcagttttcttgccatattccaggtcctacagggtgcatttctcatttttcacgtttttcagtgatttcatcaatttcaagtcgtcaactgtatgtttctcattttcaatgattttcatttttcttgccatattccatgtcctacagtggacatttctaaatttttcacctttttcagttttccttgccatatttcatgtcctaaagtgtgtatttctcattttcagtgattttcagttttctcgccatattccaggtcctacagtgtgcatttctcattttttcaggtttttcagtgatttcgtcatttttcacgttgtcaagtggatgtttctcattttccatgattttcacttttcttgccatatttcatgtcctaaagtgtgtatttctcattttcagtgattttcagttttctcgccatattccaggtcctacagtgtgcatttctcatttttcacgtttttcagtgatttcgtcatttttcaagttgtcaagtggatgtttctcattttccatgattttcacttttcttgccatattccatgtcccacagtggacatttctaaattttccacctttttctgttttcctcgccatatttcatgtcctaaagtgtgtatttctcattttccgtgattttcagttttcttgctatattccaagtcctacagtgtgcatttctcatttttcacgtttttcagtgattttgtcatttttcaatttgtcaactgcatgtttctcattttccatgattttcagttttcttgccatattccatgttctacagtggaaatttctatattttccaactttttcagttttcctcgccatatttcacgtgctaaagtgtgtatttctcatttttcgtgtttttcaggtttctcgccatattccaggtcctacagtgtgcatttctcatttttcacgtttttcagtgattttgtcatttttcaagttgtcaagtggatgtttctcattttccttgattttcagttttcttgccatattccatgtcctacagtggacatttctaaattttccacctttttcagttttccttgccatatttcatgtcctaaagtgtgtatttctcattttcagtgattttcagttttctcgccatattccaggtcctacagtgtgcatttctcattttttcaggtttttcagtgatttcgtcatttttcacgttgtcaagtggatgtttctcattttccatgattttcacttttcttgccatatttcatgtcctaaagtgtgtatttctcattttcagtgattttcagttttctcgctatattccaggtcctacagtgtgcatttctcattttttcacgttttgcagtgatttcgtcatttttcacgttgtcaagtggatgtttctcattttccatgattttcacttttcttgccatatttcatgtcctacagtggacatttctaaattttccacctttttctgttttcctcgccatatttcacatcctaaagtgtgtatttctcattttccgtgattttcagttttcttgccatattccaggtcctacagtgtgcatttctcatttttcacgtttttcagtgatttcgtcatttttcaagtcgtcaagtggatgtttctcattttccatgattttcagttttctcgccatattccaggtcctacagttgacatttctaaattttccacattttttaagtttcctcgcgatatttcacatcctaaagtgtgtatttctcattttccgtgattttcagttttcttgccatattccaggtcctacagggtgcatttctcatttttcacgtttttcagtgatttcatcaatttcaagtcgtcaactgtatgtttctcattttcaatgattttcatttttcttgccatattccatgtcctacagtggacatttctaaattttccacctttttcagttttccttgccatatttcatgtcctaaagtgtgtatttctcattttcagggattttcagttttctcgccatattccaggtcctacagtgtgcatttctcattttttcaggtttttcagtgatttcgtcatttttcacgttgtcaagtggatgtttctcattttccatgattttcacttttcttgccatatttcatgtcctaaagtgtgtatttctcattttcagtgattttcagttttctcgccatattccaggtcctacagtgtgcatttctcattttttcacgtttttcagtgatttcgtcatttttcacgttgtcaagtggatgtttctcattttccatgattttcacttttcttgccatatttcatgtcctacagtggacatttctaaattttccacctttttctgttttcctcgccatatttcacatcctaaagtgtgtatttctcattttccgtgattttcagttttcttgccatattccaggtcctacagtgtgcatttctcatttttcacgtttttcagtgatttcgtcatttttcaagtcgtcaagtggatgtttctcattttccatgattttcagttttctcgccatattccaggtcctacagttgacatttctaaattttccacattttttaagtttcctcgcgatatttcacatcctaaagtgtgtatttctcattttccgtgattttcagttttcttgccatattccaggtcctacagggtgcatttctcatttttcacgtttttcagtgatttcatcaatttcaagtcgtcaactgtatgtttctcattttcaatgattttcatttttcttgccatattccacgtcctatagtggacatttctaaattttccacctttttcagttttcttcgccatatttcacgtcccaaagtgtgtatttctcattttccgtgattttcagtttcctcgcaatattccaggtcctacagtgtgcatttctcatttttcacgtttttcagtgatttcgtcttttttcaagtcgtcaagtggatgtttctcattttccatgattttcagttttcttgccatattccatgtcctacagtggacatttctaaattttccacctttttctgttttcctcgccatatttcacgtcctaaagtgtgtatttctcattttccgtgattttcagttttcttgccatattccaggtcctacagtgtgcatttctcatttttcacgtttttcactgattttgtcattgttcaagttgtcaactgcatgtttctcattttccatgattttcaattttcttgccatattccatgtcctacagtggaaatttctatattttccaactttttcagttttcctcgccatatttcacgtgctaaagtgtgtatttctcatttttcgtgtttttcaggtttctcgccatattccaggtcctacagtgtgcatttctcatttttcacgtttttcagtgattttgtcatttttcaagttgtcaagtggttgtttctcattttccttgattttcagttttcttgccatattccatgtcctactgtggacatttctaaattttccacctttttcagttttccttgccatatttcatgtcctaaagtgtgtatttctcattttcagtgattttcagttttctcgcaatattccaggtcctacagtgtgcatttctcattttccgtgattttcagttttctcgccatatgccaggtcatacagggtgcatttctcatttttcacgtttttcagtgatttcgtcatttttcacgtcgtcaagtggatgtttctcattttcaatgattttcatttttcttgccatattccacgtcctatagtggacatttctaaattttccaactttttcagttttcttgccatatttcaggtcctacagtgtgcatttctcatttttcacgtttttcagtgatttcgtcatttttcaagtggtcaagtgcatgtttctgattttccgtgattttcagttttcttgccatgttccaggtcctacagttgacgtttctaaaatttcactttttttaagttttcctcgccatatttcacttcctaaagtgtgtatttctcattttccgtgattttcagttttctcgccagattccaggtcctacagtgtgcatttttcatatttcacctttttcagtgattttgtcatttttcaagttgtcaactgcatgtttctcattttccatgattttcagttttcttgccatattccatgtcctactgtggacatttctaaattttccaactttttcagttttcctcgccatatttcatgtcctaaagtgtgtatttctcattttcagtgtttttctgttttctcgccatattccaggtcctacagtgtgcatttctaatttttcacgtttttcagtgatttcgtcatttttcaagttgtcaagtggatgtttctcattttccatgattttcagttttcttgccatattccatgtcctacagtggacatttctaaattttccaactttttccattttcctcaccatatttcacgtcctaaagtgtgtttttctcattttttgtgattttcagttttctcgacatattccaggtcctacagtgtgcatttctaattttttcttttttcagtgatttcgtcatttttcaagtggtcaagtgcatgtttctcattttccatgattttcagttttcttgccatattccatgtcctacaatggacatttctaaattttccaactttttcagttttcctcgccatatttcacgtcctaaagtgtgtatttctcattttccgtgattttcagttttctcgccatattccaggtcctatgtgtacatttctcatttttcacgtttttcagtgattttgtcatttttcaagttgtgaagtggatgtttctcatttttcttgattttcatttttcttgccatattccatgtcctagagtggaaatttttaaattttccaactttttcagttttcctcgccatatttcacgtcctaaagtgtgtatttctcattttccgtgattttcagttttctcgccatattccaagtcctacagtgtgcatttctcatttttcacgtttttcagtgatttcgtcatttttcaagttgtcaagtggatgtttctcattttccatgattttcagctttcttgccatattcaaagtcctacagtggacatttctaaattttcgacctttatcagttttcctcgccatatttcatgtcccaaagtgtgtacttctcattttccgtgattttcagtttcctcgccatattctaggtcctacagtgtgcatttctcatttttcaggtttttcagtgatttcgtcttttttcaagtcgtcaagtggatgtttctcattttccatgattttcagttttcttgccatattccatgtcctacagtggacatttctaaattttccacctttttcagttttcctcgccatatttcatgtcctaaagtgtgtatttctcattttcagtgattttcagttttctcgccatattccaggtcctacagtgtgcatttctcatttttcacgtttttcagtgatttcgtcatttttcaagttgtcaagtggatgtttctcattttccatgattttcagttttcttgccatattccatgtcccacagtggacatttctaaattttccacctttttctgttttccttgccatatttcatgtcctaaagtgtgtatttctcattttccgtgattttcagttttcttgctatattccaagtcctacagtgtgcatttctcatttttcacgtttttaagtgattttgtcatttttcaatttgtcaactgcatgtttctcattttccatgattttcagttttcttgccatattccatgtcctacagtggaaatttctatattttccaactttttcagttttcctcgccatatttcacgtgctaaagtgtgtatttctcatttttcgtgtttttcaggtttctcgccatattccaggtcctacagtgtgcatttctcatttttcacgtttttcagtgattttgtcatttttcaagttgtcaagtggatgtttctcattttccttgattttcagttttcttgccatattccatgtcctacagtggacatttctaaattttccacctttttcagttttccttgccatatttcatgtcctaaagtgtgtatttctcattttcagtgattttcagttttctcgccatattccaggtcctacagtgtgcatttctcattttttcaggtttttcagtgatttcgtcatttttcacgttgtcaagtggatgtttctcattttccatgattttcacttttcttgccatatttcatgtcctaaagtgtgtatttctcattttcagtgattttcagttttctcgccatattccaggtcctacagtgtgcatttctcattttttcacgtttttcagtgatttcgtcatttttcacgttgtcaagtggatgtttctcattttccatgattttcacttttcttgccatatttcatgtcctacagtggacatttctaaattttccacctttttctgttttcctcgccatatttcacatcctaaagtgtgtatttctcattttccgtgattttcagttttcttgccatatttcaggtcctacagtgtgcatttctcatttttcacgtttttcagtgatttcgtcatttttcaagtcgtcaagaggatgtttctcattttccatgattttcagttttctcgccatattccaggtcctacagttgacatttctaaattttccacattttttaagtttcctcgcgatatttcacatcctaaagtgtgtatttctcattttccgtgattttcagttttcttgccatattccaggtcctacagggtgcatttctcatttttcacgtttttcagtgatttcatcaatttcaagtcgtcaactgtatgtttctcattttcaatgattttcatttttcttgccatattccacgtcctatagtggacatttctaaattttccacctttttctgttttcctcgccatatttcacgtcctaaagtgtgtatttctcattttccgtgattttcagttttcttgccatattccaggtcctacagtgtgcatttctcatttttcacgtttttcactgattttgtcattgttcaagttgtcaactgcatgtttctcattttccatgattttcagttttcttgccatattccatgtcctacagtggaaatttctatattttccacctttttcagttttcctcgccgtatttcatgtgctaaagtgtgtatttctcatttttcgtgtttttcaggtttctcgccatattccaggtcctacagtgtgcatttctcatttttcacgtttttcagtgattttgtcatttttcaagttgtcaactggatgtttctcattttccttgattttcagttttcttgccatattccatgtcctactgtggacatttctaaattttccacctttttcagttttccttgccatatttcatgtcctaaagtgtgtatttctcattttcagtgattttcagttttctcgcaatattccaggtcctacagtgtgcatttctcattttttcaggtttttcagtgatttcgtcatttttcacgttgtcaagtggatgtttctcattttccatgattttcacttttcttgccatatttcatgtcctaaagtgtgtatttctcattttcagtgattttcagttttctcgccatattccaggtcctacattgtgcatttctcattttttcacgtttttcagtgatttcgtcatttttcacgttgtcaagtggatgtttctcattttccatgattttcacttttcttgccatatttcatgttttacagtggacatttctaaattttccacctttttctgttttcctcgccatatttcacatcctaaagtgtgaatttctcattttccgtgattttcagttttcttgccatattccaggtcctacagtgtgcatttctcatttttcacgtttttcagtgatttcatcatttttcaagtcgtcaagtggatgtttctcattttccatgattttcagttttcttgccatattccatgtcctacagtggacatttctaaattttccacctttttctgttttcctcgccatatttcacgtcctaaagtgtgtatttctcattttccgtgattttcagttttcttgccatattccaggtcctacagtgtgcatttctcatttttcacgtttttcactgattttgtcatttttcaagttgtcaactgcatgtttctcattttccatgattttcagttttcttgctatattccatgtcctacagtggaaatttctaaattttccacctttttcagttttcctcgccatatttcacgtcctgaagtgtgtatttctcattttccgtgattttcagttttctcgccatattccaggtcctatgtgtacatttctcatttttcacgtttttcagtgattttgtcatttttcaagttgtgaagtggatgtttctcatttttcttgattttcatttttcttgccatattccatgtcctacagtggaaatttctaaattttccacctttttcagttttcctcgccatatttcacgtcctaaagtgtgtatttctcattttccgtgattttcagttttctcgccatattccaggtcctacagtgtgcatttctcatttttcacgtttttcagtgatttcgacatttttcaagttgtcaagtggatgtttctcattttccatgattttcagctttcttgccatattcaaagtcctacagtggacatttctaaattttcgacctttatcagttttcctcgccatatttcatgtcccaaagtgtgtacttctcattttccgtgattttcagtttcctcgccatattccaggtcctacagtgtgcatttctcatttttcacgtttttcagtgatttcgtcatttttcaagtcgtcaagtggatgtttctcattttccatgattttcagttttcttgccatattccatgtcctacagtggacatttctaaattttccacctttttctgttttcctcgccatatttcacgtcctaaagtgtgtatttctcattttccgtgattttcagttttcttgccatattccaggtcctacagtgtgcatttctcatttatcacgtttttcactgattttgtcatttttcaagttgtcaactgcatgtttctcattttccatgattttcagttttcttgctatattccatgtcctacagtggaatattctaaattttccacctttttcagttttcctcgccatatttcacgtcctgaagtgtgtatttctcattttccgtgattttcagttttctcgccatattccaggtcctatgtgtacatttctcatttttcacgtttttcagtgattttgtcatttttcaagttgtgaagtggatgtttctcatttttcttgattttcatttttcttgccatattccatgtcctacagtggaaatttctaaattttccacctttttcagttttcctcgccatatttcacgtcctaaagtgtgaatttctcattttccgtgattttcagttttctcgccatattccaggtcctacagtgtgcatttctcatttttcacgtttttcagtgatttcgacatttttcaagttgtcaagtggatgtttctcattttccatgattttcagctttcttgccatattcaaagtcctacagtggacatttctaaattttcgacctttatcagttttcctcgccatatttcatgtcccaaagtgtgtacttctcattttccgtgattttgagtttcctcgccatattccaggtcctacagtgtgcatttctcatttttcacgtttttcagtgatttcgtcttttttcaagttgtcaactgcatgtttctcattttccatgattttcagttttcttgccatattccatgtcctacagtggaaatttgtaaatttccacctttttcagttttcctcgccatatttcacgtcctaaagtatgtatttctcattttccgtgattttcagttttctcgccatattccaggtcctacagtgtgcatttctcatttttcacgtttttcagtgattttgtcattttttaagttttcaagtggatgtttctcattttccttgattttcagttttcttgccatattccatgtcctacagtggacatttctaaattttccacctttttcagttttcctcgccatatttcatgtcctaaagtgtgtatttctcattttcagtgattttcagttttctcgccatattccaggtcctacagtgtgcatttctcatttttcacgtttttcagtgatttcgtcatttttcaaggtgtcaagtggatgtttctcattttccatgattttcagttttcttgccatattccatgtcctacagtggacatttctaaattttccacctttttctgttttcctcgccatatttcatgtcctaaagtgtgtatttctcattttccgtgattttcagttttcttgctatattccaagtcctacagtgtgcatttctcatttttcacgtttttcagtgattttgtcatttttcaatttgtcaactgcatgtttctcattttccatgattttcagtttttttgccatattccatgtcctactgtggaaatttctatattttccacctttttcagttttcctcgccatatttcacgtgctaaagtgtgtatttctcatttttcgtgtttttcaggtttctcgccatattccaggtcctacagtgtgcatttctcatttttcacgtttttcagtgattttgtcatttttcaagttttcaagtggatgtttctcattttccttgattttcagttttcttgccatattccatgtcctacagtggacatttctaaattttccacctttttcagttttccttgccatatttcatgtcctaaagtgtgtatttctcattttcagtgattttcagtttccttgccatattccaggtcctacagtgtgcatttctcattttttcacgtttttcagtgatttcgtcatttttcacgttgtcaagtggatgtttctcattttccatgattttcacttttcttgccatatttcatgtcctacagtggacatttctaaattttccaactttttcaattttcctcgccatattttatgtcctaaagtgtgtatttctcatttttcgttattttcagttttcttgccatattccaggtcctacagtgtgcatttgtcatttttcacgtttttcagtgatttcgtcatttttcaagtcgtcaagtagatgtttctcatattccatgtttttcagttttctcgccatattccaggtcctacagttgacatttctaaattttctacatttttaaattttcctcgccatatttcacgtcctaaagtgtgtatttctcattttttgttattttcagttttctagccatattccaggtcctacaggatgcatttctcatttttcacgtttttcagtgatttcatcatttttcaagtcgtcaagtgtatgtttcttattttcaatgattttcatttttcttgccttattccacgtcctatagtggacatttctaaattttccacctttttcagtttttttcgccatatttcacgtcctaaagtgtgtatttctcattttctgtgattttcagttttctcaccatattccaggtcctacagtgtgcatttctcatttttcacgtttttcagtgatttcgtcatttttcaagttgtcaagtggaagtttctcattttccatgattttcagctttctagacatattccaggtcctacagtggacatttcctaattttcgacctttatcagttttcctcgtcatatttcacgtcccaaaatgtgtatttcttattttccatgattttcagtttcctcgccatattccaggtcctacagtgtgcaattctcatttttcacgtttttcagtgatttcgtcttttttcaagacgtcaagtggatgtttctcatttttcatgattttcagttttcttgccatattccatgtcctacagtggacatttctaaattttccacctttttctgttttcctcgccatatttcacgtcctaaagtgtgtatttctcattttccgtgattttcagttttcttgccatattcctggtcctacagtgtgcatttctcatttttcacgtttttcagtgattttgtcatttttcaatttgtcaactgcatgtttctcattttccattattttcagttttcttgccatattccatgtcctacagtggacatttctaaattttccacctttttctgttttcctcgccatatttcatgtcctaaagtgtgtatttctcattttccgtgattttcagttttcttgctatattccaagtcctacagtgtgcatttctcatttttcacgtttttcagtgattttgtcatttttcaatttgtcaactgcatgtttctcattttccatgattttcagtttttttgccatattccatgtcctacaggggaaatttctatattttccacctttttcagttttcctcgccatatttcatgtcctaaagtgtgtatttctcattttccgtgattttcagttttcttgccatattccaggtcctacagtgtgcatttctcatttttcacgtttttcagtgatttcgtcatttttcaagtcttcaagtagatgtttctcatattccatgtttttcagttttctcgccatattccaggtcctacagttgacatttctaaattttctacatttttaaattttcctcgccatatttcacgtcctaaagtgtgtatttctcatttttcgttattttcagttttctagccatattccaggtcctacaggatgcatttctcatttttcacgtttttcagtgatttcatcatttttcaagtcgtcaagtgtatgtttctcattttcaatgattttcatttttcttgccttattccacgtcctatagtggacatttctaaattttccacctttttcagtttttctcgccatatttcacgtcctaaagtgtgtatttctcattttctgtgattttcagttttctcaccatattccaggtcctacagtgtgcatttctcatttttcacgtttttcagtgatttcgtcatttttcaagttgtcaagtggaagtttctcattttccatgattttcagctttctagccatattccaggtcctacagtggacatttcctaattttcgacctttatcagttttcctcgccatatttcacgtcctaaagtgtgtatttctcattttccgtgattttcagttttcttgccatattccaggtcctacagtgtgcatttctcatttttcacgtttttcagtgattttgtcatttttcaatttgtcaactgcatgtttctcattttccatgatttttagttttcttgctatattccatgtcctacagtggaaatttctaaattttccacctttttcagttttcctcgccatatttcacgtcctaaagtgtgtatttctcattttccgtgattttcagttttcttgctatattccaagtcctacattgtgcatttctcatttttcacgtttttcagtgattttgtcatttttcaatttgtcaaaccacatgtttctcattttccatgattttcagtttttttgccatattccatgtcctacagtggaaatttctatattttccacctttttcagttttcctcgccatatttcacgtgctaaagtgtgtatttctcatttttcgtgtttttcaggtttctcgccatattccaggtcctacagtgtgcatttctcatttttcacgtttttcagtgattttgtcatttttcaagttgtcaagtggatgtttcccattttccttgattttcagttttcttaccatattccatgtcctacagtggacatttctaaattttccacctttttcagttttccttgccatatttcatgtcctaaagtgtgtatttctcattttcagtgattttcagtttcctcgccatattccaggtcctacagtgtgcatttctcattttttcacgtttttcagtgatttcgtcatttttcacgttgtcaagtggatgtttctcattttccatgattttcacttttcttgccatatttcatgtcctatagtggacatttctaaattttccacctttttcagtttttctcgccatatttcacgtcctaaagtgtgtatttctcattttctgtgattttcagttttctcaccatattccaggtcctacagtgtgcatttctcatttttcacgtttttcagtgatttcgtcatttttcaagtcgtcaagtagatgtttctcatattccatgtttttcagttttctcgccatattccaggtcctacagttgacatttctaaattttctacatttttaaattttcctcgccatatttcacgtcctaaagtgtgtatttctcatttttcgttattttcagttttctagccatattccaggtcctacaggatgcatttctcatttttcacgtttttcagtgatttcatcatttttcaagtcgtcaagtgtatgtttcttattttcaatgattttcatttttcttgccttattccacgtcctatagtggacatttctaaattttccaccttttttcagtttttctcgccatatttcacgtcctaaagtgtgtatttctcattttctgtgattatcagttttctcaccatattccaggtcctacagtgtgcatttctcatttttcacgtttttcagtgatttcgtcatttttcaagttgtcaagtggaagtttctcattttccatgattttcagctttctagccatattccaggtcctacagtggacatttcctaattttcgacctttatcagttttcctcgccatatttcacgtcccaaaatgtgtatttcttattttccatgattttcagtttcctcgccatattccaggtcctacagtgtgcatttctcatttttcacgtttttcagtgatttcgtcttttttcaagacgtcaagtggatgtttctcatttttcatgattttcagttttcttgccatattccatgtcctacagtggacatttctaaattttccacctttttctgttttcctcgccatatttcacgtcctaaagtgtgtatttctcattttccgtgattttcagttttcttgccatattcctggtcctacagtgtgcatttctcatttttcacgtttttcagtgattttgtcatttttcaatttgtcaactgcatgtttctcattttccatgattttcagttttcttgccatattccatgtcctacagtggacatttctaaattttccacctttttcagttttcctcgccatatttcacgtgctaaagtgtgtatttctcatttttcgtgtttttcaggtttctcgccatattccaggtcctacagtgtgcatttctcatttttcacgtttttcagtgattttgtcatttttcaagttgtcaagtggatgtttctcattttccttgattttcacttttcttgccatattccaagtcttacaggggcatttctcatttttcacgttttcagtgattttgtcattttcaatttgtcaactgcatgtttctcattttccatgattttcagtttttttgccatattccatgtcctacaggggaaatttctatattttccacctttttcagttttcctcgccatatttcatgtcctaaagtgtgtatttctcattttccgtgattttcagttttcttgccatattccaggtcctacagtgtgcatttctcatttttcacgtttttcagtgatttcgtcatttttcaagtcttcaagtagatgtttctcatattccatgtttttcagttttctcgccatattccaggtcctacagttgacatttctaaattttctacatttttaaattttcctcgccatatttcacgtcctaaagtgtgtatttctcatttttcgttattttcagttttctagccatattccaggtcctacaggatgcatttctcatttttcacgtttttcagtgatttcatcatttttcaagtcgtcaagtgtatgtttctcattttcaatgattttcatttttcttgccttattccacgtcctatagtggacatttctaaattttccacctttttcagtttttctcgccatatttcacgtcctaaagtgtgtatttctcattttctgtgattttcagttttctcaccatattccaggtcctacagtgtgcatttctcatttttcacgtttttcagtgatttcgtcatttttcaagttgtcaagtggaagtttctcattttccatgattttcagctttctagccatattccaagtcctacagtggacatttcctaattttcgacctttatcagttttcctcgccatatttcacgtcccaaaatgtgtattccttattttccatgattttcagtttcctcgccatattccaggtcctacagtgtgcatttatcatttttcacgtttttcagtgatttcgtcttttttcaagacgtcaagtggatgtttctcatttttcatgattttcagttttcttgccatattccatgtcctacagtggacatttctaaattttccacctttttctgttttcctcgccatatttcacgtcctaaagtgtgtatttctcattttccgtgattttcagttttcttgccatattcctggtcctacagtgtgcatttctcatttttcacgtttttcagtgattttgtcatttttcaagttgtcaagtggatgtttctcattttccttgattttcacttttcttgccatattccatgtcctacagtggacatttctatattttccacctttttccgttttccttgccatatttcacgtcctaaagtgtgtatttctcattttccgtgattttcaggtttctcgccatattccaggtcctacagtgtgcatttctcatttttcacgtttttcagtgattttgtcatttttcaagttgtcaagtggatgtttctcattttccttgattttcacttttcttgccatattccatgtcctacagtggacatttctaaattttccacctttttcagttttcctcgccatatttcatgtcctaaagtgtgtatttctcattttcagtgattttcagttttcttgccatattccaggtcctacagtgtgcatttctcatttttcacgtttttcagtgattttgtcatttttcaagttgtcaactgcatgtttctcattttctatgattttcagttttcttgctatattccatgtcctacagtggaaatttctaaattttccacctttttcagttttcctcgccatatttcacgtcctaaagtgtgtatttctcattttccgtgattttcagttttctcgccatattccaggtcctatgtgtacatttctcatttttcacgtttttcagtgattttgtcatttttcaagttgtgaagtggatgtttctcatttttcttgattttcatttttcttgccatattccatgtcctagagtggaaatttttaaattttccacctttttcagttttcctcgccatatttcacgtcctaaagtgtgaatttctcattttccgtgattttcagatttctcgccatattccaagtcctacagtgtgcatttctcatttttcacgtttttcagtgatttcgtcatttttcaagttgtcaagtggatgtttctcattttccatgattttcagctttcttgccatattcaaagtcctacagtggacatttctaaattttcgacctttatcagttttcctcgccatatttcatgtcccaaagtgtgtacttctcattttccgtgattttcagtttcctcgccatattctaggtcctacagtgtgcatttctcatttttcaggtttttcagtgatttcgtcttttttcaagtcgtcaagtggatgtttctcattttccatgattttcacttttcttgccatatttcatgtcctaaagtgtgtatttctcattttcagtgattttcagttttctcgctatattccaggtcctacagtgtgcatttctcattttttcacgtttttcagtgatttcgtcatttttcacgttgtcaagtggatgtttctcattttccatgattttcacttttcttgccatatttcatgtcctacagtggacatttctaaattttccacctttttctgttttcctcgccatatttcacatcctaaagtgtgtatttctcattttccgtgattttcagttttcttgccatattccaggtcctacagtgtgcatttctcatttttcacgtttttcagtgatttcgtcatttttcaagttgtcaagtggatgtttctcattttccttgattttcagttttcttgccatattccatgtcctactgtggacatttctaaattttccacctttttcagttttccttgccatatttcatgtcctaaagtgtgtatttctcattttcagtgattttcagttttctcgcaatattccaggtcctacagtgtgcatttctcattttttcaggtttttcagtgatttcgtcatttttcacgttgtcaagtggatgtttctcattttccatgattttcacttttcttgccatatttcatgtcctaaagtgtgtatttctcattttcagtgattttcagttttcctcgccatatttcacgtcccaaaatgtgtatttcttattttccatgattttcagtttcctcgccatattccaggtcctacagtgtgcatttctcatttttcacgtttttcagtgatttcgtcttttttcaagacgtcaagtggatgtttctcatttttcatgattttcagttttcttgccatattccatgtcctacagtggacatttctaaattttccacctttttctgttttcctcgccatatttcacgtcctaaagtgtgtatttctcattttccgtgattttcagttttcttgccatattcctggtcctacagtgtgcatttctcatttttcacgtttttcagtgattttgtcatttttcaatttgtcaactgcatgtttctcattttccatgattttcagttttcttgccatattccatgtcctacagtggacatttctaaattttccacctttttcagttttcctcgccatatttcacgtgctaaagtgtgtatttctcatttttcgtgtttttcaggtttctcgccatattccaggtcctacagtgtgcatttctcatttttcacgtttttcagtgattttgtcatttttcaagttgtcaagtggatgtttctcattttccttgattttcacttttcttgccatattccatgtcctacagtggacatttctaaattttccacctttttcagttttcctcgccatatttcatgtcctaaagtgtgtatttctcattttcagtgattttcagttttctcgccatattccaggtcctacagtgtgcatttctcatttttcacgtttttcagtgatttcgtcttttttcaagacgtcaagtggatgtttctcattttccatgattttcagttttcttgccatattccatgtcctacagtggacatttctaaattttccacctttttctgttttcctcgccatatttcacgtcctaaagtgtgtatttctcattttccgtgattttcagttttcttgccatattccaggtcctacagtgtgcatttctcatttttcacgtttttcagtgattttgtcatttttcaatttgtcaactgcatgtttctcattttccatgatttttagttttcttgctatattccatgtcctacagtggaaatttctaaattttccacctttttcagttttcctcgccatatttcacgtcctaaagtgtgtatttctcattttccgtgattttcagttttcttgctatattccaagtcctacattgtgcatttctcatttttcacgtttttcagtgattttgtcatttttcaatttgtcaaaccacatgtttctcattttccatgattttcagtttttttgccatattccatgtcctacagtggaaatttctatattttccacctttttcagttttcctcgccatatttcacgtgctaaagtgtgtatttctcatttttcgtgtttttcaggtttctcgccatattccaggtcctacagtgtgcatttctcatttttcacgtttttctgtgattttgtcatttttcaagttgtcaagtggatgtttctcattttccttgattttcagttttcttaccatattccatgtcctacagtggacatttctaaattttccaccttttctgttttcctcgccatatttcatgtcctaaagtgtgtatttctcattttccgtgattttcatttttcttgctatattccaagtcctacagtgtgcatttctcattttccatgattttcagttttcttgctatattccatgtcctacagtggaaatttctaaattttccacctttttcagttttcctcgccatatttcacgtcctaaagtgtgtatttctcattttccgtgattttcagttttttcgccatattacaggtcctatgtgtacatttctcatttttcacgtttttcagtgattttgtcatttttcaagttgtcaagtggatgtttctcatttttcttgattttcatttttcttgccatattccatgtcctacagtggaaatttctaaattttccacctttttcagttttcctcgccatatttcacgtcctaaagtgtgaatttctcattttccgtgattttcagttttctcgccatattccaggtctacagtgtgcatttctcatttttcacgttttcagtgattcgtcatttttcaagttgacaagtggatgtttctcattttccatgattttcagctttcttgccatattcaaagtcctacagtggacatttctaaattttcgacctttatcagttttcctcgccatatttcatgtcccaaagtgtgtacttctcattttccgtgattttcagttttcttgccatattccaagtcctacagtgtgcatttctcatttttcacgtttttcagtgattttgtcatttttcaatttgtcaactgcatgtttctcattttccatgattttcagttttcttgccatattccatgtcctacagtggaaatttctatattttccacctttttcagttttcctcgccatatttcacgtgctaaagtgtgtatttctcatttttcgtgtttttcaggtttctcgccatattccaggtcctacagtgtgcatttctcatttttcacgtttttcagtgattttgtcatttttcaagttgtcaagtggatgtttctcattttcaatgattttcatttttcttgccttattccacgtcctatagtggacatttctaaattttccacctttttcagtttttctcgccatatttcacgtcccaaaatgtgtattccttattttccatgattttcagtttcctcgccatattccaggtcctacagtgtgcatttctcatttttcacgtttttcagtgatttcgtcttttttcaagacgtcaagtggatgtttctcatttttcatgattttcagttttcttgccatattccctgtcctacagtggacatttctaaattttccacctttttctgttttcctcgccatatttcacgtcctaaagtgtgtatttctcattttccgtgattttcagttttctcgccagattccaggtcctacagtgtgcatttctcatttttcacgtttttcagtgattttgtcatttttcaatttgtcaactgcatgtttctctctttccatgattttcagttttcttgccatattccatgtcctacagtggacatttctaaattttccacctttttcagttttcctcgccatatttcacgtgctaaagtgtgtatttctcatttttcgtgtttttcaggtttctcgccatattccaggtcctacagtgtgcatttctcatttttcacgtttttcagtgattttgtcatttttcaagttgtcaagtggatgtttctcattttcaatgattttcatttttcttaccttattccacgtcctatagtggacatttctaaattttccacctttttcagtttttctcgccatatttcacgtcccaaaatgtgtattccttattttccatgattttcagtttcctcgccatattccaggtcctacagtgtgcatttctcatttttcacgtttttcagtgatttcgtcttttttcaagacgtcaagtggatgtttctcatttttcatgattttcagttttcttgccatattccctgtcctacagtggacatttctaaattttccacctttttctgttttcctcgccatatttcacgtcctaaagtgtgtatttctcattttccgtgattttcagttttctcgccagattccaggtcctacagtgtgcatttctcatttttcacgtttttcagtgatttcgtcatttttcaagtcttcaagtgtatgtttctcattttcaatgattttcatttttcttgccttattccacgtcctatagtggacatttctaaattttccacctttttcagtttttctcgccatatttcacgtcctaaagtgtgtatttctcattttctgtgattttcagttttcttaccatattccaggtcctacagtgtgcatttctcatttttcacgtttttcagtgatttcgtcatttttcaagttgtcaagtggaagtttctcattttccatgattttcagctttctagccatattccaggtattacagtggacatttccttattttcgacctttatcagttttcctcgccatatttcatgtcctaaagtgtgt	38399	1554	4%	7300	19%
9	3000001	3038400	Atcctacagtgtgcatttctcatttttcacgtttttcagtgatttcgtcatttttcaagtcatcaagtggctgtttctcattttccatgattttcagttttcttgccatattccttgtcctacagtggacatttctaaattttccacctttttcagttttccttgtcatatttcaggtcctacagtgtgtatttctcatttttcacgtttttcattgatttcgtcatttttcaagttgtcaagtgcatgtttctcattttccatgattttcagttttcttgccatattccatgtcctacaatggacatttctaaattttccaactttttcagttttcctcgccatatttcacgtcctaaagtgtgtatttctcattttccgtgattttcagttttctcgacatattccaggtcctacagtgtgcatttctcatttttcacgtttttcagtgatttcgtcatttttcacgtcgtcaagtggatgtttctcattttccatgattttcagttttcttgccatattccatgtcctacagtggacatttctaaattttccacctttttcagttttcctcgccatatttcacgtcctaaagtgtgtatttctcattttccgtgattttcagttttctcgacatattccaggtcttacagggtgcatttctcatttttcacgtttttcagtgatttcatcatttttcaagtcgtcaactgtatgtttctcattttcaatgattttcatttttcttgccatattccacgtcctatagtggacatttctaaattttccacctttttcagttttccttgccatatttcaggtcctacagtgtgcatttctcatttttcacgtttttcagtgatttcgtcatttttcaagtggtcaaatgcatgtttctcattttccatgattttcagttttcttgccatattccatgtcctacagtggacatttctaaattttccacctttttcagttttcctcgccatatttcacgtcctaaagtgtgtatttctcattttccgtgattttcagttttatcgccagattccaggtcctacggtgtgcatttttcatatttcacgtttttcagtgattttgtcatttttcaagttgtcaactgcatgtttctcattttccatgattttcagttttcttgccatattccatgtcctacagtggacatttctaaattttccacctttttcagttttcctcgccatatttcatgtcctaaagtgtgtatttctcattttcagtgattttctgttttctcgccatattccaggtcctacagtgtgcatttctcatttttcacgtttttcagtgatttcgtcatttttcaagttgtcaagtggatgtttctcattttccatgattttcagttttcttgccatattccatgtcctacaatggacatttctaaattttccacctttttcagttttcctcgccatatttcacgtcctaaagtgtgtatttctcattttccgtgattttcagttttctcgccatattccaggtcctatgtgtacatttctcatttttcacgtttttcagtgattttgtcatttttcaagttgtgaagtggatgtttctcatttttcttgattttcatttttcttgccatattccatgtcctagagtggaaatttttaaattttccacctttttcagttttcctcgccatatttcacgtcctaaagtgtgaatttctcattttccgtgattttcagttttctcgccatattccaagtcctacagtgtgcatttctcatttttcacgtttttcagtgatttcgtcatttttcaagttgtcaagtggatgtttctcattttccatgattttcagctttcttgccatattcaaagtcctacagtggacatttctaaattttcgacctttatcagttttcctcgccatatttcatgtcccaaagtgtgtacttctcattttccgtgattttcagtttcctcgccatattctaggtcctacagtgtgcatttctcatttttcaggtttttcagtgatttcgtcttttttcaagtcgtcaagtggatgtttctcattttccatgattttcagttttcttgccatattccatgtcctacagtggacatttctaaattttccaactttttcagttttcctcgccatatttcatgtcctaaagtgtgtatttctcattttcagtgattttcagttttctcgccatattccaggtcctacagtgtgcatttctcatttttcacgtttttcagtgatttcgtcatttttcaagttgtcaagtggatgtttctcatttttcatgattttcagttttcttgccatattccatgtcccacagtggacatttctaaatgttccacctttttctgttttccttgccatatttcatgtcctaaagtgtgtatttctcattttccgtgattttcagttttcttgctatattccaagtcctacagtgtgcatttctcatttttcacgtttttctgtgattttttcatttttcaatttgtcaactgcatgtttctcattttccatgattttcagttttcttgccatattccaggtcctacagtgtgcatttctcatttttcacgtttttcagtgattttgtcatttttcaagttgtcaactgcatgtttctcattttccatgattttcagttttcttgctatattccatgtcctacagtggaaatttctaaattttccacctttttcagttttcctcgccatatttcacgtcctaaagtgtgtatttctcattttccgtgattttcagttttctcgccatattccaggtcctatgtgtacatttctcatttttcacgtttttcagtgattttgtcatttttcaagttgtgaagtggatgtttctcatttttcttgattttcatttttcttgccatattccatgtcctagagtggaaatttttaaattttccacctttttcagttttcctcgccatatttcacgtcctaaattgtgaatttctcattttccgtgattttcagttttctcgccatattccaagtcctacagtgtgcatttctcatttttcacgtttttcagtgatttcgtcatttttcaagttgtcaagtggatgtttctcattttccatgattttcagctttcttgccatattcaaagtcctacagtggacatttctaaattttcgacctttatcagttttcctcgccatatttcatgtcccaaagtgtgtacttctcattttccgtgattttcagtttcctcgccatattctaggtcctacagtgtgcatttctcatttttcaggtttttcagtgatttcgtcttttttcaagtcgtcaagtggatgtttctcattttccatgattttcagttttcttgccatattccatgtcctacagtggacatttctaaattttccacctttttcagttttcctcgccatatttcatgtcctaaagtgtgtatttctcattttcagtgattttcagttttctcgccatattccaggtcctacagtgtgcatttctcatttttcacgtttttcagtgattttgtcatttttcaagttgtcaagtggatgtttctcattttccttgattttcagttttcttgccatattccatgtcctacagtggacatttctaaattttccacctttttcagttttccttgccatatttcatgtcctaaagtgtgtatttctcattttcagtgattttcagttttctcgccatattccaggtcctacagtgtgcatttctcattttttcaggtttttcagtgatttcgtcatttttcacgttgtcaagtggatgtttctcattttccatgattttcacttttcttgccatatttcatgtcctaaagtgtgtatttctcattttcagtgattttcagttttctcgccatattccaggtcctacagtgtgcatttctcattttttcacgtttttcagtgatttcgtcatttttcacgttgtcaagtggatgtttctcattttccattattttcacttttcttgccatatttcatgtcctacagtggacatttctaaattttccacctttttctgttttcctcgccatatttcacatcctaaagtgtgtatttctcattttccgtgattttcagttttcttgccatattccaggtcctacagtgtgcatttctcatttttcacgtttttcagtgatttcgtcatttttcaagtcgtcaagtggatgtttctcattttccatgattttcagttttctcgccatattccaggtcctacagttgacatttctaaattttccacattttttatgtttcctcgcgatatttcacatcctaaagtgtgtatttctcattttccgtgattttcagttttcttgccatattccaggtcctacagggtgcatttctcatttttcacgtttttcagtgatttcatcaatttcaagtcgtcaactgtatgtttctcattttcaatgattttcatttttcttgccatattccacgtcctatagtggacatttctacattttccacctttttcagttttcttcgccatatttcacgtcccaaagtgtgtatttctcattttccgtgattttcagtttcctcgccatattccaggtcctacagtgtgcatttctcatttttcacgtttttcagtgatttcgtcttttttcaagtcgtcaagtggatgtttctcattttccatgattttcagttttcttgccatattccatgtcctacagtggacatttctaaattttccacctttttctgttttcctcgccatatttcacgtcctaaagtgtgtatttctcatttaccgtgattttcagttttcttgctatattccaagtcctacagtgtgcatttctcatttttcacgtttttcactgattttgtcattgttcaagttgtcaactgcatgtttctcattttccatgattttcagttttcttgccatattccatgtcctacagtggaaatttctatattttccaactttttcagttttcctcgccatatttcacgtgctaaagtgtgtatttctcatttttcgtgtttttcaggtttctcgccatattccaggtcctacagtgtgcatttctcatttttcacgtttttcagtgattttgtaatttttcaagttgtcaagtggatgtttctcattttccttgattttcagttttcttgccatattccatgtcctactgtggacatttctaaattttccacctttttcagttttccttgccatatttcatgtcctaaagtgtgtatttctcattttcagtgattttcagttttctcgcaatattccaggtcctacagtgtgcatttctcattttttcaggtttttcagtgatttcgtcatttttcacgttgtcaagtggatgtttctcattttccatgattttcacttttcttgccatatttcatgtgctaaagtgtgtatttctcattttcagtgattttcagttttctgccatattccaggtcctacattgtgcatttctcattttttcacgtttttcagtgatttcgtcatttttcacgttgtcaagtggatgtttctcattttccatgattttcacttttcttgccatatttcatgttttacagtggacatttctaaattttccacctatttctgttttcctcgccatatttcacatcctaaagtgtgtatttctcattttccgtgattttcagttttctcgccatatgccaggtcatacagggtgcatttctcatttttcacgtttttcagtgatttcgtcatttttcacgtcgtcaagtggatgtttctcattttcaatgattttcatttttcttgccatattccacgtcctatagtggacatttctaaattttccacctttttcagttttccttgccatatttcaggtcctacagtgtgcatttctcttttttcacgtttttcagtgatttcgtcatttttcaagtggtcaagtgcatgtttctcattttccgtgattttcagttttcttgccatgttccaggtcctacagttgacgtttctaaaatttcactttttttaagttttcctcgccatatttcacttcctaaagtgtgtatttctcattttccgtgattttcagttttctcgccagattccaggtcctacagtgtgcatttttcatatttcacctttttcagtgattttgtcatttttcaagttgtcaactgcatgtttctcattttccatgattttcagttttcttgccatattccatgtcctactgtggacatttctaaattttccaactttttcagttttcctcgccatatttcatgtcctaaagtgtgtatttctcattttcagtgattttctgttttctcgccatattccaggtcctacagtgtgcatttctaatttttcacgtttttcagtgatttcgtcatttttcaagttgtcaagtggatgtttctcattttccatgattttcagttttcttgccatattccatgtcctacagtggacatttctaaattttccaactttttccattttcctcaccatatttcacgtcctaaagtgagtttttctcattttttgtgattttcagttttctcgacatattccaggtcctacagtgtgcatttctaattttttcttttttcagtgatttcgtcatttttcaagtggtcaagtgcatgtttctcattttccatgattttcagttttcttgccatattccatgtcctacaatggacatttctaaattttccaactttttcagttttcctcgccatatttcacgtcctaaagtgtgtatttctcattttccgtgattttcagttttctcgccatattccaggtcctacagtgtgcatttctcatttttcacgtttttcagtgatttcgtcatttttcaagttgtcaactgcatgtttctcattttccatgattttcagttttcttgccatattccatgtcttacagtggacatttttaaatttttcacatttttttaagttttcctccccatatttcacgttttaaagtgtgcatttctcattttcggtgattttcagttttctcgccagattccatgtcttacagtgtgcatttctcattttttcacgtttttcagtgatttcgtcatttttcaagtcgtcaagtggatgtttctcattttccatgattttcagttttcttgccatattccatgtcctacagtggaaatttctaaattttccacctttttcagttttccttgccatatttcaggtcctaaagtgtgtatttctcattttctgtgattttcagttttctcgccatattccaggtcctacagttgacatttctaaaatttccacattttttaagttttcctcgccatatttcacttcctaaagtgtgtatttctcattttccgtgattttcagttttctcgccatattccagatcctacagtgtacatttttcatttttcacgtttttcagtgattttgtcattttttagttgtcaactgcctgtttctcattttccatgattttcagttttcttgctatattccatgtcctacagtggaaatttctaaattttccacctttttcagttttcctcgccatatttcacgtcctaaagtgtgtatttctcattttccgtgattttcagttttctcgccatattccaggtcctatgtgtacatttctcatttttcacgtttttcagtgattttgtcatttttcaatttgtcaactgcatgtttctcattttccatgattttcagttttcttgccatattccatgtcctacagtggaaatttctatattttccaactttttcagttttcctcgccatatttcacgtgctaaagtgtgtatttctcatttttcgtgtttttcaggtttctcgccatattccaggtcctacagtgtgcatttctcatttttcacgtttttcagtgattttgtcatttttcaagttgtcaagtggatgtttctcattttccttgattttcagttttcttgccatattccatgtcctacagtggacatttctaaattttccacctttttcagttttccttgccatatttcatgtcctaaagtgtgtatttctcattttcagtgattttcagttttctcgccatattccaggtcctacagtgtgcatttctcattttttcaggtttttcagtgatttcgtcatttttcacgttgtcaagtggatgtttctcattttccatgattttcacttttcttgccatatttcatgtcctaaagtgtgtatttctcattttcagtgattttcagttttctcgctatattccaggtcctacagtgtgcatttctcattttttcacgtttttcagtgatttcgtcatttttcacgttgtcaagtggatgtttctcattttccatgattttcacttttcttgccatatttcatgtcctacaatggacatttctaaattttccacctttttctgttttcctcgccatatttcacatcctaaagtgtgtatttctcattttccgtgattttcagttttcttgccatattccaggtcctacagtgtgcatttctcatttttcacgtttttcagtgatttcgtcatttttcaagttgtcaagtggatgtttctcattttccttgattttcagttttcttgccatattccatgtcctactgtggacatttctaaattttccacctttttcagttttccttgccatatttcatgtcctaaagtgtgtatttctcattttcagtgattttcagttttctcgcaatattccaggtcctacagtgtgcatttctcattttttcaggtttttcagtgatttcgtcatttttcacgttgtcaagtggatgtttctcattttccatgattttcacttttcttgccatatttcatgtcctaaagtgtgtatttctcattttcagtgattttcagttttctgccatattccaggtcctacattgtgcatttctcattttttcacgtttttcagtgatttcgtcatttttcagttttctcgacatattccaggtcctacagtgtgcatttctaattttttcttttttcagtgatttcgtcatttttcaagttgtcaactgcatgtttctcattttccatgattttcagttttcttgccatattccatgtcttacagtggacatttttaaatttttcacatttttttaagttttcctccccatatttcacgttttaaagtgtgcatttctcattttcggtgattttcagttttctcgccagattccaggtcttacagtgtgcatttctcattttttcacgtttttcagtgatttcgtcatttttcaagtcgtcaagtggatgtttctcattttccatgattttcagttttcttgccatattccatgtcctacagtggaaatttctaaattttccacctttttcagttttccttgccatatttcaggtcctaaagtgtgtatttctcattttctgtgattttcagttttctcgccatattccaggtcctacagttgacatttctaaaatttccacattttttaagttttcctcgccatatttcacttcctaaagtgtgtatttctcattttccgtgattttcagttttctcgccatattccagatcctacagtgtgcatttttcatttttcacgtttttcagtgattttgtcattttttagttgtcaactgtctgtttctcattttccatgattttcagttttcttgccatattccatgtcctacactggacatttctaaattttccacctttttctgttttcctcgccatatttcacgtcctaaagtgtgtatttctcattttccgtgattttcagttttcttgccatattccaggtcctacagtgtgcatttctcatttttcacgtttttcagtgattttgtcatttttcaagttgtcaactgcatgtttctcattttctatgattttcagttttcttgctatattccatgtcctacagtggaaatttctaaattttccacctttttcagttttcctcgccatatttcacgtcctaaagtgtgtatttctcattttccgtgattttcagttttctcgccatattccaggtcctatgtgtacatttctcatttttcacgtttttcagtgattttgtcatttttcaagttgtgaagtggatgtttctcatttttcttgattttcatttttcttgccatattccatgtcctagagtggaaatttttaaattttccacctttttcagttttcctcgccatatttcacgtcctaaagtgtgaatttctcattttccgtgattttcagatttctcgccatattccaagtcctacagtgtgcatttctcatttttcacgtttttcagtgatttcgtcatttttcaagttgtcaagtggatgtttctcattttccatgattttcagctttcttgccatattcaaagtcctacagtggacatttctaaattttcgacctttatcagttttcctcgccatatttcatgtcccaaagtgtgtacttctcattttccgtgattttcagtttcctagccatattctaggtcctacagtgtgcatttctcatttttcaggtttttcagtgatttcgtcttttttcaagtcgtcaagtggatgtttctcattttccatgattttcacttttcttgccatatttcatgtcctaaagtgtgtatttctcattttcagtgattttcagttttctcgctatattccaggtcctacagtgtgcatttctcattttttcacgtttttcagtgatttcgtcatttttcacgttgtcaagtggatgtttctcattttccatgattttcacttttcttgccatatttcatgtcctacagtggacatttctaaattttccacctttttctgttttcctcgccatatttcacatcctaaagtgtgtatttctcattttccgtgattttcagttttcttgccatattccaggtcctacagtgtgcatttctcatttttcacgtttttcagtgatttcgtcatttttcaagttgtcaagtggatgtttctcattttccttgattttcagttttcttgccatattccatgtcctactgtggacatttctaaattttccacctttttcagttttccttgccatatttcatgtcctaaagtgtgtatttctcattttcagtgattttcagttttctcgcaatattccaggtcctacagtgtgcatttctcattttttcaggtttttcagtgatttcgtcatttttcacgttgtcaagtggatgtttctcattttccatgattttcacttttcttgccatatttcatgtcctaaagtgtgtatttctcattttcagtgattttcagttttctgccatattccaggtcctacattgtgcatttctcattttttcacgtttttcagtgatttcgtcatttttcacgttgtcaagtggatgtttctcattttccatgattttcacttttcttgccatatttcatgttttacagtggacatttctaaattttccacctttttctgttttcctcgccatatttcacatcctaaagtgtgtatttctcattttccgtgattttcagttttctcgccatatgccaggtcatacagggtgcatttctcatttttcacgtttttcagtgatttcgtcatttttcacgtcgtcaagtggatgtttctcattttcaatgattttcatttttcttgccatattccacgtcctatagtggacatttctaaattttccacctttttcagttttccttgccatatttcaggtcctacagtgtgcatttctcatttttcacgtttttcagtgatttcgtcatttttcaagtggtcaagtgcatgtttctcattttccgtgattttcagttttcttgccatgttccaggtcctacagttgacgtttctaaaatttcactttttttaagttttcctcgccatatttcacttcctaaagtgtgtatttctcattttccgtgattttcagttttctcgccagattccaggtcctacagtgtgcatttttcatatttcacctttttcagtgattttgtcatttttcaagttgtcaactgcatgtttctcattttccatgattttcagttttcttgccatattccatgtcctactgtggacatttctaaattttccaactttttcagttttcctcgccatatttcatgtcctaaagtgtgtatttctcattttcagtgattttctgttttctcgccatattccaggtcctacagtgtgcatttctaatttttcacgtttttcagtgatttcgtcatttttcaagttgtcaagtggatgtttctcattttccatgattttcagttttcttgccatattccatgtcctacagtggacatttctaaattttccaactttttccattttcctcaccatatttcacgtcctaaagtgtgtttttctcattttttgtgattttcagttttctcgacatattccaggtcctacagtgtgcatttctaattttttcttttttcagtgatttcgtcatttttcaagttgtcaactgcatgtttctcattttccatgattttcagttttcttgccatattccatgtcttacagtggacatttttaaatttttcacatttttttaagttttcctccccatatttcacgttttaaagtgtgcatttctcattttcggtgattttcagttttctcgccagattccaggtcttacagtgtgcatttctcattttttcacgtttttcagtgatttcgtcatttttcaagtcgtcaagtggatgtttctcattttccatgattttcagttttcttgccatattccatgtcctacagtggaaatttctaaattttccacctttttcagttttccttgccatatttcaggtcctaaagtgtgtatttctcattttctgtgattttcagttttctcgccatattccaggtcctacagttgacatttctaaaatttccacattttttaagttttcctcgccatatttcacttcctaaagtgtgtatttctcattttccgtgattttcagttttctcgccatattccagatcctacagtgtgcatttttcatttttcacgtttttcagtgattttgtcattttttagttgtcaactgtctgtttctcattttccatgattttcagttttcttgccatattccatgtcctacactggacatttctaaattttccacctttttctgttttcctcgccatatttcacgtcctaaagtgtgtatttctcattttccgtgattttcagttttcttgccatattccaggtcctacagtgtgcatttctcatttttcacgtttttcagtgattttgtcatttttcaagttgtcaactgcatgtttctcattttccatgattttcagttttcttgctatattccatgtcctacagtggaaatttctaaattttccacctttttcagttttcctcgccatatttcacgtcctaaagtgtgtatttctcattttccgtgattttcagttttctcgccatattccaggtcctatgtgtacatttctcatttttcacgtttttcagtgattttgtcatttttcaagttgtgaagtggatgtttctcatttttcttgattttcatttttcttgccatattccatgtcctagagtggaaatttttaaattttccacctttttcagttttcctcgccatatttcacgtcctaaagtgtgaatttctcattttccgtgattttcagatttctcgccatattccaagtcctacagtgtgcatttctcatttttcacgtttttcagtgatttcgtcatttttcaagttgtcaagtggatgtttctcattttccatgattttcagctttcttgccatattcaaagtcctacagtggacatttctaaattttcgacctttatcagttttcctcgccatatttcatgtcccaaagtgtgtacttctcattttccgtgattttcagtttcctcgccatattctaggtcctacagtgtgcatttctcatttttcaggtttttcagtgatttcgtcttttttcaagtcgtcaagtggatgtttctcattttccatgattttcagttttcttgccatattccatgtcctacagtggacatttctaaattttccacctttttcagttttcctcgccatatttcatgtcctaaagtgtgtatttctcattttcagtgattttcagttttctcgccatattccaggtcctacagtgtgcatttctcatttttcacgtttttcagtgatttcgtcatttttcaagttgtcaagtggatgtttctcattttccatgattttcagttttcttgccatattccatgtcccacagtggacatttctaaattttccacctttttctgttttccttgccatatttcatgtcctaaagtgtgtatttctcattttccgtgattttcagttttcttgctatattccaagtcctacagtgtgcatttctcatttttcacgtttttcagtgattttgtcatttttcaatttgtcaactgcatgtttctcattttccatgattttcagttttcttgccatattccatgtcctacagtggaaatttctatattttccaactttttcagttttcctcgccatatttcacgtgctaaagtgtgtatttctcatttttcgtgtttttcaggtttctcgccatattccaggtcctacagtgtgcatttctcatttttcacgtttttcagtgattttgtcatttttcaagttgtcaagtggatgtttctcattttccttgattttcagttttcttgccatattccatgtcctacagtggacatttctaaattttccacctttttcagttttccttgccatatttcatgtcctaaagtgtgtatttctcattttcagtgattttcagttttctcgccatattccaggtcctacagtgtgcatttctcattttttcaggtttttcagtgatttcgtcatttttcacgttgtcaagtggatgtttctcattttccatgattttcacttttcttgccatatttcatgtcctaaagtgtgtatttctcattttcagtgattttcagttttctcgctatattccaggtcctacagtgtgcatttctcattttttcacgtttttcagtgatttcgtcatttttcacgttgtcaagtggatgtttctcattttccatgattttcacttttcttgccatatttcatgtcctacagtggacatttctaaattttccacctttttctgttttcctcgccatatttcacatactaaagtgtgtatttctcattttccttgattttcagttttcttgccatattccaggtcctacagtgtgcatttctcatttttcacgtttttcagtgatttcgtcatttttcaagtcgtcaagtggatgtttctcattttccatgattttcagttttctcgccatattccaggtcctacagttgacatttctaaattttccacattttttaagtttcctcgcgatatttcacatcctaaagtgtgtatttctcattttccgtgattttcagttttcttgccatattccaggtcctacagggtgcatttctcatttttcacgtttttcagtgatttcatcaatttcaagtcgtcaactgtatgtttctcattttcaatgattttcatttttcttgccatattccatgtcctacagtggacatttctaaatttttcacctttttcagttttccttgccatatttcatgtcctaaagtgtgtatttctcattttcagtgattttcagttttctcgccatattccaggtcctacagtgtgcatttctcattttttcaggtttttcagtgatttcgtcatttttcacgttgtcaagtggatgtttctcattttccatgattttcacttttcttgccatatttcatgtcctaaagtgtgtatttctcattttcagtgattttcagttttctcgccatattccaggtcctacagtgtgcatttctcatttttcacgtttttcagtgatttcgtcatttttcaagttgtcaagtggatgtttctcattttccatgattttcacttttcttgccatattccatgtcccacagtggacatttctaaattttccacctttttctgttttcctcgccatatttcatgtcctaaagtgtgtatttctcattttccgtgattttcagttttcttgctatattccaagtcctacagtgtgcatttctcatttttcacgtttttcagtgattttgtcatttttcaatttgtcaactgcatgtttctcattttccatgattttcagttttcttgccatattccatgttctacagtggaaatttctatattttccaactttttcagttttcctcgccatatttcacgtgctaaagtgtgtatttctcatttttcgtgtttttcaggtttctcgccatattccaggtcctacagtgtgcatttctcatttttcacgtttttcagtgattttgtcatttttcaagttgtcaagtggatgtttctcattttccttgattttcagttttcttgccatattccatgtcctacagtggacatttctaaattttccacctttttcagttttccttgccatatttcatgtcctaaagtgtgtatttctcattttcagtgattttcagttttctcgccatattccaggtcctacagtgtgcatttctcattttttcaggtttttcagtgatttcgtcatttttcacgttgtcaagtggatgtttctcattttccatgattttcacttttcttgccatatttcatgtcctaaagtgtgtatttctcattttcagtgattttcagttttctcgctatattccaggtcctacagtgtgcatttctcattttttcacgttttgcagtgatttcgtcatttttcacgttgtcaagtggatgtttctcattttccatgattttcacttttcttgccatatttcatgtcctacagtggacatttctaaattttccacctttttctgttttcctcgccatatttcacatcctaaagtgtgtatttctcattttccgtgattttcagttttcttgccatattccaggtcctacagtgtgcatttctcatttttcacgtttttcagtgatttcgtcatttttcaagtcgtcaagtggatgtttctcattttccatgattttcagttttctcgccatattccaggtcctacagttgacatttctaaattttccacattttttaagtttcctcgcgatatttcacatcctaaagtgtgtatttctcattttccgtgattttcagttttcttgccatattccaggtcctacagggtgcatttctcatttttcacgtttttcagtgatttcatcaatttcaagtcgtcaactgtatgtttctcattttcaatgattttcatttttcttgccatattccatgtcctacagtggacatttctaaattttccacctttttcagttttccttgccatatttcatgtcctaaagtgtgtatttctcattttcagggattttcagttttctcgccatattccaggtcctacagtgtgcatttctcattttttcaggtttttcagtgatttcgtcatttttcacgttgtcaagtggatgtttctcattttccatgattttcacttttcttgccatatttcatgtcctaaagtgtgtatttctcattttcagtgattttcagttttctcgccatattccaggtcctacagtgtgcatttctcattttttcacgtttttcagtgatttcgtcatttttcacgttgtcaagtggatgtttctcattttccatgattttcacttttcttgccatatttcatgtcctacagtggacatttctaaattttccacctttttctgttttcctcgccatatttcacatcctaaagtgtgtatttctcattttccgtgattttcagttttcttgccatattccaggtcctacagtgtgcatttctcatttttcacgtttttcagtgatttcgtcatttttcaagtcgtcaagtggatgtttctcattttccatgattttcagttttctcgccatattccaggtcctacagttgacatttctaaattttccacattttttaagtttcctcgcgatatttcacatcctaaagtgtgtatttctcattttccgtgattttcagttttcttgccatattccaggtcctacagggtgcatttctcatttttcacgtttttcagtgatttcatcaatttcaagtcgtcaactgtatgtttctcattttcaatgattttcatttttcttgccatattccacgtcctatagtggacatttctaaattttccacctttttcagttttcttcgccatatttcacgtcccaaagtgtgtatttctcattttccgtgattttcagtttcctcgcaatattccaggtcctacagtgtgcatttctcatttttcacgtttttcagtgatttcgtcttttttcaagtcgtcaagtggatgtttctcattttccatgattttcagttttcttgccatattccatgtcctacagtggacatttctaaattttccacctttttctgttttcctcgccatatttcacgtcctaaagtgtgtatttctcattttccgtgattttcagttttcttgccatattccaggtcctacagtgtgcatttctcatttttcacgtttttcactgattttgtcattgttcaagttgtcaactgcatgtttctcattttccatgattttcaattttcttgccatattccatgtcctacagtggaaatttctatattttccaactttttcagttttcctcgccatatttcacgtgctaaagtgtgtatttctcatttttcgtgtttttcaggtttctcgccatattccaggtcctacagtgtgcatttctcatttttcacgtttttcagtgattttgtcatttttcaagttgtcaagtggttgtttctcattttccttgattttcagttttcttgccatattccatgtcctactgtggacatttctaaattttccacctttttcagttttccttgccatatttcatgtcctaaagtgtgtatttctcattttcagtgattttcagttttctcgcaatattccaggtcctacagtgtgcatttctcattttccgtgattttcagttttctcgccatatgccaggtcatacagggtgcatttctcatttttcacgtttttcagtgatttcgtcatttttcacgtcgtcaagtggatgtttctcattttcaatgattttcatttttcttgccatattccacgtcctatagtggacatttctaaattttccaactttttcagttttcttgccatatttcaggtcctacagtgtgcatttctcatttttcacgtttttcagtgatttcgtcatttttcaagtggtcaagtgcatgtttctgattttccgtgattttcagttttcttgccatgttccaggtcctacagttgacgtttctaaaatttcactttttttaagttttcctcgccatatttcacttcctaaagtgtgtatttctcattttccgtgattttcagttttctcgccagattccaggtcctacagtgtgcatttttcatatttcacctttttcagtgattttgtcatttttcaagttgtcaactgcatgtttctcattttccatgattttcagttttcttgccatattccatgtcctactgtggacatttctaaattttccaactttttcagttttcctcgccatatttcatgtcctaaagtgtgtatttctcattttcagtgtttttctgttttctcgccatattccaggtcctacagtgtgcatttctaatttttcacgtttttcagtgatttcgtcatttttcaagttgtcaagtggatgtttctcattttccatgattttcagttttcttgccatattccatgtcctacagtggacatttctaaattttccaactttttccattttcctcaccatatttcacgtcctaaagtgtgtttttctcattttttgtgattttcagttttctcgacatattccaggtcctacagtgtgcatttctaattttttcttttttcagtgatttcgtcatttttcaagtggtcaagtgcatgtttctcattttccatgattttcagttttcttgccatattccatgtcctacaatggacatttctaaattttccaactttttcagttttcctcgccatatttcacgtcctaaagtgtgtatttctcattttccgtgattttcagttttctcgccatattccaggtcctatgtgtacatttctcatttttcacgtttttcagtgattttgtcatttttcaagttgtgaagtggatgtttctcatttttcttgattttcatttttcttgccatattccatgtcctagagtggaaatttttaaattttccaactttttcagttttcctcgccatatttcacgtcctaaagtgtgtatttctcattttccgtgattttcagttttctcgccatattccaagtcctacagtgtgcatttctcatttttcacgtttttcagtgatttcgtcatttttcaagttgtcaagtggatgtttctcattttccatgattttcagctttcttgccatattcaaagtcctacagtggacatttctaaattttcgacctttatcagttttcctcgccatatttcatgtcccaaagtgtgtacttctcattttccgtgattttcagtttcctcgccatattctaggtcctacagtgtgcatttctcatttttcaggtttttcagtgatttcgtcttttttcaagtcgtcaagtggatgtttctcattttccatgattttcagttttcttgccatattccatgtcctacagtggacatttctaaattttccacctttttcagttttcctcgccatatttcatgtcctaaagtgtgtatttctcattttcagtgattttcagttttctcgccatattccaggtcctacagtgtgcatttctcatttttcacgtttttcagtgatttcgtcatttttcaagttgtcaagtggatgtttctcattttccatgattttcagttttcttgccatattccatgtcccacagtggacatttctaaattttccacctttttctgttttccttgccatatttcatgtcctaaagtgtgtatttctcattttccgtgattttcagttttcttgctatattccaagtcctacagtgtgcatttctcatttttcacgtttttaagtgattttgtcatttttcaatttgtcaactgcatgtttctcattttccatgattttcagttttcttgccatattccatgtcctacagtggaaatttctatattttccaactttttcagttttcctcgccatatttcacgtgctaaagtgtgtatttctcatttttcgtgtttttcaggtttctcgccatattccaggtcctacagtgtgcatttctcatttttcacgtttttcagtgattttgtcatttttcaagttgtcaagtggatgtttctcattttccttgattttcagttttcttgccatattccatgtcctacagtggacatttctaaattttccacctttttcagttttccttgccatatttcatgtcctaaagtgtgtatttctcattttcagtgattttcagttttctcgccatattccaggtcctacagtgtgcatttctcattttttcaggtttttcagtgatttcgtcatttttcacgttgtcaagtggatgtttctcattttccatgattttcacttttcttgccatatttcatgtcctaaagtgtgtatttctcattttcagtgattttcagttttctcgccatattccaggtcctacagtgtgcatttctcattttttcacgtttttcagtgatttcgtcatttttcacgttgtcaagtggatgtttctcattttccatgattttcacttttcttgccatatttcatgtcctacagtggacatttctaaattttccacctttttctgttttcctcgccatatttcacatcctaaagtgtgtatttctcattttccgtgattttcagttttcttgccatatttcaggtcctacagtgtgcatttctcatttttcacgtttttcagtgatttcgtcatttttcaagtcgtcaagaggatgtttctcattttccatgattttcagttttctcgccatattccaggtcctacagttgacatttctaaattttccacattttttaagtttcctcgcgatatttcacatcctaaagtgtgtatttctcattttccgtgattttcagttttcttgccatattccaggtcctacagggtgcatttctcatttttcacgtttttcagtgatttcatcaatttcaagtcgtcaactgtatgtttctcattttcaatgattttcatttttcttgccatattccacgtcctatagtggacatttctaaattttccacctttttctgttttcctcgccatatttcacgtcctaaagtgtgtatttctcattttccgtgattttcagttttcttgccatattccaggtcctacagtgtgcatttctcatttttcacgtttttcactgattttgtcattgttcaagttgtcaactgcatgtttctcattttccatgattttcagttttcttgccatattccatgtcctacagtggaaatttctatattttccacctttttcagttttcctcgccgtatttcatgtgctaaagtgtgtatttctcatttttcgtgtttttcaggtttctcgccatattccaggtcctacagtgtgcatttctcatttttcacgtttttcagtgattttgtcatttttcaagttgtcaactggatgtttctcattttccttgattttcagttttcttgccatattccatgtcctactgtggacatttctaaattttccacctttttcagttttccttgccatatttcatgtcctaaagtgtgtatttctcattttcagtgattttcagttttctcgcaatattccaggtcctacagtgtgcatttctcattttttcaggtttttcagtgatttcgtcatttttcacgttgtcaagtggatgtttctcattttccatgattttcacttttcttgccatatttcatgtcctaaagtgtgtatttctcattttcagtgattttcagttttctcgccatattccaggtcctacattgtgcatttctcattttttcacgtttttcagtgatttcgtcatttttcacgttgtcaagtggatgtttctcattttccatgattttcacttttcttgccatatttcatgttttacagtggacatttctaaattttccacctttttctgttttcctcgccatatttcacatcctaaagtgtgaatttctcattttccgtgattttcagttttcttgccatattccaggtcctacagtgtgcatttctcatttttcacgtttttcagtgatttcatcatttttcaagtcgtcaagtggatgtttctcattttccatgattttcagttttcttgccatattccatgtcctacagtggacatttctaaattttccacctttttctgttttcctcgccatatttcacgtcctaaagtgtgtatttctcattttccgtgattttcagttttcttgccatattccaggtcctacagtgtgcatttctcatttttcacgtttttcactgattttgtcatttttcaagttgtcaactgcatgtttctcattttccatgattttcagttttcttgctatattccatgtcctacagtggaaatttctaaattttccacctttttcagttttcctcgccatatttcacgtcctgaagtgtgtatttctcattttccgtgattttcagttttctcgccatattccaggtcctatgtgtacatttctcatttttcacgtttttcagtgattttgtcatttttcaagttgtgaagtggatgtttctcatttttcttgattttcatttttcttgccatattccatgtcctacagtggaaatttctaaattttccacctttttcagttttcctcgccatatttcacgtcctaaagtgtgtatttctcattttccgtgattttcagttttctcgccatattccaggtcctacagtgtgcatttctcatttttcacgtttttcagtgatttcgacatttttcaagttgtcaagtggatgtttctcattttccatgattttcagctttcttgccatattcaaagtcctacagtggacatttctaaattttcgacctttatcagttttcctcgccatatttcatgtcccaaagtgtgtacttctcattttccgtgattttcagtttcctcgccatattccaggtcctacagtgtgcatttctcatttttcacgtttttcagtgatttcgtcatttttcaagtcgtcaagtggatgtttctcattttccatgattttcagttttcttgccatattccatgtcctacagtggacatttctaaattttccacctttttctgttttcctcgccatatttcacgtcctaaagtgtgtatttctcattttccgtgattttcagttttcttgccatattccaggtcctacagtgtgcatttctcatttatcacgtttttcactgattttgtcatttttcaagttgtcaactgcatgtttctcattttccatgattttcagttttcttgctatattccatgtcctacagtggaatattctaaattttccacctttttcagttttcctcgccatatttcacgtcctgaagtgtgtatttctcattttccgtgattttcagttttctcgccatattccaggtcctatgtgtacatttctcatttttcacgtttttcagtgattttgtcatttttcaagttgtgaagtggatgtttctcatttttcttgattttcatttttcttgccatattccatgtcctacagtggaaatttctaaattttccacctttttcagttttcctcgccatatttcacgtcctaaagtgtgaatttctcattttccgtgattttcagttttctcgccatattccaggtcctacagtgtgcatttctcatttttcacgtttttcagtgatttcgacatttttcaagttgtcaagtggatgtttctcattttccatgattttcagctttcttgccatattcaaagtcctacagtggacatttctaaattttcgacctttatcagttttcctcgccatatttcatgtcccaaagtgtgtacttctcattttccgtgattttgagtttcctcgccatattccaggtcctacagtgtgcatttctcatttttcacgtttttcagtgatttcgtcttttttcaagttgtcaactgcatgtttctcattttccatgattttcagttttcttgccatattccatgtcctacagtggaaatttgtaaatttccacctttttcagttttcctcgccatatttcacgtcctaaagtatgtatttctcattttccgtgattttcagttttctcgccatattccaggtcctacagtgtgcatttctcatttttcacgtttttcagtgattttgtcattttttaagttttcaagtggatgtttctcattttccttgattttcagttttcttgccatattccatgtcctacagtggacatttctaaattttccacctttttcagttttcctcgccatatttcatgtcctaaagtgtgtatttctcattttcagtgattttcagttttctcgccatattccaggtcctacagtgtgcatttctcatttttcacgtttttcagtgatttcgtcatttttcaaggtgtcaagtggatgtttctcattttccatgattttcagttttcttgccatattccatgtcctacagtggacatttctaaattttccacctttttctgttttcctcgccatatttcatgtcctaaagtgtgtatttctcattttccgtgattttcagttttcttgctatattccaagtcctacagtgtgcatttctcatttttcacgtttttcagtgattttgtcatttttcaatttgtcaactgcatgtttctcattttccatgattttcagtttttttgccatattccatgtcctactgtggaaatttctatattttccacctttttcagttttcctcgccatatttcacgtgctaaagtgtgtatttctcatttttcgtgtttttcaggtttctcgccatattccaggtcctacagtgtgcatttctcatttttcacgtttttcagtgattttgtcatttttcaagttttcaagtggatgtttctcattttccttgattttcagttttcttgccatattccatgtcctacagtggacatttctaaattttccacctttttcagttttccttgccatatttcatgtcctaaagtgtgtatttctcattttcagtgattttcagtttccttgccatattccaggtcctacagtgtgcatttctcattttttcacgtttttcagtgatttcgtcatttttcacgttgtcaagtggatgtttctcattttccatgattttcacttttcttgccatatttcatgtcctacagtggacatttctaaattttccaactttttcaattttcctcgccatattttatgtcctaaagtgtgtatttctcatttttcgttattttcagttttcttgccatattccaggtcctacagtgtgcatttgtcatttttcacgtttttcagtgatttcgtcatttttcaagtcgtcaagtagatgtttctcatattccatgtttttcagttttctcgccatattccaggtcctacagttgacatttctaaattttctacatttttaaattttcctcgccatatttcacgtcctaaagtgtgtatttctcattttttgttattttcagttttctagccatattccaggtcctacaggatgcatttctcatttttcacgtttttcagtgatttcatcatttttcaagtcgtcaagtgtatgtttcttattttcaatgattttcatttttcttgccttattccacgtcctatagtggacatttctaaattttccacctttttcagtttttttcgccatatttcacgtcctaaagtgtgtatttctcattttctgtgattttcagttttctcaccatattccaggtcctacagtgtgcatttctcatttttcacgtttttcagtgatttcgtcatttttcaagttgtcaagtggaagtttctcattttccatgattttcagctttctagacatattccaggtcctacagtggacatttcctaattttcgacctttatcagttttcctcgtcatatttcacgtcccaaaatgtgtatttcttattttccatgattttcagtttcctcgccatattccaggtcctacagtgtgcaattctcatttttcacgtttttcagtgatttcgtcttttttcaagacgtcaagtggatgtttctcatttttcatgattttcagttttcttgccatattccatgtcctacagtggacatttctaaattttccacctttttctgttttcctcgccatatttcacgtcctaaagtgtgtatttctcattttccgtgattttcagttttcttgccatattcctggtcctacagtgtgcatttctcatttttcacgtttttcagtgattttgtcatttttcaatttgtcaactgcatgtttctcattttccattattttcagttttcttgccatattccatgtcctacagtggacatttctaaattttccacctttttctgttttcctcgccatatttcatgtcctaaagtgtgtatttctcattttccgtgattttcagttttcttgctatattccaagtcctacagtgtgcatttctcatttttcacgtttttcagtgattttgtcatttttcaatttgtcaactgcatgtttctcattttccatgattttcagtttttttgccatattccatgtcctacaggggaaatttctatattttccacctttttcagttttcctcgccatatttcatgtcctaaagtgtgtatttctcattttccgtgattttcagttttcttgccatattccaggtcctacagtgtgcatttctcatttttcacgtttttcagtgatttcgtcatttttcaagtcttcaagtagatgtttctcatattccatgtttttcagttttctcgccatattccaggtcctacagttgacatttctaaattttctacatttttaaattttcctcgccatatttcacgtcctaaagtgtgtatttctcatttttcgttattttcagttttctagccatattccaggtcctacaggatgcatttctcatttttcacgtttttcagtgatttcatcatttttcaagtcgtcaagtgtatgtttctcattttcaatgattttcatttttcttgccttattccacgtcctatagtggacatttctaaattttccacctttttcagtttttctcgccatatttcacgtcctaaagtgtgtatttctcattttctgtgattttcagttttctcaccatattccaggtcctacagtgtgcatttctcatttttcacgtttttcagtgatttcgtcatttttcaagttgtcaagtggaagtttctcattttccatgattttcagctttctagccatattccaggtcctacagtggacatttcctaattttcgacctttatcagttttcctcgccatatttcacgtcctaaagtgtgtatttctcattttccgtgattttcagttttcttgccatattccaggtcctacagtgtgcatttctcatttttcacgtttttcagtgattttgtcatttttcaatttgtcaactgcatgtttctcattttccatgatttttagttttcttgctatattccatgtcctacagtggaaatttctaaattttccacctttttcagttttcctcgccatatttcacgtcctaaagtgtgtatttctcattttccgtgattttcagttttcttgctatattccaagtcctacattgtgcatttctcatttttcacgtttttcagtgattttgtcatttttcaatttgtcaaaccacatgtttctcattttccatgattttcagtttttttgccatattccatgtcctacagtggaaatttctatattttccacctttttcagttttcctcgccatatttcacgtgctaaagtgtgtatttctcatttttcgtgtttttcaggtttctcgccatattccaggtcctacagtgtgcatttctcatttttcacgtttttcagtgattttgtcatttttcaagttgtcaagtggatgtttcccattttccttgattttcagttttcttaccatattccatgtcctacagtggacatttctaaattttccacctttttcagttttccttgccatatttcatgtcctaaagtgtgtatttctcattttcagtgattttcagtttcctcgccatattccaggtcctacagtgtgcatttctcattttttcacgtttttcagtgatttcgtcatttttcacgttgtcaagtggatgtttctcattttccatgattttcacttttcttgccatatttcatgtcctatagtggacatttctaaattttccacctttttcagtttttctcgccatatttcacgtcctaaagtgtgtatttctcattttctgtgattttcagttttctcaccatattccaggtcctacagtgtgcatttctcatttttcacgtttttcagtgatttcgtcatttttcaagtcgtcaagtagatgtttctcatattccatgtttttcagttttctcgccatattccaggtcctacagttgacatttctaaattttctacatttttaaattttcctcgccatatttcacgtcctaaagtgtgtatttctcatttttcgttattttcagttttctagccatattccaggtcctacaggatgcatttctcatttttcacgtttttcagtgatttcatcatttttcaagtcgtcaagtgtatgtttcttattttcaatgattttcatttttcttgccttattccacgtcctatagtggacatttctaaattttccaccttttttcagtttttctcgccatatttcacgtcctaaagtgtgtatttctcattttctgtgattatcagttttctcaccatattccaggtcctacagtgtgcatttctcatttttcacgtttttcagtgatttcgtcatttttcaagttgtcaagtggaagtttctcattttccatgattttcagctttctagccatattccaggtcctacagtggacatttcctaattttcgacctttatcagttttcctcgccatatttcacgtcccaaaatgtgtatttcttattttccatgattttcagtttcctcgccatattccaggtcctacagtgtgcatttctcatttttcacgtttttcagtgatttcgtcttttttcaagacgtcaagtggatgtttctcatttttcatgattttcagttttcttgccatattccatgtcctacagtggacatttctaaattttccacctttttctgttttcctcgccatatttcacgtcctaaagtgtgtatttctcattttccgtgattttcagttttcttgccatattcctggtcctacagtgtgcatttctcatttttcacgtttttcagtgattttgtcatttttcaatttgtcaactgcatgtttctcattttccatgattttcagttttcttgccatattccatgtcctacagtggacatttctaaattttccacctttttcagttttcctcgccatatttcacgtgctaaagtgtgtatttctcatttttcgtgtttttcaggtttctcgccatattccaggtcctacagtgtgcatttctcatttttcacgtttttcagtgattttgtcatttttcaagttgtcaagtggatgtttctcattttccttgattttcacttttcttgccatattccaagtcttacaggggcatttctcatttttcacgttttcagtgattttgtcattttcaatttgtcaactgcatgtttctcattttccatgattttcagtttttttgccatattccatgtcctacaggggaaatttctatattttccacctttttcagttttcctcgccatatttcatgtcctaaagtgtgtatttctcattttccgtgattttcagttttcttgccatattccaggtcctacagtgtgcatttctcatttttcacgtttttcagtgatttcgtcatttttcaagtcttcaagtagatgtttctcatattccatgtttttcagttttctcgccatattccaggtcctacagttgacatttctaaattttctacatttttaaattttcctcgccatatttcacgtcctaaagtgtgtatttctcatttttcgttattttcagttttctagccatattccaggtcctacaggatgcatttctcatttttcacgtttttcagtgatttcatcatttttcaagtcgtcaagtgtatgtttctcattttcaatgattttcatttttcttgccttattccacgtcctatagtggacatttctaaattttccacctttttcagtttttctcgccatatttcacgtcctaaagtgtgtatttctcattttctgtgattttcagttttctcaccatattccaggtcctacagtgtgcatttctcatttttcacgtttttcagtgatttcgtcatttttcaagttgtcaagtggaagtttctcattttccatgattttcagctttctagccatattccaagtcctacagtggacatttcctaattttcgacctttatcagttttcctcgccatatttcacgtcccaaaatgtgtattccttattttccatgattttcagtttcctcgccatattccaggtcctacagtgtgcatttatcatttttcacgtttttcagtgatttcgtcttttttcaagacgtcaagtggatgtttctcatttttcatgattttcagttttcttgccatattccatgtcctacagtggacatttctaaattttccacctttttctgttttcctcgccatatttcacgtcctaaagtgtgtatttctcattttccgtgattttcagttttcttgccatattcctggtcctacagtgtgcatttctcatttttcacgtttttcagtgattttgtcatttttcaagttgtcaagtggatgtttctcattttccttgattttcacttttcttgccatattccatgtcctacagtggacatttctatattttccacctttttccgttttccttgccatatttcacgtcctaaagtgtgtatttctcattttccgtgattttcaggtttctcgccatattccaggtcctacagtgtgcatttctcatttttcacgtttttcagtgattttgtcatttttcaagttgtcaagtggatgtttctcattttccttgattttcacttttcttgccatattccatgtcctacagtggacatttctaaattttccacctttttcagttttcctcgccatatttcatgtcctaaagtgtgtatttctcattttcagtgattttcagttttcttgccatattccaggtcctacagtgtgcatttctcatttttcacgtttttcagtgattttgtcatttttcaagttgtcaactgcatgtttctcattttctatgattttcagttttcttgctatattccatgtcctacagtggaaatttctaaattttccacctttttcagttttcctcgccatatttcacgtcctaaagtgtgtatttctcattttccgtgattttcagttttctcgccatattccaggtcctatgtgtacatttctcatttttcacgtttttcagtgattttgtcatttttcaagttgtgaagtggatgtttctcatttttcttgattttcatttttcttgccatattccatgtcctagagtggaaatttttaaattttccacctttttcagttttcctcgccatatttcacgtcctaaagtgtgaatttctcattttccgtgattttcagatttctcgccatattccaagtcctacagtgtgcatttctcatttttcacgtttttcagtgatttcgtcatttttcaagttgtcaagtggatgtttctcattttccatgattttcagctttcttgccatattcaaagtcctacagtggacatttctaaattttcgacctttatcagttttcctcgccatatttcatgtcccaaagtgtgtacttctcattttccgtgattttcagtttcctcgccatattctaggtcctacagtgtgcatttctcatttttcaggtttttcagtgatttcgtcttttttcaagtcgtcaagtggatgtttctcattttccatgattttcacttttcttgccatatttcatgtcctaaagtgtgtatttctcattttcagtgattttcagttttctcgctatattccaggtcctacagtgtgcatttctcattttttcacgtttttcagtgatttcgtcatttttcacgttgtcaagtggatgtttctcattttccatgattttcacttttcttgccatatttcatgtcctacagtggacatttctaaattttccacctttttctgttttcctcgccatatttcacatcctaaagtgtgtatttctcattttccgtgattttcagttttcttgccatattccaggtcctacagtgtgcatttctcatttttcacgtttttcagtgatttcgtcatttttcaagttgtcaagtggatgtttctcattttccttgattttcagttttcttgccatattccatgtcctactgtggacatttctaaattttccacctttttcagttttccttgccatatttcatgtcctaaagtgtgtatttctcattttcagtgattttcagttttctcgcaatattccaggtcctacagtgtgcatttctcattttttcaggtttttcagtgatttcgtcatttttcacgttgtcaagtggatgtttctcattttccatgattttcacttttcttgccatatttcatgtcctaaagtgtgtatttctcattttcagtgattttcagttttcctcgccatatttcacgtcccaaaatgtgtatttcttattttccatgattttcagtttcctcgccatattccaggtcctacagtgtgcatttctcatttttcacgtttttcagtgatttcgtcttttttcaagacgtcaagtggatgtttctcatttttcatgattttcagttttcttgccatattccatgtcctacagtggacatttctaaattttccacctttttctgttttcctcgccatatttcacgtcctaaagtgtgtatttctcattttccgtgattttcagttttcttgccatattcctggtcctacagtgtgcatttctcatttttcacgtttttcagtgattttgtcatttttcaatttgtcaactgcatgtttctcattttccatgattttcagttttcttgccatattccatgtcctacagtggacatttctaaattttccacctttttcagttttcctcgccatatttcacgtgctaaagtgtgtatttctcatttttcgtgtttttcaggtttctcgccatattccaggtcctacagtgtgcatttctcatttttcacgtttttcagtgattttgtcatttttcaagttgtcaagtggatgtttctcattttccttgattttcacttttcttgccatattccatgtcctacagtggacatttctaaattttccacctttttcagttttcctcgccatatttcatgtcctaaagtgtgtatttctcattttcagtgattttcagttttctcgccatattccaggtcctacagtgtgcatttctcatttttcacgtttttcagtgatttcgtcttttttcaagacgtcaagtggatgtttctcattttccatgattttcagttttcttgccatattccatgtcctacagtggacatttctaaattttccacctttttctgttttcctcgccatatttcacgtcctaaagtgtgtatttctcattttccgtgattttcagttttcttgccatattccaggtcctacagtgtgcatttctcatttttcacgtttttcagtgattttgtcatttttcaatttgtcaactgcatgtttctcattttccatgatttttagttttcttgctatattccatgtcctacagtggaaatttctaaattttccacctttttcagttttcctcgccatatttcacgtcctaaagtgtgtatttctcattttccgtgattttcagttttcttgctatattccaagtcctacattgtgcatttctcatttttcacgtttttcagtgattttgtcatttttcaatttgtcaaaccacatgtttctcattttccatgattttcagtttttttgccatattccatgtcctacagtggaaatttctatattttccacctttttcagttttcctcgccatatttcacgtgctaaagtgtgtatttctcatttttcgtgtttttcaggtttctcgccatattccaggtcctacagtgtgcatttctcatttttcacgtttttctgtgattttgtcatttttcaagttgtcaagtggatgtttctcattttccttgattttcagttttcttaccatattccatgtcctacagtggacatttctaaattttccaccttttctgttttcctcgccatatttcatgtcctaaagtgtgtatttctcattttccgtgattttcatttttcttgctatattccaagtcctacagtgtgcatttctcattttccatgattttcagttttcttgctatattccatgtcctacagtggaaatttctaaattttccacctttttcagttttcctcgccatatttcacgtcctaaagtgtgtatttctcattttccgtgattttcagttttttcgccatattacaggtcctatgtgtacatttctcatttttcacgtttttcagtgattttgtcatttttcaagttgtcaagtggatgtttctcatttttcttgattttcatttttcttgccatattccatgtcctacagtggaaatttctaaattttccacctttttcagttttcctcgccatatttcacgtcctaaagtgtgaatttctcattttccgtgattttcagttttctcgccatattccaggtctacagtgtgcatttctcatttttcacgttttcagtgattcgtcatttttcaagttgacaagtggatgtttctcattttccatgattttcagctttcttgccatattcaaagtcctacagtggacatttctaaattttcgacctttatcagttttcctcgccatatttcatgtcccaaagtgtgtacttctcattttccgtgattttcagttttcttgccatattccaagtcctacagtgtgcatttctcatttttcacgtttttcagtgattttgtcatttttcaatttgtcaactgcatgtttctcattttccatgattttcagttttcttgccatattccatgtcctacagtggaaatttctatattttccacctttttcagttttcctcgccatatttcacgtgctaaagtgtgtatttctcatttttcgtgtttttcaggtttctcgccatattccaggtcctacagtgtgcatttctcatttttcacgtttttcagtgattttgtcatttttcaagttgtcaagtggatgtttctcattttcaatgattttcatttttcttgccttattccacgtcctatagtggacatttctaaattttccacctttttcagtttttctcgccatatttcacgtcccaaaatgtgtattccttattttccatgattttcagtttcctcgccatattccaggtcctacagtgtgcatttctcatttttcacgtttttcagtgatttcgtcttttttcaagacgtcaagtggatgtttctcatttttcatgattttcagttttcttgccatattccctgtcctacagtggacatttctaaattttccacctttttctgttttcctcgccatatttcacgtcctaaagtgtgtatttctcattttccgtgattttcagttttctcgccagattccaggtcctacagtgtgcatttctcatttttcacgtttttcagtgattttgtcatttttcaatttgtcaactgcatgtttctctctttccatgattttcagttttcttgccatattccatgtcctacagtggacatttctaaattttccacctttttcagttttcctcgccatatttcacgtgctaaagtgtgtatttctcatttttcgtgtttttcaggtttctcgccatattccaggtcctacagtgtgcatttctcatttttcacgtttttcagtgattttgtcatttttcaagttgtcaagtggatgtttctcattttcaatgattttcatttttcttaccttattccacgtcctatagtggacatttctaaattttccacctttttcagtttttctcgccatatttcacgtcccaaaatgtgtattccttattttccatgattttcagtttcctcgccatattccaggtcctacagtgtgcatttctcatttttcacgtttttcagtgatttcgtcttttttcaagacgtcaagtggatgtttctcatttttcatgattttcagttttcttgccatattccctgtcctacagtggacatttctaaattttccacctttttctgttttcctcgccatatttcacgtcctaaagtgtgtatttctcattttccgtgattttcagttttctcgccagattccaggtcctacagtgtgcatttctcatttttcacgtttttcagtgatttcgtcatttttcaagtcttcaagtgtatgtttctcattttcaatgattttcatttttcttgccttattccacgtcctatagtggacatttctaaattttccacctttttcagtttttctcgccatatttcacgtcctaaagtgtgtatttctcattttctgtgattttcagttttcttaccatattccaggtcctacagtgtgcatttctcatttttcacgtttttcagtgatttcgtcatttttcaagttgtcaagtggaagtttctcattttccatgattttcagctttctagccatattccaggtattacagtggacatttccttattttcgacctttatcagttttcctcgccatatttcatgtcctaaagtgtgt	38399	1554	4%	7300	19%
9	3000001	3038400	Atcctacagtgtgcatttctcatttttcacgtttttcagtgatttcgtcatttttcaagtcatcaagtggctgtttctcattttccatgattttcagttttcttgccatattccttgtcctacagtggacatttctaaattttccacctttttcagttttccttgtcatatttcaggtcctacagtgtgtatttctcatttttcacgtttttcattgatttcgtcatttttcaagttgtcaagtgcatgtttctcattttccatgattttcagttttcttgccatattccatgtcctacaatggacatttctaaattttccaactttttcagttttcctcgccatatttcacgtcctaaagtgtgtatttctcattttccgtgattttcagttttctcgacatattccaggtcctacagtgtgcatttctcatttttcacgtttttcagtgatttcgtcatttttcacgtcgtcaagtggatgtttctcattttccatgattttcagttttcttgccatattccatgtcctacagtggacatttctaaattttccacctttttcagttttcctcgccatatttcacgtcctaaagtgtgtatttctcattttccgtgattttcagttttctcgacatattccaggtcttacagggtgcatttctcatttttcacgtttttcagtgatttcatcatttttcaagtcgtcaactgtatgtttctcattttcaatgattttcatttttcttgccatattccacgtcctatagtggacatttctaaattttccacctttttcagttttccttgccatatttcaggtcctacagtgtgcatttctcatttttcacgtttttcagtgatttcgtcatttttcaagtggtcaaatgcatgtttctcattttccatgattttcagttttcttgccatattccatgtcctacagtggacatttctaaattttccacctttttcagttttcctcgccatatttcacgtcctaaagtgtgtatttctcattttccgtgattttcagttttatcgccagattccaggtcctacggtgtgcatttttcatatttcacgtttttcagtgattttgtcatttttcaagttgtcaactgcatgtttctcattttccatgattttcagttttcttgccatattccatgtcctacagtggacatttctaaattttccacctttttcagttttcctcgccatatttcatgtcctaaagtgtgtatttctcattttcagtgattttctgttttctcgccatattccaggtcctacagtgtgcatttctcatttttcacgtttttcagtgatttcgtcatttttcaagttgtcaagtggatgtttctcattttccatgattttcagttttcttgccatattccatgtcctacaatggacatttctaaattttccacctttttcagttttcctcgccatatttcacgtcctaaagtgtgtatttctcattttccgtgattttcagttttctcgccatattccaggtcctatgtgtacatttctcatttttcacgtttttcagtgattttgtcatttttcaagttgtgaagtggatgtttctcatttttcttgattttcatttttcttgccatattccatgtcctagagtggaaatttttaaattttccacctttttcagttttcctcgccatatttcacgtcctaaagtgtgaatttctcattttccgtgattttcagttttctcgccatattccaagtcctacagtgtgcatttctcatttttcacgtttttcagtgatttcgtcatttttcaagttgtcaagtggatgtttctcattttccatgattttcagctttcttgccatattcaaagtcctacagtggacatttctaaattttcgacctttatcagttttcctcgccatatttcatgtcccaaagtgtgtacttctcattttccgtgattttcagtttcctcgccatattctaggtcctacagtgtgcatttctcatttttcaggtttttcagtgatttcgtcttttttcaagtcgtcaagtggatgtttctcattttccatgattttcagttttcttgccatattccatgtcctacagtggacatttctaaattttccaactttttcagttttcctcgccatatttcatgtcctaaagtgtgtatttctcattttcagtgattttcagttttctcgccatattccaggtcctacagtgtgcatttctcatttttcacgtttttcagtgatttcgtcatttttcaagttgtcaagtggatgtttctcatttttcatgattttcagttttcttgccatattccatgtcccacagtggacatttctaaatgttccacctttttctgttttccttgccatatttcatgtcctaaagtgtgtatttctcattttccgtgattttcagttttcttgctatattccaagtcctacagtgtgcatttctcatttttcacgtttttctgtgattttttcatttttcaatttgtcaactgcatgtttctcattttccatgattttcagttttcttgccatattccaggtcctacagtgtgcatttctcatttttcacgtttttcagtgattttgtcatttttcaagttgtcaactgcatgtttctcattttccatgattttcagttttcttgctatattccatgtcctacagtggaaatttctaaattttccacctttttcagttttcctcgccatatttcacgtcctaaagtgtgtatttctcattttccgtgattttcagttttctcgccatattccaggtcctatgtgtacatttctcatttttcacgtttttcagtgattttgtcatttttcaagttgtgaagtggatgtttctcatttttcttgattttcatttttcttgccatattccatgtcctagagtggaaatttttaaattttccacctttttcagttttcctcgccatatttcacgtcctaaattgtgaatttctcattttccgtgattttcagttttctcgccatattccaagtcctacagtgtgcatttctcatttttcacgtttttcagtgatttcgtcatttttcaagttgtcaagtggatgtttctcattttccatgattttcagctttcttgccatattcaaagtcctacagtggacatttctaaattttcgacctttatcagttttcctcgccatatttcatgtcccaaagtgtgtacttctcattttccgtgattttcagtttcctcgccatattctaggtcctacagtgtgcatttctcatttttcaggtttttcagtgatttcgtcttttttcaagtcgtcaagtggatgtttctcattttccatgattttcagttttcttgccatattccatgtcctacagtggacatttctaaattttccacctttttcagttttcctcgccatatttcatgtcctaaagtgtgtatttctcattttcagtgattttcagttttctcgccatattccaggtcctacagtgtgcatttctcatttttcacgtttttcagtgattttgtcatttttcaagttgtcaagtggatgtttctcattttccttgattttcagttttcttgccatattccatgtcctacagtggacatttctaaattttccacctttttcagttttccttgccatatttcatgtcctaaagtgtgtatttctcattttcagtgattttcagttttctcgccatattccaggtcctacagtgtgcatttctcattttttcaggtttttcagtgatttcgtcatttttcacgttgtcaagtggatgtttctcattttccatgattttcacttttcttgccatatttcatgtcctaaagtgtgtatttctcattttcagtgattttcagttttctcgccatattccaggtcctacagtgtgcatttctcattttttcacgtttttcagtgatttcgtcatttttcacgttgtcaagtggatgtttctcattttccattattttcacttttcttgccatatttcatgtcctacagtggacatttctaaattttccacctttttctgttttcctcgccatatttcacatcctaaagtgtgtatttctcattttccgtgattttcagttttcttgccatattccaggtcctacagtgtgcatttctcatttttcacgtttttcagtgatttcgtcatttttcaagtcgtcaagtggatgtttctcattttccatgattttcagttttctcgccatattccaggtcctacagttgacatttctaaattttccacattttttatgtttcctcgcgatatttcacatcctaaagtgtgtatttctcattttccgtgattttcagttttcttgccatattccaggtcctacagggtgcatttctcatttttcacgtttttcagtgatttcatcaatttcaagtcgtcaactgtatgtttctcattttcaatgattttcatttttcttgccatattccacgtcctatagtggacatttctacattttccacctttttcagttttcttcgccatatttcacgtcccaaagtgtgtatttctcattttccgtgattttcagtttcctcgccatattccaggtcctacagtgtgcatttctcatttttcacgtttttcagtgatttcgtcttttttcaagtcgtcaagtggatgtttctcattttccatgattttcagttttcttgccatattccatgtcctacagtggacatttctaaattttccacctttttctgttttcctcgccatatttcacgtcctaaagtgtgtatttctcatttaccgtgattttcagttttcttgctatattccaagtcctacagtgtgcatttctcatttttcacgtttttcactgattttgtcattgttcaagttgtcaactgcatgtttctcattttccatgattttcagttttcttgccatattccatgtcctacagtggaaatttctatattttccaactttttcagttttcctcgccatatttcacgtgctaaagtgtgtatttctcatttttcgtgtttttcaggtttctcgccatattccaggtcctacagtgtgcatttctcatttttcacgtttttcagtgattttgtaatttttcaagttgtcaagtggatgtttctcattttccttgattttcagttttcttgccatattccatgtcctactgtggacatttctaaattttccacctttttcagttttccttgccatatttcatgtcctaaagtgtgtatttctcattttcagtgattttcagttttctcgcaatattccaggtcctacagtgtgcatttctcattttttcaggtttttcagtgatttcgtcatttttcacgttgtcaagtggatgtttctcattttccatgattttcacttttcttgccatatttcatgtgctaaagtgtgtatttctcattttcagtgattttcagttttctgccatattccaggtcctacattgtgcatttctcattttttcacgtttttcagtgatttcgtcatttttcacgttgtcaagtggatgtttctcattttccatgattttcacttttcttgccatatttcatgttttacagtggacatttctaaattttccacctatttctgttttcctcgccatatttcacatcctaaagtgtgtatttctcattttccgtgattttcagttttctcgccatatgccaggtcatacagggtgcatttctcatttttcacgtttttcagtgatttcgtcatttttcacgtcgtcaagtggatgtttctcattttcaatgattttcatttttcttgccatattccacgtcctatagtggacatttctaaattttccacctttttcagttttccttgccatatttcaggtcctacagtgtgcatttctcttttttcacgtttttcagtgatttcgtcatttttcaagtggtcaagtgcatgtttctcattttccgtgattttcagttttcttgccatgttccaggtcctacagttgacgtttctaaaatttcactttttttaagttttcctcgccatatttcacttcctaaagtgtgtatttctcattttccgtgattttcagttttctcgccagattccaggtcctacagtgtgcatttttcatatttcacctttttcagtgattttgtcatttttcaagttgtcaactgcatgtttctcattttccatgattttcagttttcttgccatattccatgtcctactgtggacatttctaaattttccaactttttcagttttcctcgccatatttcatgtcctaaagtgtgtatttctcattttcagtgattttctgttttctcgccatattccaggtcctacagtgtgcatttctaatttttcacgtttttcagtgatttcgtcatttttcaagttgtcaagtggatgtttctcattttccatgattttcagttttcttgccatattccatgtcctacagtggacatttctaaattttccaactttttccattttcctcaccatatttcacgtcctaaagtgagtttttctcattttttgtgattttcagttttctcgacatattccaggtcctacagtgtgcatttctaattttttcttttttcagtgatttcgtcatttttcaagtggtcaagtgcatgtttctcattttccatgattttcagttttcttgccatattccatgtcctacaatggacatttctaaattttccaactttttcagttttcctcgccatatttcacgtcctaaagtgtgtatttctcattttccgtgattttcagttttctcgccatattccaggtcctacagtgtgcatttctcatttttcacgtttttcagtgatttcgtcatttttcaagttgtcaactgcatgtttctcattttccatgattttcagttttcttgccatattccatgtcttacagtggacatttttaaatttttcacatttttttaagttttcctccccatatttcacgttttaaagtgtgcatttctcattttcggtgattttcagttttctcgccagattccatgtcttacagtgtgcatttctcattttttcacgtttttcagtgatttcgtcatttttcaagtcgtcaagtggatgtttctcattttccatgattttcagttttcttgccatattccatgtcctacagtggaaatttctaaattttccacctttttcagttttccttgccatatttcaggtcctaaagtgtgtatttctcattttctgtgattttcagttttctcgccatattccaggtcctacagttgacatttctaaaatttccacattttttaagttttcctcgccatatttcacttcctaaagtgtgtatttctcattttccgtgattttcagttttctcgccatattccagatcctacagtgtacatttttcatttttcacgtttttcagtgattttgtcattttttagttgtcaactgcctgtttctcattttccatgattttcagttttcttgctatattccatgtcctacagtggaaatttctaaattttccacctttttcagttttcctcgccatatttcacgtcctaaagtgtgtatttctcattttccgtgattttcagttttctcgccatattccaggtcctatgtgtacatttctcatttttcacgtttttcagtgattttgtcatttttcaatttgtcaactgcatgtttctcattttccatgattttcagttttcttgccatattccatgtcctacagtggaaatttctatattttccaactttttcagttttcctcgccatatttcacgtgctaaagtgtgtatttctcatttttcgtgtttttcaggtttctcgccatattccaggtcctacagtgtgcatttctcatttttcacgtttttcagtgattttgtcatttttcaagttgtcaagtggatgtttctcattttccttgattttcagttttcttgccatattccatgtcctacagtggacatttctaaattttccacctttttcagttttccttgccatatttcatgtcctaaagtgtgtatttctcattttcagtgattttcagttttctcgccatattccaggtcctacagtgtgcatttctcattttttcaggtttttcagtgatttcgtcatttttcacgttgtcaagtggatgtttctcattttccatgattttcacttttcttgccatatttcatgtcctaaagtgtgtatttctcattttcagtgattttcagttttctcgctatattccaggtcctacagtgtgcatttctcattttttcacgtttttcagtgatttcgtcatttttcacgttgtcaagtggatgtttctcattttccatgattttcacttttcttgccatatttcatgtcctacaatggacatttctaaattttccacctttttctgttttcctcgccatatttcacatcctaaagtgtgtatttctcattttccgtgattttcagttttcttgccatattccaggtcctacagtgtgcatttctcatttttcacgtttttcagtgatttcgtcatttttcaagttgtcaagtggatgtttctcattttccttgattttcagttttcttgccatattccatgtcctactgtggacatttctaaattttccacctttttcagttttccttgccatatttcatgtcctaaagtgtgtatttctcattttcagtgattttcagttttctcgcaatattccaggtcctacagtgtgcatttctcattttttcaggtttttcagtgatttcgtcatttttcacgttgtcaagtggatgtttctcattttccatgattttcacttttcttgccatatttcatgtcctaaagtgtgtatttctcattttcagtgattttcagttttctgccatattccaggtcctacattgtgcatttctcattttttcacgtttttcagtgatttcgtcatttttcagttttctcgacatattccaggtcctacagtgtgcatttctaattttttcttttttcagtgatttcgtcatttttcaagttgtcaactgcatgtttctcattttccatgattttcagttttcttgccatattccatgtcttacagtggacatttttaaatttttcacatttttttaagttttcctccccatatttcacgttttaaagtgtgcatttctcattttcggtgattttcagttttctcgccagattccaggtcttacagtgtgcatttctcattttttcacgtttttcagtgatttcgtcatttttcaagtcgtcaagtggatgtttctcattttccatgattttcagttttcttgccatattccatgtcctacagtggaaatttctaaattttccacctttttcagttttccttgccatatttcaggtcctaaagtgtgtatttctcattttctgtgattttcagttttctcgccatattccaggtcctacagttgacatttctaaaatttccacattttttaagttttcctcgccatatttcacttcctaaagtgtgtatttctcattttccgtgattttcagttttctcgccatattccagatcctacagtgtgcatttttcatttttcacgtttttcagtgattttgtcattttttagttgtcaactgtctgtttctcattttccatgattttcagttttcttgccatattccatgtcctacactggacatttctaaattttccacctttttctgttttcctcgccatatttcacgtcctaaagtgtgtatttctcattttccgtgattttcagttttcttgccatattccaggtcctacagtgtgcatttctcatttttcacgtttttcagtgattttgtcatttttcaagttgtcaactgcatgtttctcattttctatgattttcagttttcttgctatattccatgtcctacagtggaaatttctaaattttccacctttttcagttttcctcgccatatttcacgtcctaaagtgtgtatttctcattttccgtgattttcagttttctcgccatattccaggtcctatgtgtacatttctcatttttcacgtttttcagtgattttgtcatttttcaagttgtgaagtggatgtttctcatttttcttgattttcatttttcttgccatattccatgtcctagagtggaaatttttaaattttccacctttttcagttttcctcgccatatttcacgtcctaaagtgtgaatttctcattttccgtgattttcagatttctcgccatattccaagtcctacagtgtgcatttctcatttttcacgtttttcagtgatttcgtcatttttcaagttgtcaagtggatgtttctcattttccatgattttcagctttcttgccatattcaaagtcctacagtggacatttctaaattttcgacctttatcagttttcctcgccatatttcatgtcccaaagtgtgtacttctcattttccgtgattttcagtttcctagccatattctaggtcctacagtgtgcatttctcatttttcaggtttttcagtgatttcgtcttttttcaagtcgtcaagtggatgtttctcattttccatgattttcacttttcttgccatatttcatgtcctaaagtgtgtatttctcattttcagtgattttcagttttctcgctatattccaggtcctacagtgtgcatttctcattttttcacgtttttcagtgatttcgtcatttttcacgttgtcaagtggatgtttctcattttccatgattttcacttttcttgccatatttcatgtcctacagtggacatttctaaattttccacctttttctgttttcctcgccatatttcacatcctaaagtgtgtatttctcattttccgtgattttcagttttcttgccatattccaggtcctacagtgtgcatttctcatttttcacgtttttcagtgatttcgtcatttttcaagttgtcaagtggatgtttctcattttccttgattttcagttttcttgccatattccatgtcctactgtggacatttctaaattttccacctttttcagttttccttgccatatttcatgtcctaaagtgtgtatttctcattttcagtgattttcagttttctcgcaatattccaggtcctacagtgtgcatttctcattttttcaggtttttcagtgatttcgtcatttttcacgttgtcaagtggatgtttctcattttccatgattttcacttttcttgccatatttcatgtcctaaagtgtgtatttctcattttcagtgattttcagttttctgccatattccaggtcctacattgtgcatttctcattttttcacgtttttcagtgatttcgtcatttttcacgttgtcaagtggatgtttctcattttccatgattttcacttttcttgccatatttcatgttttacagtggacatttctaaattttccacctttttctgttttcctcgccatatttcacatcctaaagtgtgtatttctcattttccgtgattttcagttttctcgccatatgccaggtcatacagggtgcatttctcatttttcacgtttttcagtgatttcgtcatttttcacgtcgtcaagtggatgtttctcattttcaatgattttcatttttcttgccatattccacgtcctatagtggacatttctaaattttccacctttttcagttttccttgccatatttcaggtcctacagtgtgcatttctcatttttcacgtttttcagtgatttcgtcatttttcaagtggtcaagtgcatgtttctcattttccgtgattttcagttttcttgccatgttccaggtcctacagttgacgtttctaaaatttcactttttttaagttttcctcgccatatttcacttcctaaagtgtgtatttctcattttccgtgattttcagttttctcgccagattccaggtcctacagtgtgcatttttcatatttcacctttttcagtgattttgtcatttttcaagttgtcaactgcatgtttctcattttccatgattttcagttttcttgccatattccatgtcctactgtggacatttctaaattttccaactttttcagttttcctcgccatatttcatgtcctaaagtgtgtatttctcattttcagtgattttctgttttctcgccatattccaggtcctacagtgtgcatttctaatttttcacgtttttcagtgatttcgtcatttttcaagttgtcaagtggatgtttctcattttccatgattttcagttttcttgccatattccatgtcctacagtggacatttctaaattttccaactttttccattttcctcaccatatttcacgtcctaaagtgtgtttttctcattttttgtgattttcagttttctcgacatattccaggtcctacagtgtgcatttctaattttttcttttttcagtgatttcgtcatttttcaagttgtcaactgcatgtttctcattttccatgattttcagttttcttgccatattccatgtcttacagtggacatttttaaatttttcacatttttttaagttttcctccccatatttcacgttttaaagtgtgcatttctcattttcggtgattttcagttttctcgccagattccaggtcttacagtgtgcatttctcattttttcacgtttttcagtgatttcgtcatttttcaagtcgtcaagtggatgtttctcattttccatgattttcagttttcttgccatattccatgtcctacagtggaaatttctaaattttccacctttttcagttttccttgccatatttcaggtcctaaagtgtgtatttctcattttctgtgattttcagttttctcgccatattccaggtcctacagttgacatttctaaaatttccacattttttaagttttcctcgccatatttcacttcctaaagtgtgtatttctcattttccgtgattttcagttttctcgccatattccagatcctacagtgtgcatttttcatttttcacgtttttcagtgattttgtcattttttagttgtcaactgtctgtttctcattttccatgattttcagttttcttgccatattccatgtcctacactggacatttctaaattttccacctttttctgttttcctcgccatatttcacgtcctaaagtgtgtatttctcattttccgtgattttcagttttcttgccatattccaggtcctacagtgtgcatttctcatttttcacgtttttcagtgattttgtcatttttcaagttgtcaactgcatgtttctcattttccatgattttcagttttcttgctatattccatgtcctacagtggaaatttctaaattttccacctttttcagttttcctcgccatatttcacgtcctaaagtgtgtatttctcattttccgtgattttcagttttctcgccatattccaggtcctatgtgtacatttctcatttttcacgtttttcagtgattttgtcatttttcaagttgtgaagtggatgtttctcatttttcttgattttcatttttcttgccatattccatgtcctagagtggaaatttttaaattttccacctttttcagttttcctcgccatatttcacgtcctaaagtgtgaatttctcattttccgtgattttcagatttctcgccatattccaagtcctacagtgtgcatttctcatttttcacgtttttcagtgatttcgtcatttttcaagttgtcaagtggatgtttctcattttccatgattttcagctttcttgccatattcaaagtcctacagtggacatttctaaattttcgacctttatcagttttcctcgccatatttcatgtcccaaagtgtgtacttctcattttccgtgattttcagtttcctcgccatattctaggtcctacagtgtgcatttctcatttttcaggtttttcagtgatttcgtcttttttcaagtcgtcaagtggatgtttctcattttccatgattttcagttttcttgccatattccatgtcctacagtggacatttctaaattttccacctttttcagttttcctcgccatatttcatgtcctaaagtgtgtatttctcattttcagtgattttcagttttctcgccatattccaggtcctacagtgtgcatttctcatttttcacgtttttcagtgatttcgtcatttttcaagttgtcaagtggatgtttctcattttccatgattttcagttttcttgccatattccatgtcccacagtggacatttctaaattttccacctttttctgttttccttgccatatttcatgtcctaaagtgtgtatttctcattttccgtgattttcagttttcttgctatattccaagtcctacagtgtgcatttctcatttttcacgtttttcagtgattttgtcatttttcaatttgtcaactgcatgtttctcattttccatgattttcagttttcttgccatattccatgtcctacagtggaaatttctatattttccaactttttcagttttcctcgccatatttcacgtgctaaagtgtgtatttctcatttttcgtgtttttcaggtttctcgccatattccaggtcctacagtgtgcatttctcatttttcacgtttttcagtgattttgtcatttttcaagttgtcaagtggatgtttctcattttccttgattttcagttttcttgccatattccatgtcctacagtggacatttctaaattttccacctttttcagttttccttgccatatttcatgtcctaaagtgtgtatttctcattttcagtgattttcagttttctcgccatattccaggtcctacagtgtgcatttctcattttttcaggtttttcagtgatttcgtcatttttcacgttgtcaagtggatgtttctcattttccatgattttcacttttcttgccatatttcatgtcctaaagtgtgtatttctcattttcagtgattttcagttttctcgctatattccaggtcctacagtgtgcatttctcattttttcacgtttttcagtgatttcgtcatttttcacgttgtcaagtggatgtttctcattttccatgattttcacttttcttgccatatttcatgtcctacagtggacatttctaaattttccacctttttctgttttcctcgccatatttcacatactaaagtgtgtatttctcattttccttgattttcagttttcttgccatattccaggtcctacagtgtgcatttctcatttttcacgtttttcagtgatttcgtcatttttcaagtcgtcaagtggatgtttctcattttccatgattttcagttttctcgccatattccaggtcctacagttgacatttctaaattttccacattttttaagtttcctcgcgatatttcacatcctaaagtgtgtatttctcattttccgtgattttcagttttcttgccatattccaggtcctacagggtgcatttctcatttttcacgtttttcagtgatttcatcaatttcaagtcgtcaactgtatgtttctcattttcaatgattttcatttttcttgccatattccatgtcctacagtggacatttctaaatttttcacctttttcagttttccttgccatatttcatgtcctaaagtgtgtatttctcattttcagtgattttcagttttctcgccatattccaggtcctacagtgtgcatttctcattttttcaggtttttcagtgatttcgtcatttttcacgttgtcaagtggatgtttctcattttccatgattttcacttttcttgccatatttcatgtcctaaagtgtgtatttctcattttcagtgattttcagttttctcgccatattccaggtcctacagtgtgcatttctcatttttcacgtttttcagtgatttcgtcatttttcaagttgtcaagtggatgtttctcattttccatgattttcacttttcttgccatattccatgtcccacagtggacatttctaaattttccacctttttctgttttcctcgccatatttcatgtcctaaagtgtgtatttctcattttccgtgattttcagttttcttgctatattccaagtcctacagtgtgcatttctcatttttcacgtttttcagtgattttgtcatttttcaatttgtcaactgcatgtttctcattttccatgattttcagttttcttgccatattccatgttctacagtggaaatttctatattttccaactttttcagttttcctcgccatatttcacgtgctaaagtgtgtatttctcatttttcgtgtttttcaggtttctcgccatattccaggtcctacagtgtgcatttctcatttttcacgtttttcagtgattttgtcatttttcaagttgtcaagtggatgtttctcattttccttgattttcagttttcttgccatattccatgtcctacagtggacatttctaaattttccacctttttcagttttccttgccatatttcatgtcctaaagtgtgtatttctcattttcagtgattttcagttttctcgccatattccaggtcctacagtgtgcatttctcattttttcaggtttttcagtgatttcgtcatttttcacgttgtcaagtggatgtttctcattttccatgattttcacttttcttgccatatttcatgtcctaaagtgtgtatttctcattttcagtgattttcagttttctcgctatattccaggtcctacagtgtgcatttctcattttttcacgttttgcagtgatttcgtcatttttcacgttgtcaagtggatgtttctcattttccatgattttcacttttcttgccatatttcatgtcctacagtggacatttctaaattttccacctttttctgttttcctcgccatatttcacatcctaaagtgtgtatttctcattttccgtgattttcagttttcttgccatattccaggtcctacagtgtgcatttctcatttttcacgtttttcagtgatttcgtcatttttcaagtcgtcaagtggatgtttctcattttccatgattttcagttttctcgccatattccaggtcctacagttgacatttctaaattttccacattttttaagtttcctcgcgatatttcacatcctaaagtgtgtatttctcattttccgtgattttcagttttcttgccatattccaggtcctacagggtgcatttctcatttttcacgtttttcagtgatttcatcaatttcaagtcgtcaactgtatgtttctcattttcaatgattttcatttttcttgccatattccatgtcctacagtggacatttctaaattttccacctttttcagttttccttgccatatttcatgtcctaaagtgtgtatttctcattttcagggattttcagttttctcgccatattccaggtcctacagtgtgcatttctcattttttcaggtttttcagtgatttcgtcatttttcacgttgtcaagtggatgtttctcattttccatgattttcacttttcttgccatatttcatgtcctaaagtgtgtatttctcattttcagtgattttcagttttctcgccatattccaggtcctacagtgtgcatttctcattttttcacgtttttcagtgatttcgtcatttttcacgttgtcaagtggatgtttctcattttccatgattttcacttttcttgccatatttcatgtcctacagtggacatttctaaattttccacctttttctgttttcctcgccatatttcacatcctaaagtgtgtatttctcattttccgtgattttcagttttcttgccatattccaggtcctacagtgtgcatttctcatttttcacgtttttcagtgatttcgtcatttttcaagtcgtcaagtggatgtttctcattttccatgattttcagttttctcgccatattccaggtcctacagttgacatttctaaattttccacattttttaagtttcctcgcgatatttcacatcctaaagtgtgtatttctcattttccgtgattttcagttttcttgccatattccaggtcctacagggtgcatttctcatttttcacgtttttcagtgatttcatcaatttcaagtcgtcaactgtatgtttctcattttcaatgattttcatttttcttgccatattccacgtcctatagtggacatttctaaattttccacctttttcagttttcttcgccatatttcacgtcccaaagtgtgtatttctcattttccgtgattttcagtttcctcgcaatattccaggtcctacagtgtgcatttctcatttttcacgtttttcagtgatttcgtcttttttcaagtcgtcaagtggatgtttctcattttccatgattttcagttttcttgccatattccatgtcctacagtggacatttctaaattttccacctttttctgttttcctcgccatatttcacgtcctaaagtgtgtatttctcattttccgtgattttcagttttcttgccatattccaggtcctacagtgtgcatttctcatttttcacgtttttcactgattttgtcattgttcaagttgtcaactgcatgtttctcattttccatgattttcaattttcttgccatattccatgtcctacagtggaaatttctatattttccaactttttcagttttcctcgccatatttcacgtgctaaagtgtgtatttctcatttttcgtgtttttcaggtttctcgccatattccaggtcctacagtgtgcatttctcatttttcacgtttttcagtgattttgtcatttttcaagttgtcaagtggttgtttctcattttccttgattttcagttttcttgccatattccatgtcctactgtggacatttctaaattttccacctttttcagttttccttgccatatttcatgtcctaaagtgtgtatttctcattttcagtgattttcagttttctcgcaatattccaggtcctacagtgtgcatttctcattttccgtgattttcagttttctcgccatatgccaggtcatacagggtgcatttctcatttttcacgtttttcagtgatttcgtcatttttcacgtcgtcaagtggatgtttctcattttcaatgattttcatttttcttgccatattccacgtcctatagtggacatttctaaattttccaactttttcagttttcttgccatatttcaggtcctacagtgtgcatttctcatttttcacgtttttcagtgatttcgtcatttttcaagtggtcaagtgcatgtttctgattttccgtgattttcagttttcttgccatgttccaggtcctacagttgacgtttctaaaatttcactttttttaagttttcctcgccatatttcacttcctaaagtgtgtatttctcattttccgtgattttcagttttctcgccagattccaggtcctacagtgtgcatttttcatatttcacctttttcagtgattttgtcatttttcaagttgtcaactgcatgtttctcattttccatgattttcagttttcttgccatattccatgtcctactgtggacatttctaaattttccaactttttcagttttcctcgccatatttcatgtcctaaagtgtgtatttctcattttcagtgtttttctgttttctcgccatattccaggtcctacagtgtgcatttctaatttttcacgtttttcagtgatttcgtcatttttcaagttgtcaagtggatgtttctcattttccatgattttcagttttcttgccatattccatgtcctacagtggacatttctaaattttccaactttttccattttcctcaccatatttcacgtcctaaagtgtgtttttctcattttttgtgattttcagttttctcgacatattccaggtcctacagtgtgcatttctaattttttcttttttcagtgatttcgtcatttttcaagtggtcaagtgcatgtttctcattttccatgattttcagttttcttgccatattccatgtcctacaatggacatttctaaattttccaactttttcagttttcctcgccatatttcacgtcctaaagtgtgtatttctcattttccgtgattttcagttttctcgccatattccaggtcctatgtgtacatttctcatttttcacgtttttcagtgattttgtcatttttcaagttgtgaagtggatgtttctcatttttcttgattttcatttttcttgccatattccatgtcctagagtggaaatttttaaattttccaactttttcagttttcctcgccatatttcacgtcctaaagtgtgtatttctcattttccgtgattttcagttttctcgccatattccaagtcctacagtgtgcatttctcatttttcacgtttttcagtgatttcgtcatttttcaagttgtcaagtggatgtttctcattttccatgattttcagctttcttgccatattcaaagtcctacagtggacatttctaaattttcgacctttatcagttttcctcgccatatttcatgtcccaaagtgtgtacttctcattttccgtgattttcagtttcctcgccatattctaggtcctacagtgtgcatttctcatttttcaggtttttcagtgatttcgtcttttttcaagtcgtcaagtggatgtttctcattttccatgattttcagttttcttgccatattccatgtcctacagtggacatttctaaattttccacctttttcagttttcctcgccatatttcatgtcctaaagtgtgtatttctcattttcagtgattttcagttttctcgccatattccaggtcctacagtgtgcatttctcatttttcacgtttttcagtgatttcgtcatttttcaagttgtcaagtggatgtttctcattttccatgattttcagttttcttgccatattccatgtcccacagtggacatttctaaattttccacctttttctgttttccttgccatatttcatgtcctaaagtgtgtatttctcattttccgtgattttcagttttcttgctatattccaagtcctacagtgtgcatttctcatttttcacgtttttaagtgattttgtcatttttcaatttgtcaactgcatgtttctcattttccatgattttcagttttcttgccatattccatgtcctacagtggaaatttctatattttccaactttttcagttttcctcgccatatttcacgtgctaaagtgtgtatttctcatttttcgtgtttttcaggtttctcgccatattccaggtcctacagtgtgcatttctcatttttcacgtttttcagtgattttgtcatttttcaagttgtcaagtggatgtttctcattttccttgattttcagttttcttgccatattccatgtcctacagtggacatttctaaattttccacctttttcagttttccttgccatatttcatgtcctaaagtgtgtatttctcattttcagtgattttcagttttctcgccatattccaggtcctacagtgtgcatttctcattttttcaggtttttcagtgatttcgtcatttttcacgttgtcaagtggatgtttctcattttccatgattttcacttttcttgccatatttcatgtcctaaagtgtgtatttctcattttcagtgattttcagttttctcgccatattccaggtcctacagtgtgcatttctcattttttcacgtttttcagtgatttcgtcatttttcacgttgtcaagtggatgtttctcattttccatgattttcacttttcttgccatatttcatgtcctacagtggacatttctaaattttccacctttttctgttttcctcgccatatttcacatcctaaagtgtgtatttctcattttccgtgattttcagttttcttgccatatttcaggtcctacagtgtgcatttctcatttttcacgtttttcagtgatttcgtcatttttcaagtcgtcaagaggatgtttctcattttccatgattttcagttttctcgccatattccaggtcctacagttgacatttctaaattttccacattttttaagtttcctcgcgatatttcacatcctaaagtgtgtatttctcattttccgtgattttcagttttcttgccatattccaggtcctacagggtgcatttctcatttttcacgtttttcagtgatttcatcaatttcaagtcgtcaactgtatgtttctcattttcaatgattttcatttttcttgccatattccacgtcctatagtggacatttctaaattttccacctttttctgttttcctcgccatatttcacgtcctaaagtgtgtatttctcattttccgtgattttcagttttcttgccatattccaggtcctacagtgtgcatttctcatttttcacgtttttcactgattttgtcattgttcaagttgtcaactgcatgtttctcattttccatgattttcagttttcttgccatattccatgtcctacagtggaaatttctatattttccacctttttcagttttcctcgccgtatttcatgtgctaaagtgtgtatttctcatttttcgtgtttttcaggtttctcgccatattccaggtcctacagtgtgcatttctcatttttcacgtttttcagtgattttgtcatttttcaagttgtcaactggatgtttctcattttccttgattttcagttttcttgccatattccatgtcctactgtggacatttctaaattttccacctttttcagttttccttgccatatttcatgtcctaaagtgtgtatttctcattttcagtgattttcagttttctcgcaatattccaggtcctacagtgtgcatttctcattttttcaggtttttcagtgatttcgtcatttttcacgttgtcaagtggatgtttctcattttccatgattttcacttttcttgccatatttcatgtcctaaagtgtgtatttctcattttcagtgattttcagttttctcgccatattccaggtcctacattgtgcatttctcattttttcacgtttttcagtgatttcgtcatttttcacgttgtcaagtggatgtttctcattttccatgattttcacttttcttgccatatttcatgttttacagtggacatttctaaattttccacctttttctgttttcctcgccatatttcacatcctaaagtgtgaatttctcattttccgtgattttcagttttcttgccatattccaggtcctacagtgtgcatttctcatttttcacgtttttcagtgatttcatcatttttcaagtcgtcaagtggatgtttctcattttccatgattttcagttttcttgccatattccatgtcctacagtggacatttctaaattttccacctttttctgttttcctcgccatatttcacgtcctaaagtgtgtatttctcattttccgtgattttcagttttcttgccatattccaggtcctacagtgtgcatttctcatttttcacgtttttcactgattttgtcatttttcaagttgtcaactgcatgtttctcattttccatgattttcagttttcttgctatattccatgtcctacagtggaaatttctaaattttccacctttttcagttttcctcgccatatttcacgtcctgaagtgtgtatttctcattttccgtgattttcagttttctcgccatattccaggtcctatgtgtacatttctcatttttcacgtttttcagtgattttgtcatttttcaagttgtgaagtggatgtttctcatttttcttgattttcatttttcttgccatattccatgtcctacagtggaaatttctaaattttccacctttttcagttttcctcgccatatttcacgtcctaaagtgtgtatttctcattttccgtgattttcagttttctcgccatattccaggtcctacagtgtgcatttctcatttttcacgtttttcagtgatttcgacatttttcaagttgtcaagtggatgtttctcattttccatgattttcagctttcttgccatattcaaagtcctacagtggacatttctaaattttcgacctttatcagttttcctcgccatatttcatgtcccaaagtgtgtacttctcattttccgtgattttcagtttcctcgccatattccaggtcctacagtgtgcatttctcatttttcacgtttttcagtgatttcgtcatttttcaagtcgtcaagtggatgtttctcattttccatgattttcagttttcttgccatattccatgtcctacagtggacatttctaaattttccacctttttctgttttcctcgccatatttcacgtcctaaagtgtgtatttctcattttccgtgattttcagttttcttgccatattccaggtcctacagtgtgcatttctcatttatcacgtttttcactgattttgtcatttttcaagttgtcaactgcatgtttctcattttccatgattttcagttttcttgctatattccatgtcctacagtggaatattctaaattttccacctttttcagttttcctcgccatatttcacgtcctgaagtgtgtatttctcattttccgtgattttcagttttctcgccatattccaggtcctatgtgtacatttctcatttttcacgtttttcagtgattttgtcatttttcaagttgtgaagtggatgtttctcatttttcttgattttcatttttcttgccatattccatgtcctacagtggaaatttctaaattttccacctttttcagttttcctcgccatatttcacgtcctaaagtgtgaatttctcattttccgtgattttcagttttctcgccatattccaggtcctacagtgtgcatttctcatttttcacgtttttcagtgatttcgacatttttcaagttgtcaagtggatgtttctcattttccatgattttcagctttcttgccatattcaaagtcctacagtggacatttctaaattttcgacctttatcagttttcctcgccatatttcatgtcccaaagtgtgtacttctcattttccgtgattttgagtttcctcgccatattccaggtcctacagtgtgcatttctcatttttcacgtttttcagtgatttcgtcttttttcaagttgtcaactgcatgtttctcattttccatgattttcagttttcttgccatattccatgtcctacagtggaaatttgtaaatttccacctttttcagttttcctcgccatatttcacgtcctaaagtatgtatttctcattttccgtgattttcagttttctcgccatattccaggtcctacagtgtgcatttctcatttttcacgtttttcagtgattttgtcattttttaagttttcaagtggatgtttctcattttccttgattttcagttttcttgccatattccatgtcctacagtggacatttctaaattttccacctttttcagttttcctcgccatatttcatgtcctaaagtgtgtatttctcattttcagtgattttcagttttctcgccatattccaggtcctacagtgtgcatttctcatttttcacgtttttcagtgatttcgtcatttttcaaggtgtcaagtggatgtttctcattttccatgattttcagttttcttgccatattccatgtcctacagtggacatttctaaattttccacctttttctgttttcctcgccatatttcatgtcctaaagtgtgtatttctcattttccgtgattttcagttttcttgctatattccaagtcctacagtgtgcatttctcatttttcacgtttttcagtgattttgtcatttttcaatttgtcaactgcatgtttctcattttccatgattttcagtttttttgccatattccatgtcctactgtggaaatttctatattttccacctttttcagttttcctcgccatatttcacgtgctaaagtgtgtatttctcatttttcgtgtttttcaggtttctcgccatattccaggtcctacagtgtgcatttctcatttttcacgtttttcagtgattttgtcatttttcaagttttcaagtggatgtttctcattttccttgattttcagttttcttgccatattccatgtcctacagtggacatttctaaattttccacctttttcagttttccttgccatatttcatgtcctaaagtgtgtatttctcattttcagtgattttcagtttccttgccatattccaggtcctacagtgtgcatttctcattttttcacgtttttcagtgatttcgtcatttttcacgttgtcaagtggatgtttctcattttccatgattttcacttttcttgccatatttcatgtcctacagtggacatttctaaattttccaactttttcaattttcctcgccatattttatgtcctaaagtgtgtatttctcatttttcgttattttcagttttcttgccatattccaggtcctacagtgtgcatttgtcatttttcacgtttttcagtgatttcgtcatttttcaagtcgtcaagtagatgtttctcatattccatgtttttcagttttctcgccatattccaggtcctacagttgacatttctaaattttctacatttttaaattttcctcgccatatttcacgtcctaaagtgtgtatttctcattttttgttattttcagttttctagccatattccaggtcctacaggatgcatttctcatttttcacgtttttcagtgatttcatcatttttcaagtcgtcaagtgtatgtttcttattttcaatgattttcatttttcttgccttattccacgtcctatagtggacatttctaaattttccacctttttcagtttttttcgccatatttcacgtcctaaagtgtgtatttctcattttctgtgattttcagttttctcaccatattccaggtcctacagtgtgcatttctcatttttcacgtttttcagtgatttcgtcatttttcaagttgtcaagtggaagtttctcattttccatgattttcagctttctagacatattccaggtcctacagtggacatttcctaattttcgacctttatcagttttcctcgtcatatttcacgtcccaaaatgtgtatttcttattttccatgattttcagtttcctcgccatattccaggtcctacagtgtgcaattctcatttttcacgtttttcagtgatttcgtcttttttcaagacgtcaagtggatgtttctcatttttcatgattttcagttttcttgccatattccatgtcctacagtggacatttctaaattttccacctttttctgttttcctcgccatatttcacgtcctaaagtgtgtatttctcattttccgtgattttcagttttcttgccatattcctggtcctacagtgtgcatttctcatttttcacgtttttcagtgattttgtcatttttcaatttgtcaactgcatgtttctcattttccattattttcagttttcttgccatattccatgtcctacagtggacatttctaaattttccacctttttctgttttcctcgccatatttcatgtcctaaagtgtgtatttctcattttccgtgattttcagttttcttgctatattccaagtcctacagtgtgcatttctcatttttcacgtttttcagtgattttgtcatttttcaatttgtcaactgcatgtttctcattttccatgattttcagtttttttgccatattccatgtcctacaggggaaatttctatattttccacctttttcagttttcctcgccatatttcatgtcctaaagtgtgtatttctcattttccgtgattttcagttttcttgccatattccaggtcctacagtgtgcatttctcatttttcacgtttttcagtgatttcgtcatttttcaagtcttcaagtagatgtttctcatattccatgtttttcagttttctcgccatattccaggtcctacagttgacatttctaaattttctacatttttaaattttcctcgccatatttcacgtcctaaagtgtgtatttctcatttttcgttattttcagttttctagccatattccaggtcctacaggatgcatttctcatttttcacgtttttcagtgatttcatcatttttcaagtcgtcaagtgtatgtttctcattttcaatgattttcatttttcttgccttattccacgtcctatagtggacatttctaaattttccacctttttcagtttttctcgccatatttcacgtcctaaagtgtgtatttctcattttctgtgattttcagttttctcaccatattccaggtcctacagtgtgcatttctcatttttcacgtttttcagtgatttcgtcatttttcaagttgtcaagtggaagtttctcattttccatgattttcagctttctagccatattccaggtcctacagtggacatttcctaattttcgacctttatcagttttcctcgccatatttcacgtcctaaagtgtgtatttctcattttccgtgattttcagttttcttgccatattccaggtcctacagtgtgcatttctcatttttcacgtttttcagtgattttgtcatttttcaatttgtcaactgcatgtttctcattttccatgatttttagttttcttgctatattccatgtcctacagtggaaatttctaaattttccacctttttcagttttcctcgccatatttcacgtcctaaagtgtgtatttctcattttccgtgattttcagttttcttgctatattccaagtcctacattgtgcatttctcatttttcacgtttttcagtgattttgtcatttttcaatttgtcaaaccacatgtttctcattttccatgattttcagtttttttgccatattccatgtcctacagtggaaatttctatattttccacctttttcagttttcctcgccatatttcacgtgctaaagtgtgtatttctcatttttcgtgtttttcaggtttctcgccatattccaggtcctacagtgtgcatttctcatttttcacgtttttcagtgattttgtcatttttcaagttgtcaagtggatgtttcccattttccttgattttcagttttcttaccatattccatgtcctacagtggacatttctaaattttccacctttttcagttttccttgccatatttcatgtcctaaagtgtgtatttctcattttcagtgattttcagtttcctcgccatattccaggtcctacagtgtgcatttctcattttttcacgtttttcagtgatttcgtcatttttcacgttgtcaagtggatgtttctcattttccatgattttcacttttcttgccatatttcatgtcctatagtggacatttctaaattttccacctttttcagtttttctcgccatatttcacgtcctaaagtgtgtatttctcattttctgtgattttcagttttctcaccatattccaggtcctacagtgtgcatttctcatttttcacgtttttcagtgatttcgtcatttttcaagtcgtcaagtagatgtttctcatattccatgtttttcagttttctcgccatattccaggtcctacagttgacatttctaaattttctacatttttaaattttcctcgccatatttcacgtcctaaagtgtgtatttctcatttttcgttattttcagttttctagccatattccaggtcctacaggatgcatttctcatttttcacgtttttcagtgatttcatcatttttcaagtcgtcaagtgtatgtttcttattttcaatgattttcatttttcttgccttattccacgtcctatagtggacatttctaaattttccaccttttttcagtttttctcgccatatttcacgtcctaaagtgtgtatttctcattttctgtgattatcagttttctcaccatattccaggtcctacagtgtgcatttctcatttttcacgtttttcagtgatttcgtcatttttcaagttgtcaagtggaagtttctcattttccatgattttcagctttctagccatattccaggtcctacagtggacatttcctaattttcgacctttatcagttttcctcgccatatttcacgtcccaaaatgtgtatttcttattttccatgattttcagtttcctcgccatattccaggtcctacagtgtgcatttctcatttttcacgtttttcagtgatttcgtcttttttcaagacgtcaagtggatgtttctcatttttcatgattttcagttttcttgccatattccatgtcctacagtggacatttctaaattttccacctttttctgttttcctcgccatatttcacgtcctaaagtgtgtatttctcattttccgtgattttcagttttcttgccatattcctggtcctacagtgtgcatttctcatttttcacgtttttcagtgattttgtcatttttcaatttgtcaactgcatgtttctcattttccatgattttcagttttcttgccatattccatgtcctacagtggacatttctaaattttccacctttttcagttttcctcgccatatttcacgtgctaaagtgtgtatttctcatttttcgtgtttttcaggtttctcgccatattccaggtcctacagtgtgcatttctcatttttcacgtttttcagtgattttgtcatttttcaagttgtcaagtggatgtttctcattttccttgattttcacttttcttgccatattccaagtcttacaggggcatttctcatttttcacgttttcagtgattttgtcattttcaatttgtcaactgcatgtttctcattttccatgattttcagtttttttgccatattccatgtcctacaggggaaatttctatattttccacctttttcagttttcctcgccatatttcatgtcctaaagtgtgtatttctcattttccgtgattttcagttttcttgccatattccaggtcctacagtgtgcatttctcatttttcacgtttttcagtgatttcgtcatttttcaagtcttcaagtagatgtttctcatattccatgtttttcagttttctcgccatattccaggtcctacagttgacatttctaaattttctacatttttaaattttcctcgccatatttcacgtcctaaagtgtgtatttctcatttttcgttattttcagttttctagccatattccaggtcctacaggatgcatttctcatttttcacgtttttcagtgatttcatcatttttcaagtcgtcaagtgtatgtttctcattttcaatgattttcatttttcttgccttattccacgtcctatagtggacatttctaaattttccacctttttcagtttttctcgccatatttcacgtcctaaagtgtgtatttctcattttctgtgattttcagttttctcaccatattccaggtcctacagtgtgcatttctcatttttcacgtttttcagtgatttcgtcatttttcaagttgtcaagtggaagtttctcattttccatgattttcagctttctagccatattccaagtcctacagtggacatttcctaattttcgacctttatcagttttcctcgccatatttcacgtcccaaaatgtgtattccttattttccatgattttcagtttcctcgccatattccaggtcctacagtgtgcatttatcatttttcacgtttttcagtgatttcgtcttttttcaagacgtcaagtggatgtttctcatttttcatgattttcagttttcttgccatattccatgtcctacagtggacatttctaaattttccacctttttctgttttcctcgccatatttcacgtcctaaagtgtgtatttctcattttccgtgattttcagttttcttgccatattcctggtcctacagtgtgcatttctcatttttcacgtttttcagtgattttgtcatttttcaagttgtcaagtggatgtttctcattttccttgattttcacttttcttgccatattccatgtcctacagtggacatttctatattttccacctttttccgttttccttgccatatttcacgtcctaaagtgtgtatttctcattttccgtgattttcaggtttctcgccatattccaggtcctacagtgtgcatttctcatttttcacgtttttcagtgattttgtcatttttcaagttgtcaagtggatgtttctcattttccttgattttcacttttcttgccatattccatgtcctacagtggacatttctaaattttccacctttttcagttttcctcgccatatttcatgtcctaaagtgtgtatttctcattttcagtgattttcagttttcttgccatattccaggtcctacagtgtgcatttctcatttttcacgtttttcagtgattttgtcatttttcaagttgtcaactgcatgtttctcattttctatgattttcagttttcttgctatattccatgtcctacagtggaaatttctaaattttccacctttttcagttttcctcgccatatttcacgtcctaaagtgtgtatttctcattttccgtgattttcagttttctcgccatattccaggtcctatgtgtacatttctcatttttcacgtttttcagtgattttgtcatttttcaagttgtgaagtggatgtttctcatttttcttgattttcatttttcttgccatattccatgtcctagagtggaaatttttaaattttccacctttttcagttttcctcgccatatttcacgtcctaaagtgtgaatttctcattttccgtgattttcagatttctcgccatattccaagtcctacagtgtgcatttctcatttttcacgtttttcagtgatttcgtcatttttcaagttgtcaagtggatgtttctcattttccatgattttcagctttcttgccatattcaaagtcctacagtggacatttctaaattttcgacctttatcagttttcctcgccatatttcatgtcccaaagtgtgtacttctcattttccgtgattttcagtttcctcgccatattctaggtcctacagtgtgcatttctcatttttcaggtttttcagtgatttcgtcttttttcaagtcgtcaagtggatgtttctcattttccatgattttcacttttcttgccatatttcatgtcctaaagtgtgtatttctcattttcagtgattttcagttttctcgctatattccaggtcctacagtgtgcatttctcattttttcacgtttttcagtgatttcgtcatttttcacgttgtcaagtggatgtttctcattttccatgattttcacttttcttgccatatttcatgtcctacagtggacatttctaaattttccacctttttctgttttcctcgccatatttcacatcctaaagtgtgtatttctcattttccgtgattttcagttttcttgccatattccaggtcctacagtgtgcatttctcatttttcacgtttttcagtgatttcgtcatttttcaagttgtcaagtggatgtttctcattttccttgattttcagttttcttgccatattccatgtcctactgtggacatttctaaattttccacctttttcagttttccttgccatatttcatgtcctaaagtgtgtatttctcattttcagtgattttcagttttctcgcaatattccaggtcctacagtgtgcatttctcattttttcaggtttttcagtgatttcgtcatttttcacgttgtcaagtggatgtttctcattttccatgattttcacttttcttgccatatttcatgtcctaaagtgtgtatttctcattttcagtgattttcagttttcctcgccatatttcacgtcccaaaatgtgtatttcttattttccatgattttcagtttcctcgccatattccaggtcctacagtgtgcatttctcatttttcacgtttttcagtgatttcgtcttttttcaagacgtcaagtggatgtttctcatttttcatgattttcagttttcttgccatattccatgtcctacagtggacatttctaaattttccacctttttctgttttcctcgccatatttcacgtcctaaagtgtgtatttctcattttccgtgattttcagttttcttgccatattcctggtcctacagtgtgcatttctcatttttcacgtttttcagtgattttgtcatttttcaatttgtcaactgcatgtttctcattttccatgattttcagttttcttgccatattccatgtcctacagtggacatttctaaattttccacctttttcagttttcctcgccatatttcacgtgctaaagtgtgtatttctcatttttcgtgtttttcaggtttctcgccatattccaggtcctacagtgtgcatttctcatttttcacgtttttcagtgattttgtcatttttcaagttgtcaagtggatgtttctcattttccttgattttcacttttcttgccatattccatgtcctacagtggacatttctaaattttccacctttttcagttttcctcgccatatttcatgtcctaaagtgtgtatttctcattttcagtgattttcagttttctcgccatattccaggtcctacagtgtgcatttctcatttttcacgtttttcagtgatttcgtcttttttcaagacgtcaagtggatgtttctcattttccatgattttcagttttcttgccatattccatgtcctacagtggacatttctaaattttccacctttttctgttttcctcgccatatttcacgtcctaaagtgtgtatttctcattttccgtgattttcagttttcttgccatattccaggtcctacagtgtgcatttctcatttttcacgtttttcagtgattttgtcatttttcaatttgtcaactgcatgtttctcattttccatgatttttagttttcttgctatattccatgtcctacagtggaaatttctaaattttccacctttttcagttttcctcgccatatttcacgtcctaaagtgtgtatttctcattttccgtgattttcagttttcttgctatattccaagtcctacattgtgcatttctcatttttcacgtttttcagtgattttgtcatttttcaatttgtcaaaccacatgtttctcattttccatgattttcagtttttttgccatattccatgtcctacagtggaaatttctatattttccacctttttcagttttcctcgccatatttcacgtgctaaagtgtgtatttctcatttttcgtgtttttcaggtttctcgccatattccaggtcctacagtgtgcatttctcatttttcacgtttttctgtgattttgtcatttttcaagttgtcaagtggatgtttctcattttccttgattttcagttttcttaccatattccatgtcctacagtggacatttctaaattttccaccttttctgttttcctcgccatatttcatgtcctaaagtgtgtatttctcattttccgtgattttcatttttcttgctatattccaagtcctacagtgtgcatttctcattttccatgattttcagttttcttgctatattccatgtcctacagtggaaatttctaaattttccacctttttcagttttcctcgccatatttcacgtcctaaagtgtgtatttctcattttccgtgattttcagttttttcgccatattacaggtcctatgtgtacatttctcatttttcacgtttttcagtgattttgtcatttttcaagttgtcaagtggatgtttctcatttttcttgattttcatttttcttgccatattccatgtcctacagtggaaatttctaaattttccacctttttcagttttcctcgccatatttcacgtcctaaagtgtgaatttctcattttccgtgattttcagttttctcgccatattccaggtctacagtgtgcatttctcatttttcacgttttcagtgattcgtcatttttcaagttgacaagtggatgtttctcattttccatgattttcagctttcttgccatattcaaagtcctacagtggacatttctaaattttcgacctttatcagttttcctcgccatatttcatgtcccaaagtgtgtacttctcattttccgtgattttcagttttcttgccatattccaagtcctacagtgtgcatttctcatttttcacgtttttcagtgattttgtcatttttcaatttgtcaactgcatgtttctcattttccatgattttcagttttcttgccatattccatgtcctacagtggaaatttctatattttccacctttttcagttttcctcgccatatttcacgtgctaaagtgtgtatttctcatttttcgtgtttttcaggtttctcgccatattccaggtcctacagtgtgcatttctcatttttcacgtttttcagtgattttgtcatttttcaagttgtcaagtggatgtttctcattttcaatgattttcatttttcttgccttattccacgtcctatagtggacatttctaaattttccacctttttcagtttttctcgccatatttcacgtcccaaaatgtgtattccttattttccatgattttcagtttcctcgccatattccaggtcctacagtgtgcatttctcatttttcacgtttttcagtgatttcgtcttttttcaagacgtcaagtggatgtttctcatttttcatgattttcagttttcttgccatattccctgtcctacagtggacatttctaaattttccacctttttctgttttcctcgccatatttcacgtcctaaagtgtgtatttctcattttccgtgattttcagttttctcgccagattccaggtcctacagtgtgcatttctcatttttcacgtttttcagtgattttgtcatttttcaatttgtcaactgcatgtttctctctttccatgattttcagttttcttgccatattccatgtcctacagtggacatttctaaattttccacctttttcagttttcctcgccatatttcacgtgctaaagtgtgtatttctcatttttcgtgtttttcaggtttctcgccatattccaggtcctacagtgtgcatttctcatttttcacgtttttcagtgattttgtcatttttcaagttgtcaagtggatgtttctcattttcaatgattttcatttttcttaccttattccacgtcctatagtggacatttctaaattttccacctttttcagtttttctcgccatatttcacgtcccaaaatgtgtattccttattttccatgattttcagtttcctcgccatattccaggtcctacagtgtgcatttctcatttttcacgtttttcagtgatttcgtcttttttcaagacgtcaagtggatgtttctcatttttcatgattttcagttttcttgccatattccctgtcctacagtggacatttctaaattttccacctttttctgttttcctcgccatatttcacgtcctaaagtgtgtatttctcattttccgtgattttcagttttctcgccagattccaggtcctacagtgtgcatttctcatttttcacgtttttcagtgatttcgtcatttttcaagtcttcaagtgtatgtttctcattttcaatgattttcatttttcttgccttattccacgtcctatagtggacatttctaaattttccacctttttcagtttttctcgccatatttcacgtcctaaagtgtgtatttctcattttctgtgattttcagttttcttaccatattccaggtcctacagtgtgcatttctcatttttcacgtttttcagtgatttcgtcatttttcaagttgtcaagtggaagtttctcattttccatgattttcagctttctagccatattccaggtattacagtggacatttccttattttcgacctttatcagttttcctcgccatatttcatgtcctaaagtgtgt	38399	1554	4%	7300	19%
9	3000001	3038400	Atcctacagtgtgcatttctcatttttcacgtttttcagtgatttcgtcatttttcaagtcatcaagtggctgtttctcattttccatgattttcagttttcttgccatattccttgtcctacagtggacatttctaaattttccacctttttcagttttccttgtcatatttcaggtcctacagtgtgtatttctcatttttcacgtttttcattgatttcgtcatttttcaagttgtcaagtgcatgtttctcattttccatgattttcagttttcttgccatattccatgtcctacaatggacatttctaaattttccaactttttcagttttcctcgccatatttcacgtcctaaagtgtgtatttctcattttccgtgattttcagttttctcgacatattccaggtcctacagtgtgcatttctcatttttcacgtttttcagtgatttcgtcatttttcacgtcgtcaagtggatgtttctcattttccatgattttcagttttcttgccatattccatgtcctacagtggacatttctaaattttccacctttttcagttttcctcgccatatttcacgtcctaaagtgtgtatttctcattttccgtgattttcagttttctcgacatattccaggtcttacagggtgcatttctcatttttcacgtttttcagtgatttcatcatttttcaagtcgtcaactgtatgtttctcattttcaatgattttcatttttcttgccatattccacgtcctatagtggacatttctaaattttccacctttttcagttttccttgccatatttcaggtcctacagtgtgcatttctcatttttcacgtttttcagtgatttcgtcatttttcaagtggtcaaatgcatgtttctcattttccatgattttcagttttcttgccatattccatgtcctacagtggacatttctaaattttccacctttttcagttttcctcgccatatttcacgtcctaaagtgtgtatttctcattttccgtgattttcagttttatcgccagattccaggtcctacggtgtgcatttttcatatttcacgtttttcagtgattttgtcatttttcaagttgtcaactgcatgtttctcattttccatgattttcagttttcttgccatattccatgtcctacagtggacatttctaaattttccacctttttcagttttcctcgccatatttcatgtcctaaagtgtgtatttctcattttcagtgattttctgttttctcgccatattccaggtcctacagtgtgcatttctcatttttcacgtttttcagtgatttcgtcatttttcaagttgtcaagtggatgtttctcattttccatgattttcagttttcttgccatattccatgtcctacaatggacatttctaaattttccacctttttcagttttcctcgccatatttcacgtcctaaagtgtgtatttctcattttccgtgattttcagttttctcgccatattccaggtcctatgtgtacatttctcatttttcacgtttttcagtgattttgtcatttttcaagttgtgaagtggatgtttctcatttttcttgattttcatttttcttgccatattccatgtcctagagtggaaatttttaaattttccacctttttcagttttcctcgccatatttcacgtcctaaagtgtgaatttctcattttccgtgattttcagttttctcgccatattccaagtcctacagtgtgcatttctcatttttcacgtttttcagtgatttcgtcatttttcaagttgtcaagtggatgtttctcattttccatgattttcagctttcttgccatattcaaagtcctacagtggacatttctaaattttcgacctttatcagttttcctcgccatatttcatgtcccaaagtgtgtacttctcattttccgtgattttcagtttcctcgccatattctaggtcctacagtgtgcatttctcatttttcaggtttttcagtgatttcgtcttttttcaagtcgtcaagtggatgtttctcattttccatgattttcagttttcttgccatattccatgtcctacagtggacatttctaaattttccaactttttcagttttcctcgccatatttcatgtcctaaagtgtgtatttctcattttcagtgattttcagttttctcgccatattccaggtcctacagtgtgcatttctcatttttcacgtttttcagtgatttcgtcatttttcaagttgtcaagtggatgtttctcatttttcatgattttcagttttcttgccatattccatgtcccacagtggacatttctaaatgttccacctttttctgttttccttgccatatttcatgtcctaaagtgtgtatttctcattttccgtgattttcagttttcttgctatattccaagtcctacagtgtgcatttctcatttttcacgtttttctgtgattttttcatttttcaatttgtcaactgcatgtttctcattttccatgattttcagttttcttgccatattccaggtcctacagtgtgcatttctcatttttcacgtttttcagtgattttgtcatttttcaagttgtcaactgcatgtttctcattttccatgattttcagttttcttgctatattccatgtcctacagtggaaatttctaaattttccacctttttcagttttcctcgccatatttcacgtcctaaagtgtgtatttctcattttccgtgattttcagttttctcgccatattccaggtcctatgtgtacatttctcatttttcacgtttttcagtgattttgtcatttttcaagttgtgaagtggatgtttctcatttttcttgattttcatttttcttgccatattccatgtcctagagtggaaatttttaaattttccacctttttcagttttcctcgccatatttcacgtcctaaattgtgaatttctcattttccgtgattttcagttttctcgccatattccaagtcctacagtgtgcatttctcatttttcacgtttttcagtgatttcgtcatttttcaagttgtcaagtggatgtttctcattttccatgattttcagctttcttgccatattcaaagtcctacagtggacatttctaaattttcgacctttatcagttttcctcgccatatttcatgtcccaaagtgtgtacttctcattttccgtgattttcagtttcctcgccatattctaggtcctacagtgtgcatttctcatttttcaggtttttcagtgatttcgtcttttttcaagtcgtcaagtggatgtttctcattttccatgattttcagttttcttgccatattccatgtcctacagtggacatttctaaattttccacctttttcagttttcctcgccatatttcatgtcctaaagtgtgtatttctcattttcagtgattttcagttttctcgccatattccaggtcctacagtgtgcatttctcatttttcacgtttttcagtgattttgtcatttttcaagttgtcaagtggatgtttctcattttccttgattttcagttttcttgccatattccatgtcctacagtggacatttctaaattttccacctttttcagttttccttgccatatttcatgtcctaaagtgtgtatttctcattttcagtgattttcagttttctcgccatattccaggtcctacagtgtgcatttctcattttttcaggtttttcagtgatttcgtcatttttcacgttgtcaagtggatgtttctcattttccatgattttcacttttcttgccatatttcatgtcctaaagtgtgtatttctcattttcagtgattttcagttttctcgccatattccaggtcctacagtgtgcatttctcattttttcacgtttttcagtgatttcgtcatttttcacgttgtcaagtggatgtttctcattttccattattttcacttttcttgccatatttcatgtcctacagtggacatttctaaattttccacctttttctgttttcctcgccatatttcacatcctaaagtgtgtatttctcattttccgtgattttcagttttcttgccatattccaggtcctacagtgtgcatttctcatttttcacgtttttcagtgatttcgtcatttttcaagtcgtcaagtggatgtttctcattttccatgattttcagttttctcgccatattccaggtcctacagttgacatttctaaattttccacattttttatgtttcctcgcgatatttcacatcctaaagtgtgtatttctcattttccgtgattttcagttttcttgccatattccaggtcctacagggtgcatttctcatttttcacgtttttcagtgatttcatcaatttcaagtcgtcaactgtatgtttctcattttcaatgattttcatttttcttgccatattccacgtcctatagtggacatttctacattttccacctttttcagttttcttcgccatatttcacgtcccaaagtgtgtatttctcattttccgtgattttcagtttcctcgccatattccaggtcctacagtgtgcatttctcatttttcacgtttttcagtgatttcgtcttttttcaagtcgtcaagtggatgtttctcattttccatgattttcagttttcttgccatattccatgtcctacagtggacatttctaaattttccacctttttctgttttcctcgccatatttcacgtcctaaagtgtgtatttctcatttaccgtgattttcagttttcttgctatattccaagtcctacagtgtgcatttctcatttttcacgtttttcactgattttgtcattgttcaagttgtcaactgcatgtttctcattttccatgattttcagttttcttgccatattccatgtcctacagtggaaatttctatattttccaactttttcagttttcctcgccatatttcacgtgctaaagtgtgtatttctcatttttcgtgtttttcaggtttctcgccatattccaggtcctacagtgtgcatttctcatttttcacgtttttcagtgattttgtaatttttcaagttgtcaagtggatgtttctcattttccttgattttcagttttcttgccatattccatgtcctactgtggacatttctaaattttccacctttttcagttttccttgccatatttcatgtcctaaagtgtgtatttctcattttcagtgattttcagttttctcgcaatattccaggtcctacagtgtgcatttctcattttttcaggtttttcagtgatttcgtcatttttcacgttgtcaagtggatgtttctcattttccatgattttcacttttcttgccatatttcatgtgctaaagtgtgtatttctcattttcagtgattttcagttttctgccatattccaggtcctacattgtgcatttctcattttttcacgtttttcagtgatttcgtcatttttcacgttgtcaagtggatgtttctcattttccatgattttcacttttcttgccatatttcatgttttacagtggacatttctaaattttccacctatttctgttttcctcgccatatttcacatcctaaagtgtgtatttctcattttccgtgattttcagttttctcgccatatgccaggtcatacagggtgcatttctcatttttcacgtttttcagtgatttcgtcatttttcacgtcgtcaagtggatgtttctcattttcaatgattttcatttttcttgccatattccacgtcctatagtggacatttctaaattttccacctttttcagttttccttgccatatttcaggtcctacagtgtgcatttctcttttttcacgtttttcagtgatttcgtcatttttcaagtggtcaagtgcatgtttctcattttccgtgattttcagttttcttgccatgttccaggtcctacagttgacgtttctaaaatttcactttttttaagttttcctcgccatatttcacttcctaaagtgtgtatttctcattttccgtgattttcagttttctcgccagattccaggtcctacagtgtgcatttttcatatttcacctttttcagtgattttgtcatttttcaagttgtcaactgcatgtttctcattttccatgattttcagttttcttgccatattccatgtcctactgtggacatttctaaattttccaactttttcagttttcctcgccatatttcatgtcctaaagtgtgtatttctcattttcagtgattttctgttttctcgccatattccaggtcctacagtgtgcatttctaatttttcacgtttttcagtgatttcgtcatttttcaagttgtcaagtggatgtttctcattttccatgattttcagttttcttgccatattccatgtcctacagtggacatttctaaattttccaactttttccattttcctcaccatatttcacgtcctaaagtgagtttttctcattttttgtgattttcagttttctcgacatattccaggtcctacagtgtgcatttctaattttttcttttttcagtgatttcgtcatttttcaagtggtcaagtgcatgtttctcattttccatgattttcagttttcttgccatattccatgtcctacaatggacatttctaaattttccaactttttcagttttcctcgccatatttcacgtcctaaagtgtgtatttctcattttccgtgattttcagttttctcgccatattccaggtcctacagtgtgcatttctcatttttcacgtttttcagtgatttcgtcatttttcaagttgtcaactgcatgtttctcattttccatgattttcagttttcttgccatattccatgtcttacagtggacatttttaaatttttcacatttttttaagttttcctccccatatttcacgttttaaagtgtgcatttctcattttcggtgattttcagttttctcgccagattccatgtcttacagtgtgcatttctcattttttcacgtttttcagtgatttcgtcatttttcaagtcgtcaagtggatgtttctcattttccatgattttcagttttcttgccatattccatgtcctacagtggaaatttctaaattttccacctttttcagttttccttgccatatttcaggtcctaaagtgtgtatttctcattttctgtgattttcagttttctcgccatattccaggtcctacagttgacatttctaaaatttccacattttttaagttttcctcgccatatttcacttcctaaagtgtgtatttctcattttccgtgattttcagttttctcgccatattccagatcctacagtgtacatttttcatttttcacgtttttcagtgattttgtcattttttagttgtcaactgcctgtttctcattttccatgattttcagttttcttgctatattccatgtcctacagtggaaatttctaaattttccacctttttcagttttcctcgccatatttcacgtcctaaagtgtgtatttctcattttccgtgattttcagttttctcgccatattccaggtcctatgtgtacatttctcatttttcacgtttttcagtgattttgtcatttttcaatttgtcaactgcatgtttctcattttccatgattttcagttttcttgccatattccatgtcctacagtggaaatttctatattttccaactttttcagttttcctcgccatatttcacgtgctaaagtgtgtatttctcatttttcgtgtttttcaggtttctcgccatattccaggtcctacagtgtgcatttctcatttttcacgtttttcagtgattttgtcatttttcaagttgtcaagtggatgtttctcattttccttgattttcagttttcttgccatattccatgtcctacagtggacatttctaaattttccacctttttcagttttccttgccatatttcatgtcctaaagtgtgtatttctcattttcagtgattttcagttttctcgccatattccaggtcctacagtgtgcatttctcattttttcaggtttttcagtgatttcgtcatttttcacgttgtcaagtggatgtttctcattttccatgattttcacttttcttgccatatttcatgtcctaaagtgtgtatttctcattttcagtgattttcagttttctcgctatattccaggtcctacagtgtgcatttctcattttttcacgtttttcagtgatttcgtcatttttcacgttgtcaagtggatgtttctcattttccatgattttcacttttcttgccatatttcatgtcctacaatggacatttctaaattttccacctttttctgttttcctcgccatatttcacatcctaaagtgtgtatttctcattttccgtgattttcagttttcttgccatattccaggtcctacagtgtgcatttctcatttttcacgtttttcagtgatttcgtcatttttcaagttgtcaagtggatgtttctcattttccttgattttcagttttcttgccatattccatgtcctactgtggacatttctaaattttccacctttttcagttttccttgccatatttcatgtcctaaagtgtgtatttctcattttcagtgattttcagttttctcgcaatattccaggtcctacagtgtgcatttctcattttttcaggtttttcagtgatttcgtcatttttcacgttgtcaagtggatgtttctcattttccatgattttcacttttcttgccatatttcatgtcctaaagtgtgtatttctcattttcagtgattttcagttttctgccatattccaggtcctacattgtgcatttctcattttttcacgtttttcagtgatttcgtcatttttcagttttctcgacatattccaggtcctacagtgtgcatttctaattttttcttttttcagtgatttcgtcatttttcaagttgtcaactgcatgtttctcattttccatgattttcagttttcttgccatattccatgtcttacagtggacatttttaaatttttcacatttttttaagttttcctccccatatttcacgttttaaagtgtgcatttctcattttcggtgattttcagttttctcgccagattccaggtcttacagtgtgcatttctcattttttcacgtttttcagtgatttcgtcatttttcaagtcgtcaagtggatgtttctcattttccatgattttcagttttcttgccatattccatgtcctacagtggaaatttctaaattttccacctttttcagttttccttgccatatttcaggtcctaaagtgtgtatttctcattttctgtgattttcagttttctcgccatattccaggtcctacagttgacatttctaaaatttccacattttttaagttttcctcgccatatttcacttcctaaagtgtgtatttctcattttccgtgattttcagttttctcgccatattccagatcctacagtgtgcatttttcatttttcacgtttttcagtgattttgtcattttttagttgtcaactgtctgtttctcattttccatgattttcagttttcttgccatattccatgtcctacactggacatttctaaattttccacctttttctgttttcctcgccatatttcacgtcctaaagtgtgtatttctcattttccgtgattttcagttttcttgccatattccaggtcctacagtgtgcatttctcatttttcacgtttttcagtgattttgtcatttttcaagttgtcaactgcatgtttctcattttctatgattttcagttttcttgctatattccatgtcctacagtggaaatttctaaattttccacctttttcagttttcctcgccatatttcacgtcctaaagtgtgtatttctcattttccgtgattttcagttttctcgccatattccaggtcctatgtgtacatttctcatttttcacgtttttcagtgattttgtcatttttcaagttgtgaagtggatgtttctcatttttcttgattttcatttttcttgccatattccatgtcctagagtggaaatttttaaattttccacctttttcagttttcctcgccatatttcacgtcctaaagtgtgaatttctcattttccgtgattttcagatttctcgccatattccaagtcctacagtgtgcatttctcatttttcacgtttttcagtgatttcgtcatttttcaagttgtcaagtggatgtttctcattttccatgattttcagctttcttgccatattcaaagtcctacagtggacatttctaaattttcgacctttatcagttttcctcgccatatttcatgtcccaaagtgtgtacttctcattttccgtgattttcagtttcctagccatattctaggtcctacagtgtgcatttctcatttttcaggtttttcagtgatttcgtcttttttcaagtcgtcaagtggatgtttctcattttccatgattttcacttttcttgccatatttcatgtcctaaagtgtgtatttctcattttcagtgattttcagttttctcgctatattccaggtcctacagtgtgcatttctcattttttcacgtttttcagtgatttcgtcatttttcacgttgtcaagtggatgtttctcattttccatgattttcacttttcttgccatatttcatgtcctacagtggacatttctaaattttccacctttttctgttttcctcgccatatttcacatcctaaagtgtgtatttctcattttccgtgattttcagttttcttgccatattccaggtcctacagtgtgcatttctcatttttcacgtttttcagtgatttcgtcatttttcaagttgtcaagtggatgtttctcattttccttgattttcagttttcttgccatattccatgtcctactgtggacatttctaaattttccacctttttcagttttccttgccatatttcatgtcctaaagtgtgtatttctcattttcagtgattttcagttttctcgcaatattccaggtcctacagtgtgcatttctcattttttcaggtttttcagtgatttcgtcatttttcacgttgtcaagtggatgtttctcattttccatgattttcacttttcttgccatatttcatgtcctaaagtgtgtatttctcattttcagtgattttcagttttctgccatattccaggtcctacattgtgcatttctcattttttcacgtttttcagtgatttcgtcatttttcacgttgtcaagtggatgtttctcattttccatgattttcacttttcttgccatatttcatgttttacagtggacatttctaaattttccacctttttctgttttcctcgccatatttcacatcctaaagtgtgtatttctcattttccgtgattttcagttttctcgccatatgccaggtcatacagggtgcatttctcatttttcacgtttttcagtgatttcgtcatttttcacgtcgtcaagtggatgtttctcattttcaatgattttcatttttcttgccatattccacgtcctatagtggacatttctaaattttccacctttttcagttttccttgccatatttcaggtcctacagtgtgcatttctcatttttcacgtttttcagtgatttcgtcatttttcaagtggtcaagtgcatgtttctcattttccgtgattttcagttttcttgccatgttccaggtcctacagttgacgtttctaaaatttcactttttttaagttttcctcgccatatttcacttcctaaagtgtgtatttctcattttccgtgattttcagttttctcgccagattccaggtcctacagtgtgcatttttcatatttcacctttttcagtgattttgtcatttttcaagttgtcaactgcatgtttctcattttccatgattttcagttttcttgccatattccatgtcctactgtggacatttctaaattttccaactttttcagttttcctcgccatatttcatgtcctaaagtgtgtatttctcattttcagtgattttctgttttctcgccatattccaggtcctacagtgtgcatttctaatttttcacgtttttcagtgatttcgtcatttttcaagttgtcaagtggatgtttctcattttccatgattttcagttttcttgccatattccatgtcctacagtggacatttctaaattttccaactttttccattttcctcaccatatttcacgtcctaaagtgtgtttttctcattttttgtgattttcagttttctcgacatattccaggtcctacagtgtgcatttctaattttttcttttttcagtgatttcgtcatttttcaagttgtcaactgcatgtttctcattttccatgattttcagttttcttgccatattccatgtcttacagtggacatttttaaatttttcacatttttttaagttttcctccccatatttcacgttttaaagtgtgcatttctcattttcggtgattttcagttttctcgccagattccaggtcttacagtgtgcatttctcattttttcacgtttttcagtgatttcgtcatttttcaagtcgtcaagtggatgtttctcattttccatgattttcagttttcttgccatattccatgtcctacagtggaaatttctaaattttccacctttttcagttttccttgccatatttcaggtcctaaagtgtgtatttctcattttctgtgattttcagttttctcgccatattccaggtcctacagttgacatttctaaaatttccacattttttaagttttcctcgccatatttcacttcctaaagtgtgtatttctcattttccgtgattttcagttttctcgccatattccagatcctacagtgtgcatttttcatttttcacgtttttcagtgattttgtcattttttagttgtcaactgtctgtttctcattttccatgattttcagttttcttgccatattccatgtcctacactggacatttctaaattttccacctttttctgttttcctcgccatatttcacgtcctaaagtgtgtatttctcattttccgtgattttcagttttcttgccatattccaggtcctacagtgtgcatttctcatttttcacgtttttcagtgattttgtcatttttcaagttgtcaactgcatgtttctcattttccatgattttcagttttcttgctatattccatgtcctacagtggaaatttctaaattttccacctttttcagttttcctcgccatatttcacgtcctaaagtgtgtatttctcattttccgtgattttcagttttctcgccatattccaggtcctatgtgtacatttctcatttttcacgtttttcagtgattttgtcatttttcaagttgtgaagtggatgtttctcatttttcttgattttcatttttcttgccatattccatgtcctagagtggaaatttttaaattttccacctttttcagttttcctcgccatatttcacgtcctaaagtgtgaatttctcattttccgtgattttcagatttctcgccatattccaagtcctacagtgtgcatttctcatttttcacgtttttcagtgatttcgtcatttttcaagttgtcaagtggatgtttctcattttccatgattttcagctttcttgccatattcaaagtcctacagtggacatttctaaattttcgacctttatcagttttcctcgccatatttcatgtcccaaagtgtgtacttctcattttccgtgattttcagtttcctcgccatattctaggtcctacagtgtgcatttctcatttttcaggtttttcagtgatttcgtcttttttcaagtcgtcaagtggatgtttctcattttccatgattttcagttttcttgccatattccatgtcctacagtggacatttctaaattttccacctttttcagttttcctcgccatatttcatgtcctaaagtgtgtatttctcattttcagtgattttcagttttctcgccatattccaggtcctacagtgtgcatttctcatttttcacgtttttcagtgatttcgtcatttttcaagttgtcaagtggatgtttctcattttccatgattttcagttttcttgccatattccatgtcccacagtggacatttctaaattttccacctttttctgttttccttgccatatttcatgtcctaaagtgtgtatttctcattttccgtgattttcagttttcttgctatattccaagtcctacagtgtgcatttctcatttttcacgtttttcagtgattttgtcatttttcaatttgtcaactgcatgtttctcattttccatgattttcagttttcttgccatattccatgtcctacagtggaaatttctatattttccaactttttcagttttcctcgccatatttcacgtgctaaagtgtgtatttctcatttttcgtgtttttcaggtttctcgccatattccaggtcctacagtgtgcatttctcatttttcacgtttttcagtgattttgtcatttttcaagttgtcaagtggatgtttctcattttccttgattttcagttttcttgccatattccatgtcctacagtggacatttctaaattttccacctttttcagttttccttgccatatttcatgtcctaaagtgtgtatttctcattttcagtgattttcagttttctcgccatattccaggtcctacagtgtgcatttctcattttttcaggtttttcagtgatttcgtcatttttcacgttgtcaagtggatgtttctcattttccatgattttcacttttcttgccatatttcatgtcctaaagtgtgtatttctcattttcagtgattttcagttttctcgctatattccaggtcctacagtgtgcatttctcattttttcacgtttttcagtgatttcgtcatttttcacgttgtcaagtggatgtttctcattttccatgattttcacttttcttgccatatttcatgtcctacagtggacatttctaaattttccacctttttctgttttcctcgccatatttcacatactaaagtgtgtatttctcattttccttgattttcagttttcttgccatattccaggtcctacagtgtgcatttctcatttttcacgtttttcagtgatttcgtcatttttcaagtcgtcaagtggatgtttctcattttccatgattttcagttttctcgccatattccaggtcctacagttgacatttctaaattttccacattttttaagtttcctcgcgatatttcacatcctaaagtgtgtatttctcattttccgtgattttcagttttcttgccatattccaggtcctacagggtgcatttctcatttttcacgtttttcagtgatttcatcaatttcaagtcgtcaactgtatgtttctcattttcaatgattttcatttttcttgccatattccatgtcctacagtggacatttctaaatttttcacctttttcagttttccttgccatatttcatgtcctaaagtgtgtatttctcattttcagtgattttcagttttctcgccatattccaggtcctacagtgtgcatttctcattttttcaggtttttcagtgatttcgtcatttttcacgttgtcaagtggatgtttctcattttccatgattttcacttttcttgccatatttcatgtcctaaagtgtgtatttctcattttcagtgattttcagttttctcgccatattccaggtcctacagtgtgcatttctcatttttcacgtttttcagtgatttcgtcatttttcaagttgtcaagtggatgtttctcattttccatgattttcacttttcttgccatattccatgtcccacagtggacatttctaaattttccacctttttctgttttcctcgccatatttcatgtcctaaagtgtgtatttctcattttccgtgattttcagttttcttgctatattccaagtcctacagtgtgcatttctcatttttcacgtttttcagtgattttgtcatttttcaatttgtcaactgcatgtttctcattttccatgattttcagttttcttgccatattccatgttctacagtggaaatttctatattttccaactttttcagttttcctcgccatatttcacgtgctaaagtgtgtatttctcatttttcgtgtttttcaggtttctcgccatattccaggtcctacagtgtgcatttctcatttttcacgtttttcagtgattttgtcatttttcaagttgtcaagtggatgtttctcattttccttgattttcagttttcttgccatattccatgtcctacagtggacatttctaaattttccacctttttcagttttccttgccatatttcatgtcctaaagtgtgtatttctcattttcagtgattttcagttttctcgccatattccaggtcctacagtgtgcatttctcattttttcaggtttttcagtgatttcgtcatttttcacgttgtcaagtggatgtttctcattttccatgattttcacttttcttgccatatttcatgtcctaaagtgtgtatttctcattttcagtgattttcagttttctcgctatattccaggtcctacagtgtgcatttctcattttttcacgttttgcagtgatttcgtcatttttcacgttgtcaagtggatgtttctcattttccatgattttcacttttcttgccatatttcatgtcctacagtggacatttctaaattttccacctttttctgttttcctcgccatatttcacatcctaaagtgtgtatttctcattttccgtgattttcagttttcttgccatattccaggtcctacagtgtgcatttctcatttttcacgtttttcagtgatttcgtcatttttcaagtcgtcaagtggatgtttctcattttccatgattttcagttttctcgccatattccaggtcctacagttgacatttctaaattttccacattttttaagtttcctcgcgatatttcacatcctaaagtgtgtatttctcattttccgtgattttcagttttcttgccatattccaggtcctacagggtgcatttctcatttttcacgtttttcagtgatttcatcaatttcaagtcgtcaactgtatgtttctcattttcaatgattttcatttttcttgccatattccatgtcctacagtggacatttctaaattttccacctttttcagttttccttgccatatttcatgtcctaaagtgtgtatttctcattttcagggattttcagttttctcgccatattccaggtcctacagtgtgcatttctcattttttcaggtttttcagtgatttcgtcatttttcacgttgtcaagtggatgtttctcattttccatgattttcacttttcttgccatatttcatgtcctaaagtgtgtatttctcattttcagtgattttcagttttctcgccatattccaggtcctacagtgtgcatttctcattttttcacgtttttcagtgatttcgtcatttttcacgttgtcaagtggatgtttctcattttccatgattttcacttttcttgccatatttcatgtcctacagtggacatttctaaattttccacctttttctgttttcctcgccatatttcacatcctaaagtgtgtatttctcattttccgtgattttcagttttcttgccatattccaggtcctacagtgtgcatttctcatttttcacgtttttcagtgatttcgtcatttttcaagtcgtcaagtggatgtttctcattttccatgattttcagttttctcgccatattccaggtcctacagttgacatttctaaattttccacattttttaagtttcctcgcgatatttcacatcctaaagtgtgtatttctcattttccgtgattttcagttttcttgccatattccaggtcctacagggtgcatttctcatttttcacgtttttcagtgatttcatcaatttcaagtcgtcaactgtatgtttctcattttcaatgattttcatttttcttgccatattccacgtcctatagtggacatttctaaattttccacctttttcagttttcttcgccatatttcacgtcccaaagtgtgtatttctcattttccgtgattttcagtttcctcgcaatattccaggtcctacagtgtgcatttctcatttttcacgtttttcagtgatttcgtcttttttcaagtcgtcaagtggatgtttctcattttccatgattttcagttttcttgccatattccatgtcctacagtggacatttctaaattttccacctttttctgttttcctcgccatatttcacgtcctaaagtgtgtatttctcattttccgtgattttcagttttcttgccatattccaggtcctacagtgtgcatttctcatttttcacgtttttcactgattttgtcattgttcaagttgtcaactgcatgtttctcattttccatgattttcaattttcttgccatattccatgtcctacagtggaaatttctatattttccaactttttcagttttcctcgccatatttcacgtgctaaagtgtgtatttctcatttttcgtgtttttcaggtttctcgccatattccaggtcctacagtgtgcatttctcatttttcacgtttttcagtgattttgtcatttttcaagttgtcaagtggttgtttctcattttccttgattttcagttttcttgccatattccatgtcctactgtggacatttctaaattttccacctttttcagttttccttgccatatttcatgtcctaaagtgtgtatttctcattttcagtgattttcagttttctcgcaatattccaggtcctacagtgtgcatttctcattttccgtgattttcagttttctcgccatatgccaggtcatacagggtgcatttctcatttttcacgtttttcagtgatttcgtcatttttcacgtcgtcaagtggatgtttctcattttcaatgattttcatttttcttgccatattccacgtcctatagtggacatttctaaattttccaactttttcagttttcttgccatatttcaggtcctacagtgtgcatttctcatttttcacgtttttcagtgatttcgtcatttttcaagtggtcaagtgcatgtttctgattttccgtgattttcagttttcttgccatgttccaggtcctacagttgacgtttctaaaatttcactttttttaagttttcctcgccatatttcacttcctaaagtgtgtatttctcattttccgtgattttcagttttctcgccagattccaggtcctacagtgtgcatttttcatatttcacctttttcagtgattttgtcatttttcaagttgtcaactgcatgtttctcattttccatgattttcagttttcttgccatattccatgtcctactgtggacatttctaaattttccaactttttcagttttcctcgccatatttcatgtcctaaagtgtgtatttctcattttcagtgtttttctgttttctcgccatattccaggtcctacagtgtgcatttctaatttttcacgtttttcagtgatttcgtcatttttcaagttgtcaagtggatgtttctcattttccatgattttcagttttcttgccatattccatgtcctacagtggacatttctaaattttccaactttttccattttcctcaccatatttcacgtcctaaagtgtgtttttctcattttttgtgattttcagttttctcgacatattccaggtcctacagtgtgcatttctaattttttcttttttcagtgatttcgtcatttttcaagtggtcaagtgcatgtttctcattttccatgattttcagttttcttgccatattccatgtcctacaatggacatttctaaattttccaactttttcagttttcctcgccatatttcacgtcctaaagtgtgtatttctcattttccgtgattttcagttttctcgccatattccaggtcctatgtgtacatttctcatttttcacgtttttcagtgattttgtcatttttcaagttgtgaagtggatgtttctcatttttcttgattttcatttttcttgccatattccatgtcctagagtggaaatttttaaattttccaactttttcagttttcctcgccatatttcacgtcctaaagtgtgtatttctcattttccgtgattttcagttttctcgccatattccaagtcctacagtgtgcatttctcatttttcacgtttttcagtgatttcgtcatttttcaagttgtcaagtggatgtttctcattttccatgattttcagctttcttgccatattcaaagtcctacagtggacatttctaaattttcgacctttatcagttttcctcgccatatttcatgtcccaaagtgtgtacttctcattttccgtgattttcagtttcctcgccatattctaggtcctacagtgtgcatttctcatttttcaggtttttcagtgatttcgtcttttttcaagtcgtcaagtggatgtttctcattttccatgattttcagttttcttgccatattccatgtcctacagtggacatttctaaattttccacctttttcagttttcctcgccatatttcatgtcctaaagtgtgtatttctcattttcagtgattttcagttttctcgccatattccaggtcctacagtgtgcatttctcatttttcacgtttttcagtgatttcgtcatttttcaagttgtcaagtggatgtttctcattttccatgattttcagttttcttgccatattccatgtcccacagtggacatttctaaattttccacctttttctgttttccttgccatatttcatgtcctaaagtgtgtatttctcattttccgtgattttcagttttcttgctatattccaagtcctacagtgtgcatttctcatttttcacgtttttaagtgattttgtcatttttcaatttgtcaactgcatgtttctcattttccatgattttcagttttcttgccatattccatgtcctacagtggaaatttctatattttccaactttttcagttttcctcgccatatttcacgtgctaaagtgtgtatttctcatttttcgtgtttttcaggtttctcgccatattccaggtcctacagtgtgcatttctcatttttcacgtttttcagtgattttgtcatttttcaagttgtcaagtggatgtttctcattttccttgattttcagttttcttgccatattccatgtcctacagtggacatttctaaattttccacctttttcagttttccttgccatatttcatgtcctaaagtgtgtatttctcattttcagtgattttcagttttctcgccatattccaggtcctacagtgtgcatttctcattttttcaggtttttcagtgatttcgtcatttttcacgttgtcaagtggatgtttctcattttccatgattttcacttttcttgccatatttcatgtcctaaagtgtgtatttctcattttcagtgattttcagttttctcgccatattccaggtcctacagtgtgcatttctcattttttcacgtttttcagtgatttcgtcatttttcacgttgtcaagtggatgtttctcattttccatgattttcacttttcttgccatatttcatgtcctacagtggacatttctaaattttccacctttttctgttttcctcgccatatttcacatcctaaagtgtgtatttctcattttccgtgattttcagttttcttgccatatttcaggtcctacagtgtgcatttctcatttttcacgtttttcagtgatttcgtcatttttcaagtcgtcaagaggatgtttctcattttccatgattttcagttttctcgccatattccaggtcctacagttgacatttctaaattttccacattttttaagtttcctcgcgatatttcacatcctaaagtgtgtatttctcattttccgtgattttcagttttcttgccatattccaggtcctacagggtgcatttctcatttttcacgtttttcagtgatttcatcaatttcaagtcgtcaactgtatgtttctcattttcaatgattttcatttttcttgccatattccacgtcctatagtggacatttctaaattttccacctttttctgttttcctcgccatatttcacgtcctaaagtgtgtatttctcattttccgtgattttcagttttcttgccatattccaggtcctacagtgtgcatttctcatttttcacgtttttcactgattttgtcattgttcaagttgtcaactgcatgtttctcattttccatgattttcagttttcttgccatattccatgtcctacagtggaaatttctatattttccacctttttcagttttcctcgccgtatttcatgtgctaaagtgtgtatttctcatttttcgtgtttttcaggtttctcgccatattccaggtcctacagtgtgcatttctcatttttcacgtttttcagtgattttgtcatttttcaagttgtcaactggatgtttctcattttccttgattttcagttttcttgccatattccatgtcctactgtggacatttctaaattttccacctttttcagttttccttgccatatttcatgtcctaaagtgtgtatttctcattttcagtgattttcagttttctcgcaatattccaggtcctacagtgtgcatttctcattttttcaggtttttcagtgatttcgtcatttttcacgttgtcaagtggatgtttctcattttccatgattttcacttttcttgccatatttcatgtcctaaagtgtgtatttctcattttcagtgattttcagttttctcgccatattccaggtcctacattgtgcatttctcattttttcacgtttttcagtgatttcgtcatttttcacgttgtcaagtggatgtttctcattttccatgattttcacttttcttgccatatttcatgttttacagtggacatttctaaattttccacctttttctgttttcctcgccatatttcacatcctaaagtgtgaatttctcattttccgtgattttcagttttcttgccatattccaggtcctacagtgtgcatttctcatttttcacgtttttcagtgatttcatcatttttcaagtcgtcaagtggatgtttctcattttccatgattttcagttttcttgccatattccatgtcctacagtggacatttctaaattttccacctttttctgttttcctcgccatatttcacgtcctaaagtgtgtatttctcattttccgtgattttcagttttcttgccatattccaggtcctacagtgtgcatttctcatttttcacgtttttcactgattttgtcatttttcaagttgtcaactgcatgtttctcattttccatgattttcagttttcttgctatattccatgtcctacagtggaaatttctaaattttccacctttttcagttttcctcgccatatttcacgtcctgaagtgtgtatttctcattttccgtgattttcagttttctcgccatattccaggtcctatgtgtacatttctcatttttcacgtttttcagtgattttgtcatttttcaagttgtgaagtggatgtttctcatttttcttgattttcatttttcttgccatattccatgtcctacagtggaaatttctaaattttccacctttttcagttttcctcgccatatttcacgtcctaaagtgtgtatttctcattttccgtgattttcagttttctcgccatattccaggtcctacagtgtgcatttctcatttttcacgtttttcagtgatttcgacatttttcaagttgtcaagtggatgtttctcattttccatgattttcagctttcttgccatattcaaagtcctacagtggacatttctaaattttcgacctttatcagttttcctcgccatatttcatgtcccaaagtgtgtacttctcattttccgtgattttcagtttcctcgccatattccaggtcctacagtgtgcatttctcatttttcacgtttttcagtgatttcgtcatttttcaagtcgtcaagtggatgtttctcattttccatgattttcagttttcttgccatattccatgtcctacagtggacatttctaaattttccacctttttctgttttcctcgccatatttcacgtcctaaagtgtgtatttctcattttccgtgattttcagttttcttgccatattccaggtcctacagtgtgcatttctcatttatcacgtttttcactgattttgtcatttttcaagttgtcaactgcatgtttctcattttccatgattttcagttttcttgctatattccatgtcctacagtggaatattctaaattttccacctttttcagttttcctcgccatatttcacgtcctgaagtgtgtatttctcattttccgtgattttcagttttctcgccatattccaggtcctatgtgtacatttctcatttttcacgtttttcagtgattttgtcatttttcaagttgtgaagtggatgtttctcatttttcttgattttcatttttcttgccatattccatgtcctacagtggaaatttctaaattttccacctttttcagttttcctcgccatatttcacgtcctaaagtgtgaatttctcattttccgtgattttcagttttctcgccatattccaggtcctacagtgtgcatttctcatttttcacgtttttcagtgatttcgacatttttcaagttgtcaagtggatgtttctcattttccatgattttcagctttcttgccatattcaaagtcctacagtggacatttctaaattttcgacctttatcagttttcctcgccatatttcatgtcccaaagtgtgtacttctcattttccgtgattttgagtttcctcgccatattccaggtcctacagtgtgcatttctcatttttcacgtttttcagtgatttcgtcttttttcaagttgtcaactgcatgtttctcattttccatgattttcagttttcttgccatattccatgtcctacagtggaaatttgtaaatttccacctttttcagttttcctcgccatatttcacgtcctaaagtatgtatttctcattttccgtgattttcagttttctcgccatattccaggtcctacagtgtgcatttctcatttttcacgtttttcagtgattttgtcattttttaagttttcaagtggatgtttctcattttccttgattttcagttttcttgccatattccatgtcctacagtggacatttctaaattttccacctttttcagttttcctcgccatatttcatgtcctaaagtgtgtatttctcattttcagtgattttcagttttctcgccatattccaggtcctacagtgtgcatttctcatttttcacgtttttcagtgatttcgtcatttttcaaggtgtcaagtggatgtttctcattttccatgattttcagttttcttgccatattccatgtcctacagtggacatttctaaattttccacctttttctgttttcctcgccatatttcatgtcctaaagtgtgtatttctcattttccgtgattttcagttttcttgctatattccaagtcctacagtgtgcatttctcatttttcacgtttttcagtgattttgtcatttttcaatttgtcaactgcatgtttctcattttccatgattttcagtttttttgccatattccatgtcctactgtggaaatttctatattttccacctttttcagttttcctcgccatatttcacgtgctaaagtgtgtatttctcatttttcgtgtttttcaggtttctcgccatattccaggtcctacagtgtgcatttctcatttttcacgtttttcagtgattttgtcatttttcaagttttcaagtggatgtttctcattttccttgattttcagttttcttgccatattccatgtcctacagtggacatttctaaattttccacctttttcagttttccttgccatatttcatgtcctaaagtgtgtatttctcattttcagtgattttcagtttccttgccatattccaggtcctacagtgtgcatttctcattttttcacgtttttcagtgatttcgtcatttttcacgttgtcaagtggatgtttctcattttccatgattttcacttttcttgccatatttcatgtcctacagtggacatttctaaattttccaactttttcaattttcctcgccatattttatgtcctaaagtgtgtatttctcatttttcgttattttcagttttcttgccatattccaggtcctacagtgtgcatttgtcatttttcacgtttttcagtgatttcgtcatttttcaagtcgtcaagtagatgtttctcatattccatgtttttcagttttctcgccatattccaggtcctacagttgacatttctaaattttctacatttttaaattttcctcgccatatttcacgtcctaaagtgtgtatttctcattttttgttattttcagttttctagccatattccaggtcctacaggatgcatttctcatttttcacgtttttcagtgatttcatcatttttcaagtcgtcaagtgtatgtttcttattttcaatgattttcatttttcttgccttattccacgtcctatagtggacatttctaaattttccacctttttcagtttttttcgccatatttcacgtcctaaagtgtgtatttctcattttctgtgattttcagttttctcaccatattccaggtcctacagtgtgcatttctcatttttcacgtttttcagtgatttcgtcatttttcaagttgtcaagtggaagtttctcattttccatgattttcagctttctagacatattccaggtcctacagtggacatttcctaattttcgacctttatcagttttcctcgtcatatttcacgtcccaaaatgtgtatttcttattttccatgattttcagtttcctcgccatattccaggtcctacagtgtgcaattctcatttttcacgtttttcagtgatttcgtcttttttcaagacgtcaagtggatgtttctcatttttcatgattttcagttttcttgccatattccatgtcctacagtggacatttctaaattttccacctttttctgttttcctcgccatatttcacgtcctaaagtgtgtatttctcattttccgtgattttcagttttcttgccatattcctggtcctacagtgtgcatttctcatttttcacgtttttcagtgattttgtcatttttcaatttgtcaactgcatgtttctcattttccattattttcagttttcttgccatattccatgtcctacagtggacatttctaaattttccacctttttctgttttcctcgccatatttcatgtcctaaagtgtgtatttctcattttccgtgattttcagttttcttgctatattccaagtcctacagtgtgcatttctcatttttcacgtttttcagtgattttgtcatttttcaatttgtcaactgcatgtttctcattttccatgattttcagtttttttgccatattccatgtcctacaggggaaatttctatattttccacctttttcagttttcctcgccatatttcatgtcctaaagtgtgtatttctcattttccgtgattttcagttttcttgccatattccaggtcctacagtgtgcatttctcatttttcacgtttttcagtgatttcgtcatttttcaagtcttcaagtagatgtttctcatattccatgtttttcagttttctcgccatattccaggtcctacagttgacatttctaaattttctacatttttaaattttcctcgccatatttcacgtcctaaagtgtgtatttctcatttttcgttattttcagttttctagccatattccaggtcctacaggatgcatttctcatttttcacgtttttcagtgatttcatcatttttcaagtcgtcaagtgtatgtttctcattttcaatgattttcatttttcttgccttattccacgtcctatagtggacatttctaaattttccacctttttcagtttttctcgccatatttcacgtcctaaagtgtgtatttctcattttctgtgattttcagttttctcaccatattccaggtcctacagtgtgcatttctcatttttcacgtttttcagtgatttcgtcatttttcaagttgtcaagtggaagtttctcattttccatgattttcagctttctagccatattccaggtcctacagtggacatttcctaattttcgacctttatcagttttcctcgccatatttcacgtcctaaagtgtgtatttctcattttccgtgattttcagttttcttgccatattccaggtcctacagtgtgcatttctcatttttcacgtttttcagtgattttgtcatttttcaatttgtcaactgcatgtttctcattttccatgatttttagttttcttgctatattccatgtcctacagtggaaatttctaaattttccacctttttcagttttcctcgccatatttcacgtcctaaagtgtgtatttctcattttccgtgattttcagttttcttgctatattccaagtcctacattgtgcatttctcatttttcacgtttttcagtgattttgtcatttttcaatttgtcaaaccacatgtttctcattttccatgattttcagtttttttgccatattccatgtcctacagtggaaatttctatattttccacctttttcagttttcctcgccatatttcacgtgctaaagtgtgtatttctcatttttcgtgtttttcaggtttctcgccatattccaggtcctacagtgtgcatttctcatttttcacgtttttcagtgattttgtcatttttcaagttgtcaagtggatgtttcccattttccttgattttcagttttcttaccatattccatgtcctacagtggacatttctaaattttccacctttttcagttttccttgccatatttcatgtcctaaagtgtgtatttctcattttcagtgattttcagtttcctcgccatattccaggtcctacagtgtgcatttctcattttttcacgtttttcagtgatttcgtcatttttcacgttgtcaagtggatgtttctcattttccatgattttcacttttcttgccatatttcatgtcctatagtggacatttctaaattttccacctttttcagtttttctcgccatatttcacgtcctaaagtgtgtatttctcattttctgtgattttcagttttctcaccatattccaggtcctacagtgtgcatttctcatttttcacgtttttcagtgatttcgtcatttttcaagtcgtcaagtagatgtttctcatattccatgtttttcagttttctcgccatattccaggtcctacagttgacatttctaaattttctacatttttaaattttcctcgccatatttcacgtcctaaagtgtgtatttctcatttttcgttattttcagttttctagccatattccaggtcctacaggatgcatttctcatttttcacgtttttcagtgatttcatcatttttcaagtcgtcaagtgtatgtttcttattttcaatgattttcatttttcttgccttattccacgtcctatagtggacatttctaaattttccaccttttttcagtttttctcgccatatttcacgtcctaaagtgtgtatttctcattttctgtgattatcagttttctcaccatattccaggtcctacagtgtgcatttctcatttttcacgtttttcagtgatttcgtcatttttcaagttgtcaagtggaagtttctcattttccatgattttcagctttctagccatattccaggtcctacagtggacatttcctaattttcgacctttatcagttttcctcgccatatttcacgtcccaaaatgtgtatttcttattttccatgattttcagtttcctcgccatattccaggtcctacagtgtgcatttctcatttttcacgtttttcagtgatttcgtcttttttcaagacgtcaagtggatgtttctcatttttcatgattttcagttttcttgccatattccatgtcctacagtggacatttctaaattttccacctttttctgttttcctcgccatatttcacgtcctaaagtgtgtatttctcattttccgtgattttcagttttcttgccatattcctggtcctacagtgtgcatttctcatttttcacgtttttcagtgattttgtcatttttcaatttgtcaactgcatgtttctcattttccatgattttcagttttcttgccatattccatgtcctacagtggacatttctaaattttccacctttttcagttttcctcgccatatttcacgtgctaaagtgtgtatttctcatttttcgtgtttttcaggtttctcgccatattccaggtcctacagtgtgcatttctcatttttcacgtttttcagtgattttgtcatttttcaagttgtcaagtggatgtttctcattttccttgattttcacttttcttgccatattccaagtcttacaggggcatttctcatttttcacgttttcagtgattttgtcattttcaatttgtcaactgcatgtttctcattttccatgattttcagtttttttgccatattccatgtcctacaggggaaatttctatattttccacctttttcagttttcctcgccatatttcatgtcctaaagtgtgtatttctcattttccgtgattttcagttttcttgccatattccaggtcctacagtgtgcatttctcatttttcacgtttttcagtgatttcgtcatttttcaagtcttcaagtagatgtttctcatattccatgtttttcagttttctcgccatattccaggtcctacagttgacatttctaaattttctacatttttaaattttcctcgccatatttcacgtcctaaagtgtgtatttctcatttttcgttattttcagttttctagccatattccaggtcctacaggatgcatttctcatttttcacgtttttcagtgatttcatcatttttcaagtcgtcaagtgtatgtttctcattttcaatgattttcatttttcttgccttattccacgtcctatagtggacatttctaaattttccacctttttcagtttttctcgccatatttcacgtcctaaagtgtgtatttctcattttctgtgattttcagttttctcaccatattccaggtcctacagtgtgcatttctcatttttcacgtttttcagtgatttcgtcatttttcaagttgtcaagtggaagtttctcattttccatgattttcagctttctagccatattccaagtcctacagtggacatttcctaattttcgacctttatcagttttcctcgccatatttcacgtcccaaaatgtgtattccttattttccatgattttcagtttcctcgccatattccaggtcctacagtgtgcatttatcatttttcacgtttttcagtgatttcgtcttttttcaagacgtcaagtggatgtttctcatttttcatgattttcagttttcttgccatattccatgtcctacagtggacatttctaaattttccacctttttctgttttcctcgccatatttcacgtcctaaagtgtgtatttctcattttccgtgattttcagttttcttgccatattcctggtcctacagtgtgcatttctcatttttcacgtttttcagtgattttgtcatttttcaagttgtcaagtggatgtttctcattttccttgattttcacttttcttgccatattccatgtcctacagtggacatttctatattttccacctttttccgttttccttgccatatttcacgtcctaaagtgtgtatttctcattttccgtgattttcaggtttctcgccatattccaggtcctacagtgtgcatttctcatttttcacgtttttcagtgattttgtcatttttcaagttgtcaagtggatgtttctcattttccttgattttcacttttcttgccatattccatgtcctacagtggacatttctaaattttccacctttttcagttttcctcgccatatttcatgtcctaaagtgtgtatttctcattttcagtgattttcagttttcttgccatattccaggtcctacagtgtgcatttctcatttttcacgtttttcagtgattttgtcatttttcaagttgtcaactgcatgtttctcattttctatgattttcagttttcttgctatattccatgtcctacagtggaaatttctaaattttccacctttttcagttttcctcgccatatttcacgtcctaaagtgtgtatttctcattttccgtgattttcagttttctcgccatattccaggtcctatgtgtacatttctcatttttcacgtttttcagtgattttgtcatttttcaagttgtgaagtggatgtttctcatttttcttgattttcatttttcttgccatattccatgtcctagagtggaaatttttaaattttccacctttttcagttttcctcgccatatttcacgtcctaaagtgtgaatttctcattttccgtgattttcagatttctcgccatattccaagtcctacagtgtgcatttctcatttttcacgtttttcagtgatttcgtcatttttcaagttgtcaagtggatgtttctcattttccatgattttcagctttcttgccatattcaaagtcctacagtggacatttctaaattttcgacctttatcagttttcctcgccatatttcatgtcccaaagtgtgtacttctcattttccgtgattttcagtttcctcgccatattctaggtcctacagtgtgcatttctcatttttcaggtttttcagtgatttcgtcttttttcaagtcgtcaagtggatgtttctcattttccatgattttcacttttcttgccatatttcatgtcctaaagtgtgtatttctcattttcagtgattttcagttttctcgctatattccaggtcctacagtgtgcatttctcattttttcacgtttttcagtgatttcgtcatttttcacgttgtcaagtggatgtttctcattttccatgattttcacttttcttgccatatttcatgtcctacagtggacatttctaaattttccacctttttctgttttcctcgccatatttcacatcctaaagtgtgtatttctcattttccgtgattttcagttttcttgccatattccaggtcctacagtgtgcatttctcatttttcacgtttttcagtgatttcgtcatttttcaagttgtcaagtggatgtttctcattttccttgattttcagttttcttgccatattccatgtcctactgtggacatttctaaattttccacctttttcagttttccttgccatatttcatgtcctaaagtgtgtatttctcattttcagtgattttcagttttctcgcaatattccaggtcctacagtgtgcatttctcattttttcaggtttttcagtgatttcgtcatttttcacgttgtcaagtggatgtttctcattttccatgattttcacttttcttgccatatttcatgtcctaaagtgtgtatttctcattttcagtgattttcagttttcctcgccatatttcacgtcccaaaatgtgtatttcttattttccatgattttcagtttcctcgccatattccaggtcctacagtgtgcatttctcatttttcacgtttttcagtgatttcgtcttttttcaagacgtcaagtggatgtttctcatttttcatgattttcagttttcttgccatattccatgtcctacagtggacatttctaaattttccacctttttctgttttcctcgccatatttcacgtcctaaagtgtgtatttctcattttccgtgattttcagttttcttgccatattcctggtcctacagtgtgcatttctcatttttcacgtttttcagtgattttgtcatttttcaatttgtcaactgcatgtttctcattttccatgattttcagttttcttgccatattccatgtcctacagtggacatttctaaattttccacctttttcagttttcctcgccatatttcacgtgctaaagtgtgtatttctcatttttcgtgtttttcaggtttctcgccatattccaggtcctacagtgtgcatttctcatttttcacgtttttcagtgattttgtcatttttcaagttgtcaagtggatgtttctcattttccttgattttcacttttcttgccatattccatgtcctacagtggacatttctaaattttccacctttttcagttttcctcgccatatttcatgtcctaaagtgtgtatttctcattttcagtgattttcagttttctcgccatattccaggtcctacagtgtgcatttctcatttttcacgtttttcagtgatttcgtcttttttcaagacgtcaagtggatgtttctcattttccatgattttcagttttcttgccatattccatgtcctacagtggacatttctaaattttccacctttttctgttttcctcgccatatttcacgtcctaaagtgtgtatttctcattttccgtgattttcagttttcttgccatattccaggtcctacagtgtgcatttctcatttttcacgtttttcagtgattttgtcatttttcaatttgtcaactgcatgtttctcattttccatgatttttagttttcttgctatattccatgtcctacagtggaaatttctaaattttccacctttttcagttttcctcgccatatttcacgtcctaaagtgtgtatttctcattttccgtgattttcagttttcttgctatattccaagtcctacattgtgcatttctcatttttcacgtttttcagtgattttgtcatttttcaatttgtcaaaccacatgtttctcattttccatgattttcagtttttttgccatattccatgtcctacagtggaaatttctatattttccacctttttcagttttcctcgccatatttcacgtgctaaagtgtgtatttctcatttttcgtgtttttcaggtttctcgccatattccaggtcctacagtgtgcatttctcatttttcacgtttttctgtgattttgtcatttttcaagttgtcaagtggatgtttctcattttccttgattttcagttttcttaccatattccatgtcctacagtggacatttctaaattttccaccttttctgttttcctcgccatatttcatgtcctaaagtgtgtatttctcattttccgtgattttcatttttcttgctatattccaagtcctacagtgtgcatttctcattttccatgattttcagttttcttgctatattccatgtcctacagtggaaatttctaaattttccacctttttcagttttcctcgccatatttcacgtcctaaagtgtgtatttctcattttccgtgattttcagttttttcgccatattacaggtcctatgtgtacatttctcatttttcacgtttttcagtgattttgtcatttttcaagttgtcaagtggatgtttctcatttttcttgattttcatttttcttgccatattccatgtcctacagtggaaatttctaaattttccacctttttcagttttcctcgccatatttcacgtcctaaagtgtgaatttctcattttccgtgattttcagttttctcgccatattccaggtctacagtgtgcatttctcatttttcacgttttcagtgattcgtcatttttcaagttgacaagtggatgtttctcattttccatgattttcagctttcttgccatattcaaagtcctacagtggacatttctaaattttcgacctttatcagttttcctcgccatatttcatgtcccaaagtgtgtacttctcattttccgtgattttcagttttcttgccatattccaagtcctacagtgtgcatttctcatttttcacgtttttcagtgattttgtcatttttcaatttgtcaactgcatgtttctcattttccatgattttcagttttcttgccatattccatgtcctacagtggaaatttctatattttccacctttttcagttttcctcgccatatttcacgtgctaaagtgtgtatttctcatttttcgtgtttttcaggtttctcgccatattccaggtcctacagtgtgcatttctcatttttcacgtttttcagtgattttgtcatttttcaagttgtcaagtggatgtttctcattttcaatgattttcatttttcttgccttattccacgtcctatagtggacatttctaaattttccacctttttcagtttttctcgccatatttcacgtcccaaaatgtgtattccttattttccatgattttcagtttcctcgccatattccaggtcctacagtgtgcatttctcatttttcacgtttttcagtgatttcgtcttttttcaagacgtcaagtggatgtttctcatttttcatgattttcagttttcttgccatattccctgtcctacagtggacatttctaaattttccacctttttctgttttcctcgccatatttcacgtcctaaagtgtgtatttctcattttccgtgattttcagttttctcgccagattccaggtcctacagtgtgcatttctcatttttcacgtttttcagtgattttgtcatttttcaatttgtcaactgcatgtttctctctttccatgattttcagttttcttgccatattccatgtcctacagtggacatttctaaattttccacctttttcagttttcctcgccatatttcacgtgctaaagtgtgtatttctcatttttcgtgtttttcaggtttctcgccatattccaggtcctacagtgtgcatttctcatttttcacgtttttcagtgattttgtcatttttcaagttgtcaagtggatgtttctcattttcaatgattttcatttttcttaccttattccacgtcctatagtggacatttctaaattttccacctttttcagtttttctcgccatatttcacgtcccaaaatgtgtattccttattttccatgattttcagtttcctcgccatattccaggtcctacagtgtgcatttctcatttttcacgtttttcagtgatttcgtcttttttcaagacgtcaagtggatgtttctcatttttcatgattttcagttttcttgccatattccctgtcctacagtggacatttctaaattttccacctttttctgttttcctcgccatatttcacgtcctaaagtgtgtatttctcattttccgtgattttcagttttctcgccagattccaggtcctacagtgtgcatttctcatttttcacgtttttcagtgatttcgtcatttttcaagtcttcaagtgtatgtttctcattttcaatgattttcatttttcttgccttattccacgtcctatagtggacatttctaaattttccacctttttcagtttttctcgccatatttcacgtcctaaagtgtgtatttctcattttctgtgattttcagttttcttaccatattccaggtcctacagtgtgcatttctcatttttcacgtttttcagtgatttcgtcatttttcaagttgtcaagtggaagtttctcattttccatgattttcagctttctagccatattccaggtattacagtggacatttccttattttcgacctttatcagttttcctcgccatatttcatgtcctaaagtgtgt	38399	1554	4%	7300	19%
9	3000001	3038400	Atcctacagtgtgcatttctcatttttcacgtttttcagtgatttcgtcatttttcaagtcatcaagtggctgtttctcattttccatgattttcagttttcttgccatattccttgtcctacagtggacatttctaaattttccacctttttcagttttccttgtcatatttcaggtcctacagtgtgtatttctcatttttcacgtttttcattgatttcgtcatttttcaagttgtcaagtgcatgtttctcattttccatgattttcagttttcttgccatattccatgtcctacaatggacatttctaaattttccaactttttcagttttcctcgccatatttcacgtcctaaagtgtgtatttctcattttccgtgattttcagttttctcgacatattccaggtcctacagtgtgcatttctcatttttcacgtttttcagtgatttcgtcatttttcacgtcgtcaagtggatgtttctcattttccatgattttcagttttcttgccatattccatgtcctacagtggacatttctaaattttccacctttttcagttttcctcgccatatttcacgtcctaaagtgtgtatttctcattttccgtgattttcagttttctcgacatattccaggtcttacagggtgcatttctcatttttcacgtttttcagtgatttcatcatttttcaagtcgtcaactgtatgtttctcattttcaatgattttcatttttcttgccatattccacgtcctatagtggacatttctaaattttccacctttttcagttttccttgccatatttcaggtcctacagtgtgcatttctcatttttcacgtttttcagtgatttcgtcatttttcaagtggtcaaatgcatgtttctcattttccatgattttcagttttcttgccatattccatgtcctacagtggacatttctaaattttccacctttttcagttttcctcgccatatttcacgtcctaaagtgtgtatttctcattttccgtgattttcagttttatcgccagattccaggtcctacggtgtgcatttttcatatttcacgtttttcagtgattttgtcatttttcaagttgtcaactgcatgtttctcattttccatgattttcagttttcttgccatattccatgtcctacagtggacatttctaaattttccacctttttcagttttcctcgccatatttcatgtcctaaagtgtgtatttctcattttcagtgattttctgttttctcgccatattccaggtcctacagtgtgcatttctcatttttcacgtttttcagtgatttcgtcatttttcaagttgtcaagtggatgtttctcattttccatgattttcagttttcttgccatattccatgtcctacaatggacatttctaaattttccacctttttcagttttcctcgccatatttcacgtcctaaagtgtgtatttctcattttccgtgattttcagttttctcgccatattccaggtcctatgtgtacatttctcatttttcacgtttttcagtgattttgtcatttttcaagttgtgaagtggatgtttctcatttttcttgattttcatttttcttgccatattccatgtcctagagtggaaatttttaaattttccacctttttcagttttcctcgccatatttcacgtcctaaagtgtgaatttctcattttccgtgattttcagttttctcgccatattccaagtcctacagtgtgcatttctcatttttcacgtttttcagtgatttcgtcatttttcaagttgtcaagtggatgtttctcattttccatgattttcagctttcttgccatattcaaagtcctacagtggacatttctaaattttcgacctttatcagttttcctcgccatatttcatgtcccaaagtgtgtacttctcattttccgtgattttcagtttcctcgccatattctaggtcctacagtgtgcatttctcatttttcaggtttttcagtgatttcgtcttttttcaagtcgtcaagtggatgtttctcattttccatgattttcagttttcttgccatattccatgtcctacagtggacatttctaaattttccaactttttcagttttcctcgccatatttcatgtcctaaagtgtgtatttctcattttcagtgattttcagttttctcgccatattccaggtcctacagtgtgcatttctcatttttcacgtttttcagtgatttcgtcatttttcaagttgtcaagtggatgtttctcatttttcatgattttcagttttcttgccatattccatgtcccacagtggacatttctaaatgttccacctttttctgttttccttgccatatttcatgtcctaaagtgtgtatttctcattttccgtgattttcagttttcttgctatattccaagtcctacagtgtgcatttctcatttttcacgtttttctgtgattttttcatttttcaatttgtcaactgcatgtttctcattttccatgattttcagttttcttgccatattccaggtcctacagtgtgcatttctcatttttcacgtttttcagtgattttgtcatttttcaagttgtcaactgcatgtttctcattttccatgattttcagttttcttgctatattccatgtcctacagtggaaatttctaaattttccacctttttcagttttcctcgccatatttcacgtcctaaagtgtgtatttctcattttccgtgattttcagttttctcgccatattccaggtcctatgtgtacatttctcatttttcacgtttttcagtgattttgtcatttttcaagttgtgaagtggatgtttctcatttttcttgattttcatttttcttgccatattccatgtcctagagtggaaatttttaaattttccacctttttcagttttcctcgccatatttcacgtcctaaattgtgaatttctcattttccgtgattttcagttttctcgccatattccaagtcctacagtgtgcatttctcatttttcacgtttttcagtgatttcgtcatttttcaagttgtcaagtggatgtttctcattttccatgattttcagctttcttgccatattcaaagtcctacagtggacatttctaaattttcgacctttatcagttttcctcgccatatttcatgtcccaaagtgtgtacttctcattttccgtgattttcagtttcctcgccatattctaggtcctacagtgtgcatttctcatttttcaggtttttcagtgatttcgtcttttttcaagtcgtcaagtggatgtttctcattttccatgattttcagttttcttgccatattccatgtcctacagtggacatttctaaattttccacctttttcagttttcctcgccatatttcatgtcctaaagtgtgtatttctcattttcagtgattttcagttttctcgccatattccaggtcctacagtgtgcatttctcatttttcacgtttttcagtgattttgtcatttttcaagttgtcaagtggatgtttctcattttccttgattttcagttttcttgccatattccatgtcctacagtggacatttctaaattttccacctttttcagttttccttgccatatttcatgtcctaaagtgtgtatttctcattttcagtgattttcagttttctcgccatattccaggtcctacagtgtgcatttctcattttttcaggtttttcagtgatttcgtcatttttcacgttgtcaagtggatgtttctcattttccatgattttcacttttcttgccatatttcatgtcctaaagtgtgtatttctcattttcagtgattttcagttttctcgccatattccaggtcctacagtgtgcatttctcattttttcacgtttttcagtgatttcgtcatttttcacgttgtcaagtggatgtttctcattttccattattttcacttttcttgccatatttcatgtcctacagtggacatttctaaattttccacctttttctgttttcctcgccatatttcacatcctaaagtgtgtatttctcattttccgtgattttcagttttcttgccatattccaggtcctacagtgtgcatttctcatttttcacgtttttcagtgatttcgtcatttttcaagtcgtcaagtggatgtttctcattttccatgattttcagttttctcgccatattccaggtcctacagttgacatttctaaattttccacattttttatgtttcctcgcgatatttcacatcctaaagtgtgtatttctcattttccgtgattttcagttttcttgccatattccaggtcctacagggtgcatttctcatttttcacgtttttcagtgatttcatcaatttcaagtcgtcaactgtatgtttctcattttcaatgattttcatttttcttgccatattccacgtcctatagtggacatttctacattttccacctttttcagttttcttcgccatatttcacgtcccaaagtgtgtatttctcattttccgtgattttcagtttcctcgccatattccaggtcctacagtgtgcatttctcatttttcacgtttttcagtgatttcgtcttttttcaagtcgtcaagtggatgtttctcattttccatgattttcagttttcttgccatattccatgtcctacagtggacatttctaaattttccacctttttctgttttcctcgccatatttcacgtcctaaagtgtgtatttctcatttaccgtgattttcagttttcttgctatattccaagtcctacagtgtgcatttctcatttttcacgtttttcactgattttgtcattgttcaagttgtcaactgcatgtttctcattttccatgattttcagttttcttgccatattccatgtcctacagtggaaatttctatattttccaactttttcagttttcctcgccatatttcacgtgctaaagtgtgtatttctcatttttcgtgtttttcaggtttctcgccatattccaggtcctacagtgtgcatttctcatttttcacgtttttcagtgattttgtaatttttcaagttgtcaagtggatgtttctcattttccttgattttcagttttcttgccatattccatgtcctactgtggacatttctaaattttccacctttttcagttttccttgccatatttcatgtcctaaagtgtgtatttctcattttcagtgattttcagttttctcgcaatattccaggtcctacagtgtgcatttctcattttttcaggtttttcagtgatttcgtcatttttcacgttgtcaagtggatgtttctcattttccatgattttcacttttcttgccatatttcatgtgctaaagtgtgtatttctcattttcagtgattttcagttttctgccatattccaggtcctacattgtgcatttctcattttttcacgtttttcagtgatttcgtcatttttcacgttgtcaagtggatgtttctcattttccatgattttcacttttcttgccatatttcatgttttacagtggacatttctaaattttccacctatttctgttttcctcgccatatttcacatcctaaagtgtgtatttctcattttccgtgattttcagttttctcgccatatgccaggtcatacagggtgcatttctcatttttcacgtttttcagtgatttcgtcatttttcacgtcgtcaagtggatgtttctcattttcaatgattttcatttttcttgccatattccacgtcctatagtggacatttctaaattttccacctttttcagttttccttgccatatttcaggtcctacagtgtgcatttctcttttttcacgtttttcagtgatttcgtcatttttcaagtggtcaagtgcatgtttctcattttccgtgattttcagttttcttgccatgttccaggtcctacagttgacgtttctaaaatttcactttttttaagttttcctcgccatatttcacttcctaaagtgtgtatttctcattttccgtgattttcagttttctcgccagattccaggtcctacagtgtgcatttttcatatttcacctttttcagtgattttgtcatttttcaagttgtcaactgcatgtttctcattttccatgattttcagttttcttgccatattccatgtcctactgtggacatttctaaattttccaactttttcagttttcctcgccatatttcatgtcctaaagtgtgtatttctcattttcagtgattttctgttttctcgccatattccaggtcctacagtgtgcatttctaatttttcacgtttttcagtgatttcgtcatttttcaagttgtcaagtggatgtttctcattttccatgattttcagttttcttgccatattccatgtcctacagtggacatttctaaattttccaactttttccattttcctcaccatatttcacgtcctaaagtgagtttttctcattttttgtgattttcagttttctcgacatattccaggtcctacagtgtgcatttctaattttttcttttttcagtgatttcgtcatttttcaagtggtcaagtgcatgtttctcattttccatgattttcagttttcttgccatattccatgtcctacaatggacatttctaaattttccaactttttcagttttcctcgccatatttcacgtcctaaagtgtgtatttctcattttccgtgattttcagttttctcgccatattccaggtcctacagtgtgcatttctcatttttcacgtttttcagtgatttcgtcatttttcaagttgtcaactgcatgtttctcattttccatgattttcagttttcttgccatattccatgtcttacagtggacatttttaaatttttcacatttttttaagttttcctccccatatttcacgttttaaagtgtgcatttctcattttcggtgattttcagttttctcgccagattccatgtcttacagtgtgcatttctcattttttcacgtttttcagtgatttcgtcatttttcaagtcgtcaagtggatgtttctcattttccatgattttcagttttcttgccatattccatgtcctacagtggaaatttctaaattttccacctttttcagttttccttgccatatttcaggtcctaaagtgtgtatttctcattttctgtgattttcagttttctcgccatattccaggtcctacagttgacatttctaaaatttccacattttttaagttttcctcgccatatttcacttcctaaagtgtgtatttctcattttccgtgattttcagttttctcgccatattccagatcctacagtgtacatttttcatttttcacgtttttcagtgattttgtcattttttagttgtcaactgcctgtttctcattttccatgattttcagttttcttgctatattccatgtcctacagtggaaatttctaaattttccacctttttcagttttcctcgccatatttcacgtcctaaagtgtgtatttctcattttccgtgattttcagttttctcgccatattccaggtcctatgtgtacatttctcatttttcacgtttttcagtgattttgtcatttttcaatttgtcaactgcatgtttctcattttccatgattttcagttttcttgccatattccatgtcctacagtggaaatttctatattttccaactttttcagttttcctcgccatatttcacgtgctaaagtgtgtatttctcatttttcgtgtttttcaggtttctcgccatattccaggtcctacagtgtgcatttctcatttttcacgtttttcagtgattttgtcatttttcaagttgtcaagtggatgtttctcattttccttgattttcagttttcttgccatattccatgtcctacagtggacatttctaaattttccacctttttcagttttccttgccatatttcatgtcctaaagtgtgtatttctcattttcagtgattttcagttttctcgccatattccaggtcctacagtgtgcatttctcattttttcaggtttttcagtgatttcgtcatttttcacgttgtcaagtggatgtttctcattttccatgattttcacttttcttgccatatttcatgtcctaaagtgtgtatttctcattttcagtgattttcagttttctcgctatattccaggtcctacagtgtgcatttctcattttttcacgtttttcagtgatttcgtcatttttcacgttgtcaagtggatgtttctcattttccatgattttcacttttcttgccatatttcatgtcctacaatggacatttctaaattttccacctttttctgttttcctcgccatatttcacatcctaaagtgtgtatttctcattttccgtgattttcagttttcttgccatattccaggtcctacagtgtgcatttctcatttttcacgtttttcagtgatttcgtcatttttcaagttgtcaagtggatgtttctcattttccttgattttcagttttcttgccatattccatgtcctactgtggacatttctaaattttccacctttttcagttttccttgccatatttcatgtcctaaagtgtgtatttctcattttcagtgattttcagttttctcgcaatattccaggtcctacagtgtgcatttctcattttttcaggtttttcagtgatttcgtcatttttcacgttgtcaagtggatgtttctcattttccatgattttcacttttcttgccatatttcatgtcctaaagtgtgtatttctcattttcagtgattttcagttttctgccatattccaggtcctacattgtgcatttctcattttttcacgtttttcagtgatttcgtcatttttcagttttctcgacatattccaggtcctacagtgtgcatttctaattttttcttttttcagtgatttcgtcatttttcaagttgtcaactgcatgtttctcattttccatgattttcagttttcttgccatattccatgtcttacagtggacatttttaaatttttcacatttttttaagttttcctccccatatttcacgttttaaagtgtgcatttctcattttcggtgattttcagttttctcgccagattccaggtcttacagtgtgcatttctcattttttcacgtttttcagtgatttcgtcatttttcaagtcgtcaagtggatgtttctcattttccatgattttcagttttcttgccatattccatgtcctacagtggaaatttctaaattttccacctttttcagttttccttgccatatttcaggtcctaaagtgtgtatttctcattttctgtgattttcagttttctcgccatattccaggtcctacagttgacatttctaaaatttccacattttttaagttttcctcgccatatttcacttcctaaagtgtgtatttctcattttccgtgattttcagttttctcgccatattccagatcctacagtgtgcatttttcatttttcacgtttttcagtgattttgtcattttttagttgtcaactgtctgtttctcattttccatgattttcagttttcttgccatattccatgtcctacactggacatttctaaattttccacctttttctgttttcctcgccatatttcacgtcctaaagtgtgtatttctcattttccgtgattttcagttttcttgccatattccaggtcctacagtgtgcatttctcatttttcacgtttttcagtgattttgtcatttttcaagttgtcaactgcatgtttctcattttctatgattttcagttttcttgctatattccatgtcctacagtggaaatttctaaattttccacctttttcagttttcctcgccatatttcacgtcctaaagtgtgtatttctcattttccgtgattttcagttttctcgccatattccaggtcctatgtgtacatttctcatttttcacgtttttcagtgattttgtcatttttcaagttgtgaagtggatgtttctcatttttcttgattttcatttttcttgccatattccatgtcctagagtggaaatttttaaattttccacctttttcagttttcctcgccatatttcacgtcctaaagtgtgaatttctcattttccgtgattttcagatttctcgccatattccaagtcctacagtgtgcatttctcatttttcacgtttttcagtgatttcgtcatttttcaagttgtcaagtggatgtttctcattttccatgattttcagctttcttgccatattcaaagtcctacagtggacatttctaaattttcgacctttatcagttttcctcgccatatttcatgtcccaaagtgtgtacttctcattttccgtgattttcagtttcctagccatattctaggtcctacagtgtgcatttctcatttttcaggtttttcagtgatttcgtcttttttcaagtcgtcaagtggatgtttctcattttccatgattttcacttttcttgccatatttcatgtcctaaagtgtgtatttctcattttcagtgattttcagttttctcgctatattccaggtcctacagtgtgcatttctcattttttcacgtttttcagtgatttcgtcatttttcacgttgtcaagtggatgtttctcattttccatgattttcacttttcttgccatatttcatgtcctacagtggacatttctaaattttccacctttttctgttttcctcgccatatttcacatcctaaagtgtgtatttctcattttccgtgattttcagttttcttgccatattccaggtcctacagtgtgcatttctcatttttcacgtttttcagtgatttcgtcatttttcaagttgtcaagtggatgtttctcattttccttgattttcagttttcttgccatattccatgtcctactgtggacatttctaaattttccacctttttcagttttccttgccatatttcatgtcctaaagtgtgtatttctcattttcagtgattttcagttttctcgcaatattccaggtcctacagtgtgcatttctcattttttcaggtttttcagtgatttcgtcatttttcacgttgtcaagtggatgtttctcattttccatgattttcacttttcttgccatatttcatgtcctaaagtgtgtatttctcattttcagtgattttcagttttctgccatattccaggtcctacattgtgcatttctcattttttcacgtttttcagtgatttcgtcatttttcacgttgtcaagtggatgtttctcattttccatgattttcacttttcttgccatatttcatgttttacagtggacatttctaaattttccacctttttctgttttcctcgccatatttcacatcctaaagtgtgtatttctcattttccgtgattttcagttttctcgccatatgccaggtcatacagggtgcatttctcatttttcacgtttttcagtgatttcgtcatttttcacgtcgtcaagtggatgtttctcattttcaatgattttcatttttcttgccatattccacgtcctatagtggacatttctaaattttccacctttttcagttttccttgccatatttcaggtcctacagtgtgcatttctcatttttcacgtttttcagtgatttcgtcatttttcaagtggtcaagtgcatgtttctcattttccgtgattttcagttttcttgccatgttccaggtcctacagttgacgtttctaaaatttcactttttttaagttttcctcgccatatttcacttcctaaagtgtgtatttctcattttccgtgattttcagttttctcgccagattccaggtcctacagtgtgcatttttcatatttcacctttttcagtgattttgtcatttttcaagttgtcaactgcatgtttctcattttccatgattttcagttttcttgccatattccatgtcctactgtggacatttctaaattttccaactttttcagttttcctcgccatatttcatgtcctaaagtgtgtatttctcattttcagtgattttctgttttctcgccatattccaggtcctacagtgtgcatttctaatttttcacgtttttcagtgatttcgtcatttttcaagttgtcaagtggatgtttctcattttccatgattttcagttttcttgccatattccatgtcctacagtggacatttctaaattttccaactttttccattttcctcaccatatttcacgtcctaaagtgtgtttttctcattttttgtgattttcagttttctcgacatattccaggtcctacagtgtgcatttctaattttttcttttttcagtgatttcgtcatttttcaagttgtcaactgcatgtttctcattttccatgattttcagttttcttgccatattccatgtcttacagtggacatttttaaatttttcacatttttttaagttttcctccccatatttcacgttttaaagtgtgcatttctcattttcggtgattttcagttttctcgccagattccaggtcttacagtgtgcatttctcattttttcacgtttttcagtgatttcgtcatttttcaagtcgtcaagtggatgtttctcattttccatgattttcagttttcttgccatattccatgtcctacagtggaaatttctaaattttccacctttttcagttttccttgccatatttcaggtcctaaagtgtgtatttctcattttctgtgattttcagttttctcgccatattccaggtcctacagttgacatttctaaaatttccacattttttaagttttcctcgccatatttcacttcctaaagtgtgtatttctcattttccgtgattttcagttttctcgccatattccagatcctacagtgtgcatttttcatttttcacgtttttcagtgattttgtcattttttagttgtcaactgtctgtttctcattttccatgattttcagttttcttgccatattccatgtcctacactggacatttctaaattttccacctttttctgttttcctcgccatatttcacgtcctaaagtgtgtatttctcattttccgtgattttcagttttcttgccatattccaggtcctacagtgtgcatttctcatttttcacgtttttcagtgattttgtcatttttcaagttgtcaactgcatgtttctcattttccatgattttcagttttcttgctatattccatgtcctacagtggaaatttctaaattttccacctttttcagttttcctcgccatatttcacgtcctaaagtgtgtatttctcattttccgtgattttcagttttctcgccatattccaggtcctatgtgtacatttctcatttttcacgtttttcagtgattttgtcatttttcaagttgtgaagtggatgtttctcatttttcttgattttcatttttcttgccatattccatgtcctagagtggaaatttttaaattttccacctttttcagttttcctcgccatatttcacgtcctaaagtgtgaatttctcattttccgtgattttcagatttctcgccatattccaagtcctacagtgtgcatttctcatttttcacgtttttcagtgatttcgtcatttttcaagttgtcaagtggatgtttctcattttccatgattttcagctttcttgccatattcaaagtcctacagtggacatttctaaattttcgacctttatcagttttcctcgccatatttcatgtcccaaagtgtgtacttctcattttccgtgattttcagtttcctcgccatattctaggtcctacagtgtgcatttctcatttttcaggtttttcagtgatttcgtcttttttcaagtcgtcaagtggatgtttctcattttccatgattttcagttttcttgccatattccatgtcctacagtggacatttctaaattttccacctttttcagttttcctcgccatatttcatgtcctaaagtgtgtatttctcattttcagtgattttcagttttctcgccatattccaggtcctacagtgtgcatttctcatttttcacgtttttcagtgatttcgtcatttttcaagttgtcaagtggatgtttctcattttccatgattttcagttttcttgccatattccatgtcccacagtggacatttctaaattttccacctttttctgttttccttgccatatttcatgtcctaaagtgtgtatttctcattttccgtgattttcagttttcttgctatattccaagtcctacagtgtgcatttctcatttttcacgtttttcagtgattttgtcatttttcaatttgtcaactgcatgtttctcattttccatgattttcagttttcttgccatattccatgtcctacagtggaaatttctatattttccaactttttcagttttcctcgccatatttcacgtgctaaagtgtgtatttctcatttttcgtgtttttcaggtttctcgccatattccaggtcctacagtgtgcatttctcatttttcacgtttttcagtgattttgtcatttttcaagttgtcaagtggatgtttctcattttccttgattttcagttttcttgccatattccatgtcctacagtggacatttctaaattttccacctttttcagttttccttgccatatttcatgtcctaaagtgtgtatttctcattttcagtgattttcagttttctcgccatattccaggtcctacagtgtgcatttctcattttttcaggtttttcagtgatttcgtcatttttcacgttgtcaagtggatgtttctcattttccatgattttcacttttcttgccatatttcatgtcctaaagtgtgtatttctcattttcagtgattttcagttttctcgctatattccaggtcctacagtgtgcatttctcattttttcacgtttttcagtgatttcgtcatttttcacgttgtcaagtggatgtttctcattttccatgattttcacttttcttgccatatttcatgtcctacagtggacatttctaaattttccacctttttctgttttcctcgccatatttcacatactaaagtgtgtatttctcattttccttgattttcagttttcttgccatattccaggtcctacagtgtgcatttctcatttttcacgtttttcagtgatttcgtcatttttcaagtcgtcaagtggatgtttctcattttccatgattttcagttttctcgccatattccaggtcctacagttgacatttctaaattttccacattttttaagtttcctcgcgatatttcacatcctaaagtgtgtatttctcattttccgtgattttcagttttcttgccatattccaggtcctacagggtgcatttctcatttttcacgtttttcagtgatttcatcaatttcaagtcgtcaactgtatgtttctcattttcaatgattttcatttttcttgccatattccatgtcctacagtggacatttctaaatttttcacctttttcagttttccttgccatatttcatgtcctaaagtgtgtatttctcattttcagtgattttcagttttctcgccatattccaggtcctacagtgtgcatttctcattttttcaggtttttcagtgatttcgtcatttttcacgttgtcaagtggatgtttctcattttccatgattttcacttttcttgccatatttcatgtcctaaagtgtgtatttctcattttcagtgattttcagttttctcgccatattccaggtcctacagtgtgcatttctcatttttcacgtttttcagtgatttcgtcatttttcaagttgtcaagtggatgtttctcattttccatgattttcacttttcttgccatattccatgtcccacagtggacatttctaaattttccacctttttctgttttcctcgccatatttcatgtcctaaagtgtgtatttctcattttccgtgattttcagttttcttgctatattccaagtcctacagtgtgcatttctcatttttcacgtttttcagtgattttgtcatttttcaatttgtcaactgcatgtttctcattttccatgattttcagttttcttgccatattccatgttctacagtggaaatttctatattttccaactttttcagttttcctcgccatatttcacgtgctaaagtgtgtatttctcatttttcgtgtttttcaggtttctcgccatattccaggtcctacagtgtgcatttctcatttttcacgtttttcagtgattttgtcatttttcaagttgtcaagtggatgtttctcattttccttgattttcagttttcttgccatattccatgtcctacagtggacatttctaaattttccacctttttcagttttccttgccatatttcatgtcctaaagtgtgtatttctcattttcagtgattttcagttttctcgccatattccaggtcctacagtgtgcatttctcattttttcaggtttttcagtgatttcgtcatttttcacgttgtcaagtggatgtttctcattttccatgattttcacttttcttgccatatttcatgtcctaaagtgtgtatttctcattttcagtgattttcagttttctcgctatattccaggtcctacagtgtgcatttctcattttttcacgttttgcagtgatttcgtcatttttcacgttgtcaagtggatgtttctcattttccatgattttcacttttcttgccatatttcatgtcctacagtggacatttctaaattttccacctttttctgttttcctcgccatatttcacatcctaaagtgtgtatttctcattttccgtgattttcagttttcttgccatattccaggtcctacagtgtgcatttctcatttttcacgtttttcagtgatttcgtcatttttcaagtcgtcaagtggatgtttctcattttccatgattttcagttttctcgccatattccaggtcctacagttgacatttctaaattttccacattttttaagtttcctcgcgatatttcacatcctaaagtgtgtatttctcattttccgtgattttcagttttcttgccatattccaggtcctacagggtgcatttctcatttttcacgtttttcagtgatttcatcaatttcaagtcgtcaactgtatgtttctcattttcaatgattttcatttttcttgccatattccatgtcctacagtggacatttctaaattttccacctttttcagttttccttgccatatttcatgtcctaaagtgtgtatttctcattttcagggattttcagttttctcgccatattccaggtcctacagtgtgcatttctcattttttcaggtttttcagtgatttcgtcatttttcacgttgtcaagtggatgtttctcattttccatgattttcacttttcttgccatatttcatgtcctaaagtgtgtatttctcattttcagtgattttcagttttctcgccatattccaggtcctacagtgtgcatttctcattttttcacgtttttcagtgatttcgtcatttttcacgttgtcaagtggatgtttctcattttccatgattttcacttttcttgccatatttcatgtcctacagtggacatttctaaattttccacctttttctgttttcctcgccatatttcacatcctaaagtgtgtatttctcattttccgtgattttcagttttcttgccatattccaggtcctacagtgtgcatttctcatttttcacgtttttcagtgatttcgtcatttttcaagtcgtcaagtggatgtttctcattttccatgattttcagttttctcgccatattccaggtcctacagttgacatttctaaattttccacattttttaagtttcctcgcgatatttcacatcctaaagtgtgtatttctcattttccgtgattttcagttttcttgccatattccaggtcctacagggtgcatttctcatttttcacgtttttcagtgatttcatcaatttcaagtcgtcaactgtatgtttctcattttcaatgattttcatttttcttgccatattccacgtcctatagtggacatttctaaattttccacctttttcagttttcttcgccatatttcacgtcccaaagtgtgtatttctcattttccgtgattttcagtttcctcgcaatattccaggtcctacagtgtgcatttctcatttttcacgtttttcagtgatttcgtcttttttcaagtcgtcaagtggatgtttctcattttccatgattttcagttttcttgccatattccatgtcctacagtggacatttctaaattttccacctttttctgttttcctcgccatatttcacgtcctaaagtgtgtatttctcattttccgtgattttcagttttcttgccatattccaggtcctacagtgtgcatttctcatttttcacgtttttcactgattttgtcattgttcaagttgtcaactgcatgtttctcattttccatgattttcaattttcttgccatattccatgtcctacagtggaaatttctatattttccaactttttcagttttcctcgccatatttcacgtgctaaagtgtgtatttctcatttttcgtgtttttcaggtttctcgccatattccaggtcctacagtgtgcatttctcatttttcacgtttttcagtgattttgtcatttttcaagttgtcaagtggttgtttctcattttccttgattttcagttttcttgccatattccatgtcctactgtggacatttctaaattttccacctttttcagttttccttgccatatttcatgtcctaaagtgtgtatttctcattttcagtgattttcagttttctcgcaatattccaggtcctacagtgtgcatttctcattttccgtgattttcagttttctcgccatatgccaggtcatacagggtgcatttctcatttttcacgtttttcagtgatttcgtcatttttcacgtcgtcaagtggatgtttctcattttcaatgattttcatttttcttgccatattccacgtcctatagtggacatttctaaattttccaactttttcagttttcttgccatatttcaggtcctacagtgtgcatttctcatttttcacgtttttcagtgatttcgtcatttttcaagtggtcaagtgcatgtttctgattttccgtgattttcagttttcttgccatgttccaggtcctacagttgacgtttctaaaatttcactttttttaagttttcctcgccatatttcacttcctaaagtgtgtatttctcattttccgtgattttcagttttctcgccagattccaggtcctacagtgtgcatttttcatatttcacctttttcagtgattttgtcatttttcaagttgtcaactgcatgtttctcattttccatgattttcagttttcttgccatattccatgtcctactgtggacatttctaaattttccaactttttcagttttcctcgccatatttcatgtcctaaagtgtgtatttctcattttcagtgtttttctgttttctcgccatattccaggtcctacagtgtgcatttctaatttttcacgtttttcagtgatttcgtcatttttcaagttgtcaagtggatgtttctcattttccatgattttcagttttcttgccatattccatgtcctacagtggacatttctaaattttccaactttttccattttcctcaccatatttcacgtcctaaagtgtgtttttctcattttttgtgattttcagttttctcgacatattccaggtcctacagtgtgcatttctaattttttcttttttcagtgatttcgtcatttttcaagtggtcaagtgcatgtttctcattttccatgattttcagttttcttgccatattccatgtcctacaatggacatttctaaattttccaactttttcagttttcctcgccatatttcacgtcctaaagtgtgtatttctcattttccgtgattttcagttttctcgccatattccaggtcctatgtgtacatttctcatttttcacgtttttcagtgattttgtcatttttcaagttgtgaagtggatgtttctcatttttcttgattttcatttttcttgccatattccatgtcctagagtggaaatttttaaattttccaactttttcagttttcctcgccatatttcacgtcctaaagtgtgtatttctcattttccgtgattttcagttttctcgccatattccaagtcctacagtgtgcatttctcatttttcacgtttttcagtgatttcgtcatttttcaagttgtcaagtggatgtttctcattttccatgattttcagctttcttgccatattcaaagtcctacagtggacatttctaaattttcgacctttatcagttttcctcgccatatttcatgtcccaaagtgtgtacttctcattttccgtgattttcagtttcctcgccatattctaggtcctacagtgtgcatttctcatttttcaggtttttcagtgatttcgtcttttttcaagtcgtcaagtggatgtttctcattttccatgattttcagttttcttgccatattccatgtcctacagtggacatttctaaattttccacctttttcagttttcctcgccatatttcatgtcctaaagtgtgtatttctcattttcagtgattttcagttttctcgccatattccaggtcctacagtgtgcatttctcatttttcacgtttttcagtgatttcgtcatttttcaagttgtcaagtggatgtttctcattttccatgattttcagttttcttgccatattccatgtcccacagtggacatttctaaattttccacctttttctgttttccttgccatatttcatgtcctaaagtgtgtatttctcattttccgtgattttcagttttcttgctatattccaagtcctacagtgtgcatttctcatttttcacgtttttaagtgattttgtcatttttcaatttgtcaactgcatgtttctcattttccatgattttcagttttcttgccatattccatgtcctacagtggaaatttctatattttccaactttttcagttttcctcgccatatttcacgtgctaaagtgtgtatttctcatttttcgtgtttttcaggtttctcgccatattccaggtcctacagtgtgcatttctcatttttcacgtttttcagtgattttgtcatttttcaagttgtcaagtggatgtttctcattttccttgattttcagttttcttgccatattccatgtcctacagtggacatttctaaattttccacctttttcagttttccttgccatatttcatgtcctaaagtgtgtatttctcattttcagtgattttcagttttctcgccatattccaggtcctacagtgtgcatttctcattttttcaggtttttcagtgatttcgtcatttttcacgttgtcaagtggatgtttctcattttccatgattttcacttttcttgccatatttcatgtcctaaagtgtgtatttctcattttcagtgattttcagttttctcgccatattccaggtcctacagtgtgcatttctcattttttcacgtttttcagtgatttcgtcatttttcacgttgtcaagtggatgtttctcattttccatgattttcacttttcttgccatatttcatgtcctacagtggacatttctaaattttccacctttttctgttttcctcgccatatttcacatcctaaagtgtgtatttctcattttccgtgattttcagttttcttgccatatttcaggtcctacagtgtgcatttctcatttttcacgtttttcagtgatttcgtcatttttcaagtcgtcaagaggatgtttctcattttccatgattttcagttttctcgccatattccaggtcctacagttgacatttctaaattttccacattttttaagtttcctcgcgatatttcacatcctaaagtgtgtatttctcattttccgtgattttcagttttcttgccatattccaggtcctacagggtgcatttctcatttttcacgtttttcagtgatttcatcaatttcaagtcgtcaactgtatgtttctcattttcaatgattttcatttttcttgccatattccacgtcctatagtggacatttctaaattttccacctttttctgttttcctcgccatatttcacgtcctaaagtgtgtatttctcattttccgtgattttcagttttcttgccatattccaggtcctacagtgtgcatttctcatttttcacgtttttcactgattttgtcattgttcaagttgtcaactgcatgtttctcattttccatgattttcagttttcttgccatattccatgtcctacagtggaaatttctatattttccacctttttcagttttcctcgccgtatttcatgtgctaaagtgtgtatttctcatttttcgtgtttttcaggtttctcgccatattccaggtcctacagtgtgcatttctcatttttcacgtttttcagtgattttgtcatttttcaagttgtcaactggatgtttctcattttccttgattttcagttttcttgccatattccatgtcctactgtggacatttctaaattttccacctttttcagttttccttgccatatttcatgtcctaaagtgtgtatttctcattttcagtgattttcagttttctcgcaatattccaggtcctacagtgtgcatttctcattttttcaggtttttcagtgatttcgtcatttttcacgttgtcaagtggatgtttctcattttccatgattttcacttttcttgccatatttcatgtcctaaagtgtgtatttctcattttcagtgattttcagttttctcgccatattccaggtcctacattgtgcatttctcattttttcacgtttttcagtgatttcgtcatttttcacgttgtcaagtggatgtttctcattttccatgattttcacttttcttgccatatttcatgttttacagtggacatttctaaattttccacctttttctgttttcctcgccatatttcacatcctaaagtgtgaatttctcattttccgtgattttcagttttcttgccatattccaggtcctacagtgtgcatttctcatttttcacgtttttcagtgatttcatcatttttcaagtcgtcaagtggatgtttctcattttccatgattttcagttttcttgccatattccatgtcctacagtggacatttctaaattttccacctttttctgttttcctcgccatatttcacgtcctaaagtgtgtatttctcattttccgtgattttcagttttcttgccatattccaggtcctacagtgtgcatttctcatttttcacgtttttcactgattttgtcatttttcaagttgtcaactgcatgtttctcattttccatgattttcagttttcttgctatattccatgtcctacagtggaaatttctaaattttccacctttttcagttttcctcgccatatttcacgtcctgaagtgtgtatttctcattttccgtgattttcagttttctcgccatattccaggtcctatgtgtacatttctcatttttcacgtttttcagtgattttgtcatttttcaagttgtgaagtggatgtttctcatttttcttgattttcatttttcttgccatattccatgtcctacagtggaaatttctaaattttccacctttttcagttttcctcgccatatttcacgtcctaaagtgtgtatttctcattttccgtgattttcagttttctcgccatattccaggtcctacagtgtgcatttctcatttttcacgtttttcagtgatttcgacatttttcaagttgtcaagtggatgtttctcattttccatgattttcagctttcttgccatattcaaagtcctacagtggacatttctaaattttcgacctttatcagttttcctcgccatatttcatgtcccaaagtgtgtacttctcattttccgtgattttcagtttcctcgccatattccaggtcctacagtgtgcatttctcatttttcacgtttttcagtgatttcgtcatttttcaagtcgtcaagtggatgtttctcattttccatgattttcagttttcttgccatattccatgtcctacagtggacatttctaaattttccacctttttctgttttcctcgccatatttcacgtcctaaagtgtgtatttctcattttccgtgattttcagttttcttgccatattccaggtcctacagtgtgcatttctcatttatcacgtttttcactgattttgtcatttttcaagttgtcaactgcatgtttctcattttccatgattttcagttttcttgctatattccatgtcctacagtggaatattctaaattttccacctttttcagttttcctcgccatatttcacgtcctgaagtgtgtatttctcattttccgtgattttcagttttctcgccatattccaggtcctatgtgtacatttctcatttttcacgtttttcagtgattttgtcatttttcaagttgtgaagtggatgtttctcatttttcttgattttcatttttcttgccatattccatgtcctacagtggaaatttctaaattttccacctttttcagttttcctcgccatatttcacgtcctaaagtgtgaatttctcattttccgtgattttcagttttctcgccatattccaggtcctacagtgtgcatttctcatttttcacgtttttcagtgatttcgacatttttcaagttgtcaagtggatgtttctcattttccatgattttcagctttcttgccatattcaaagtcctacagtggacatttctaaattttcgacctttatcagttttcctcgccatatttcatgtcccaaagtgtgtacttctcattttccgtgattttgagtttcctcgccatattccaggtcctacagtgtgcatttctcatttttcacgtttttcagtgatttcgtcttttttcaagttgtcaactgcatgtttctcattttccatgattttcagttttcttgccatattccatgtcctacagtggaaatttgtaaatttccacctttttcagttttcctcgccatatttcacgtcctaaagtatgtatttctcattttccgtgattttcagttttctcgccatattccaggtcctacagtgtgcatttctcatttttcacgtttttcagtgattttgtcattttttaagttttcaagtggatgtttctcattttccttgattttcagttttcttgccatattccatgtcctacagtggacatttctaaattttccacctttttcagttttcctcgccatatttcatgtcctaaagtgtgtatttctcattttcagtgattttcagttttctcgccatattccaggtcctacagtgtgcatttctcatttttcacgtttttcagtgatttcgtcatttttcaaggtgtcaagtggatgtttctcattttccatgattttcagttttcttgccatattccatgtcctacagtggacatttctaaattttccacctttttctgttttcctcgccatatttcatgtcctaaagtgtgtatttctcattttccgtgattttcagttttcttgctatattccaagtcctacagtgtgcatttctcatttttcacgtttttcagtgattttgtcatttttcaatttgtcaactgcatgtttctcattttccatgattttcagtttttttgccatattccatgtcctactgtggaaatttctatattttccacctttttcagttttcctcgccatatttcacgtgctaaagtgtgtatttctcatttttcgtgtttttcaggtttctcgccatattccaggtcctacagtgtgcatttctcatttttcacgtttttcagtgattttgtcatttttcaagttttcaagtggatgtttctcattttccttgattttcagttttcttgccatattccatgtcctacagtggacatttctaaattttccacctttttcagttttccttgccatatttcatgtcctaaagtgtgtatttctcattttcagtgattttcagtttccttgccatattccaggtcctacagtgtgcatttctcattttttcacgtttttcagtgatttcgtcatttttcacgttgtcaagtggatgtttctcattttccatgattttcacttttcttgccatatttcatgtcctacagtggacatttctaaattttccaactttttcaattttcctcgccatattttatgtcctaaagtgtgtatttctcatttttcgttattttcagttttcttgccatattccaggtcctacagtgtgcatttgtcatttttcacgtttttcagtgatttcgtcatttttcaagtcgtcaagtagatgtttctcatattccatgtttttcagttttctcgccatattccaggtcctacagttgacatttctaaattttctacatttttaaattttcctcgccatatttcacgtcctaaagtgtgtatttctcattttttgttattttcagttttctagccatattccaggtcctacaggatgcatttctcatttttcacgtttttcagtgatttcatcatttttcaagtcgtcaagtgtatgtttcttattttcaatgattttcatttttcttgccttattccacgtcctatagtggacatttctaaattttccacctttttcagtttttttcgccatatttcacgtcctaaagtgtgtatttctcattttctgtgattttcagttttctcaccatattccaggtcctacagtgtgcatttctcatttttcacgtttttcagtgatttcgtcatttttcaagttgtcaagtggaagtttctcattttccatgattttcagctttctagacatattccaggtcctacagtggacatttcctaattttcgacctttatcagttttcctcgtcatatttcacgtcccaaaatgtgtatttcttattttccatgattttcagtttcctcgccatattccaggtcctacagtgtgcaattctcatttttcacgtttttcagtgatttcgtcttttttcaagacgtcaagtggatgtttctcatttttcatgattttcagttttcttgccatattccatgtcctacagtggacatttctaaattttccacctttttctgttttcctcgccatatttcacgtcctaaagtgtgtatttctcattttccgtgattttcagttttcttgccatattcctggtcctacagtgtgcatttctcatttttcacgtttttcagtgattttgtcatttttcaatttgtcaactgcatgtttctcattttccattattttcagttttcttgccatattccatgtcctacagtggacatttctaaattttccacctttttctgttttcctcgccatatttcatgtcctaaagtgtgtatttctcattttccgtgattttcagttttcttgctatattccaagtcctacagtgtgcatttctcatttttcacgtttttcagtgattttgtcatttttcaatttgtcaactgcatgtttctcattttccatgattttcagtttttttgccatattccatgtcctacaggggaaatttctatattttccacctttttcagttttcctcgccatatttcatgtcctaaagtgtgtatttctcattttccgtgattttcagttttcttgccatattccaggtcctacagtgtgcatttctcatttttcacgtttttcagtgatttcgtcatttttcaagtcttcaagtagatgtttctcatattccatgtttttcagttttctcgccatattccaggtcctacagttgacatttctaaattttctacatttttaaattttcctcgccatatttcacgtcctaaagtgtgtatttctcatttttcgttattttcagttttctagccatattccaggtcctacaggatgcatttctcatttttcacgtttttcagtgatttcatcatttttcaagtcgtcaagtgtatgtttctcattttcaatgattttcatttttcttgccttattccacgtcctatagtggacatttctaaattttccacctttttcagtttttctcgccatatttcacgtcctaaagtgtgtatttctcattttctgtgattttcagttttctcaccatattccaggtcctacagtgtgcatttctcatttttcacgtttttcagtgatttcgtcatttttcaagttgtcaagtggaagtttctcattttccatgattttcagctttctagccatattccaggtcctacagtggacatttcctaattttcgacctttatcagttttcctcgccatatttcacgtcctaaagtgtgtatttctcattttccgtgattttcagttttcttgccatattccaggtcctacagtgtgcatttctcatttttcacgtttttcagtgattttgtcatttttcaatttgtcaactgcatgtttctcattttccatgatttttagttttcttgctatattccatgtcctacagtggaaatttctaaattttccacctttttcagttttcctcgccatatttcacgtcctaaagtgtgtatttctcattttccgtgattttcagttttcttgctatattccaagtcctacattgtgcatttctcatttttcacgtttttcagtgattttgtcatttttcaatttgtcaaaccacatgtttctcattttccatgattttcagtttttttgccatattccatgtcctacagtggaaatttctatattttccacctttttcagttttcctcgccatatttcacgtgctaaagtgtgtatttctcatttttcgtgtttttcaggtttctcgccatattccaggtcctacagtgtgcatttctcatttttcacgtttttcagtgattttgtcatttttcaagttgtcaagtggatgtttcccattttccttgattttcagttttcttaccatattccatgtcctacagtggacatttctaaattttccacctttttcagttttccttgccatatttcatgtcctaaagtgtgtatttctcattttcagtgattttcagtttcctcgccatattccaggtcctacagtgtgcatttctcattttttcacgtttttcagtgatttcgtcatttttcacgttgtcaagtggatgtttctcattttccatgattttcacttttcttgccatatttcatgtcctatagtggacatttctaaattttccacctttttcagtttttctcgccatatttcacgtcctaaagtgtgtatttctcattttctgtgattttcagttttctcaccatattccaggtcctacagtgtgcatttctcatttttcacgtttttcagtgatttcgtcatttttcaagtcgtcaagtagatgtttctcatattccatgtttttcagttttctcgccatattccaggtcctacagttgacatttctaaattttctacatttttaaattttcctcgccatatttcacgtcctaaagtgtgtatttctcatttttcgttattttcagttttctagccatattccaggtcctacaggatgcatttctcatttttcacgtttttcagtgatttcatcatttttcaagtcgtcaagtgtatgtttcttattttcaatgattttcatttttcttgccttattccacgtcctatagtggacatttctaaattttccaccttttttcagtttttctcgccatatttcacgtcctaaagtgtgtatttctcattttctgtgattatcagttttctcaccatattccaggtcctacagtgtgcatttctcatttttcacgtttttcagtgatttcgtcatttttcaagttgtcaagtggaagtttctcattttccatgattttcagctttctagccatattccaggtcctacagtggacatttcctaattttcgacctttatcagttttcctcgccatatttcacgtcccaaaatgtgtatttcttattttccatgattttcagtttcctcgccatattccaggtcctacagtgtgcatttctcatttttcacgtttttcagtgatttcgtcttttttcaagacgtcaagtggatgtttctcatttttcatgattttcagttttcttgccatattccatgtcctacagtggacatttctaaattttccacctttttctgttttcctcgccatatttcacgtcctaaagtgtgtatttctcattttccgtgattttcagttttcttgccatattcctggtcctacagtgtgcatttctcatttttcacgtttttcagtgattttgtcatttttcaatttgtcaactgcatgtttctcattttccatgattttcagttttcttgccatattccatgtcctacagtggacatttctaaattttccacctttttcagttttcctcgccatatttcacgtgctaaagtgtgtatttctcatttttcgtgtttttcaggtttctcgccatattccaggtcctacagtgtgcatttctcatttttcacgtttttcagtgattttgtcatttttcaagttgtcaagtggatgtttctcattttccttgattttcacttttcttgccatattccaagtcttacaggggcatttctcatttttcacgttttcagtgattttgtcattttcaatttgtcaactgcatgtttctcattttccatgattttcagtttttttgccatattccatgtcctacaggggaaatttctatattttccacctttttcagttttcctcgccatatttcatgtcctaaagtgtgtatttctcattttccgtgattttcagttttcttgccatattccaggtcctacagtgtgcatttctcatttttcacgtttttcagtgatttcgtcatttttcaagtcttcaagtagatgtttctcatattccatgtttttcagttttctcgccatattccaggtcctacagttgacatttctaaattttctacatttttaaattttcctcgccatatttcacgtcctaaagtgtgtatttctcatttttcgttattttcagttttctagccatattccaggtcctacaggatgcatttctcatttttcacgtttttcagtgatttcatcatttttcaagtcgtcaagtgtatgtttctcattttcaatgattttcatttttcttgccttattccacgtcctatagtggacatttctaaattttccacctttttcagtttttctcgccatatttcacgtcctaaagtgtgtatttctcattttctgtgattttcagttttctcaccatattccaggtcctacagtgtgcatttctcatttttcacgtttttcagtgatttcgtcatttttcaagttgtcaagtggaagtttctcattttccatgattttcagctttctagccatattccaagtcctacagtggacatttcctaattttcgacctttatcagttttcctcgccatatttcacgtcccaaaatgtgtattccttattttccatgattttcagtttcctcgccatattccaggtcctacagtgtgcatttatcatttttcacgtttttcagtgatttcgtcttttttcaagacgtcaagtggatgtttctcatttttcatgattttcagttttcttgccatattccatgtcctacagtggacatttctaaattttccacctttttctgttttcctcgccatatttcacgtcctaaagtgtgtatttctcattttccgtgattttcagttttcttgccatattcctggtcctacagtgtgcatttctcatttttcacgtttttcagtgattttgtcatttttcaagttgtcaagtggatgtttctcattttccttgattttcacttttcttgccatattccatgtcctacagtggacatttctatattttccacctttttccgttttccttgccatatttcacgtcctaaagtgtgtatttctcattttccgtgattttcaggtttctcgccatattccaggtcctacagtgtgcatttctcatttttcacgtttttcagtgattttgtcatttttcaagttgtcaagtggatgtttctcattttccttgattttcacttttcttgccatattccatgtcctacagtggacatttctaaattttccacctttttcagttttcctcgccatatttcatgtcctaaagtgtgtatttctcattttcagtgattttcagttttcttgccatattccaggtcctacagtgtgcatttctcatttttcacgtttttcagtgattttgtcatttttcaagttgtcaactgcatgtttctcattttctatgattttcagttttcttgctatattccatgtcctacagtggaaatttctaaattttccacctttttcagttttcctcgccatatttcacgtcctaaagtgtgtatttctcattttccgtgattttcagttttctcgccatattccaggtcctatgtgtacatttctcatttttcacgtttttcagtgattttgtcatttttcaagttgtgaagtggatgtttctcatttttcttgattttcatttttcttgccatattccatgtcctagagtggaaatttttaaattttccacctttttcagttttcctcgccatatttcacgtcctaaagtgtgaatttctcattttccgtgattttcagatttctcgccatattccaagtcctacagtgtgcatttctcatttttcacgtttttcagtgatttcgtcatttttcaagttgtcaagtggatgtttctcattttccatgattttcagctttcttgccatattcaaagtcctacagtggacatttctaaattttcgacctttatcagttttcctcgccatatttcatgtcccaaagtgtgtacttctcattttccgtgattttcagtttcctcgccatattctaggtcctacagtgtgcatttctcatttttcaggtttttcagtgatttcgtcttttttcaagtcgtcaagtggatgtttctcattttccatgattttcacttttcttgccatatttcatgtcctaaagtgtgtatttctcattttcagtgattttcagttttctcgctatattccaggtcctacagtgtgcatttctcattttttcacgtttttcagtgatttcgtcatttttcacgttgtcaagtggatgtttctcattttccatgattttcacttttcttgccatatttcatgtcctacagtggacatttctaaattttccacctttttctgttttcctcgccatatttcacatcctaaagtgtgtatttctcattttccgtgattttcagttttcttgccatattccaggtcctacagtgtgcatttctcatttttcacgtttttcagtgatttcgtcatttttcaagttgtcaagtggatgtttctcattttccttgattttcagttttcttgccatattccatgtcctactgtggacatttctaaattttccacctttttcagttttccttgccatatttcatgtcctaaagtgtgtatttctcattttcagtgattttcagttttctcgcaatattccaggtcctacagtgtgcatttctcattttttcaggtttttcagtgatttcgtcatttttcacgttgtcaagtggatgtttctcattttccatgattttcacttttcttgccatatttcatgtcctaaagtgtgtatttctcattttcagtgattttcagttttcctcgccatatttcacgtcccaaaatgtgtatttcttattttccatgattttcagtttcctcgccatattccaggtcctacagtgtgcatttctcatttttcacgtttttcagtgatttcgtcttttttcaagacgtcaagtggatgtttctcatttttcatgattttcagttttcttgccatattccatgtcctacagtggacatttctaaattttccacctttttctgttttcctcgccatatttcacgtcctaaagtgtgtatttctcattttccgtgattttcagttttcttgccatattcctggtcctacagtgtgcatttctcatttttcacgtttttcagtgattttgtcatttttcaatttgtcaactgcatgtttctcattttccatgattttcagttttcttgccatattccatgtcctacagtggacatttctaaattttccacctttttcagttttcctcgccatatttcacgtgctaaagtgtgtatttctcatttttcgtgtttttcaggtttctcgccatattccaggtcctacagtgtgcatttctcatttttcacgtttttcagtgattttgtcatttttcaagttgtcaagtggatgtttctcattttccttgattttcacttttcttgccatattccatgtcctacagtggacatttctaaattttccacctttttcagttttcctcgccatatttcatgtcctaaagtgtgtatttctcattttcagtgattttcagttttctcgccatattccaggtcctacagtgtgcatttctcatttttcacgtttttcagtgatttcgtcttttttcaagacgtcaagtggatgtttctcattttccatgattttcagttttcttgccatattccatgtcctacagtggacatttctaaattttccacctttttctgttttcctcgccatatttcacgtcctaaagtgtgtatttctcattttccgtgattttcagttttcttgccatattccaggtcctacagtgtgcatttctcatttttcacgtttttcagtgattttgtcatttttcaatttgtcaactgcatgtttctcattttccatgatttttagttttcttgctatattccatgtcctacagtggaaatttctaaattttccacctttttcagttttcctcgccatatttcacgtcctaaagtgtgtatttctcattttccgtgattttcagttttcttgctatattccaagtcctacattgtgcatttctcatttttcacgtttttcagtgattttgtcatttttcaatttgtcaaaccacatgtttctcattttccatgattttcagtttttttgccatattccatgtcctacagtggaaatttctatattttccacctttttcagttttcctcgccatatttcacgtgctaaagtgtgtatttctcatttttcgtgtttttcaggtttctcgccatattccaggtcctacagtgtgcatttctcatttttcacgtttttctgtgattttgtcatttttcaagttgtcaagtggatgtttctcattttccttgattttcagttttcttaccatattccatgtcctacagtggacatttctaaattttccaccttttctgttttcctcgccatatttcatgtcctaaagtgtgtatttctcattttccgtgattttcatttttcttgctatattccaagtcctacagtgtgcatttctcattttccatgattttcagttttcttgctatattccatgtcctacagtggaaatttctaaattttccacctttttcagttttcctcgccatatttcacgtcctaaagtgtgtatttctcattttccgtgattttcagttttttcgccatattacaggtcctatgtgtacatttctcatttttcacgtttttcagtgattttgtcatttttcaagttgtcaagtggatgtttctcatttttcttgattttcatttttcttgccatattccatgtcctacagtggaaatttctaaattttccacctttttcagttttcctcgccatatttcacgtcctaaagtgtgaatttctcattttccgtgattttcagttttctcgccatattccaggtctacagtgtgcatttctcatttttcacgttttcagtgattcgtcatttttcaagttgacaagtggatgtttctcattttccatgattttcagctttcttgccatattcaaagtcctacagtggacatttctaaattttcgacctttatcagttttcctcgccatatttcatgtcccaaagtgtgtacttctcattttccgtgattttcagttttcttgccatattccaagtcctacagtgtgcatttctcatttttcacgtttttcagtgattttgtcatttttcaatttgtcaactgcatgtttctcattttccatgattttcagttttcttgccatattccatgtcctacagtggaaatttctatattttccacctttttcagttttcctcgccatatttcacgtgctaaagtgtgtatttctcatttttcgtgtttttcaggtttctcgccatattccaggtcctacagtgtgcatttctcatttttcacgtttttcagtgattttgtcatttttcaagttgtcaagtggatgtttctcattttcaatgattttcatttttcttgccttattccacgtcctatagtggacatttctaaattttccacctttttcagtttttctcgccatatttcacgtcccaaaatgtgtattccttattttccatgattttcagtttcctcgccatattccaggtcctacagtgtgcatttctcatttttcacgtttttcagtgatttcgtcttttttcaagacgtcaagtggatgtttctcatttttcatgattttcagttttcttgccatattccctgtcctacagtggacatttctaaattttccacctttttctgttttcctcgccatatttcacgtcctaaagtgtgtatttctcattttccgtgattttcagttttctcgccagattccaggtcctacagtgtgcatttctcatttttcacgtttttcagtgattttgtcatttttcaatttgtcaactgcatgtttctctctttccatgattttcagttttcttgccatattccatgtcctacagtggacatttctaaattttccacctttttcagttttcctcgccatatttcacgtgctaaagtgtgtatttctcatttttcgtgtttttcaggtttctcgccatattccaggtcctacagtgtgcatttctcatttttcacgtttttcagtgattttgtcatttttcaagttgtcaagtggatgtttctcattttcaatgattttcatttttcttaccttattccacgtcctatagtggacatttctaaattttccacctttttcagtttttctcgccatatttcacgtcccaaaatgtgtattccttattttccatgattttcagtttcctcgccatattccaggtcctacagtgtgcatttctcatttttcacgtttttcagtgatttcgtcttttttcaagacgtcaagtggatgtttctcatttttcatgattttcagttttcttgccatattccctgtcctacagtggacatttctaaattttccacctttttctgttttcctcgccatatttcacgtcctaaagtgtgtatttctcattttccgtgattttcagttttctcgccagattccaggtcctacagtgtgcatttctcatttttcacgtttttcagtgatttcgtcatttttcaagtcttcaagtgtatgtttctcattttcaatgattttcatttttcttgccttattccacgtcctatagtggacatttctaaattttccacctttttcagtttttctcgccatatttcacgtcctaaagtgtgtatttctcattttctgtgattttcagttttcttaccatattccaggtcctacagtgtgcatttctcatttttcacgtttttcagtgatttcgtcatttttcaagttgtcaagtggaagtttctcattttccatgattttcagctttctagccatattccaggtattacagtggacatttccttattttcgacctttatcagttttcctcgccatatttcatgtcctaaagtgtgt	38399	1554	4%	7300	19%
9	3000001	3038400	Atcctacagtgtgcatttctcatttttcacgtttttcagtgatttcgtcatttttcaagtcatcaagtggctgtttctcattttccatgattttcagttttcttgccatattccttgtcctacagtggacatttctaaattttccacctttttcagttttccttgtcatatttcaggtcctacagtgtgtatttctcatttttcacgtttttcattgatttcgtcatttttcaagttgtcaagtgcatgtttctcattttccatgattttcagttttcttgccatattccatgtcctacaatggacatttctaaattttccaactttttcagttttcctcgccatatttcacgtcctaaagtgtgtatttctcattttccgtgattttcagttttctcgacatattccaggtcctacagtgtgcatttctcatttttcacgtttttcagtgatttcgtcatttttcacgtcgtcaagtggatgtttctcattttccatgattttcagttttcttgccatattccatgtcctacagtggacatttctaaattttccacctttttcagttttcctcgccatatttcacgtcctaaagtgtgtatttctcattttccgtgattttcagttttctcgacatattccaggtcttacagggtgcatttctcatttttcacgtttttcagtgatttcatcatttttcaagtcgtcaactgtatgtttctcattttcaatgattttcatttttcttgccatattccacgtcctatagtggacatttctaaattttccacctttttcagttttccttgccatatttcaggtcctacagtgtgcatttctcatttttcacgtttttcagtgatttcgtcatttttcaagtggtcaaatgcatgtttctcattttccatgattttcagttttcttgccatattccatgtcctacagtggacatttctaaattttccacctttttcagttttcctcgccatatttcacgtcctaaagtgtgtatttctcattttccgtgattttcagttttatcgccagattccaggtcctacggtgtgcatttttcatatttcacgtttttcagtgattttgtcatttttcaagttgtcaactgcatgtttctcattttccatgattttcagttttcttgccatattccatgtcctacagtggacatttctaaattttccacctttttcagttttcctcgccatatttcatgtcctaaagtgtgtatttctcattttcagtgattttctgttttctcgccatattccaggtcctacagtgtgcatttctcatttttcacgtttttcagtgatttcgtcatttttcaagttgtcaagtggatgtttctcattttccatgattttcagttttcttgccatattccatgtcctacaatggacatttctaaattttccacctttttcagttttcctcgccatatttcacgtcctaaagtgtgtatttctcattttccgtgattttcagttttctcgccatattccaggtcctatgtgtacatttctcatttttcacgtttttcagtgattttgtcatttttcaagttgtgaagtggatgtttctcatttttcttgattttcatttttcttgccatattccatgtcctagagtggaaatttttaaattttccacctttttcagttttcctcgccatatttcacgtcctaaagtgtgaatttctcattttccgtgattttcagttttctcgccatattccaagtcctacagtgtgcatttctcatttttcacgtttttcagtgatttcgtcatttttcaagttgtcaagtggatgtttctcattttccatgattttcagctttcttgccatattcaaagtcctacagtggacatttctaaattttcgacctttatcagttttcctcgccatatttcatgtcccaaagtgtgtacttctcattttccgtgattttcagtttcctcgccatattctaggtcctacagtgtgcatttctcatttttcaggtttttcagtgatttcgtcttttttcaagtcgtcaagtggatgtttctcattttccatgattttcagttttcttgccatattccatgtcctacagtggacatttctaaattttccaactttttcagttttcctcgccatatttcatgtcctaaagtgtgtatttctcattttcagtgattttcagttttctcgccatattccaggtcctacagtgtgcatttctcatttttcacgtttttcagtgatttcgtcatttttcaagttgtcaagtggatgtttctcatttttcatgattttcagttttcttgccatattccatgtcccacagtggacatttctaaatgttccacctttttctgttttccttgccatatttcatgtcctaaagtgtgtatttctcattttccgtgattttcagttttcttgctatattccaagtcctacagtgtgcatttctcatttttcacgtttttctgtgattttttcatttttcaatttgtcaactgcatgtttctcattttccatgattttcagttttcttgccatattccaggtcctacagtgtgcatttctcatttttcacgtttttcagtgattttgtcatttttcaagttgtcaactgcatgtttctcattttccatgattttcagttttcttgctatattccatgtcctacagtggaaatttctaaattttccacctttttcagttttcctcgccatatttcacgtcctaaagtgtgtatttctcattttccgtgattttcagttttctcgccatattccaggtcctatgtgtacatttctcatttttcacgtttttcagtgattttgtcatttttcaagttgtgaagtggatgtttctcatttttcttgattttcatttttcttgccatattccatgtcctagagtggaaatttttaaattttccacctttttcagttttcctcgccatatttcacgtcctaaattgtgaatttctcattttccgtgattttcagttttctcgccatattccaagtcctacagtgtgcatttctcatttttcacgtttttcagtgatttcgtcatttttcaagttgtcaagtggatgtttctcattttccatgattttcagctttcttgccatattcaaagtcctacagtggacatttctaaattttcgacctttatcagttttcctcgccatatttcatgtcccaaagtgtgtacttctcattttccgtgattttcagtttcctcgccatattctaggtcctacagtgtgcatttctcatttttcaggtttttcagtgatttcgtcttttttcaagtcgtcaagtggatgtttctcattttccatgattttcagttttcttgccatattccatgtcctacagtggacatttctaaattttccacctttttcagttttcctcgccatatttcatgtcctaaagtgtgtatttctcattttcagtgattttcagttttctcgccatattccaggtcctacagtgtgcatttctcatttttcacgtttttcagtgattttgtcatttttcaagttgtcaagtggatgtttctcattttccttgattttcagttttcttgccatattccatgtcctacagtggacatttctaaattttccacctttttcagttttccttgccatatttcatgtcctaaagtgtgtatttctcattttcagtgattttcagttttctcgccatattccaggtcctacagtgtgcatttctcattttttcaggtttttcagtgatttcgtcatttttcacgttgtcaagtggatgtttctcattttccatgattttcacttttcttgccatatttcatgtcctaaagtgtgtatttctcattttcagtgattttcagttttctcgccatattccaggtcctacagtgtgcatttctcattttttcacgtttttcagtgatttcgtcatttttcacgttgtcaagtggatgtttctcattttccattattttcacttttcttgccatatttcatgtcctacagtggacatttctaaattttccacctttttctgttttcctcgccatatttcacatcctaaagtgtgtatttctcattttccgtgattttcagttttcttgccatattccaggtcctacagtgtgcatttctcatttttcacgtttttcagtgatttcgtcatttttcaagtcgtcaagtggatgtttctcattttccatgattttcagttttctcgccatattccaggtcctacagttgacatttctaaattttccacattttttatgtttcctcgcgatatttcacatcctaaagtgtgtatttctcattttccgtgattttcagttttcttgccatattccaggtcctacagggtgcatttctcatttttcacgtttttcagtgatttcatcaatttcaagtcgtcaactgtatgtttctcattttcaatgattttcatttttcttgccatattccacgtcctatagtggacatttctacattttccacctttttcagttttcttcgccatatttcacgtcccaaagtgtgtatttctcattttccgtgattttcagtttcctcgccatattccaggtcctacagtgtgcatttctcatttttcacgtttttcagtgatttcgtcttttttcaagtcgtcaagtggatgtttctcattttccatgattttcagttttcttgccatattccatgtcctacagtggacatttctaaattttccacctttttctgttttcctcgccatatttcacgtcctaaagtgtgtatttctcatttaccgtgattttcagttttcttgctatattccaagtcctacagtgtgcatttctcatttttcacgtttttcactgattttgtcattgttcaagttgtcaactgcatgtttctcattttccatgattttcagttttcttgccatattccatgtcctacagtggaaatttctatattttccaactttttcagttttcctcgccatatttcacgtgctaaagtgtgtatttctcatttttcgtgtttttcaggtttctcgccatattccaggtcctacagtgtgcatttctcatttttcacgtttttcagtgattttgtaatttttcaagttgtcaagtggatgtttctcattttccttgattttcagttttcttgccatattccatgtcctactgtggacatttctaaattttccacctttttcagttttccttgccatatttcatgtcctaaagtgtgtatttctcattttcagtgattttcagttttctcgcaatattccaggtcctacagtgtgcatttctcattttttcaggtttttcagtgatttcgtcatttttcacgttgtcaagtggatgtttctcattttccatgattttcacttttcttgccatatttcatgtgctaaagtgtgtatttctcattttcagtgattttcagttttctgccatattccaggtcctacattgtgcatttctcattttttcacgtttttcagtgatttcgtcatttttcacgttgtcaagtggatgtttctcattttccatgattttcacttttcttgccatatttcatgttttacagtggacatttctaaattttccacctatttctgttttcctcgccatatttcacatcctaaagtgtgtatttctcattttccgtgattttcagttttctcgccatatgccaggtcatacagggtgcatttctcatttttcacgtttttcagtgatttcgtcatttttcacgtcgtcaagtggatgtttctcattttcaatgattttcatttttcttgccatattccacgtcctatagtggacatttctaaattttccacctttttcagttttccttgccatatttcaggtcctacagtgtgcatttctcttttttcacgtttttcagtgatttcgtcatttttcaagtggtcaagtgcatgtttctcattttccgtgattttcagttttcttgccatgttccaggtcctacagttgacgtttctaaaatttcactttttttaagttttcctcgccatatttcacttcctaaagtgtgtatttctcattttccgtgattttcagttttctcgccagattccaggtcctacagtgtgcatttttcatatttcacctttttcagtgattttgtcatttttcaagttgtcaactgcatgtttctcattttccatgattttcagttttcttgccatattccatgtcctactgtggacatttctaaattttccaactttttcagttttcctcgccatatttcatgtcctaaagtgtgtatttctcattttcagtgattttctgttttctcgccatattccaggtcctacagtgtgcatttctaatttttcacgtttttcagtgatttcgtcatttttcaagttgtcaagtggatgtttctcattttccatgattttcagttttcttgccatattccatgtcctacagtggacatttctaaattttccaactttttccattttcctcaccatatttcacgtcctaaagtgagtttttctcattttttgtgattttcagttttctcgacatattccaggtcctacagtgtgcatttctaattttttcttttttcagtgatttcgtcatttttcaagtggtcaagtgcatgtttctcattttccatgattttcagttttcttgccatattccatgtcctacaatggacatttctaaattttccaactttttcagttttcctcgccatatttcacgtcctaaagtgtgtatttctcattttccgtgattttcagttttctcgccatattccaggtcctacagtgtgcatttctcatttttcacgtttttcagtgatttcgtcatttttcaagttgtcaactgcatgtttctcattttccatgattttcagttttcttgccatattccatgtcttacagtggacatttttaaatttttcacatttttttaagttttcctccccatatttcacgttttaaagtgtgcatttctcattttcggtgattttcagttttctcgccagattccatgtcttacagtgtgcatttctcattttttcacgtttttcagtgatttcgtcatttttcaagtcgtcaagtggatgtttctcattttccatgattttcagttttcttgccatattccatgtcctacagtggaaatttctaaattttccacctttttcagttttccttgccatatttcaggtcctaaagtgtgtatttctcattttctgtgattttcagttttctcgccatattccaggtcctacagttgacatttctaaaatttccacattttttaagttttcctcgccatatttcacttcctaaagtgtgtatttctcattttccgtgattttcagttttctcgccatattccagatcctacagtgtacatttttcatttttcacgtttttcagtgattttgtcattttttagttgtcaactgcctgtttctcattttccatgattttcagttttcttgctatattccatgtcctacagtggaaatttctaaattttccacctttttcagttttcctcgccatatttcacgtcctaaagtgtgtatttctcattttccgtgattttcagttttctcgccatattccaggtcctatgtgtacatttctcatttttcacgtttttcagtgattttgtcatttttcaatttgtcaactgcatgtttctcattttccatgattttcagttttcttgccatattccatgtcctacagtggaaatttctatattttccaactttttcagttttcctcgccatatttcacgtgctaaagtgtgtatttctcatttttcgtgtttttcaggtttctcgccatattccaggtcctacagtgtgcatttctcatttttcacgtttttcagtgattttgtcatttttcaagttgtcaagtggatgtttctcattttccttgattttcagttttcttgccatattccatgtcctacagtggacatttctaaattttccacctttttcagttttccttgccatatttcatgtcctaaagtgtgtatttctcattttcagtgattttcagttttctcgccatattccaggtcctacagtgtgcatttctcattttttcaggtttttcagtgatttcgtcatttttcacgttgtcaagtggatgtttctcattttccatgattttcacttttcttgccatatttcatgtcctaaagtgtgtatttctcattttcagtgattttcagttttctcgctatattccaggtcctacagtgtgcatttctcattttttcacgtttttcagtgatttcgtcatttttcacgttgtcaagtggatgtttctcattttccatgattttcacttttcttgccatatttcatgtcctacaatggacatttctaaattttccacctttttctgttttcctcgccatatttcacatcctaaagtgtgtatttctcattttccgtgattttcagttttcttgccatattccaggtcctacagtgtgcatttctcatttttcacgtttttcagtgatttcgtcatttttcaagttgtcaagtggatgtttctcattttccttgattttcagttttcttgccatattccatgtcctactgtggacatttctaaattttccacctttttcagttttccttgccatatttcatgtcctaaagtgtgtatttctcattttcagtgattttcagttttctcgcaatattccaggtcctacagtgtgcatttctcattttttcaggtttttcagtgatttcgtcatttttcacgttgtcaagtggatgtttctcattttccatgattttcacttttcttgccatatttcatgtcctaaagtgtgtatttctcattttcagtgattttcagttttctgccatattccaggtcctacattgtgcatttctcattttttcacgtttttcagtgatttcgtcatttttcagttttctcgacatattccaggtcctacagtgtgcatttctaattttttcttttttcagtgatttcgtcatttttcaagttgtcaactgcatgtttctcattttccatgattttcagttttcttgccatattccatgtcttacagtggacatttttaaatttttcacatttttttaagttttcctccccatatttcacgttttaaagtgtgcatttctcattttcggtgattttcagttttctcgccagattccaggtcttacagtgtgcatttctcattttttcacgtttttcagtgatttcgtcatttttcaagtcgtcaagtggatgtttctcattttccatgattttcagttttcttgccatattccatgtcctacagtggaaatttctaaattttccacctttttcagttttccttgccatatttcaggtcctaaagtgtgtatttctcattttctgtgattttcagttttctcgccatattccaggtcctacagttgacatttctaaaatttccacattttttaagttttcctcgccatatttcacttcctaaagtgtgtatttctcattttccgtgattttcagttttctcgccatattccagatcctacagtgtgcatttttcatttttcacgtttttcagtgattttgtcattttttagttgtcaactgtctgtttctcattttccatgattttcagttttcttgccatattccatgtcctacactggacatttctaaattttccacctttttctgttttcctcgccatatttcacgtcctaaagtgtgtatttctcattttccgtgattttcagttttcttgccatattccaggtcctacagtgtgcatttctcatttttcacgtttttcagtgattttgtcatttttcaagttgtcaactgcatgtttctcattttctatgattttcagttttcttgctatattccatgtcctacagtggaaatttctaaattttccacctttttcagttttcctcgccatatttcacgtcctaaagtgtgtatttctcattttccgtgattttcagttttctcgccatattccaggtcctatgtgtacatttctcatttttcacgtttttcagtgattttgtcatttttcaagttgtgaagtggatgtttctcatttttcttgattttcatttttcttgccatattccatgtcctagagtggaaatttttaaattttccacctttttcagttttcctcgccatatttcacgtcctaaagtgtgaatttctcattttccgtgattttcagatttctcgccatattccaagtcctacagtgtgcatttctcatttttcacgtttttcagtgatttcgtcatttttcaagttgtcaagtggatgtttctcattttccatgattttcagctttcttgccatattcaaagtcctacagtggacatttctaaattttcgacctttatcagttttcctcgccatatttcatgtcccaaagtgtgtacttctcattttccgtgattttcagtttcctagccatattctaggtcctacagtgtgcatttctcatttttcaggtttttcagtgatttcgtcttttttcaagtcgtcaagtggatgtttctcattttccatgattttcacttttcttgccatatttcatgtcctaaagtgtgtatttctcattttcagtgattttcagttttctcgctatattccaggtcctacagtgtgcatttctcattttttcacgtttttcagtgatttcgtcatttttcacgttgtcaagtggatgtttctcattttccatgattttcacttttcttgccatatttcatgtcctacagtggacatttctaaattttccacctttttctgttttcctcgccatatttcacatcctaaagtgtgtatttctcattttccgtgattttcagttttcttgccatattccaggtcctacagtgtgcatttctcatttttcacgtttttcagtgatttcgtcatttttcaagttgtcaagtggatgtttctcattttccttgattttcagttttcttgccatattccatgtcctactgtggacatttctaaattttccacctttttcagttttccttgccatatttcatgtcctaaagtgtgtatttctcattttcagtgattttcagttttctcgcaatattccaggtcctacagtgtgcatttctcattttttcaggtttttcagtgatttcgtcatttttcacgttgtcaagtggatgtttctcattttccatgattttcacttttcttgccatatttcatgtcctaaagtgtgtatttctcattttcagtgattttcagttttctgccatattccaggtcctacattgtgcatttctcattttttcacgtttttcagtgatttcgtcatttttcacgttgtcaagtggatgtttctcattttccatgattttcacttttcttgccatatttcatgttttacagtggacatttctaaattttccacctttttctgttttcctcgccatatttcacatcctaaagtgtgtatttctcattttccgtgattttcagttttctcgccatatgccaggtcatacagggtgcatttctcatttttcacgtttttcagtgatttcgtcatttttcacgtcgtcaagtggatgtttctcattttcaatgattttcatttttcttgccatattccacgtcctatagtggacatttctaaattttccacctttttcagttttccttgccatatttcaggtcctacagtgtgcatttctcatttttcacgtttttcagtgatttcgtcatttttcaagtggtcaagtgcatgtttctcattttccgtgattttcagttttcttgccatgttccaggtcctacagttgacgtttctaaaatttcactttttttaagttttcctcgccatatttcacttcctaaagtgtgtatttctcattttccgtgattttcagttttctcgccagattccaggtcctacagtgtgcatttttcatatttcacctttttcagtgattttgtcatttttcaagttgtcaactgcatgtttctcattttccatgattttcagttttcttgccatattccatgtcctactgtggacatttctaaattttccaactttttcagttttcctcgccatatttcatgtcctaaagtgtgtatttctcattttcagtgattttctgttttctcgccatattccaggtcctacagtgtgcatttctaatttttcacgtttttcagtgatttcgtcatttttcaagttgtcaagtggatgtttctcattttccatgattttcagttttcttgccatattccatgtcctacagtggacatttctaaattttccaactttttccattttcctcaccatatttcacgtcctaaagtgtgtttttctcattttttgtgattttcagttttctcgacatattccaggtcctacagtgtgcatttctaattttttcttttttcagtgatttcgtcatttttcaagttgtcaactgcatgtttctcattttccatgattttcagttttcttgccatattccatgtcttacagtggacatttttaaatttttcacatttttttaagttttcctccccatatttcacgttttaaagtgtgcatttctcattttcggtgattttcagttttctcgccagattccaggtcttacagtgtgcatttctcattttttcacgtttttcagtgatttcgtcatttttcaagtcgtcaagtggatgtttctcattttccatgattttcagttttcttgccatattccatgtcctacagtggaaatttctaaattttccacctttttcagttttccttgccatatttcaggtcctaaagtgtgtatttctcattttctgtgattttcagttttctcgccatattccaggtcctacagttgacatttctaaaatttccacattttttaagttttcctcgccatatttcacttcctaaagtgtgtatttctcattttccgtgattttcagttttctcgccatattccagatcctacagtgtgcatttttcatttttcacgtttttcagtgattttgtcattttttagttgtcaactgtctgtttctcattttccatgattttcagttttcttgccatattccatgtcctacactggacatttctaaattttccacctttttctgttttcctcgccatatttcacgtcctaaagtgtgtatttctcattttccgtgattttcagttttcttgccatattccaggtcctacagtgtgcatttctcatttttcacgtttttcagtgattttgtcatttttcaagttgtcaactgcatgtttctcattttccatgattttcagttttcttgctatattccatgtcctacagtggaaatttctaaattttccacctttttcagttttcctcgccatatttcacgtcctaaagtgtgtatttctcattttccgtgattttcagttttctcgccatattccaggtcctatgtgtacatttctcatttttcacgtttttcagtgattttgtcatttttcaagttgtgaagtggatgtttctcatttttcttgattttcatttttcttgccatattccatgtcctagagtggaaatttttaaattttccacctttttcagttttcctcgccatatttcacgtcctaaagtgtgaatttctcattttccgtgattttcagatttctcgccatattccaagtcctacagtgtgcatttctcatttttcacgtttttcagtgatttcgtcatttttcaagttgtcaagtggatgtttctcattttccatgattttcagctttcttgccatattcaaagtcctacagtggacatttctaaattttcgacctttatcagttttcctcgccatatttcatgtcccaaagtgtgtacttctcattttccgtgattttcagtttcctcgccatattctaggtcctacagtgtgcatttctcatttttcaggtttttcagtgatttcgtcttttttcaagtcgtcaagtggatgtttctcattttccatgattttcagttttcttgccatattccatgtcctacagtggacatttctaaattttccacctttttcagttttcctcgccatatttcatgtcctaaagtgtgtatttctcattttcagtgattttcagttttctcgccatattccaggtcctacagtgtgcatttctcatttttcacgtttttcagtgatttcgtcatttttcaagttgtcaagtggatgtttctcattttccatgattttcagttttcttgccatattccatgtcccacagtggacatttctaaattttccacctttttctgttttccttgccatatttcatgtcctaaagtgtgtatttctcattttccgtgattttcagttttcttgctatattccaagtcctacagtgtgcatttctcatttttcacgtttttcagtgattttgtcatttttcaatttgtcaactgcatgtttctcattttccatgattttcagttttcttgccatattccatgtcctacagtggaaatttctatattttccaactttttcagttttcctcgccatatttcacgtgctaaagtgtgtatttctcatttttcgtgtttttcaggtttctcgccatattccaggtcctacagtgtgcatttctcatttttcacgtttttcagtgattttgtcatttttcaagttgtcaagtggatgtttctcattttccttgattttcagttttcttgccatattccatgtcctacagtggacatttctaaattttccacctttttcagttttccttgccatatttcatgtcctaaagtgtgtatttctcattttcagtgattttcagttttctcgccatattccaggtcctacagtgtgcatttctcattttttcaggtttttcagtgatttcgtcatttttcacgttgtcaagtggatgtttctcattttccatgattttcacttttcttgccatatttcatgtcctaaagtgtgtatttctcattttcagtgattttcagttttctcgctatattccaggtcctacagtgtgcatttctcattttttcacgtttttcagtgatttcgtcatttttcacgttgtcaagtggatgtttctcattttccatgattttcacttttcttgccatatttcatgtcctacagtggacatttctaaattttccacctttttctgttttcctcgccatatttcacatactaaagtgtgtatttctcattttccttgattttcagttttcttgccatattccaggtcctacagtgtgcatttctcatttttcacgtttttcagtgatttcgtcatttttcaagtcgtcaagtggatgtttctcattttccatgattttcagttttctcgccatattccaggtcctacagttgacatttctaaattttccacattttttaagtttcctcgcgatatttcacatcctaaagtgtgtatttctcattttccgtgattttcagttttcttgccatattccaggtcctacagggtgcatttctcatttttcacgtttttcagtgatttcatcaatttcaagtcgtcaactgtatgtttctcattttcaatgattttcatttttcttgccatattccatgtcctacagtggacatttctaaatttttcacctttttcagttttccttgccatatttcatgtcctaaagtgtgtatttctcattttcagtgattttcagttttctcgccatattccaggtcctacagtgtgcatttctcattttttcaggtttttcagtgatttcgtcatttttcacgttgtcaagtggatgtttctcattttccatgattttcacttttcttgccatatttcatgtcctaaagtgtgtatttctcattttcagtgattttcagttttctcgccatattccaggtcctacagtgtgcatttctcatttttcacgtttttcagtgatttcgtcatttttcaagttgtcaagtggatgtttctcattttccatgattttcacttttcttgccatattccatgtcccacagtggacatttctaaattttccacctttttctgttttcctcgccatatttcatgtcctaaagtgtgtatttctcattttccgtgattttcagttttcttgctatattccaagtcctacagtgtgcatttctcatttttcacgtttttcagtgattttgtcatttttcaatttgtcaactgcatgtttctcattttccatgattttcagttttcttgccatattccatgttctacagtggaaatttctatattttccaactttttcagttttcctcgccatatttcacgtgctaaagtgtgtatttctcatttttcgtgtttttcaggtttctcgccatattccaggtcctacagtgtgcatttctcatttttcacgtttttcagtgattttgtcatttttcaagttgtcaagtggatgtttctcattttccttgattttcagttttcttgccatattccatgtcctacagtggacatttctaaattttccacctttttcagttttccttgccatatttcatgtcctaaagtgtgtatttctcattttcagtgattttcagttttctcgccatattccaggtcctacagtgtgcatttctcattttttcaggtttttcagtgatttcgtcatttttcacgttgtcaagtggatgtttctcattttccatgattttcacttttcttgccatatttcatgtcctaaagtgtgtatttctcattttcagtgattttcagttttctcgctatattccaggtcctacagtgtgcatttctcattttttcacgttttgcagtgatttcgtcatttttcacgttgtcaagtggatgtttctcattttccatgattttcacttttcttgccatatttcatgtcctacagtggacatttctaaattttccacctttttctgttttcctcgccatatttcacatcctaaagtgtgtatttctcattttccgtgattttcagttttcttgccatattccaggtcctacagtgtgcatttctcatttttcacgtttttcagtgatttcgtcatttttcaagtcgtcaagtggatgtttctcattttccatgattttcagttttctcgccatattccaggtcctacagttgacatttctaaattttccacattttttaagtttcctcgcgatatttcacatcctaaagtgtgtatttctcattttccgtgattttcagttttcttgccatattccaggtcctacagggtgcatttctcatttttcacgtttttcagtgatttcatcaatttcaagtcgtcaactgtatgtttctcattttcaatgattttcatttttcttgccatattccatgtcctacagtggacatttctaaattttccacctttttcagttttccttgccatatttcatgtcctaaagtgtgtatttctcattttcagggattttcagttttctcgccatattccaggtcctacagtgtgcatttctcattttttcaggtttttcagtgatttcgtcatttttcacgttgtcaagtggatgtttctcattttccatgattttcacttttcttgccatatttcatgtcctaaagtgtgtatttctcattttcagtgattttcagttttctcgccatattccaggtcctacagtgtgcatttctcattttttcacgtttttcagtgatttcgtcatttttcacgttgtcaagtggatgtttctcattttccatgattttcacttttcttgccatatttcatgtcctacagtggacatttctaaattttccacctttttctgttttcctcgccatatttcacatcctaaagtgtgtatttctcattttccgtgattttcagttttcttgccatattccaggtcctacagtgtgcatttctcatttttcacgtttttcagtgatttcgtcatttttcaagtcgtcaagtggatgtttctcattttccatgattttcagttttctcgccatattccaggtcctacagttgacatttctaaattttccacattttttaagtttcctcgcgatatttcacatcctaaagtgtgtatttctcattttccgtgattttcagttttcttgccatattccaggtcctacagggtgcatttctcatttttcacgtttttcagtgatttcatcaatttcaagtcgtcaactgtatgtttctcattttcaatgattttcatttttcttgccatattccacgtcctatagtggacatttctaaattttccacctttttcagttttcttcgccatatttcacgtcccaaagtgtgtatttctcattttccgtgattttcagtttcctcgcaatattccaggtcctacagtgtgcatttctcatttttcacgtttttcagtgatttcgtcttttttcaagtcgtcaagtggatgtttctcattttccatgattttcagttttcttgccatattccatgtcctacagtggacatttctaaattttccacctttttctgttttcctcgccatatttcacgtcctaaagtgtgtatttctcattttccgtgattttcagttttcttgccatattccaggtcctacagtgtgcatttctcatttttcacgtttttcactgattttgtcattgttcaagttgtcaactgcatgtttctcattttccatgattttcaattttcttgccatattccatgtcctacagtggaaatttctatattttccaactttttcagttttcctcgccatatttcacgtgctaaagtgtgtatttctcatttttcgtgtttttcaggtttctcgccatattccaggtcctacagtgtgcatttctcatttttcacgtttttcagtgattttgtcatttttcaagttgtcaagtggttgtttctcattttccttgattttcagttttcttgccatattccatgtcctactgtggacatttctaaattttccacctttttcagttttccttgccatatttcatgtcctaaagtgtgtatttctcattttcagtgattttcagttttctcgcaatattccaggtcctacagtgtgcatttctcattttccgtgattttcagttttctcgccatatgccaggtcatacagggtgcatttctcatttttcacgtttttcagtgatttcgtcatttttcacgtcgtcaagtggatgtttctcattttcaatgattttcatttttcttgccatattccacgtcctatagtggacatttctaaattttccaactttttcagttttcttgccatatttcaggtcctacagtgtgcatttctcatttttcacgtttttcagtgatttcgtcatttttcaagtggtcaagtgcatgtttctgattttccgtgattttcagttttcttgccatgttccaggtcctacagttgacgtttctaaaatttcactttttttaagttttcctcgccatatttcacttcctaaagtgtgtatttctcattttccgtgattttcagttttctcgccagattccaggtcctacagtgtgcatttttcatatttcacctttttcagtgattttgtcatttttcaagttgtcaactgcatgtttctcattttccatgattttcagttttcttgccatattccatgtcctactgtggacatttctaaattttccaactttttcagttttcctcgccatatttcatgtcctaaagtgtgtatttctcattttcagtgtttttctgttttctcgccatattccaggtcctacagtgtgcatttctaatttttcacgtttttcagtgatttcgtcatttttcaagttgtcaagtggatgtttctcattttccatgattttcagttttcttgccatattccatgtcctacagtggacatttctaaattttccaactttttccattttcctcaccatatttcacgtcctaaagtgtgtttttctcattttttgtgattttcagttttctcgacatattccaggtcctacagtgtgcatttctaattttttcttttttcagtgatttcgtcatttttcaagtggtcaagtgcatgtttctcattttccatgattttcagttttcttgccatattccatgtcctacaatggacatttctaaattttccaactttttcagttttcctcgccatatttcacgtcctaaagtgtgtatttctcattttccgtgattttcagttttctcgccatattccaggtcctatgtgtacatttctcatttttcacgtttttcagtgattttgtcatttttcaagttgtgaagtggatgtttctcatttttcttgattttcatttttcttgccatattccatgtcctagagtggaaatttttaaattttccaactttttcagttttcctcgccatatttcacgtcctaaagtgtgtatttctcattttccgtgattttcagttttctcgccatattccaagtcctacagtgtgcatttctcatttttcacgtttttcagtgatttcgtcatttttcaagttgtcaagtggatgtttctcattttccatgattttcagctttcttgccatattcaaagtcctacagtggacatttctaaattttcgacctttatcagttttcctcgccatatttcatgtcccaaagtgtgtacttctcattttccgtgattttcagtttcctcgccatattctaggtcctacagtgtgcatttctcatttttcaggtttttcagtgatttcgtcttttttcaagtcgtcaagtggatgtttctcattttccatgattttcagttttcttgccatattccatgtcctacagtggacatttctaaattttccacctttttcagttttcctcgccatatttcatgtcctaaagtgtgtatttctcattttcagtgattttcagttttctcgccatattccaggtcctacagtgtgcatttctcatttttcacgtttttcagtgatttcgtcatttttcaagttgtcaagtggatgtttctcattttccatgattttcagttttcttgccatattccatgtcccacagtggacatttctaaattttccacctttttctgttttccttgccatatttcatgtcctaaagtgtgtatttctcattttccgtgattttcagttttcttgctatattccaagtcctacagtgtgcatttctcatttttcacgtttttaagtgattttgtcatttttcaatttgtcaactgcatgtttctcattttccatgattttcagttttcttgccatattccatgtcctacagtggaaatttctatattttccaactttttcagttttcctcgccatatttcacgtgctaaagtgtgtatttctcatttttcgtgtttttcaggtttctcgccatattccaggtcctacagtgtgcatttctcatttttcacgtttttcagtgattttgtcatttttcaagttgtcaagtggatgtttctcattttccttgattttcagttttcttgccatattccatgtcctacagtggacatttctaaattttccacctttttcagttttccttgccatatttcatgtcctaaagtgtgtatttctcattttcagtgattttcagttttctcgccatattccaggtcctacagtgtgcatttctcattttttcaggtttttcagtgatttcgtcatttttcacgttgtcaagtggatgtttctcattttccatgattttcacttttcttgccatatttcatgtcctaaagtgtgtatttctcattttcagtgattttcagttttctcgccatattccaggtcctacagtgtgcatttctcattttttcacgtttttcagtgatttcgtcatttttcacgttgtcaagtggatgtttctcattttccatgattttcacttttcttgccatatttcatgtcctacagtggacatttctaaattttccacctttttctgttttcctcgccatatttcacatcctaaagtgtgtatttctcattttccgtgattttcagttttcttgccatatttcaggtcctacagtgtgcatttctcatttttcacgtttttcagtgatttcgtcatttttcaagtcgtcaagaggatgtttctcattttccatgattttcagttttctcgccatattccaggtcctacagttgacatttctaaattttccacattttttaagtttcctcgcgatatttcacatcctaaagtgtgtatttctcattttccgtgattttcagttttcttgccatattccaggtcctacagggtgcatttctcatttttcacgtttttcagtgatttcatcaatttcaagtcgtcaactgtatgtttctcattttcaatgattttcatttttcttgccatattccacgtcctatagtggacatttctaaattttccacctttttctgttttcctcgccatatttcacgtcctaaagtgtgtatttctcattttccgtgattttcagttttcttgccatattccaggtcctacagtgtgcatttctcatttttcacgtttttcactgattttgtcattgttcaagttgtcaactgcatgtttctcattttccatgattttcagttttcttgccatattccatgtcctacagtggaaatttctatattttccacctttttcagttttcctcgccgtatttcatgtgctaaagtgtgtatttctcatttttcgtgtttttcaggtttctcgccatattccaggtcctacagtgtgcatttctcatttttcacgtttttcagtgattttgtcatttttcaagttgtcaactggatgtttctcattttccttgattttcagttttcttgccatattccatgtcctactgtggacatttctaaattttccacctttttcagttttccttgccatatttcatgtcctaaagtgtgtatttctcattttcagtgattttcagttttctcgcaatattccaggtcctacagtgtgcatttctcattttttcaggtttttcagtgatttcgtcatttttcacgttgtcaagtggatgtttctcattttccatgattttcacttttcttgccatatttcatgtcctaaagtgtgtatttctcattttcagtgattttcagttttctcgccatattccaggtcctacattgtgcatttctcattttttcacgtttttcagtgatttcgtcatttttcacgttgtcaagtggatgtttctcattttccatgattttcacttttcttgccatatttcatgttttacagtggacatttctaaattttccacctttttctgttttcctcgccatatttcacatcctaaagtgtgaatttctcattttccgtgattttcagttttcttgccatattccaggtcctacagtgtgcatttctcatttttcacgtttttcagtgatttcatcatttttcaagtcgtcaagtggatgtttctcattttccatgattttcagttttcttgccatattccatgtcctacagtggacatttctaaattttccacctttttctgttttcctcgccatatttcacgtcctaaagtgtgtatttctcattttccgtgattttcagttttcttgccatattccaggtcctacagtgtgcatttctcatttttcacgtttttcactgattttgtcatttttcaagttgtcaactgcatgtttctcattttccatgattttcagttttcttgctatattccatgtcctacagtggaaatttctaaattttccacctttttcagttttcctcgccatatttcacgtcctgaagtgtgtatttctcattttccgtgattttcagttttctcgccatattccaggtcctatgtgtacatttctcatttttcacgtttttcagtgattttgtcatttttcaagttgtgaagtggatgtttctcatttttcttgattttcatttttcttgccatattccatgtcctacagtggaaatttctaaattttccacctttttcagttttcctcgccatatttcacgtcctaaagtgtgtatttctcattttccgtgattttcagttttctcgccatattccaggtcctacagtgtgcatttctcatttttcacgtttttcagtgatttcgacatttttcaagttgtcaagtggatgtttctcattttccatgattttcagctttcttgccatattcaaagtcctacagtggacatttctaaattttcgacctttatcagttttcctcgccatatttcatgtcccaaagtgtgtacttctcattttccgtgattttcagtttcctcgccatattccaggtcctacagtgtgcatttctcatttttcacgtttttcagtgatttcgtcatttttcaagtcgtcaagtggatgtttctcattttccatgattttcagttttcttgccatattccatgtcctacagtggacatttctaaattttccacctttttctgttttcctcgccatatttcacgtcctaaagtgtgtatttctcattttccgtgattttcagttttcttgccatattccaggtcctacagtgtgcatttctcatttatcacgtttttcactgattttgtcatttttcaagttgtcaactgcatgtttctcattttccatgattttcagttttcttgctatattccatgtcctacagtggaatattctaaattttccacctttttcagttttcctcgccatatttcacgtcctgaagtgtgtatttctcattttccgtgattttcagttttctcgccatattccaggtcctatgtgtacatttctcatttttcacgtttttcagtgattttgtcatttttcaagttgtgaagtggatgtttctcatttttcttgattttcatttttcttgccatattccatgtcctacagtggaaatttctaaattttccacctttttcagttttcctcgccatatttcacgtcctaaagtgtgaatttctcattttccgtgattttcagttttctcgccatattccaggtcctacagtgtgcatttctcatttttcacgtttttcagtgatttcgacatttttcaagttgtcaagtggatgtttctcattttccatgattttcagctttcttgccatattcaaagtcctacagtggacatttctaaattttcgacctttatcagttttcctcgccatatttcatgtcccaaagtgtgtacttctcattttccgtgattttgagtttcctcgccatattccaggtcctacagtgtgcatttctcatttttcacgtttttcagtgatttcgtcttttttcaagttgtcaactgcatgtttctcattttccatgattttcagttttcttgccatattccatgtcctacagtggaaatttgtaaatttccacctttttcagttttcctcgccatatttcacgtcctaaagtatgtatttctcattttccgtgattttcagttttctcgccatattccaggtcctacagtgtgcatttctcatttttcacgtttttcagtgattttgtcattttttaagttttcaagtggatgtttctcattttccttgattttcagttttcttgccatattccatgtcctacagtggacatttctaaattttccacctttttcagttttcctcgccatatttcatgtcctaaagtgtgtatttctcattttcagtgattttcagttttctcgccatattccaggtcctacagtgtgcatttctcatttttcacgtttttcagtgatttcgtcatttttcaaggtgtcaagtggatgtttctcattttccatgattttcagttttcttgccatattccatgtcctacagtggacatttctaaattttccacctttttctgttttcctcgccatatttcatgtcctaaagtgtgtatttctcattttccgtgattttcagttttcttgctatattccaagtcctacagtgtgcatttctcatttttcacgtttttcagtgattttgtcatttttcaatttgtcaactgcatgtttctcattttccatgattttcagtttttttgccatattccatgtcctactgtggaaatttctatattttccacctttttcagttttcctcgccatatttcacgtgctaaagtgtgtatttctcatttttcgtgtttttcaggtttctcgccatattccaggtcctacagtgtgcatttctcatttttcacgtttttcagtgattttgtcatttttcaagttttcaagtggatgtttctcattttccttgattttcagttttcttgccatattccatgtcctacagtggacatttctaaattttccacctttttcagttttccttgccatatttcatgtcctaaagtgtgtatttctcattttcagtgattttcagtttccttgccatattccaggtcctacagtgtgcatttctcattttttcacgtttttcagtgatttcgtcatttttcacgttgtcaagtggatgtttctcattttccatgattttcacttttcttgccatatttcatgtcctacagtggacatttctaaattttccaactttttcaattttcctcgccatattttatgtcctaaagtgtgtatttctcatttttcgttattttcagttttcttgccatattccaggtcctacagtgtgcatttgtcatttttcacgtttttcagtgatttcgtcatttttcaagtcgtcaagtagatgtttctcatattccatgtttttcagttttctcgccatattccaggtcctacagttgacatttctaaattttctacatttttaaattttcctcgccatatttcacgtcctaaagtgtgtatttctcattttttgttattttcagttttctagccatattccaggtcctacaggatgcatttctcatttttcacgtttttcagtgatttcatcatttttcaagtcgtcaagtgtatgtttcttattttcaatgattttcatttttcttgccttattccacgtcctatagtggacatttctaaattttccacctttttcagtttttttcgccatatttcacgtcctaaagtgtgtatttctcattttctgtgattttcagttttctcaccatattccaggtcctacagtgtgcatttctcatttttcacgtttttcagtgatttcgtcatttttcaagttgtcaagtggaagtttctcattttccatgattttcagctttctagacatattccaggtcctacagtggacatttcctaattttcgacctttatcagttttcctcgtcatatttcacgtcccaaaatgtgtatttcttattttccatgattttcagtttcctcgccatattccaggtcctacagtgtgcaattctcatttttcacgtttttcagtgatttcgtcttttttcaagacgtcaagtggatgtttctcatttttcatgattttcagttttcttgccatattccatgtcctacagtggacatttctaaattttccacctttttctgttttcctcgccatatttcacgtcctaaagtgtgtatttctcattttccgtgattttcagttttcttgccatattcctggtcctacagtgtgcatttctcatttttcacgtttttcagtgattttgtcatttttcaatttgtcaactgcatgtttctcattttccattattttcagttttcttgccatattccatgtcctacagtggacatttctaaattttccacctttttctgttttcctcgccatatttcatgtcctaaagtgtgtatttctcattttccgtgattttcagttttcttgctatattccaagtcctacagtgtgcatttctcatttttcacgtttttcagtgattttgtcatttttcaatttgtcaactgcatgtttctcattttccatgattttcagtttttttgccatattccatgtcctacaggggaaatttctatattttccacctttttcagttttcctcgccatatttcatgtcctaaagtgtgtatttctcattttccgtgattttcagttttcttgccatattccaggtcctacagtgtgcatttctcatttttcacgtttttcagtgatttcgtcatttttcaagtcttcaagtagatgtttctcatattccatgtttttcagttttctcgccatattccaggtcctacagttgacatttctaaattttctacatttttaaattttcctcgccatatttcacgtcctaaagtgtgtatttctcatttttcgttattttcagttttctagccatattccaggtcctacaggatgcatttctcatttttcacgtttttcagtgatttcatcatttttcaagtcgtcaagtgtatgtttctcattttcaatgattttcatttttcttgccttattccacgtcctatagtggacatttctaaattttccacctttttcagtttttctcgccatatttcacgtcctaaagtgtgtatttctcattttctgtgattttcagttttctcaccatattccaggtcctacagtgtgcatttctcatttttcacgtttttcagtgatttcgtcatttttcaagttgtcaagtggaagtttctcattttccatgattttcagctttctagccatattccaggtcctacagtggacatttcctaattttcgacctttatcagttttcctcgccatatttcacgtcctaaagtgtgtatttctcattttccgtgattttcagttttcttgccatattccaggtcctacagtgtgcatttctcatttttcacgtttttcagtgattttgtcatttttcaatttgtcaactgcatgtttctcattttccatgatttttagttttcttgctatattccatgtcctacagtggaaatttctaaattttccacctttttcagttttcctcgccatatttcacgtcctaaagtgtgtatttctcattttccgtgattttcagttttcttgctatattccaagtcctacattgtgcatttctcatttttcacgtttttcagtgattttgtcatttttcaatttgtcaaaccacatgtttctcattttccatgattttcagtttttttgccatattccatgtcctacagtggaaatttctatattttccacctttttcagttttcctcgccatatttcacgtgctaaagtgtgtatttctcatttttcgtgtttttcaggtttctcgccatattccaggtcctacagtgtgcatttctcatttttcacgtttttcagtgattttgtcatttttcaagttgtcaagtggatgtttcccattttccttgattttcagttttcttaccatattccatgtcctacagtggacatttctaaattttccacctttttcagttttccttgccatatttcatgtcctaaagtgtgtatttctcattttcagtgattttcagtttcctcgccatattccaggtcctacagtgtgcatttctcattttttcacgtttttcagtgatttcgtcatttttcacgttgtcaagtggatgtttctcattttccatgattttcacttttcttgccatatttcatgtcctatagtggacatttctaaattttccacctttttcagtttttctcgccatatttcacgtcctaaagtgtgtatttctcattttctgtgattttcagttttctcaccatattccaggtcctacagtgtgcatttctcatttttcacgtttttcagtgatttcgtcatttttcaagtcgtcaagtagatgtttctcatattccatgtttttcagttttctcgccatattccaggtcctacagttgacatttctaaattttctacatttttaaattttcctcgccatatttcacgtcctaaagtgtgtatttctcatttttcgttattttcagttttctagccatattccaggtcctacaggatgcatttctcatttttcacgtttttcagtgatttcatcatttttcaagtcgtcaagtgtatgtttcttattttcaatgattttcatttttcttgccttattccacgtcctatagtggacatttctaaattttccaccttttttcagtttttctcgccatatttcacgtcctaaagtgtgtatttctcattttctgtgattatcagttttctcaccatattccaggtcctacagtgtgcatttctcatttttcacgtttttcagtgatttcgtcatttttcaagttgtcaagtggaagtttctcattttccatgattttcagctttctagccatattccaggtcctacagtggacatttcctaattttcgacctttatcagttttcctcgccatatttcacgtcccaaaatgtgtatttcttattttccatgattttcagtttcctcgccatattccaggtcctacagtgtgcatttctcatttttcacgtttttcagtgatttcgtcttttttcaagacgtcaagtggatgtttctcatttttcatgattttcagttttcttgccatattccatgtcctacagtggacatttctaaattttccacctttttctgttttcctcgccatatttcacgtcctaaagtgtgtatttctcattttccgtgattttcagttttcttgccatattcctggtcctacagtgtgcatttctcatttttcacgtttttcagtgattttgtcatttttcaatttgtcaactgcatgtttctcattttccatgattttcagttttcttgccatattccatgtcctacagtggacatttctaaattttccacctttttcagttttcctcgccatatttcacgtgctaaagtgtgtatttctcatttttcgtgtttttcaggtttctcgccatattccaggtcctacagtgtgcatttctcatttttcacgtttttcagtgattttgtcatttttcaagttgtcaagtggatgtttctcattttccttgattttcacttttcttgccatattccaagtcttacaggggcatttctcatttttcacgttttcagtgattttgtcattttcaatttgtcaactgcatgtttctcattttccatgattttcagtttttttgccatattccatgtcctacaggggaaatttctatattttccacctttttcagttttcctcgccatatttcatgtcctaaagtgtgtatttctcattttccgtgattttcagttttcttgccatattccaggtcctacagtgtgcatttctcatttttcacgtttttcagtgatttcgtcatttttcaagtcttcaagtagatgtttctcatattccatgtttttcagttttctcgccatattccaggtcctacagttgacatttctaaattttctacatttttaaattttcctcgccatatttcacgtcctaaagtgtgtatttctcatttttcgttattttcagttttctagccatattccaggtcctacaggatgcatttctcatttttcacgtttttcagtgatttcatcatttttcaagtcgtcaagtgtatgtttctcattttcaatgattttcatttttcttgccttattccacgtcctatagtggacatttctaaattttccacctttttcagtttttctcgccatatttcacgtcctaaagtgtgtatttctcattttctgtgattttcagttttctcaccatattccaggtcctacagtgtgcatttctcatttttcacgtttttcagtgatttcgtcatttttcaagttgtcaagtggaagtttctcattttccatgattttcagctttctagccatattccaagtcctacagtggacatttcctaattttcgacctttatcagttttcctcgccatatttcacgtcccaaaatgtgtattccttattttccatgattttcagtttcctcgccatattccaggtcctacagtgtgcatttatcatttttcacgtttttcagtgatttcgtcttttttcaagacgtcaagtggatgtttctcatttttcatgattttcagttttcttgccatattccatgtcctacagtggacatttctaaattttccacctttttctgttttcctcgccatatttcacgtcctaaagtgtgtatttctcattttccgtgattttcagttttcttgccatattcctggtcctacagtgtgcatttctcatttttcacgtttttcagtgattttgtcatttttcaagttgtcaagtggatgtttctcattttccttgattttcacttttcttgccatattccatgtcctacagtggacatttctatattttccacctttttccgttttccttgccatatttcacgtcctaaagtgtgtatttctcattttccgtgattttcaggtttctcgccatattccaggtcctacagtgtgcatttctcatttttcacgtttttcagtgattttgtcatttttcaagttgtcaagtggatgtttctcattttccttgattttcacttttcttgccatattccatgtcctacagtggacatttctaaattttccacctttttcagttttcctcgccatatttcatgtcctaaagtgtgtatttctcattttcagtgattttcagttttcttgccatattccaggtcctacagtgtgcatttctcatttttcacgtttttcagtgattttgtcatttttcaagttgtcaactgcatgtttctcattttctatgattttcagttttcttgctatattccatgtcctacagtggaaatttctaaattttccacctttttcagttttcctcgccatatttcacgtcctaaagtgtgtatttctcattttccgtgattttcagttttctcgccatattccaggtcctatgtgtacatttctcatttttcacgtttttcagtgattttgtcatttttcaagttgtgaagtggatgtttctcatttttcttgattttcatttttcttgccatattccatgtcctagagtggaaatttttaaattttccacctttttcagttttcctcgccatatttcacgtcctaaagtgtgaatttctcattttccgtgattttcagatttctcgccatattccaagtcctacagtgtgcatttctcatttttcacgtttttcagtgatttcgtcatttttcaagttgtcaagtggatgtttctcattttccatgattttcagctttcttgccatattcaaagtcctacagtggacatttctaaattttcgacctttatcagttttcctcgccatatttcatgtcccaaagtgtgtacttctcattttccgtgattttcagtttcctcgccatattctaggtcctacagtgtgcatttctcatttttcaggtttttcagtgatttcgtcttttttcaagtcgtcaagtggatgtttctcattttccatgattttcacttttcttgccatatttcatgtcctaaagtgtgtatttctcattttcagtgattttcagttttctcgctatattccaggtcctacagtgtgcatttctcattttttcacgtttttcagtgatttcgtcatttttcacgttgtcaagtggatgtttctcattttccatgattttcacttttcttgccatatttcatgtcctacagtggacatttctaaattttccacctttttctgttttcctcgccatatttcacatcctaaagtgtgtatttctcattttccgtgattttcagttttcttgccatattccaggtcctacagtgtgcatttctcatttttcacgtttttcagtgatttcgtcatttttcaagttgtcaagtggatgtttctcattttccttgattttcagttttcttgccatattccatgtcctactgtggacatttctaaattttccacctttttcagttttccttgccatatttcatgtcctaaagtgtgtatttctcattttcagtgattttcagttttctcgcaatattccaggtcctacagtgtgcatttctcattttttcaggtttttcagtgatttcgtcatttttcacgttgtcaagtggatgtttctcattttccatgattttcacttttcttgccatatttcatgtcctaaagtgtgtatttctcattttcagtgattttcagttttcctcgccatatttcacgtcccaaaatgtgtatttcttattttccatgattttcagtttcctcgccatattccaggtcctacagtgtgcatttctcatttttcacgtttttcagtgatttcgtcttttttcaagacgtcaagtggatgtttctcatttttcatgattttcagttttcttgccatattccatgtcctacagtggacatttctaaattttccacctttttctgttttcctcgccatatttcacgtcctaaagtgtgtatttctcattttccgtgattttcagttttcttgccatattcctggtcctacagtgtgcatttctcatttttcacgtttttcagtgattttgtcatttttcaatttgtcaactgcatgtttctcattttccatgattttcagttttcttgccatattccatgtcctacagtggacatttctaaattttccacctttttcagttttcctcgccatatttcacgtgctaaagtgtgtatttctcatttttcgtgtttttcaggtttctcgccatattccaggtcctacagtgtgcatttctcatttttcacgtttttcagtgattttgtcatttttcaagttgtcaagtggatgtttctcattttccttgattttcacttttcttgccatattccatgtcctacagtggacatttctaaattttccacctttttcagttttcctcgccatatttcatgtcctaaagtgtgtatttctcattttcagtgattttcagttttctcgccatattccaggtcctacagtgtgcatttctcatttttcacgtttttcagtgatttcgtcttttttcaagacgtcaagtggatgtttctcattttccatgattttcagttttcttgccatattccatgtcctacagtggacatttctaaattttccacctttttctgttttcctcgccatatttcacgtcctaaagtgtgtatttctcattttccgtgattttcagttttcttgccatattccaggtcctacagtgtgcatttctcatttttcacgtttttcagtgattttgtcatttttcaatttgtcaactgcatgtttctcattttccatgatttttagttttcttgctatattccatgtcctacagtggaaatttctaaattttccacctttttcagttttcctcgccatatttcacgtcctaaagtgtgtatttctcattttccgtgattttcagttttcttgctatattccaagtcctacattgtgcatttctcatttttcacgtttttcagtgattttgtcatttttcaatttgtcaaaccacatgtttctcattttccatgattttcagtttttttgccatattccatgtcctacagtggaaatttctatattttccacctttttcagttttcctcgccatatttcacgtgctaaagtgtgtatttctcatttttcgtgtttttcaggtttctcgccatattccaggtcctacagtgtgcatttctcatttttcacgtttttctgtgattttgtcatttttcaagttgtcaagtggatgtttctcattttccttgattttcagttttcttaccatattccatgtcctacagtggacatttctaaattttccaccttttctgttttcctcgccatatttcatgtcctaaagtgtgtatttctcattttccgtgattttcatttttcttgctatattccaagtcctacagtgtgcatttctcattttccatgattttcagttttcttgctatattccatgtcctacagtggaaatttctaaattttccacctttttcagttttcctcgccatatttcacgtcctaaagtgtgtatttctcattttccgtgattttcagttttttcgccatattacaggtcctatgtgtacatttctcatttttcacgtttttcagtgattttgtcatttttcaagttgtcaagtggatgtttctcatttttcttgattttcatttttcttgccatattccatgtcctacagtggaaatttctaaattttccacctttttcagttttcctcgccatatttcacgtcctaaagtgtgaatttctcattttccgtgattttcagttttctcgccatattccaggtctacagtgtgcatttctcatttttcacgttttcagtgattcgtcatttttcaagttgacaagtggatgtttctcattttccatgattttcagctttcttgccatattcaaagtcctacagtggacatttctaaattttcgacctttatcagttttcctcgccatatttcatgtcccaaagtgtgtacttctcattttccgtgattttcagttttcttgccatattccaagtcctacagtgtgcatttctcatttttcacgtttttcagtgattttgtcatttttcaatttgtcaactgcatgtttctcattttccatgattttcagttttcttgccatattccatgtcctacagtggaaatttctatattttccacctttttcagttttcctcgccatatttcacgtgctaaagtgtgtatttctcatttttcgtgtttttcaggtttctcgccatattccaggtcctacagtgtgcatttctcatttttcacgtttttcagtgattttgtcatttttcaagttgtcaagtggatgtttctcattttcaatgattttcatttttcttgccttattccacgtcctatagtggacatttctaaattttccacctttttcagtttttctcgccatatttcacgtcccaaaatgtgtattccttattttccatgattttcagtttcctcgccatattccaggtcctacagtgtgcatttctcatttttcacgtttttcagtgatttcgtcttttttcaagacgtcaagtggatgtttctcatttttcatgattttcagttttcttgccatattccctgtcctacagtggacatttctaaattttccacctttttctgttttcctcgccatatttcacgtcctaaagtgtgtatttctcattttccgtgattttcagttttctcgccagattccaggtcctacagtgtgcatttctcatttttcacgtttttcagtgattttgtcatttttcaatttgtcaactgcatgtttctctctttccatgattttcagttttcttgccatattccatgtcctacagtggacatttctaaattttccacctttttcagttttcctcgccatatttcacgtgctaaagtgtgtatttctcatttttcgtgtttttcaggtttctcgccatattccaggtcctacagtgtgcatttctcatttttcacgtttttcagtgattttgtcatttttcaagttgtcaagtggatgtttctcattttcaatgattttcatttttcttaccttattccacgtcctatagtggacatttctaaattttccacctttttcagtttttctcgccatatttcacgtcccaaaatgtgtattccttattttccatgattttcagtttcctcgccatattccaggtcctacagtgtgcatttctcatttttcacgtttttcagtgatttcgtcttttttcaagacgtcaagtggatgtttctcatttttcatgattttcagttttcttgccatattccctgtcctacagtggacatttctaaattttccacctttttctgttttcctcgccatatttcacgtcctaaagtgtgtatttctcattttccgtgattttcagttttctcgccagattccaggtcctacagtgtgcatttctcatttttcacgtttttcagtgatttcgtcatttttcaagtcttcaagtgtatgtttctcattttcaatgattttcatttttcttgccttattccacgtcctatagtggacatttctaaattttccacctttttcagtttttctcgccatatttcacgtcctaaagtgtgtatttctcattttctgtgattttcagttttcttaccatattccaggtcctacagtgtgcatttctcatttttcacgtttttcagtgatttcgtcatttttcaagttgtcaagtggaagtttctcattttccatgattttcagctttctagccatattccaggtattacagtggacatttccttattttcgacctttatcagttttcctcgccatatttcatgtcctaaagtgtgt	38399	1554	4%	7300	19%
9	3000001	3038400	Atcctacagtgtgcatttctcatttttcacgtttttcagtgatttcgtcatttttcaagtcatcaagtggctgtttctcattttccatgattttcagttttcttgccatattccttgtcctacagtggacatttctaaattttccacctttttcagttttccttgtcatatttcaggtcctacagtgtgtatttctcatttttcacgtttttcattgatttcgtcatttttcaagttgtcaagtgcatgtttctcattttccatgattttcagttttcttgccatattccatgtcctacaatggacatttctaaattttccaactttttcagttttcctcgccatatttcacgtcctaaagtgtgtatttctcattttccgtgattttcagttttctcgacatattccaggtcctacagtgtgcatttctcatttttcacgtttttcagtgatttcgtcatttttcacgtcgtcaagtggatgtttctcattttccatgattttcagttttcttgccatattccatgtcctacagtggacatttctaaattttccacctttttcagttttcctcgccatatttcacgtcctaaagtgtgtatttctcattttccgtgattttcagttttctcgacatattccaggtcttacagggtgcatttctcatttttcacgtttttcagtgatttcatcatttttcaagtcgtcaactgtatgtttctcattttcaatgattttcatttttcttgccatattccacgtcctatagtggacatttctaaattttccacctttttcagttttccttgccatatttcaggtcctacagtgtgcatttctcatttttcacgtttttcagtgatttcgtcatttttcaagtggtcaaatgcatgtttctcattttccatgattttcagttttcttgccatattccatgtcctacagtggacatttctaaattttccacctttttcagttttcctcgccatatttcacgtcctaaagtgtgtatttctcattttccgtgattttcagttttatcgccagattccaggtcctacggtgtgcatttttcatatttcacgtttttcagtgattttgtcatttttcaagttgtcaactgcatgtttctcattttccatgattttcagttttcttgccatattccatgtcctacagtggacatttctaaattttccacctttttcagttttcctcgccatatttcatgtcctaaagtgtgtatttctcattttcagtgattttctgttttctcgccatattccaggtcctacagtgtgcatttctcatttttcacgtttttcagtgatttcgtcatttttcaagttgtcaagtggatgtttctcattttccatgattttcagttttcttgccatattccatgtcctacaatggacatttctaaattttccacctttttcagttttcctcgccatatttcacgtcctaaagtgtgtatttctcattttccgtgattttcagttttctcgccatattccaggtcctatgtgtacatttctcatttttcacgtttttcagtgattttgtcatttttcaagttgtgaagtggatgtttctcatttttcttgattttcatttttcttgccatattccatgtcctagagtggaaatttttaaattttccacctttttcagttttcctcgccatatttcacgtcctaaagtgtgaatttctcattttccgtgattttcagttttctcgccatattccaagtcctacagtgtgcatttctcatttttcacgtttttcagtgatttcgtcatttttcaagttgtcaagtggatgtttctcattttccatgattttcagctttcttgccatattcaaagtcctacagtggacatttctaaattttcgacctttatcagttttcctcgccatatttcatgtcccaaagtgtgtacttctcattttccgtgattttcagtttcctcgccatattctaggtcctacagtgtgcatttctcatttttcaggtttttcagtgatttcgtcttttttcaagtcgtcaagtggatgtttctcattttccatgattttcagttttcttgccatattccatgtcctacagtggacatttctaaattttccaactttttcagttttcctcgccatatttcatgtcctaaagtgtgtatttctcattttcagtgattttcagttttctcgccatattccaggtcctacagtgtgcatttctcatttttcacgtttttcagtgatttcgtcatttttcaagttgtcaagtggatgtttctcatttttcatgattttcagttttcttgccatattccatgtcccacagtggacatttctaaatgttccacctttttctgttttccttgccatatttcatgtcctaaagtgtgtatttctcattttccgtgattttcagttttcttgctatattccaagtcctacagtgtgcatttctcatttttcacgtttttctgtgattttttcatttttcaatttgtcaactgcatgtttctcattttccatgattttcagttttcttgccatattccaggtcctacagtgtgcatttctcatttttcacgtttttcagtgattttgtcatttttcaagttgtcaactgcatgtttctcattttccatgattttcagttttcttgctatattccatgtcctacagtggaaatttctaaattttccacctttttcagttttcctcgccatatttcacgtcctaaagtgtgtatttctcattttccgtgattttcagttttctcgccatattccaggtcctatgtgtacatttctcatttttcacgtttttcagtgattttgtcatttttcaagttgtgaagtggatgtttctcatttttcttgattttcatttttcttgccatattccatgtcctagagtggaaatttttaaattttccacctttttcagttttcctcgccatatttcacgtcctaaattgtgaatttctcattttccgtgattttcagttttctcgccatattccaagtcctacagtgtgcatttctcatttttcacgtttttcagtgatttcgtcatttttcaagttgtcaagtggatgtttctcattttccatgattttcagctttcttgccatattcaaagtcctacagtggacatttctaaattttcgacctttatcagttttcctcgccatatttcatgtcccaaagtgtgtacttctcattttccgtgattttcagtttcctcgccatattctaggtcctacagtgtgcatttctcatttttcaggtttttcagtgatttcgtcttttttcaagtcgtcaagtggatgtttctcattttccatgattttcagttttcttgccatattccatgtcctacagtggacatttctaaattttccacctttttcagttttcctcgccatatttcatgtcctaaagtgtgtatttctcattttcagtgattttcagttttctcgccatattccaggtcctacagtgtgcatttctcatttttcacgtttttcagtgattttgtcatttttcaagttgtcaagtggatgtttctcattttccttgattttcagttttcttgccatattccatgtcctacagtggacatttctaaattttccacctttttcagttttccttgccatatttcatgtcctaaagtgtgtatttctcattttcagtgattttcagttttctcgccatattccaggtcctacagtgtgcatttctcattttttcaggtttttcagtgatttcgtcatttttcacgttgtcaagtggatgtttctcattttccatgattttcacttttcttgccatatttcatgtcctaaagtgtgtatttctcattttcagtgattttcagttttctcgccatattccaggtcctacagtgtgcatttctcattttttcacgtttttcagtgatttcgtcatttttcacgttgtcaagtggatgtttctcattttccattattttcacttttcttgccatatttcatgtcctacagtggacatttctaaattttccacctttttctgttttcctcgccatatttcacatcctaaagtgtgtatttctcattttccgtgattttcagttttcttgccatattccaggtcctacagtgtgcatttctcatttttcacgtttttcagtgatttcgtcatttttcaagtcgtcaagtggatgtttctcattttccatgattttcagttttctcgccatattccaggtcctacagttgacatttctaaattttccacattttttatgtttcctcgcgatatttcacatcctaaagtgtgtatttctcattttccgtgattttcagttttcttgccatattccaggtcctacagggtgcatttctcatttttcacgtttttcagtgatttcatcaatttcaagtcgtcaactgtatgtttctcattttcaatgattttcatttttcttgccatattccacgtcctatagtggacatttctacattttccacctttttcagttttcttcgccatatttcacgtcccaaagtgtgtatttctcattttccgtgattttcagtttcctcgccatattccaggtcctacagtgtgcatttctcatttttcacgtttttcagtgatttcgtcttttttcaagtcgtcaagtggatgtttctcattttccatgattttcagttttcttgccatattccatgtcctacagtggacatttctaaattttccacctttttctgttttcctcgccatatttcacgtcctaaagtgtgtatttctcatttaccgtgattttcagttttcttgctatattccaagtcctacagtgtgcatttctcatttttcacgtttttcactgattttgtcattgttcaagttgtcaactgcatgtttctcattttccatgattttcagttttcttgccatattccatgtcctacagtggaaatttctatattttccaactttttcagttttcctcgccatatttcacgtgctaaagtgtgtatttctcatttttcgtgtttttcaggtttctcgccatattccaggtcctacagtgtgcatttctcatttttcacgtttttcagtgattttgtaatttttcaagttgtcaagtggatgtttctcattttccttgattttcagttttcttgccatattccatgtcctactgtggacatttctaaattttccacctttttcagttttccttgccatatttcatgtcctaaagtgtgtatttctcattttcagtgattttcagttttctcgcaatattccaggtcctacagtgtgcatttctcattttttcaggtttttcagtgatttcgtcatttttcacgttgtcaagtggatgtttctcattttccatgattttcacttttcttgccatatttcatgtgctaaagtgtgtatttctcattttcagtgattttcagttttctgccatattccaggtcctacattgtgcatttctcattttttcacgtttttcagtgatttcgtcatttttcacgttgtcaagtggatgtttctcattttccatgattttcacttttcttgccatatttcatgttttacagtggacatttctaaattttccacctatttctgttttcctcgccatatttcacatcctaaagtgtgtatttctcattttccgtgattttcagttttctcgccatatgccaggtcatacagggtgcatttctcatttttcacgtttttcagtgatttcgtcatttttcacgtcgtcaagtggatgtttctcattttcaatgattttcatttttcttgccatattccacgtcctatagtggacatttctaaattttccacctttttcagttttccttgccatatttcaggtcctacagtgtgcatttctcttttttcacgtttttcagtgatttcgtcatttttcaagtggtcaagtgcatgtttctcattttccgtgattttcagttttcttgccatgttccaggtcctacagttgacgtttctaaaatttcactttttttaagttttcctcgccatatttcacttcctaaagtgtgtatttctcattttccgtgattttcagttttctcgccagattccaggtcctacagtgtgcatttttcatatttcacctttttcagtgattttgtcatttttcaagttgtcaactgcatgtttctcattttccatgattttcagttttcttgccatattccatgtcctactgtggacatttctaaattttccaactttttcagttttcctcgccatatttcatgtcctaaagtgtgtatttctcattttcagtgattttctgttttctcgccatattccaggtcctacagtgtgcatttctaatttttcacgtttttcagtgatttcgtcatttttcaagttgtcaagtggatgtttctcattttccatgattttcagttttcttgccatattccatgtcctacagtggacatttctaaattttccaactttttccattttcctcaccatatttcacgtcctaaagtgagtttttctcattttttgtgattttcagttttctcgacatattccaggtcctacagtgtgcatttctaattttttcttttttcagtgatttcgtcatttttcaagtggtcaagtgcatgtttctcattttccatgattttcagttttcttgccatattccatgtcctacaatggacatttctaaattttccaactttttcagttttcctcgccatatttcacgtcctaaagtgtgtatttctcattttccgtgattttcagttttctcgccatattccaggtcctacagtgtgcatttctcatttttcacgtttttcagtgatttcgtcatttttcaagttgtcaactgcatgtttctcattttccatgattttcagttttcttgccatattccatgtcttacagtggacatttttaaatttttcacatttttttaagttttcctccccatatttcacgttttaaagtgtgcatttctcattttcggtgattttcagttttctcgccagattccatgtcttacagtgtgcatttctcattttttcacgtttttcagtgatttcgtcatttttcaagtcgtcaagtggatgtttctcattttccatgattttcagttttcttgccatattccatgtcctacagtggaaatttctaaattttccacctttttcagttttccttgccatatttcaggtcctaaagtgtgtatttctcattttctgtgattttcagttttctcgccatattccaggtcctacagttgacatttctaaaatttccacattttttaagttttcctcgccatatttcacttcctaaagtgtgtatttctcattttccgtgattttcagttttctcgccatattccagatcctacagtgtacatttttcatttttcacgtttttcagtgattttgtcattttttagttgtcaactgcctgtttctcattttccatgattttcagttttcttgctatattccatgtcctacagtggaaatttctaaattttccacctttttcagttttcctcgccatatttcacgtcctaaagtgtgtatttctcattttccgtgattttcagttttctcgccatattccaggtcctatgtgtacatttctcatttttcacgtttttcagtgattttgtcatttttcaatttgtcaactgcatgtttctcattttccatgattttcagttttcttgccatattccatgtcctacagtggaaatttctatattttccaactttttcagttttcctcgccatatttcacgtgctaaagtgtgtatttctcatttttcgtgtttttcaggtttctcgccatattccaggtcctacagtgtgcatttctcatttttcacgtttttcagtgattttgtcatttttcaagttgtcaagtggatgtttctcattttccttgattttcagttttcttgccatattccatgtcctacagtggacatttctaaattttccacctttttcagttttccttgccatatttcatgtcctaaagtgtgtatttctcattttcagtgattttcagttttctcgccatattccaggtcctacagtgtgcatttctcattttttcaggtttttcagtgatttcgtcatttttcacgttgtcaagtggatgtttctcattttccatgattttcacttttcttgccatatttcatgtcctaaagtgtgtatttctcattttcagtgattttcagttttctcgctatattccaggtcctacagtgtgcatttctcattttttcacgtttttcagtgatttcgtcatttttcacgttgtcaagtggatgtttctcattttccatgattttcacttttcttgccatatttcatgtcctacaatggacatttctaaattttccacctttttctgttttcctcgccatatttcacatcctaaagtgtgtatttctcattttccgtgattttcagttttcttgccatattccaggtcctacagtgtgcatttctcatttttcacgtttttcagtgatttcgtcatttttcaagttgtcaagtggatgtttctcattttccttgattttcagttttcttgccatattccatgtcctactgtggacatttctaaattttccacctttttcagttttccttgccatatttcatgtcctaaagtgtgtatttctcattttcagtgattttcagttttctcgcaatattccaggtcctacagtgtgcatttctcattttttcaggtttttcagtgatttcgtcatttttcacgttgtcaagtggatgtttctcattttccatgattttcacttttcttgccatatttcatgtcctaaagtgtgtatttctcattttcagtgattttcagttttctgccatattccaggtcctacattgtgcatttctcattttttcacgtttttcagtgatttcgtcatttttcagttttctcgacatattccaggtcctacagtgtgcatttctaattttttcttttttcagtgatttcgtcatttttcaagttgtcaactgcatgtttctcattttccatgattttcagttttcttgccatattccatgtcttacagtggacatttttaaatttttcacatttttttaagttttcctccccatatttcacgttttaaagtgtgcatttctcattttcggtgattttcagttttctcgccagattccaggtcttacagtgtgcatttctcattttttcacgtttttcagtgatttcgtcatttttcaagtcgtcaagtggatgtttctcattttccatgattttcagttttcttgccatattccatgtcctacagtggaaatttctaaattttccacctttttcagttttccttgccatatttcaggtcctaaagtgtgtatttctcattttctgtgattttcagttttctcgccatattccaggtcctacagttgacatttctaaaatttccacattttttaagttttcctcgccatatttcacttcctaaagtgtgtatttctcattttccgtgattttcagttttctcgccatattccagatcctacagtgtgcatttttcatttttcacgtttttcagtgattttgtcattttttagttgtcaactgtctgtttctcattttccatgattttcagttttcttgccatattccatgtcctacactggacatttctaaattttccacctttttctgttttcctcgccatatttcacgtcctaaagtgtgtatttctcattttccgtgattttcagttttcttgccatattccaggtcctacagtgtgcatttctcatttttcacgtttttcagtgattttgtcatttttcaagttgtcaactgcatgtttctcattttctatgattttcagttttcttgctatattccatgtcctacagtggaaatttctaaattttccacctttttcagttttcctcgccatatttcacgtcctaaagtgtgtatttctcattttccgtgattttcagttttctcgccatattccaggtcctatgtgtacatttctcatttttcacgtttttcagtgattttgtcatttttcaagttgtgaagtggatgtttctcatttttcttgattttcatttttcttgccatattccatgtcctagagtggaaatttttaaattttccacctttttcagttttcctcgccatatttcacgtcctaaagtgtgaatttctcattttccgtgattttcagatttctcgccatattccaagtcctacagtgtgcatttctcatttttcacgtttttcagtgatttcgtcatttttcaagttgtcaagtggatgtttctcattttccatgattttcagctttcttgccatattcaaagtcctacagtggacatttctaaattttcgacctttatcagttttcctcgccatatttcatgtcccaaagtgtgtacttctcattttccgtgattttcagtttcctagccatattctaggtcctacagtgtgcatttctcatttttcaggtttttcagtgatttcgtcttttttcaagtcgtcaagtggatgtttctcattttccatgattttcacttttcttgccatatttcatgtcctaaagtgtgtatttctcattttcagtgattttcagttttctcgctatattccaggtcctacagtgtgcatttctcattttttcacgtttttcagtgatttcgtcatttttcacgttgtcaagtggatgtttctcattttccatgattttcacttttcttgccatatttcatgtcctacagtggacatttctaaattttccacctttttctgttttcctcgccatatttcacatcctaaagtgtgtatttctcattttccgtgattttcagttttcttgccatattccaggtcctacagtgtgcatttctcatttttcacgtttttcagtgatttcgtcatttttcaagttgtcaagtggatgtttctcattttccttgattttcagttttcttgccatattccatgtcctactgtggacatttctaaattttccacctttttcagttttccttgccatatttcatgtcctaaagtgtgtatttctcattttcagtgattttcagttttctcgcaatattccaggtcctacagtgtgcatttctcattttttcaggtttttcagtgatttcgtcatttttcacgttgtcaagtggatgtttctcattttccatgattttcacttttcttgccatatttcatgtcctaaagtgtgtatttctcattttcagtgattttcagttttctgccatattccaggtcctacattgtgcatttctcattttttcacgtttttcagtgatttcgtcatttttcacgttgtcaagtggatgtttctcattttccatgattttcacttttcttgccatatttcatgttttacagtggacatttctaaattttccacctttttctgttttcctcgccatatttcacatcctaaagtgtgtatttctcattttccgtgattttcagttttctcgccatatgccaggtcatacagggtgcatttctcatttttcacgtttttcagtgatttcgtcatttttcacgtcgtcaagtggatgtttctcattttcaatgattttcatttttcttgccatattccacgtcctatagtggacatttctaaattttccacctttttcagttttccttgccatatttcaggtcctacagtgtgcatttctcatttttcacgtttttcagtgatttcgtcatttttcaagtggtcaagtgcatgtttctcattttccgtgattttcagttttcttgccatgttccaggtcctacagttgacgtttctaaaatttcactttttttaagttttcctcgccatatttcacttcctaaagtgtgtatttctcattttccgtgattttcagttttctcgccagattccaggtcctacagtgtgcatttttcatatttcacctttttcagtgattttgtcatttttcaagttgtcaactgcatgtttctcattttccatgattttcagttttcttgccatattccatgtcctactgtggacatttctaaattttccaactttttcagttttcctcgccatatttcatgtcctaaagtgtgtatttctcattttcagtgattttctgttttctcgccatattccaggtcctacagtgtgcatttctaatttttcacgtttttcagtgatttcgtcatttttcaagttgtcaagtggatgtttctcattttccatgattttcagttttcttgccatattccatgtcctacagtggacatttctaaattttccaactttttccattttcctcaccatatttcacgtcctaaagtgtgtttttctcattttttgtgattttcagttttctcgacatattccaggtcctacagtgtgcatttctaattttttcttttttcagtgatttcgtcatttttcaagttgtcaactgcatgtttctcattttccatgattttcagttttcttgccatattccatgtcttacagtggacatttttaaatttttcacatttttttaagttttcctccccatatttcacgttttaaagtgtgcatttctcattttcggtgattttcagttttctcgccagattccaggtcttacagtgtgcatttctcattttttcacgtttttcagtgatttcgtcatttttcaagtcgtcaagtggatgtttctcattttccatgattttcagttttcttgccatattccatgtcctacagtggaaatttctaaattttccacctttttcagttttccttgccatatttcaggtcctaaagtgtgtatttctcattttctgtgattttcagttttctcgccatattccaggtcctacagttgacatttctaaaatttccacattttttaagttttcctcgccatatttcacttcctaaagtgtgtatttctcattttccgtgattttcagttttctcgccatattccagatcctacagtgtgcatttttcatttttcacgtttttcagtgattttgtcattttttagttgtcaactgtctgtttctcattttccatgattttcagttttcttgccatattccatgtcctacactggacatttctaaattttccacctttttctgttttcctcgccatatttcacgtcctaaagtgtgtatttctcattttccgtgattttcagttttcttgccatattccaggtcctacagtgtgcatttctcatttttcacgtttttcagtgattttgtcatttttcaagttgtcaactgcatgtttctcattttccatgattttcagttttcttgctatattccatgtcctacagtggaaatttctaaattttccacctttttcagttttcctcgccatatttcacgtcctaaagtgtgtatttctcattttccgtgattttcagttttctcgccatattccaggtcctatgtgtacatttctcatttttcacgtttttcagtgattttgtcatttttcaagttgtgaagtggatgtttctcatttttcttgattttcatttttcttgccatattccatgtcctagagtggaaatttttaaattttccacctttttcagttttcctcgccatatttcacgtcctaaagtgtgaatttctcattttccgtgattttcagatttctcgccatattccaagtcctacagtgtgcatttctcatttttcacgtttttcagtgatttcgtcatttttcaagttgtcaagtggatgtttctcattttccatgattttcagctttcttgccatattcaaagtcctacagtggacatttctaaattttcgacctttatcagttttcctcgccatatttcatgtcccaaagtgtgtacttctcattttccgtgattttcagtttcctcgccatattctaggtcctacagtgtgcatttctcatttttcaggtttttcagtgatttcgtcttttttcaagtcgtcaagtggatgtttctcattttccatgattttcagttttcttgccatattccatgtcctacagtggacatttctaaattttccacctttttcagttttcctcgccatatttcatgtcctaaagtgtgtatttctcattttcagtgattttcagttttctcgccatattccaggtcctacagtgtgcatttctcatttttcacgtttttcagtgatttcgtcatttttcaagttgtcaagtggatgtttctcattttccatgattttcagttttcttgccatattccatgtcccacagtggacatttctaaattttccacctttttctgttttccttgccatatttcatgtcctaaagtgtgtatttctcattttccgtgattttcagttttcttgctatattccaagtcctacagtgtgcatttctcatttttcacgtttttcagtgattttgtcatttttcaatttgtcaactgcatgtttctcattttccatgattttcagttttcttgccatattccatgtcctacagtggaaatttctatattttccaactttttcagttttcctcgccatatttcacgtgctaaagtgtgtatttctcatttttcgtgtttttcaggtttctcgccatattccaggtcctacagtgtgcatttctcatttttcacgtttttcagtgattttgtcatttttcaagttgtcaagtggatgtttctcattttccttgattttcagttttcttgccatattccatgtcctacagtggacatttctaaattttccacctttttcagttttccttgccatatttcatgtcctaaagtgtgtatttctcattttcagtgattttcagttttctcgccatattccaggtcctacagtgtgcatttctcattttttcaggtttttcagtgatttcgtcatttttcacgttgtcaagtggatgtttctcattttccatgattttcacttttcttgccatatttcatgtcctaaagtgtgtatttctcattttcagtgattttcagttttctcgctatattccaggtcctacagtgtgcatttctcattttttcacgtttttcagtgatttcgtcatttttcacgttgtcaagtggatgtttctcattttccatgattttcacttttcttgccatatttcatgtcctacagtggacatttctaaattttccacctttttctgttttcctcgccatatttcacatactaaagtgtgtatttctcattttccttgattttcagttttcttgccatattccaggtcctacagtgtgcatttctcatttttcacgtttttcagtgatttcgtcatttttcaagtcgtcaagtggatgtttctcattttccatgattttcagttttctcgccatattccaggtcctacagttgacatttctaaattttccacattttttaagtttcctcgcgatatttcacatcctaaagtgtgtatttctcattttccgtgattttcagttttcttgccatattccaggtcctacagggtgcatttctcatttttcacgtttttcagtgatttcatcaatttcaagtcgtcaactgtatgtttctcattttcaatgattttcatttttcttgccatattccatgtcctacagtggacatttctaaatttttcacctttttcagttttccttgccatatttcatgtcctaaagtgtgtatttctcattttcagtgattttcagttttctcgccatattccaggtcctacagtgtgcatttctcattttttcaggtttttcagtgatttcgtcatttttcacgttgtcaagtggatgtttctcattttccatgattttcacttttcttgccatatttcatgtcctaaagtgtgtatttctcattttcagtgattttcagttttctcgccatattccaggtcctacagtgtgcatttctcatttttcacgtttttcagtgatttcgtcatttttcaagttgtcaagtggatgtttctcattttccatgattttcacttttcttgccatattccatgtcccacagtggacatttctaaattttccacctttttctgttttcctcgccatatttcatgtcctaaagtgtgtatttctcattttccgtgattttcagttttcttgctatattccaagtcctacagtgtgcatttctcatttttcacgtttttcagtgattttgtcatttttcaatttgtcaactgcatgtttctcattttccatgattttcagttttcttgccatattccatgttctacagtggaaatttctatattttccaactttttcagttttcctcgccatatttcacgtgctaaagtgtgtatttctcatttttcgtgtttttcaggtttctcgccatattccaggtcctacagtgtgcatttctcatttttcacgtttttcagtgattttgtcatttttcaagttgtcaagtggatgtttctcattttccttgattttcagttttcttgccatattccatgtcctacagtggacatttctaaattttccacctttttcagttttccttgccatatttcatgtcctaaagtgtgtatttctcattttcagtgattttcagttttctcgccatattccaggtcctacagtgtgcatttctcattttttcaggtttttcagtgatttcgtcatttttcacgttgtcaagtggatgtttctcattttccatgattttcacttttcttgccatatttcatgtcctaaagtgtgtatttctcattttcagtgattttcagttttctcgctatattccaggtcctacagtgtgcatttctcattttttcacgttttgcagtgatttcgtcatttttcacgttgtcaagtggatgtttctcattttccatgattttcacttttcttgccatatttcatgtcctacagtggacatttctaaattttccacctttttctgttttcctcgccatatttcacatcctaaagtgtgtatttctcattttccgtgattttcagttttcttgccatattccaggtcctacagtgtgcatttctcatttttcacgtttttcagtgatttcgtcatttttcaagtcgtcaagtggatgtttctcattttccatgattttcagttttctcgccatattccaggtcctacagttgacatttctaaattttccacattttttaagtttcctcgcgatatttcacatcctaaagtgtgtatttctcattttccgtgattttcagttttcttgccatattccaggtcctacagggtgcatttctcatttttcacgtttttcagtgatttcatcaatttcaagtcgtcaactgtatgtttctcattttcaatgattttcatttttcttgccatattccatgtcctacagtggacatttctaaattttccacctttttcagttttccttgccatatttcatgtcctaaagtgtgtatttctcattttcagggattttcagttttctcgccatattccaggtcctacagtgtgcatttctcattttttcaggtttttcagtgatttcgtcatttttcacgttgtcaagtggatgtttctcattttccatgattttcacttttcttgccatatttcatgtcctaaagtgtgtatttctcattttcagtgattttcagttttctcgccatattccaggtcctacagtgtgcatttctcattttttcacgtttttcagtgatttcgtcatttttcacgttgtcaagtggatgtttctcattttccatgattttcacttttcttgccatatttcatgtcctacagtggacatttctaaattttccacctttttctgttttcctcgccatatttcacatcctaaagtgtgtatttctcattttccgtgattttcagttttcttgccatattccaggtcctacagtgtgcatttctcatttttcacgtttttcagtgatttcgtcatttttcaagtcgtcaagtggatgtttctcattttccatgattttcagttttctcgccatattccaggtcctacagttgacatttctaaattttccacattttttaagtttcctcgcgatatttcacatcctaaagtgtgtatttctcattttccgtgattttcagttttcttgccatattccaggtcctacagggtgcatttctcatttttcacgtttttcagtgatttcatcaatttcaagtcgtcaactgtatgtttctcattttcaatgattttcatttttcttgccatattccacgtcctatagtggacatttctaaattttccacctttttcagttttcttcgccatatttcacgtcccaaagtgtgtatttctcattttccgtgattttcagtttcctcgcaatattccaggtcctacagtgtgcatttctcatttttcacgtttttcagtgatttcgtcttttttcaagtcgtcaagtggatgtttctcattttccatgattttcagttttcttgccatattccatgtcctacagtggacatttctaaattttccacctttttctgttttcctcgccatatttcacgtcctaaagtgtgtatttctcattttccgtgattttcagttttcttgccatattccaggtcctacagtgtgcatttctcatttttcacgtttttcactgattttgtcattgttcaagttgtcaactgcatgtttctcattttccatgattttcaattttcttgccatattccatgtcctacagtggaaatttctatattttccaactttttcagttttcctcgccatatttcacgtgctaaagtgtgtatttctcatttttcgtgtttttcaggtttctcgccatattccaggtcctacagtgtgcatttctcatttttcacgtttttcagtgattttgtcatttttcaagttgtcaagtggttgtttctcattttccttgattttcagttttcttgccatattccatgtcctactgtggacatttctaaattttccacctttttcagttttccttgccatatttcatgtcctaaagtgtgtatttctcattttcagtgattttcagttttctcgcaatattccaggtcctacagtgtgcatttctcattttccgtgattttcagttttctcgccatatgccaggtcatacagggtgcatttctcatttttcacgtttttcagtgatttcgtcatttttcacgtcgtcaagtggatgtttctcattttcaatgattttcatttttcttgccatattccacgtcctatagtggacatttctaaattttccaactttttcagttttcttgccatatttcaggtcctacagtgtgcatttctcatttttcacgtttttcagtgatttcgtcatttttcaagtggtcaagtgcatgtttctgattttccgtgattttcagttttcttgccatgttccaggtcctacagttgacgtttctaaaatttcactttttttaagttttcctcgccatatttcacttcctaaagtgtgtatttctcattttccgtgattttcagttttctcgccagattccaggtcctacagtgtgcatttttcatatttcacctttttcagtgattttgtcatttttcaagttgtcaactgcatgtttctcattttccatgattttcagttttcttgccatattccatgtcctactgtggacatttctaaattttccaactttttcagttttcctcgccatatttcatgtcctaaagtgtgtatttctcattttcagtgtttttctgttttctcgccatattccaggtcctacagtgtgcatttctaatttttcacgtttttcagtgatttcgtcatttttcaagttgtcaagtggatgtttctcattttccatgattttcagttttcttgccatattccatgtcctacagtggacatttctaaattttccaactttttccattttcctcaccatatttcacgtcctaaagtgtgtttttctcattttttgtgattttcagttttctcgacatattccaggtcctacagtgtgcatttctaattttttcttttttcagtgatttcgtcatttttcaagtggtcaagtgcatgtttctcattttccatgattttcagttttcttgccatattccatgtcctacaatggacatttctaaattttccaactttttcagttttcctcgccatatttcacgtcctaaagtgtgtatttctcattttccgtgattttcagttttctcgccatattccaggtcctatgtgtacatttctcatttttcacgtttttcagtgattttgtcatttttcaagttgtgaagtggatgtttctcatttttcttgattttcatttttcttgccatattccatgtcctagagtggaaatttttaaattttccaactttttcagttttcctcgccatatttcacgtcctaaagtgtgtatttctcattttccgtgattttcagttttctcgccatattccaagtcctacagtgtgcatttctcatttttcacgtttttcagtgatttcgtcatttttcaagttgtcaagtggatgtttctcattttccatgattttcagctttcttgccatattcaaagtcctacagtggacatttctaaattttcgacctttatcagttttcctcgccatatttcatgtcccaaagtgtgtacttctcattttccgtgattttcagtttcctcgccatattctaggtcctacagtgtgcatttctcatttttcaggtttttcagtgatttcgtcttttttcaagtcgtcaagtggatgtttctcattttccatgattttcagttttcttgccatattccatgtcctacagtggacatttctaaattttccacctttttcagttttcctcgccatatttcatgtcctaaagtgtgtatttctcattttcagtgattttcagttttctcgccatattccaggtcctacagtgtgcatttctcatttttcacgtttttcagtgatttcgtcatttttcaagttgtcaagtggatgtttctcattttccatgattttcagttttcttgccatattccatgtcccacagtggacatttctaaattttccacctttttctgttttccttgccatatttcatgtcctaaagtgtgtatttctcattttccgtgattttcagttttcttgctatattccaagtcctacagtgtgcatttctcatttttcacgtttttaagtgattttgtcatttttcaatttgtcaactgcatgtttctcattttccatgattttcagttttcttgccatattccatgtcctacagtggaaatttctatattttccaactttttcagttttcctcgccatatttcacgtgctaaagtgtgtatttctcatttttcgtgtttttcaggtttctcgccatattccaggtcctacagtgtgcatttctcatttttcacgtttttcagtgattttgtcatttttcaagttgtcaagtggatgtttctcattttccttgattttcagttttcttgccatattccatgtcctacagtggacatttctaaattttccacctttttcagttttccttgccatatttcatgtcctaaagtgtgtatttctcattttcagtgattttcagttttctcgccatattccaggtcctacagtgtgcatttctcattttttcaggtttttcagtgatttcgtcatttttcacgttgtcaagtggatgtttctcattttccatgattttcacttttcttgccatatttcatgtcctaaagtgtgtatttctcattttcagtgattttcagttttctcgccatattccaggtcctacagtgtgcatttctcattttttcacgtttttcagtgatttcgtcatttttcacgttgtcaagtggatgtttctcattttccatgattttcacttttcttgccatatttcatgtcctacagtggacatttctaaattttccacctttttctgttttcctcgccatatttcacatcctaaagtgtgtatttctcattttccgtgattttcagttttcttgccatatttcaggtcctacagtgtgcatttctcatttttcacgtttttcagtgatttcgtcatttttcaagtcgtcaagaggatgtttctcattttccatgattttcagttttctcgccatattccaggtcctacagttgacatttctaaattttccacattttttaagtttcctcgcgatatttcacatcctaaagtgtgtatttctcattttccgtgattttcagttttcttgccatattccaggtcctacagggtgcatttctcatttttcacgtttttcagtgatttcatcaatttcaagtcgtcaactgtatgtttctcattttcaatgattttcatttttcttgccatattccacgtcctatagtggacatttctaaattttccacctttttctgttttcctcgccatatttcacgtcctaaagtgtgtatttctcattttccgtgattttcagttttcttgccatattccaggtcctacagtgtgcatttctcatttttcacgtttttcactgattttgtcattgttcaagttgtcaactgcatgtttctcattttccatgattttcagttttcttgccatattccatgtcctacagtggaaatttctatattttccacctttttcagttttcctcgccgtatttcatgtgctaaagtgtgtatttctcatttttcgtgtttttcaggtttctcgccatattccaggtcctacagtgtgcatttctcatttttcacgtttttcagtgattttgtcatttttcaagttgtcaactggatgtttctcattttccttgattttcagttttcttgccatattccatgtcctactgtggacatttctaaattttccacctttttcagttttccttgccatatttcatgtcctaaagtgtgtatttctcattttcagtgattttcagttttctcgcaatattccaggtcctacagtgtgcatttctcattttttcaggtttttcagtgatttcgtcatttttcacgttgtcaagtggatgtttctcattttccatgattttcacttttcttgccatatttcatgtcctaaagtgtgtatttctcattttcagtgattttcagttttctcgccatattccaggtcctacattgtgcatttctcattttttcacgtttttcagtgatttcgtcatttttcacgttgtcaagtggatgtttctcattttccatgattttcacttttcttgccatatttcatgttttacagtggacatttctaaattttccacctttttctgttttcctcgccatatttcacatcctaaagtgtgaatttctcattttccgtgattttcagttttcttgccatattccaggtcctacagtgtgcatttctcatttttcacgtttttcagtgatttcatcatttttcaagtcgtcaagtggatgtttctcattttccatgattttcagttttcttgccatattccatgtcctacagtggacatttctaaattttccacctttttctgttttcctcgccatatttcacgtcctaaagtgtgtatttctcattttccgtgattttcagttttcttgccatattccaggtcctacagtgtgcatttctcatttttcacgtttttcactgattttgtcatttttcaagttgtcaactgcatgtttctcattttccatgattttcagttttcttgctatattccatgtcctacagtggaaatttctaaattttccacctttttcagttttcctcgccatatttcacgtcctgaagtgtgtatttctcattttccgtgattttcagttttctcgccatattccaggtcctatgtgtacatttctcatttttcacgtttttcagtgattttgtcatttttcaagttgtgaagtggatgtttctcatttttcttgattttcatttttcttgccatattccatgtcctacagtggaaatttctaaattttccacctttttcagttttcctcgccatatttcacgtcctaaagtgtgtatttctcattttccgtgattttcagttttctcgccatattccaggtcctacagtgtgcatttctcatttttcacgtttttcagtgatttcgacatttttcaagttgtcaagtggatgtttctcattttccatgattttcagctttcttgccatattcaaagtcctacagtggacatttctaaattttcgacctttatcagttttcctcgccatatttcatgtcccaaagtgtgtacttctcattttccgtgattttcagtttcctcgccatattccaggtcctacagtgtgcatttctcatttttcacgtttttcagtgatttcgtcatttttcaagtcgtcaagtggatgtttctcattttccatgattttcagttttcttgccatattccatgtcctacagtggacatttctaaattttccacctttttctgttttcctcgccatatttcacgtcctaaagtgtgtatttctcattttccgtgattttcagttttcttgccatattccaggtcctacagtgtgcatttctcatttatcacgtttttcactgattttgtcatttttcaagttgtcaactgcatgtttctcattttccatgattttcagttttcttgctatattccatgtcctacagtggaatattctaaattttccacctttttcagttttcctcgccatatttcacgtcctgaagtgtgtatttctcattttccgtgattttcagttttctcgccatattccaggtcctatgtgtacatttctcatttttcacgtttttcagtgattttgtcatttttcaagttgtgaagtggatgtttctcatttttcttgattttcatttttcttgccatattccatgtcctacagtggaaatttctaaattttccacctttttcagttttcctcgccatatttcacgtcctaaagtgtgaatttctcattttccgtgattttcagttttctcgccatattccaggtcctacagtgtgcatttctcatttttcacgtttttcagtgatttcgacatttttcaagttgtcaagtggatgtttctcattttccatgattttcagctttcttgccatattcaaagtcctacagtggacatttctaaattttcgacctttatcagttttcctcgccatatttcatgtcccaaagtgtgtacttctcattttccgtgattttgagtttcctcgccatattccaggtcctacagtgtgcatttctcatttttcacgtttttcagtgatttcgtcttttttcaagttgtcaactgcatgtttctcattttccatgattttcagttttcttgccatattccatgtcctacagtggaaatttgtaaatttccacctttttcagttttcctcgccatatttcacgtcctaaagtatgtatttctcattttccgtgattttcagttttctcgccatattccaggtcctacagtgtgcatttctcatttttcacgtttttcagtgattttgtcattttttaagttttcaagtggatgtttctcattttccttgattttcagttttcttgccatattccatgtcctacagtggacatttctaaattttccacctttttcagttttcctcgccatatttcatgtcctaaagtgtgtatttctcattttcagtgattttcagttttctcgccatattccaggtcctacagtgtgcatttctcatttttcacgtttttcagtgatttcgtcatttttcaaggtgtcaagtggatgtttctcattttccatgattttcagttttcttgccatattccatgtcctacagtggacatttctaaattttccacctttttctgttttcctcgccatatttcatgtcctaaagtgtgtatttctcattttccgtgattttcagttttcttgctatattccaagtcctacagtgtgcatttctcatttttcacgtttttcagtgattttgtcatttttcaatttgtcaactgcatgtttctcattttccatgattttcagtttttttgccatattccatgtcctactgtggaaatttctatattttccacctttttcagttttcctcgccatatttcacgtgctaaagtgtgtatttctcatttttcgtgtttttcaggtttctcgccatattccaggtcctacagtgtgcatttctcatttttcacgtttttcagtgattttgtcatttttcaagttttcaagtggatgtttctcattttccttgattttcagttttcttgccatattccatgtcctacagtggacatttctaaattttccacctttttcagttttccttgccatatttcatgtcctaaagtgtgtatttctcattttcagtgattttcagtttccttgccatattccaggtcctacagtgtgcatttctcattttttcacgtttttcagtgatttcgtcatttttcacgttgtcaagtggatgtttctcattttccatgattttcacttttcttgccatatttcatgtcctacagtggacatttctaaattttccaactttttcaattttcctcgccatattttatgtcctaaagtgtgtatttctcatttttcgttattttcagttttcttgccatattccaggtcctacagtgtgcatttgtcatttttcacgtttttcagtgatttcgtcatttttcaagtcgtcaagtagatgtttctcatattccatgtttttcagttttctcgccatattccaggtcctacagttgacatttctaaattttctacatttttaaattttcctcgccatatttcacgtcctaaagtgtgtatttctcattttttgttattttcagttttctagccatattccaggtcctacaggatgcatttctcatttttcacgtttttcagtgatttcatcatttttcaagtcgtcaagtgtatgtttcttattttcaatgattttcatttttcttgccttattccacgtcctatagtggacatttctaaattttccacctttttcagtttttttcgccatatttcacgtcctaaagtgtgtatttctcattttctgtgattttcagttttctcaccatattccaggtcctacagtgtgcatttctcatttttcacgtttttcagtgatttcgtcatttttcaagttgtcaagtggaagtttctcattttccatgattttcagctttctagacatattccaggtcctacagtggacatttcctaattttcgacctttatcagttttcctcgtcatatttcacgtcccaaaatgtgtatttcttattttccatgattttcagtttcctcgccatattccaggtcctacagtgtgcaattctcatttttcacgtttttcagtgatttcgtcttttttcaagacgtcaagtggatgtttctcatttttcatgattttcagttttcttgccatattccatgtcctacagtggacatttctaaattttccacctttttctgttttcctcgccatatttcacgtcctaaagtgtgtatttctcattttccgtgattttcagttttcttgccatattcctggtcctacagtgtgcatttctcatttttcacgtttttcagtgattttgtcatttttcaatttgtcaactgcatgtttctcattttccattattttcagttttcttgccatattccatgtcctacagtggacatttctaaattttccacctttttctgttttcctcgccatatttcatgtcctaaagtgtgtatttctcattttccgtgattttcagttttcttgctatattccaagtcctacagtgtgcatttctcatttttcacgtttttcagtgattttgtcatttttcaatttgtcaactgcatgtttctcattttccatgattttcagtttttttgccatattccatgtcctacaggggaaatttctatattttccacctttttcagttttcctcgccatatttcatgtcctaaagtgtgtatttctcattttccgtgattttcagttttcttgccatattccaggtcctacagtgtgcatttctcatttttcacgtttttcagtgatttcgtcatttttcaagtcttcaagtagatgtttctcatattccatgtttttcagttttctcgccatattccaggtcctacagttgacatttctaaattttctacatttttaaattttcctcgccatatttcacgtcctaaagtgtgtatttctcatttttcgttattttcagttttctagccatattccaggtcctacaggatgcatttctcatttttcacgtttttcagtgatttcatcatttttcaagtcgtcaagtgtatgtttctcattttcaatgattttcatttttcttgccttattccacgtcctatagtggacatttctaaattttccacctttttcagtttttctcgccatatttcacgtcctaaagtgtgtatttctcattttctgtgattttcagttttctcaccatattccaggtcctacagtgtgcatttctcatttttcacgtttttcagtgatttcgtcatttttcaagttgtcaagtggaagtttctcattttccatgattttcagctttctagccatattccaggtcctacagtggacatttcctaattttcgacctttatcagttttcctcgccatatttcacgtcctaaagtgtgtatttctcattttccgtgattttcagttttcttgccatattccaggtcctacagtgtgcatttctcatttttcacgtttttcagtgattttgtcatttttcaatttgtcaactgcatgtttctcattttccatgatttttagttttcttgctatattccatgtcctacagtggaaatttctaaattttccacctttttcagttttcctcgccatatttcacgtcctaaagtgtgtatttctcattttccgtgattttcagttttcttgctatattccaagtcctacattgtgcatttctcatttttcacgtttttcagtgattttgtcatttttcaatttgtcaaaccacatgtttctcattttccatgattttcagtttttttgccatattccatgtcctacagtggaaatttctatattttccacctttttcagttttcctcgccatatttcacgtgctaaagtgtgtatttctcatttttcgtgtttttcaggtttctcgccatattccaggtcctacagtgtgcatttctcatttttcacgtttttcagtgattttgtcatttttcaagttgtcaagtggatgtttcccattttccttgattttcagttttcttaccatattccatgtcctacagtggacatttctaaattttccacctttttcagttttccttgccatatttcatgtcctaaagtgtgtatttctcattttcagtgattttcagtttcctcgccatattccaggtcctacagtgtgcatttctcattttttcacgtttttcagtgatttcgtcatttttcacgttgtcaagtggatgtttctcattttccatgattttcacttttcttgccatatttcatgtcctatagtggacatttctaaattttccacctttttcagtttttctcgccatatttcacgtcctaaagtgtgtatttctcattttctgtgattttcagttttctcaccatattccaggtcctacagtgtgcatttctcatttttcacgtttttcagtgatttcgtcatttttcaagtcgtcaagtagatgtttctcatattccatgtttttcagttttctcgccatattccaggtcctacagttgacatttctaaattttctacatttttaaattttcctcgccatatttcacgtcctaaagtgtgtatttctcatttttcgttattttcagttttctagccatattccaggtcctacaggatgcatttctcatttttcacgtttttcagtgatttcatcatttttcaagtcgtcaagtgtatgtttcttattttcaatgattttcatttttcttgccttattccacgtcctatagtggacatttctaaattttccaccttttttcagtttttctcgccatatttcacgtcctaaagtgtgtatttctcattttctgtgattatcagttttctcaccatattccaggtcctacagtgtgcatttctcatttttcacgtttttcagtgatttcgtcatttttcaagttgtcaagtggaagtttctcattttccatgattttcagctttctagccatattccaggtcctacagtggacatttcctaattttcgacctttatcagttttcctcgccatatttcacgtcccaaaatgtgtatttcttattttccatgattttcagtttcctcgccatattccaggtcctacagtgtgcatttctcatttttcacgtttttcagtgatttcgtcttttttcaagacgtcaagtggatgtttctcatttttcatgattttcagttttcttgccatattccatgtcctacagtggacatttctaaattttccacctttttctgttttcctcgccatatttcacgtcctaaagtgtgtatttctcattttccgtgattttcagttttcttgccatattcctggtcctacagtgtgcatttctcatttttcacgtttttcagtgattttgtcatttttcaatttgtcaactgcatgtttctcattttccatgattttcagttttcttgccatattccatgtcctacagtggacatttctaaattttccacctttttcagttttcctcgccatatttcacgtgctaaagtgtgtatttctcatttttcgtgtttttcaggtttctcgccatattccaggtcctacagtgtgcatttctcatttttcacgtttttcagtgattttgtcatttttcaagttgtcaagtggatgtttctcattttccttgattttcacttttcttgccatattccaagtcttacaggggcatttctcatttttcacgttttcagtgattttgtcattttcaatttgtcaactgcatgtttctcattttccatgattttcagtttttttgccatattccatgtcctacaggggaaatttctatattttccacctttttcagttttcctcgccatatttcatgtcctaaagtgtgtatttctcattttccgtgattttcagttttcttgccatattccaggtcctacagtgtgcatttctcatttttcacgtttttcagtgatttcgtcatttttcaagtcttcaagtagatgtttctcatattccatgtttttcagttttctcgccatattccaggtcctacagttgacatttctaaattttctacatttttaaattttcctcgccatatttcacgtcctaaagtgtgtatttctcatttttcgttattttcagttttctagccatattccaggtcctacaggatgcatttctcatttttcacgtttttcagtgatttcatcatttttcaagtcgtcaagtgtatgtttctcattttcaatgattttcatttttcttgccttattccacgtcctatagtggacatttctaaattttccacctttttcagtttttctcgccatatttcacgtcctaaagtgtgtatttctcattttctgtgattttcagttttctcaccatattccaggtcctacagtgtgcatttctcatttttcacgtttttcagtgatttcgtcatttttcaagttgtcaagtggaagtttctcattttccatgattttcagctttctagccatattccaagtcctacagtggacatttcctaattttcgacctttatcagttttcctcgccatatttcacgtcccaaaatgtgtattccttattttccatgattttcagtttcctcgccatattccaggtcctacagtgtgcatttatcatttttcacgtttttcagtgatttcgtcttttttcaagacgtcaagtggatgtttctcatttttcatgattttcagttttcttgccatattccatgtcctacagtggacatttctaaattttccacctttttctgttttcctcgccatatttcacgtcctaaagtgtgtatttctcattttccgtgattttcagttttcttgccatattcctggtcctacagtgtgcatttctcatttttcacgtttttcagtgattttgtcatttttcaagttgtcaagtggatgtttctcattttccttgattttcacttttcttgccatattccatgtcctacagtggacatttctatattttccacctttttccgttttccttgccatatttcacgtcctaaagtgtgtatttctcattttccgtgattttcaggtttctcgccatattccaggtcctacagtgtgcatttctcatttttcacgtttttcagtgattttgtcatttttcaagttgtcaagtggatgtttctcattttccttgattttcacttttcttgccatattccatgtcctacagtggacatttctaaattttccacctttttcagttttcctcgccatatttcatgtcctaaagtgtgtatttctcattttcagtgattttcagttttcttgccatattccaggtcctacagtgtgcatttctcatttttcacgtttttcagtgattttgtcatttttcaagttgtcaactgcatgtttctcattttctatgattttcagttttcttgctatattccatgtcctacagtggaaatttctaaattttccacctttttcagttttcctcgccatatttcacgtcctaaagtgtgtatttctcattttccgtgattttcagttttctcgccatattccaggtcctatgtgtacatttctcatttttcacgtttttcagtgattttgtcatttttcaagttgtgaagtggatgtttctcatttttcttgattttcatttttcttgccatattccatgtcctagagtggaaatttttaaattttccacctttttcagttttcctcgccatatttcacgtcctaaagtgtgaatttctcattttccgtgattttcagatttctcgccatattccaagtcctacagtgtgcatttctcatttttcacgtttttcagtgatttcgtcatttttcaagttgtcaagtggatgtttctcattttccatgattttcagctttcttgccatattcaaagtcctacagtggacatttctaaattttcgacctttatcagttttcctcgccatatttcatgtcccaaagtgtgtacttctcattttccgtgattttcagtttcctcgccatattctaggtcctacagtgtgcatttctcatttttcaggtttttcagtgatttcgtcttttttcaagtcgtcaagtggatgtttctcattttccatgattttcacttttcttgccatatttcatgtcctaaagtgtgtatttctcattttcagtgattttcagttttctcgctatattccaggtcctacagtgtgcatttctcattttttcacgtttttcagtgatttcgtcatttttcacgttgtcaagtggatgtttctcattttccatgattttcacttttcttgccatatttcatgtcctacagtggacatttctaaattttccacctttttctgttttcctcgccatatttcacatcctaaagtgtgtatttctcattttccgtgattttcagttttcttgccatattccaggtcctacagtgtgcatttctcatttttcacgtttttcagtgatttcgtcatttttcaagttgtcaagtggatgtttctcattttccttgattttcagttttcttgccatattccatgtcctactgtggacatttctaaattttccacctttttcagttttccttgccatatttcatgtcctaaagtgtgtatttctcattttcagtgattttcagttttctcgcaatattccaggtcctacagtgtgcatttctcattttttcaggtttttcagtgatttcgtcatttttcacgttgtcaagtggatgtttctcattttccatgattttcacttttcttgccatatttcatgtcctaaagtgtgtatttctcattttcagtgattttcagttttcctcgccatatttcacgtcccaaaatgtgtatttcttattttccatgattttcagtttcctcgccatattccaggtcctacagtgtgcatttctcatttttcacgtttttcagtgatttcgtcttttttcaagacgtcaagtggatgtttctcatttttcatgattttcagttttcttgccatattccatgtcctacagtggacatttctaaattttccacctttttctgttttcctcgccatatttcacgtcctaaagtgtgtatttctcattttccgtgattttcagttttcttgccatattcctggtcctacagtgtgcatttctcatttttcacgtttttcagtgattttgtcatttttcaatttgtcaactgcatgtttctcattttccatgattttcagttttcttgccatattccatgtcctacagtggacatttctaaattttccacctttttcagttttcctcgccatatttcacgtgctaaagtgtgtatttctcatttttcgtgtttttcaggtttctcgccatattccaggtcctacagtgtgcatttctcatttttcacgtttttcagtgattttgtcatttttcaagttgtcaagtggatgtttctcattttccttgattttcacttttcttgccatattccatgtcctacagtggacatttctaaattttccacctttttcagttttcctcgccatatttcatgtcctaaagtgtgtatttctcattttcagtgattttcagttttctcgccatattccaggtcctacagtgtgcatttctcatttttcacgtttttcagtgatttcgtcttttttcaagacgtcaagtggatgtttctcattttccatgattttcagttttcttgccatattccatgtcctacagtggacatttctaaattttccacctttttctgttttcctcgccatatttcacgtcctaaagtgtgtatttctcattttccgtgattttcagttttcttgccatattccaggtcctacagtgtgcatttctcatttttcacgtttttcagtgattttgtcatttttcaatttgtcaactgcatgtttctcattttccatgatttttagttttcttgctatattccatgtcctacagtggaaatttctaaattttccacctttttcagttttcctcgccatatttcacgtcctaaagtgtgtatttctcattttccgtgattttcagttttcttgctatattccaagtcctacattgtgcatttctcatttttcacgtttttcagtgattttgtcatttttcaatttgtcaaaccacatgtttctcattttccatgattttcagtttttttgccatattccatgtcctacagtggaaatttctatattttccacctttttcagttttcctcgccatatttcacgtgctaaagtgtgtatttctcatttttcgtgtttttcaggtttctcgccatattccaggtcctacagtgtgcatttctcatttttcacgtttttctgtgattttgtcatttttcaagttgtcaagtggatgtttctcattttccttgattttcagttttcttaccatattccatgtcctacagtggacatttctaaattttccaccttttctgttttcctcgccatatttcatgtcctaaagtgtgtatttctcattttccgtgattttcatttttcttgctatattccaagtcctacagtgtgcatttctcattttccatgattttcagttttcttgctatattccatgtcctacagtggaaatttctaaattttccacctttttcagttttcctcgccatatttcacgtcctaaagtgtgtatttctcattttccgtgattttcagttttttcgccatattacaggtcctatgtgtacatttctcatttttcacgtttttcagtgattttgtcatttttcaagttgtcaagtggatgtttctcatttttcttgattttcatttttcttgccatattccatgtcctacagtggaaatttctaaattttccacctttttcagttttcctcgccatatttcacgtcctaaagtgtgaatttctcattttccgtgattttcagttttctcgccatattccaggtctacagtgtgcatttctcatttttcacgttttcagtgattcgtcatttttcaagttgacaagtggatgtttctcattttccatgattttcagctttcttgccatattcaaagtcctacagtggacatttctaaattttcgacctttatcagttttcctcgccatatttcatgtcccaaagtgtgtacttctcattttccgtgattttcagttttcttgccatattccaagtcctacagtgtgcatttctcatttttcacgtttttcagtgattttgtcatttttcaatttgtcaactgcatgtttctcattttccatgattttcagttttcttgccatattccatgtcctacagtggaaatttctatattttccacctttttcagttttcctcgccatatttcacgtgctaaagtgtgtatttctcatttttcgtgtttttcaggtttctcgccatattccaggtcctacagtgtgcatttctcatttttcacgtttttcagtgattttgtcatttttcaagttgtcaagtggatgtttctcattttcaatgattttcatttttcttgccttattccacgtcctatagtggacatttctaaattttccacctttttcagtttttctcgccatatttcacgtcccaaaatgtgtattccttattttccatgattttcagtttcctcgccatattccaggtcctacagtgtgcatttctcatttttcacgtttttcagtgatttcgtcttttttcaagacgtcaagtggatgtttctcatttttcatgattttcagttttcttgccatattccctgtcctacagtggacatttctaaattttccacctttttctgttttcctcgccatatttcacgtcctaaagtgtgtatttctcattttccgtgattttcagttttctcgccagattccaggtcctacagtgtgcatttctcatttttcacgtttttcagtgattttgtcatttttcaatttgtcaactgcatgtttctctctttccatgattttcagttttcttgccatattccatgtcctacagtggacatttctaaattttccacctttttcagttttcctcgccatatttcacgtgctaaagtgtgtatttctcatttttcgtgtttttcaggtttctcgccatattccaggtcctacagtgtgcatttctcatttttcacgtttttcagtgattttgtcatttttcaagttgtcaagtggatgtttctcattttcaatgattttcatttttcttaccttattccacgtcctatagtggacatttctaaattttccacctttttcagtttttctcgccatatttcacgtcccaaaatgtgtattccttattttccatgattttcagtttcctcgccatattccaggtcctacagtgtgcatttctcatttttcacgtttttcagtgatttcgtcttttttcaagacgtcaagtggatgtttctcatttttcatgattttcagttttcttgccatattccctgtcctacagtggacatttctaaattttccacctttttctgttttcctcgccatatttcacgtcctaaagtgtgtatttctcattttccgtgattttcagttttctcgccagattccaggtcctacagtgtgcatttctcatttttcacgtttttcagtgatttcgtcatttttcaagtcttcaagtgtatgtttctcattttcaatgattttcatttttcttgccttattccacgtcctatagtggacatttctaaattttccacctttttcagtttttctcgccatatttcacgtcctaaagtgtgtatttctcattttctgtgattttcagttttcttaccatattccaggtcctacagtgtgcatttctcatttttcacgtttttcagtgatttcgtcatttttcaagttgtcaagtggaagtttctcattttccatgattttcagctttctagccatattccaggtattacagtggacatttccttattttcgacctttatcagttttcctcgccatatttcatgtcctaaagtgtgt	38399	1554	4%	7300	19%
9	3000001	3038400	Atcctacagtgtgcatttctcatttttcacgtttttcagtgatttcgtcatttttcaagtcatcaagtggctgtttctcattttccatgattttcagttttcttgccatattccttgtcctacagtggacatttctaaattttccacctttttcagttttccttgtcatatttcaggtcctacagtgtgtatttctcatttttcacgtttttcattgatttcgtcatttttcaagttgtcaagtgcatgtttctcattttccatgattttcagttttcttgccatattccatgtcctacaatggacatttctaaattttccaactttttcagttttcctcgccatatttcacgtcctaaagtgtgtatttctcattttccgtgattttcagttttctcgacatattccaggtcctacagtgtgcatttctcatttttcacgtttttcagtgatttcgtcatttttcacgtcgtcaagtggatgtttctcattttccatgattttcagttttcttgccatattccatgtcctacagtggacatttctaaattttccacctttttcagttttcctcgccatatttcacgtcctaaagtgtgtatttctcattttccgtgattttcagttttctcgacatattccaggtcttacagggtgcatttctcatttttcacgtttttcagtgatttcatcatttttcaagtcgtcaactgtatgtttctcattttcaatgattttcatttttcttgccatattccacgtcctatagtggacatttctaaattttccacctttttcagttttccttgccatatttcaggtcctacagtgtgcatttctcatttttcacgtttttcagtgatttcgtcatttttcaagtggtcaaatgcatgtttctcattttccatgattttcagttttcttgccatattccatgtcctacagtggacatttctaaattttccacctttttcagttttcctcgccatatttcacgtcctaaagtgtgtatttctcattttccgtgattttcagttttatcgccagattccaggtcctacggtgtgcatttttcatatttcacgtttttcagtgattttgtcatttttcaagttgtcaactgcatgtttctcattttccatgattttcagttttcttgccatattccatgtcctacagtggacatttctaaattttccacctttttcagttttcctcgccatatttcatgtcctaaagtgtgtatttctcattttcagtgattttctgttttctcgccatattccaggtcctacagtgtgcatttctcatttttcacgtttttcagtgatttcgtcatttttcaagttgtcaagtggatgtttctcattttccatgattttcagttttcttgccatattccatgtcctacaatggacatttctaaattttccacctttttcagttttcctcgccatatttcacgtcctaaagtgtgtatttctcattttccgtgattttcagttttctcgccatattccaggtcctatgtgtacatttctcatttttcacgtttttcagtgattttgtcatttttcaagttgtgaagtggatgtttctcatttttcttgattttcatttttcttgccatattccatgtcctagagtggaaatttttaaattttccacctttttcagttttcctcgccatatttcacgtcctaaagtgtgaatttctcattttccgtgattttcagttttctcgccatattccaagtcctacagtgtgcatttctcatttttcacgtttttcagtgatttcgtcatttttcaagttgtcaagtggatgtttctcattttccatgattttcagctttcttgccatattcaaagtcctacagtggacatttctaaattttcgacctttatcagttttcctcgccatatttcatgtcccaaagtgtgtacttctcattttccgtgattttcagtttcctcgccatattctaggtcctacagtgtgcatttctcatttttcaggtttttcagtgatttcgtcttttttcaagtcgtcaagtggatgtttctcattttccatgattttcagttttcttgccatattccatgtcctacagtggacatttctaaattttccaactttttcagttttcctcgccatatttcatgtcctaaagtgtgtatttctcattttcagtgattttcagttttctcgccatattccaggtcctacagtgtgcatttctcatttttcacgtttttcagtgatttcgtcatttttcaagttgtcaagtggatgtttctcatttttcatgattttcagttttcttgccatattccatgtcccacagtggacatttctaaatgttccacctttttctgttttccttgccatatttcatgtcctaaagtgtgtatttctcattttccgtgattttcagttttcttgctatattccaagtcctacagtgtgcatttctcatttttcacgtttttctgtgattttttcatttttcaatttgtcaactgcatgtttctcattttccatgattttcagttttcttgccatattccaggtcctacagtgtgcatttctcatttttcacgtttttcagtgattttgtcatttttcaagttgtcaactgcatgtttctcattttccatgattttcagttttcttgctatattccatgtcctacagtggaaatttctaaattttccacctttttcagttttcctcgccatatttcacgtcctaaagtgtgtatttctcattttccgtgattttcagttttctcgccatattccaggtcctatgtgtacatttctcatttttcacgtttttcagtgattttgtcatttttcaagttgtgaagtggatgtttctcatttttcttgattttcatttttcttgccatattccatgtcctagagtggaaatttttaaattttccacctttttcagttttcctcgccatatttcacgtcctaaattgtgaatttctcattttccgtgattttcagttttctcgccatattccaagtcctacagtgtgcatttctcatttttcacgtttttcagtgatttcgtcatttttcaagttgtcaagtggatgtttctcattttccatgattttcagctttcttgccatattcaaagtcctacagtggacatttctaaattttcgacctttatcagttttcctcgccatatttcatgtcccaaagtgtgtacttctcattttccgtgattttcagtttcctcgccatattctaggtcctacagtgtgcatttctcatttttcaggtttttcagtgatttcgtcttttttcaagtcgtcaagtggatgtttctcattttccatgattttcagttttcttgccatattccatgtcctacagtggacatttctaaattttccacctttttcagttttcctcgccatatttcatgtcctaaagtgtgtatttctcattttcagtgattttcagttttctcgccatattccaggtcctacagtgtgcatttctcatttttcacgtttttcagtgattttgtcatttttcaagttgtcaagtggatgtttctcattttccttgattttcagttttcttgccatattccatgtcctacagtggacatttctaaattttccacctttttcagttttccttgccatatttcatgtcctaaagtgtgtatttctcattttcagtgattttcagttttctcgccatattccaggtcctacagtgtgcatttctcattttttcaggtttttcagtgatttcgtcatttttcacgttgtcaagtggatgtttctcattttccatgattttcacttttcttgccatatttcatgtcctaaagtgtgtatttctcattttcagtgattttcagttttctcgccatattccaggtcctacagtgtgcatttctcattttttcacgtttttcagtgatttcgtcatttttcacgttgtcaagtggatgtttctcattttccattattttcacttttcttgccatatttcatgtcctacagtggacatttctaaattttccacctttttctgttttcctcgccatatttcacatcctaaagtgtgtatttctcattttccgtgattttcagttttcttgccatattccaggtcctacagtgtgcatttctcatttttcacgtttttcagtgatttcgtcatttttcaagtcgtcaagtggatgtttctcattttccatgattttcagttttctcgccatattccaggtcctacagttgacatttctaaattttccacattttttatgtttcctcgcgatatttcacatcctaaagtgtgtatttctcattttccgtgattttcagttttcttgccatattccaggtcctacagggtgcatttctcatttttcacgtttttcagtgatttcatcaatttcaagtcgtcaactgtatgtttctcattttcaatgattttcatttttcttgccatattccacgtcctatagtggacatttctacattttccacctttttcagttttcttcgccatatttcacgtcccaaagtgtgtatttctcattttccgtgattttcagtttcctcgccatattccaggtcctacagtgtgcatttctcatttttcacgtttttcagtgatttcgtcttttttcaagtcgtcaagtggatgtttctcattttccatgattttcagttttcttgccatattccatgtcctacagtggacatttctaaattttccacctttttctgttttcctcgccatatttcacgtcctaaagtgtgtatttctcatttaccgtgattttcagttttcttgctatattccaagtcctacagtgtgcatttctcatttttcacgtttttcactgattttgtcattgttcaagttgtcaactgcatgtttctcattttccatgattttcagttttcttgccatattccatgtcctacagtggaaatttctatattttccaactttttcagttttcctcgccatatttcacgtgctaaagtgtgtatttctcatttttcgtgtttttcaggtttctcgccatattccaggtcctacagtgtgcatttctcatttttcacgtttttcagtgattttgtaatttttcaagttgtcaagtggatgtttctcattttccttgattttcagttttcttgccatattccatgtcctactgtggacatttctaaattttccacctttttcagttttccttgccatatttcatgtcctaaagtgtgtatttctcattttcagtgattttcagttttctcgcaatattccaggtcctacagtgtgcatttctcattttttcaggtttttcagtgatttcgtcatttttcacgttgtcaagtggatgtttctcattttccatgattttcacttttcttgccatatttcatgtgctaaagtgtgtatttctcattttcagtgattttcagttttctgccatattccaggtcctacattgtgcatttctcattttttcacgtttttcagtgatttcgtcatttttcacgttgtcaagtggatgtttctcattttccatgattttcacttttcttgccatatttcatgttttacagtggacatttctaaattttccacctatttctgttttcctcgccatatttcacatcctaaagtgtgtatttctcattttccgtgattttcagttttctcgccatatgccaggtcatacagggtgcatttctcatttttcacgtttttcagtgatttcgtcatttttcacgtcgtcaagtggatgtttctcattttcaatgattttcatttttcttgccatattccacgtcctatagtggacatttctaaattttccacctttttcagttttccttgccatatttcaggtcctacagtgtgcatttctcttttttcacgtttttcagtgatttcgtcatttttcaagtggtcaagtgcatgtttctcattttccgtgattttcagttttcttgccatgttccaggtcctacagttgacgtttctaaaatttcactttttttaagttttcctcgccatatttcacttcctaaagtgtgtatttctcattttccgtgattttcagttttctcgccagattccaggtcctacagtgtgcatttttcatatttcacctttttcagtgattttgtcatttttcaagttgtcaactgcatgtttctcattttccatgattttcagttttcttgccatattccatgtcctactgtggacatttctaaattttccaactttttcagttttcctcgccatatttcatgtcctaaagtgtgtatttctcattttcagtgattttctgttttctcgccatattccaggtcctacagtgtgcatttctaatttttcacgtttttcagtgatttcgtcatttttcaagttgtcaagtggatgtttctcattttccatgattttcagttttcttgccatattccatgtcctacagtggacatttctaaattttccaactttttccattttcctcaccatatttcacgtcctaaagtgagtttttctcattttttgtgattttcagttttctcgacatattccaggtcctacagtgtgcatttctaattttttcttttttcagtgatttcgtcatttttcaagtggtcaagtgcatgtttctcattttccatgattttcagttttcttgccatattccatgtcctacaatggacatttctaaattttccaactttttcagttttcctcgccatatttcacgtcctaaagtgtgtatttctcattttccgtgattttcagttttctcgccatattccaggtcctacagtgtgcatttctcatttttcacgtttttcagtgatttcgtcatttttcaagttgtcaactgcatgtttctcattttccatgattttcagttttcttgccatattccatgtcttacagtggacatttttaaatttttcacatttttttaagttttcctccccatatttcacgttttaaagtgtgcatttctcattttcggtgattttcagttttctcgccagattccatgtcttacagtgtgcatttctcattttttcacgtttttcagtgatttcgtcatttttcaagtcgtcaagtggatgtttctcattttccatgattttcagttttcttgccatattccatgtcctacagtggaaatttctaaattttccacctttttcagttttccttgccatatttcaggtcctaaagtgtgtatttctcattttctgtgattttcagttttctcgccatattccaggtcctacagttgacatttctaaaatttccacattttttaagttttcctcgccatatttcacttcctaaagtgtgtatttctcattttccgtgattttcagttttctcgccatattccagatcctacagtgtacatttttcatttttcacgtttttcagtgattttgtcattttttagttgtcaactgcctgtttctcattttccatgattttcagttttcttgctatattccatgtcctacagtggaaatttctaaattttccacctttttcagttttcctcgccatatttcacgtcctaaagtgtgtatttctcattttccgtgattttcagttttctcgccatattccaggtcctatgtgtacatttctcatttttcacgtttttcagtgattttgtcatttttcaatttgtcaactgcatgtttctcattttccatgattttcagttttcttgccatattccatgtcctacagtggaaatttctatattttccaactttttcagttttcctcgccatatttcacgtgctaaagtgtgtatttctcatttttcgtgtttttcaggtttctcgccatattccaggtcctacagtgtgcatttctcatttttcacgtttttcagtgattttgtcatttttcaagttgtcaagtggatgtttctcattttccttgattttcagttttcttgccatattccatgtcctacagtggacatttctaaattttccacctttttcagttttccttgccatatttcatgtcctaaagtgtgtatttctcattttcagtgattttcagttttctcgccatattccaggtcctacagtgtgcatttctcattttttcaggtttttcagtgatttcgtcatttttcacgttgtcaagtggatgtttctcattttccatgattttcacttttcttgccatatttcatgtcctaaagtgtgtatttctcattttcagtgattttcagttttctcgctatattccaggtcctacagtgtgcatttctcattttttcacgtttttcagtgatttcgtcatttttcacgttgtcaagtggatgtttctcattttccatgattttcacttttcttgccatatttcatgtcctacaatggacatttctaaattttccacctttttctgttttcctcgccatatttcacatcctaaagtgtgtatttctcattttccgtgattttcagttttcttgccatattccaggtcctacagtgtgcatttctcatttttcacgtttttcagtgatttcgtcatttttcaagttgtcaagtggatgtttctcattttccttgattttcagttttcttgccatattccatgtcctactgtggacatttctaaattttccacctttttcagttttccttgccatatttcatgtcctaaagtgtgtatttctcattttcagtgattttcagttttctcgcaatattccaggtcctacagtgtgcatttctcattttttcaggtttttcagtgatttcgtcatttttcacgttgtcaagtggatgtttctcattttccatgattttcacttttcttgccatatttcatgtcctaaagtgtgtatttctcattttcagtgattttcagttttctgccatattccaggtcctacattgtgcatttctcattttttcacgtttttcagtgatttcgtcatttttcagttttctcgacatattccaggtcctacagtgtgcatttctaattttttcttttttcagtgatttcgtcatttttcaagttgtcaactgcatgtttctcattttccatgattttcagttttcttgccatattccatgtcttacagtggacatttttaaatttttcacatttttttaagttttcctccccatatttcacgttttaaagtgtgcatttctcattttcggtgattttcagttttctcgccagattccaggtcttacagtgtgcatttctcattttttcacgtttttcagtgatttcgtcatttttcaagtcgtcaagtggatgtttctcattttccatgattttcagttttcttgccatattccatgtcctacagtggaaatttctaaattttccacctttttcagttttccttgccatatttcaggtcctaaagtgtgtatttctcattttctgtgattttcagttttctcgccatattccaggtcctacagttgacatttctaaaatttccacattttttaagttttcctcgccatatttcacttcctaaagtgtgtatttctcattttccgtgattttcagttttctcgccatattccagatcctacagtgtgcatttttcatttttcacgtttttcagtgattttgtcattttttagttgtcaactgtctgtttctcattttccatgattttcagttttcttgccatattccatgtcctacactggacatttctaaattttccacctttttctgttttcctcgccatatttcacgtcctaaagtgtgtatttctcattttccgtgattttcagttttcttgccatattccaggtcctacagtgtgcatttctcatttttcacgtttttcagtgattttgtcatttttcaagttgtcaactgcatgtttctcattttctatgattttcagttttcttgctatattccatgtcctacagtggaaatttctaaattttccacctttttcagttttcctcgccatatttcacgtcctaaagtgtgtatttctcattttccgtgattttcagttttctcgccatattccaggtcctatgtgtacatttctcatttttcacgtttttcagtgattttgtcatttttcaagttgtgaagtggatgtttctcatttttcttgattttcatttttcttgccatattccatgtcctagagtggaaatttttaaattttccacctttttcagttttcctcgccatatttcacgtcctaaagtgtgaatttctcattttccgtgattttcagatttctcgccatattccaagtcctacagtgtgcatttctcatttttcacgtttttcagtgatttcgtcatttttcaagttgtcaagtggatgtttctcattttccatgattttcagctttcttgccatattcaaagtcctacagtggacatttctaaattttcgacctttatcagttttcctcgccatatttcatgtcccaaagtgtgtacttctcattttccgtgattttcagtttcctagccatattctaggtcctacagtgtgcatttctcatttttcaggtttttcagtgatttcgtcttttttcaagtcgtcaagtggatgtttctcattttccatgattttcacttttcttgccatatttcatgtcctaaagtgtgtatttctcattttcagtgattttcagttttctcgctatattccaggtcctacagtgtgcatttctcattttttcacgtttttcagtgatttcgtcatttttcacgttgtcaagtggatgtttctcattttccatgattttcacttttcttgccatatttcatgtcctacagtggacatttctaaattttccacctttttctgttttcctcgccatatttcacatcctaaagtgtgtatttctcattttccgtgattttcagttttcttgccatattccaggtcctacagtgtgcatttctcatttttcacgtttttcagtgatttcgtcatttttcaagttgtcaagtggatgtttctcattttccttgattttcagttttcttgccatattccatgtcctactgtggacatttctaaattttccacctttttcagttttccttgccatatttcatgtcctaaagtgtgtatttctcattttcagtgattttcagttttctcgcaatattccaggtcctacagtgtgcatttctcattttttcaggtttttcagtgatttcgtcatttttcacgttgtcaagtggatgtttctcattttccatgattttcacttttcttgccatatttcatgtcctaaagtgtgtatttctcattttcagtgattttcagttttctgccatattccaggtcctacattgtgcatttctcattttttcacgtttttcagtgatttcgtcatttttcacgttgtcaagtggatgtttctcattttccatgattttcacttttcttgccatatttcatgttttacagtggacatttctaaattttccacctttttctgttttcctcgccatatttcacatcctaaagtgtgtatttctcattttccgtgattttcagttttctcgccatatgccaggtcatacagggtgcatttctcatttttcacgtttttcagtgatttcgtcatttttcacgtcgtcaagtggatgtttctcattttcaatgattttcatttttcttgccatattccacgtcctatagtggacatttctaaattttccacctttttcagttttccttgccatatttcaggtcctacagtgtgcatttctcatttttcacgtttttcagtgatttcgtcatttttcaagtggtcaagtgcatgtttctcattttccgtgattttcagttttcttgccatgttccaggtcctacagttgacgtttctaaaatttcactttttttaagttttcctcgccatatttcacttcctaaagtgtgtatttctcattttccgtgattttcagttttctcgccagattccaggtcctacagtgtgcatttttcatatttcacctttttcagtgattttgtcatttttcaagttgtcaactgcatgtttctcattttccatgattttcagttttcttgccatattccatgtcctactgtggacatttctaaattttccaactttttcagttttcctcgccatatttcatgtcctaaagtgtgtatttctcattttcagtgattttctgttttctcgccatattccaggtcctacagtgtgcatttctaatttttcacgtttttcagtgatttcgtcatttttcaagttgtcaagtggatgtttctcattttccatgattttcagttttcttgccatattccatgtcctacagtggacatttctaaattttccaactttttccattttcctcaccatatttcacgtcctaaagtgtgtttttctcattttttgtgattttcagttttctcgacatattccaggtcctacagtgtgcatttctaattttttcttttttcagtgatttcgtcatttttcaagttgtcaactgcatgtttctcattttccatgattttcagttttcttgccatattccatgtcttacagtggacatttttaaatttttcacatttttttaagttttcctccccatatttcacgttttaaagtgtgcatttctcattttcggtgattttcagttttctcgccagattccaggtcttacagtgtgcatttctcattttttcacgtttttcagtgatttcgtcatttttcaagtcgtcaagtggatgtttctcattttccatgattttcagttttcttgccatattccatgtcctacagtggaaatttctaaattttccacctttttcagttttccttgccatatttcaggtcctaaagtgtgtatttctcattttctgtgattttcagttttctcgccatattccaggtcctacagttgacatttctaaaatttccacattttttaagttttcctcgccatatttcacttcctaaagtgtgtatttctcattttccgtgattttcagttttctcgccatattccagatcctacagtgtgcatttttcatttttcacgtttttcagtgattttgtcattttttagttgtcaactgtctgtttctcattttccatgattttcagttttcttgccatattccatgtcctacactggacatttctaaattttccacctttttctgttttcctcgccatatttcacgtcctaaagtgtgtatttctcattttccgtgattttcagttttcttgccatattccaggtcctacagtgtgcatttctcatttttcacgtttttcagtgattttgtcatttttcaagttgtcaactgcatgtttctcattttccatgattttcagttttcttgctatattccatgtcctacagtggaaatttctaaattttccacctttttcagttttcctcgccatatttcacgtcctaaagtgtgtatttctcattttccgtgattttcagttttctcgccatattccaggtcctatgtgtacatttctcatttttcacgtttttcagtgattttgtcatttttcaagttgtgaagtggatgtttctcatttttcttgattttcatttttcttgccatattccatgtcctagagtggaaatttttaaattttccacctttttcagttttcctcgccatatttcacgtcctaaagtgtgaatttctcattttccgtgattttcagatttctcgccatattccaagtcctacagtgtgcatttctcatttttcacgtttttcagtgatttcgtcatttttcaagttgtcaagtggatgtttctcattttccatgattttcagctttcttgccatattcaaagtcctacagtggacatttctaaattttcgacctttatcagttttcctcgccatatttcatgtcccaaagtgtgtacttctcattttccgtgattttcagtttcctcgccatattctaggtcctacagtgtgcatttctcatttttcaggtttttcagtgatttcgtcttttttcaagtcgtcaagtggatgtttctcattttccatgattttcagttttcttgccatattccatgtcctacagtggacatttctaaattttccacctttttcagttttcctcgccatatttcatgtcctaaagtgtgtatttctcattttcagtgattttcagttttctcgccatattccaggtcctacagtgtgcatttctcatttttcacgtttttcagtgatttcgtcatttttcaagttgtcaagtggatgtttctcattttccatgattttcagttttcttgccatattccatgtcccacagtggacatttctaaattttccacctttttctgttttccttgccatatttcatgtcctaaagtgtgtatttctcattttccgtgattttcagttttcttgctatattccaagtcctacagtgtgcatttctcatttttcacgtttttcagtgattttgtcatttttcaatttgtcaactgcatgtttctcattttccatgattttcagttttcttgccatattccatgtcctacagtggaaatttctatattttccaactttttcagttttcctcgccatatttcacgtgctaaagtgtgtatttctcatttttcgtgtttttcaggtttctcgccatattccaggtcctacagtgtgcatttctcatttttcacgtttttcagtgattttgtcatttttcaagttgtcaagtggatgtttctcattttccttgattttcagttttcttgccatattccatgtcctacagtggacatttctaaattttccacctttttcagttttccttgccatatttcatgtcctaaagtgtgtatttctcattttcagtgattttcagttttctcgccatattccaggtcctacagtgtgcatttctcattttttcaggtttttcagtgatttcgtcatttttcacgttgtcaagtggatgtttctcattttccatgattttcacttttcttgccatatttcatgtcctaaagtgtgtatttctcattttcagtgattttcagttttctcgctatattccaggtcctacagtgtgcatttctcattttttcacgtttttcagtgatttcgtcatttttcacgttgtcaagtggatgtttctcattttccatgattttcacttttcttgccatatttcatgtcctacagtggacatttctaaattttccacctttttctgttttcctcgccatatttcacatactaaagtgtgtatttctcattttccttgattttcagttttcttgccatattccaggtcctacagtgtgcatttctcatttttcacgtttttcagtgatttcgtcatttttcaagtcgtcaagtggatgtttctcattttccatgattttcagttttctcgccatattccaggtcctacagttgacatttctaaattttccacattttttaagtttcctcgcgatatttcacatcctaaagtgtgtatttctcattttccgtgattttcagttttcttgccatattccaggtcctacagggtgcatttctcatttttcacgtttttcagtgatttcatcaatttcaagtcgtcaactgtatgtttctcattttcaatgattttcatttttcttgccatattccatgtcctacagtggacatttctaaatttttcacctttttcagttttccttgccatatttcatgtcctaaagtgtgtatttctcattttcagtgattttcagttttctcgccatattccaggtcctacagtgtgcatttctcattttttcaggtttttcagtgatttcgtcatttttcacgttgtcaagtggatgtttctcattttccatgattttcacttttcttgccatatttcatgtcctaaagtgtgtatttctcattttcagtgattttcagttttctcgccatattccaggtcctacagtgtgcatttctcatttttcacgtttttcagtgatttcgtcatttttcaagttgtcaagtggatgtttctcattttccatgattttcacttttcttgccatattccatgtcccacagtggacatttctaaattttccacctttttctgttttcctcgccatatttcatgtcctaaagtgtgtatttctcattttccgtgattttcagttttcttgctatattccaagtcctacagtgtgcatttctcatttttcacgtttttcagtgattttgtcatttttcaatttgtcaactgcatgtttctcattttccatgattttcagttttcttgccatattccatgttctacagtggaaatttctatattttccaactttttcagttttcctcgccatatttcacgtgctaaagtgtgtatttctcatttttcgtgtttttcaggtttctcgccatattccaggtcctacagtgtgcatttctcatttttcacgtttttcagtgattttgtcatttttcaagttgtcaagtggatgtttctcattttccttgattttcagttttcttgccatattccatgtcctacagtggacatttctaaattttccacctttttcagttttccttgccatatttcatgtcctaaagtgtgtatttctcattttcagtgattttcagttttctcgccatattccaggtcctacagtgtgcatttctcattttttcaggtttttcagtgatttcgtcatttttcacgttgtcaagtggatgtttctcattttccatgattttcacttttcttgccatatttcatgtcctaaagtgtgtatttctcattttcagtgattttcagttttctcgctatattccaggtcctacagtgtgcatttctcattttttcacgttttgcagtgatttcgtcatttttcacgttgtcaagtggatgtttctcattttccatgattttcacttttcttgccatatttcatgtcctacagtggacatttctaaattttccacctttttctgttttcctcgccatatttcacatcctaaagtgtgtatttctcattttccgtgattttcagttttcttgccatattccaggtcctacagtgtgcatttctcatttttcacgtttttcagtgatttcgtcatttttcaagtcgtcaagtggatgtttctcattttccatgattttcagttttctcgccatattccaggtcctacagttgacatttctaaattttccacattttttaagtttcctcgcgatatttcacatcctaaagtgtgtatttctcattttccgtgattttcagttttcttgccatattccaggtcctacagggtgcatttctcatttttcacgtttttcagtgatttcatcaatttcaagtcgtcaactgtatgtttctcattttcaatgattttcatttttcttgccatattccatgtcctacagtggacatttctaaattttccacctttttcagttttccttgccatatttcatgtcctaaagtgtgtatttctcattttcagggattttcagttttctcgccatattccaggtcctacagtgtgcatttctcattttttcaggtttttcagtgatttcgtcatttttcacgttgtcaagtggatgtttctcattttccatgattttcacttttcttgccatatttcatgtcctaaagtgtgtatttctcattttcagtgattttcagttttctcgccatattccaggtcctacagtgtgcatttctcattttttcacgtttttcagtgatttcgtcatttttcacgttgtcaagtggatgtttctcattttccatgattttcacttttcttgccatatttcatgtcctacagtggacatttctaaattttccacctttttctgttttcctcgccatatttcacatcctaaagtgtgtatttctcattttccgtgattttcagttttcttgccatattccaggtcctacagtgtgcatttctcatttttcacgtttttcagtgatttcgtcatttttcaagtcgtcaagtggatgtttctcattttccatgattttcagttttctcgccatattccaggtcctacagttgacatttctaaattttccacattttttaagtttcctcgcgatatttcacatcctaaagtgtgtatttctcattttccgtgattttcagttttcttgccatattccaggtcctacagggtgcatttctcatttttcacgtttttcagtgatttcatcaatttcaagtcgtcaactgtatgtttctcattttcaatgattttcatttttcttgccatattccacgtcctatagtggacatttctaaattttccacctttttcagttttcttcgccatatttcacgtcccaaagtgtgtatttctcattttccgtgattttcagtttcctcgcaatattccaggtcctacagtgtgcatttctcatttttcacgtttttcagtgatttcgtcttttttcaagtcgtcaagtggatgtttctcattttccatgattttcagttttcttgccatattccatgtcctacagtggacatttctaaattttccacctttttctgttttcctcgccatatttcacgtcctaaagtgtgtatttctcattttccgtgattttcagttttcttgccatattccaggtcctacagtgtgcatttctcatttttcacgtttttcactgattttgtcattgttcaagttgtcaactgcatgtttctcattttccatgattttcaattttcttgccatattccatgtcctacagtggaaatttctatattttccaactttttcagttttcctcgccatatttcacgtgctaaagtgtgtatttctcatttttcgtgtttttcaggtttctcgccatattccaggtcctacagtgtgcatttctcatttttcacgtttttcagtgattttgtcatttttcaagttgtcaagtggttgtttctcattttccttgattttcagttttcttgccatattccatgtcctactgtggacatttctaaattttccacctttttcagttttccttgccatatttcatgtcctaaagtgtgtatttctcattttcagtgattttcagttttctcgcaatattccaggtcctacagtgtgcatttctcattttccgtgattttcagttttctcgccatatgccaggtcatacagggtgcatttctcatttttcacgtttttcagtgatttcgtcatttttcacgtcgtcaagtggatgtttctcattttcaatgattttcatttttcttgccatattccacgtcctatagtggacatttctaaattttccaactttttcagttttcttgccatatttcaggtcctacagtgtgcatttctcatttttcacgtttttcagtgatttcgtcatttttcaagtggtcaagtgcatgtttctgattttccgtgattttcagttttcttgccatgttccaggtcctacagttgacgtttctaaaatttcactttttttaagttttcctcgccatatttcacttcctaaagtgtgtatttctcattttccgtgattttcagttttctcgccagattccaggtcctacagtgtgcatttttcatatttcacctttttcagtgattttgtcatttttcaagttgtcaactgcatgtttctcattttccatgattttcagttttcttgccatattccatgtcctactgtggacatttctaaattttccaactttttcagttttcctcgccatatttcatgtcctaaagtgtgtatttctcattttcagtgtttttctgttttctcgccatattccaggtcctacagtgtgcatttctaatttttcacgtttttcagtgatttcgtcatttttcaagttgtcaagtggatgtttctcattttccatgattttcagttttcttgccatattccatgtcctacagtggacatttctaaattttccaactttttccattttcctcaccatatttcacgtcctaaagtgtgtttttctcattttttgtgattttcagttttctcgacatattccaggtcctacagtgtgcatttctaattttttcttttttcagtgatttcgtcatttttcaagtggtcaagtgcatgtttctcattttccatgattttcagttttcttgccatattccatgtcctacaatggacatttctaaattttccaactttttcagttttcctcgccatatttcacgtcctaaagtgtgtatttctcattttccgtgattttcagttttctcgccatattccaggtcctatgtgtacatttctcatttttcacgtttttcagtgattttgtcatttttcaagttgtgaagtggatgtttctcatttttcttgattttcatttttcttgccatattccatgtcctagagtggaaatttttaaattttccaactttttcagttttcctcgccatatttcacgtcctaaagtgtgtatttctcattttccgtgattttcagttttctcgccatattccaagtcctacagtgtgcatttctcatttttcacgtttttcagtgatttcgtcatttttcaagttgtcaagtggatgtttctcattttccatgattttcagctttcttgccatattcaaagtcctacagtggacatttctaaattttcgacctttatcagttttcctcgccatatttcatgtcccaaagtgtgtacttctcattttccgtgattttcagtttcctcgccatattctaggtcctacagtgtgcatttctcatttttcaggtttttcagtgatttcgtcttttttcaagtcgtcaagtggatgtttctcattttccatgattttcagttttcttgccatattccatgtcctacagtggacatttctaaattttccacctttttcagttttcctcgccatatttcatgtcctaaagtgtgtatttctcattttcagtgattttcagttttctcgccatattccaggtcctacagtgtgcatttctcatttttcacgtttttcagtgatttcgtcatttttcaagttgtcaagtggatgtttctcattttccatgattttcagttttcttgccatattccatgtcccacagtggacatttctaaattttccacctttttctgttttccttgccatatttcatgtcctaaagtgtgtatttctcattttccgtgattttcagttttcttgctatattccaagtcctacagtgtgcatttctcatttttcacgtttttaagtgattttgtcatttttcaatttgtcaactgcatgtttctcattttccatgattttcagttttcttgccatattccatgtcctacagtggaaatttctatattttccaactttttcagttttcctcgccatatttcacgtgctaaagtgtgtatttctcatttttcgtgtttttcaggtttctcgccatattccaggtcctacagtgtgcatttctcatttttcacgtttttcagtgattttgtcatttttcaagttgtcaagtggatgtttctcattttccttgattttcagttttcttgccatattccatgtcctacagtggacatttctaaattttccacctttttcagttttccttgccatatttcatgtcctaaagtgtgtatttctcattttcagtgattttcagttttctcgccatattccaggtcctacagtgtgcatttctcattttttcaggtttttcagtgatttcgtcatttttcacgttgtcaagtggatgtttctcattttccatgattttcacttttcttgccatatttcatgtcctaaagtgtgtatttctcattttcagtgattttcagttttctcgccatattccaggtcctacagtgtgcatttctcattttttcacgtttttcagtgatttcgtcatttttcacgttgtcaagtggatgtttctcattttccatgattttcacttttcttgccatatttcatgtcctacagtggacatttctaaattttccacctttttctgttttcctcgccatatttcacatcctaaagtgtgtatttctcattttccgtgattttcagttttcttgccatatttcaggtcctacagtgtgcatttctcatttttcacgtttttcagtgatttcgtcatttttcaagtcgtcaagaggatgtttctcattttccatgattttcagttttctcgccatattccaggtcctacagttgacatttctaaattttccacattttttaagtttcctcgcgatatttcacatcctaaagtgtgtatttctcattttccgtgattttcagttttcttgccatattccaggtcctacagggtgcatttctcatttttcacgtttttcagtgatttcatcaatttcaagtcgtcaactgtatgtttctcattttcaatgattttcatttttcttgccatattccacgtcctatagtggacatttctaaattttccacctttttctgttttcctcgccatatttcacgtcctaaagtgtgtatttctcattttccgtgattttcagttttcttgccatattccaggtcctacagtgtgcatttctcatttttcacgtttttcactgattttgtcattgttcaagttgtcaactgcatgtttctcattttccatgattttcagttttcttgccatattccatgtcctacagtggaaatttctatattttccacctttttcagttttcctcgccgtatttcatgtgctaaagtgtgtatttctcatttttcgtgtttttcaggtttctcgccatattccaggtcctacagtgtgcatttctcatttttcacgtttttcagtgattttgtcatttttcaagttgtcaactggatgtttctcattttccttgattttcagttttcttgccatattccatgtcctactgtggacatttctaaattttccacctttttcagttttccttgccatatttcatgtcctaaagtgtgtatttctcattttcagtgattttcagttttctcgcaatattccaggtcctacagtgtgcatttctcattttttcaggtttttcagtgatttcgtcatttttcacgttgtcaagtggatgtttctcattttccatgattttcacttttcttgccatatttcatgtcctaaagtgtgtatttctcattttcagtgattttcagttttctcgccatattccaggtcctacattgtgcatttctcattttttcacgtttttcagtgatttcgtcatttttcacgttgtcaagtggatgtttctcattttccatgattttcacttttcttgccatatttcatgttttacagtggacatttctaaattttccacctttttctgttttcctcgccatatttcacatcctaaagtgtgaatttctcattttccgtgattttcagttttcttgccatattccaggtcctacagtgtgcatttctcatttttcacgtttttcagtgatttcatcatttttcaagtcgtcaagtggatgtttctcattttccatgattttcagttttcttgccatattccatgtcctacagtggacatttctaaattttccacctttttctgttttcctcgccatatttcacgtcctaaagtgtgtatttctcattttccgtgattttcagttttcttgccatattccaggtcctacagtgtgcatttctcatttttcacgtttttcactgattttgtcatttttcaagttgtcaactgcatgtttctcattttccatgattttcagttttcttgctatattccatgtcctacagtggaaatttctaaattttccacctttttcagttttcctcgccatatttcacgtcctgaagtgtgtatttctcattttccgtgattttcagttttctcgccatattccaggtcctatgtgtacatttctcatttttcacgtttttcagtgattttgtcatttttcaagttgtgaagtggatgtttctcatttttcttgattttcatttttcttgccatattccatgtcctacagtggaaatttctaaattttccacctttttcagttttcctcgccatatttcacgtcctaaagtgtgtatttctcattttccgtgattttcagttttctcgccatattccaggtcctacagtgtgcatttctcatttttcacgtttttcagtgatttcgacatttttcaagttgtcaagtggatgtttctcattttccatgattttcagctttcttgccatattcaaagtcctacagtggacatttctaaattttcgacctttatcagttttcctcgccatatttcatgtcccaaagtgtgtacttctcattttccgtgattttcagtttcctcgccatattccaggtcctacagtgtgcatttctcatttttcacgtttttcagtgatttcgtcatttttcaagtcgtcaagtggatgtttctcattttccatgattttcagttttcttgccatattccatgtcctacagtggacatttctaaattttccacctttttctgttttcctcgccatatttcacgtcctaaagtgtgtatttctcattttccgtgattttcagttttcttgccatattccaggtcctacagtgtgcatttctcatttatcacgtttttcactgattttgtcatttttcaagttgtcaactgcatgtttctcattttccatgattttcagttttcttgctatattccatgtcctacagtggaatattctaaattttccacctttttcagttttcctcgccatatttcacgtcctgaagtgtgtatttctcattttccgtgattttcagttttctcgccatattccaggtcctatgtgtacatttctcatttttcacgtttttcagtgattttgtcatttttcaagttgtgaagtggatgtttctcatttttcttgattttcatttttcttgccatattccatgtcctacagtggaaatttctaaattttccacctttttcagttttcctcgccatatttcacgtcctaaagtgtgaatttctcattttccgtgattttcagttttctcgccatattccaggtcctacagtgtgcatttctcatttttcacgtttttcagtgatttcgacatttttcaagttgtcaagtggatgtttctcattttccatgattttcagctttcttgccatattcaaagtcctacagtggacatttctaaattttcgacctttatcagttttcctcgccatatttcatgtcccaaagtgtgtacttctcattttccgtgattttgagtttcctcgccatattccaggtcctacagtgtgcatttctcatttttcacgtttttcagtgatttcgtcttttttcaagttgtcaactgcatgtttctcattttccatgattttcagttttcttgccatattccatgtcctacagtggaaatttgtaaatttccacctttttcagttttcctcgccatatttcacgtcctaaagtatgtatttctcattttccgtgattttcagttttctcgccatattccaggtcctacagtgtgcatttctcatttttcacgtttttcagtgattttgtcattttttaagttttcaagtggatgtttctcattttccttgattttcagttttcttgccatattccatgtcctacagtggacatttctaaattttccacctttttcagttttcctcgccatatttcatgtcctaaagtgtgtatttctcattttcagtgattttcagttttctcgccatattccaggtcctacagtgtgcatttctcatttttcacgtttttcagtgatttcgtcatttttcaaggtgtcaagtggatgtttctcattttccatgattttcagttttcttgccatattccatgtcctacagtggacatttctaaattttccacctttttctgttttcctcgccatatttcatgtcctaaagtgtgtatttctcattttccgtgattttcagttttcttgctatattccaagtcctacagtgtgcatttctcatttttcacgtttttcagtgattttgtcatttttcaatttgtcaactgcatgtttctcattttccatgattttcagtttttttgccatattccatgtcctactgtggaaatttctatattttccacctttttcagttttcctcgccatatttcacgtgctaaagtgtgtatttctcatttttcgtgtttttcaggtttctcgccatattccaggtcctacagtgtgcatttctcatttttcacgtttttcagtgattttgtcatttttcaagttttcaagtggatgtttctcattttccttgattttcagttttcttgccatattccatgtcctacagtggacatttctaaattttccacctttttcagttttccttgccatatttcatgtcctaaagtgtgtatttctcattttcagtgattttcagtttccttgccatattccaggtcctacagtgtgcatttctcattttttcacgtttttcagtgatttcgtcatttttcacgttgtcaagtggatgtttctcattttccatgattttcacttttcttgccatatttcatgtcctacagtggacatttctaaattttccaactttttcaattttcctcgccatattttatgtcctaaagtgtgtatttctcatttttcgttattttcagttttcttgccatattccaggtcctacagtgtgcatttgtcatttttcacgtttttcagtgatttcgtcatttttcaagtcgtcaagtagatgtttctcatattccatgtttttcagttttctcgccatattccaggtcctacagttgacatttctaaattttctacatttttaaattttcctcgccatatttcacgtcctaaagtgtgtatttctcattttttgttattttcagttttctagccatattccaggtcctacaggatgcatttctcatttttcacgtttttcagtgatttcatcatttttcaagtcgtcaagtgtatgtttcttattttcaatgattttcatttttcttgccttattccacgtcctatagtggacatttctaaattttccacctttttcagtttttttcgccatatttcacgtcctaaagtgtgtatttctcattttctgtgattttcagttttctcaccatattccaggtcctacagtgtgcatttctcatttttcacgtttttcagtgatttcgtcatttttcaagttgtcaagtggaagtttctcattttccatgattttcagctttctagacatattccaggtcctacagtggacatttcctaattttcgacctttatcagttttcctcgtcatatttcacgtcccaaaatgtgtatttcttattttccatgattttcagtttcctcgccatattccaggtcctacagtgtgcaattctcatttttcacgtttttcagtgatttcgtcttttttcaagacgtcaagtggatgtttctcatttttcatgattttcagttttcttgccatattccatgtcctacagtggacatttctaaattttccacctttttctgttttcctcgccatatttcacgtcctaaagtgtgtatttctcattttccgtgattttcagttttcttgccatattcctggtcctacagtgtgcatttctcatttttcacgtttttcagtgattttgtcatttttcaatttgtcaactgcatgtttctcattttccattattttcagttttcttgccatattccatgtcctacagtggacatttctaaattttccacctttttctgttttcctcgccatatttcatgtcctaaagtgtgtatttctcattttccgtgattttcagttttcttgctatattccaagtcctacagtgtgcatttctcatttttcacgtttttcagtgattttgtcatttttcaatttgtcaactgcatgtttctcattttccatgattttcagtttttttgccatattccatgtcctacaggggaaatttctatattttccacctttttcagttttcctcgccatatttcatgtcctaaagtgtgtatttctcattttccgtgattttcagttttcttgccatattccaggtcctacagtgtgcatttctcatttttcacgtttttcagtgatttcgtcatttttcaagtcttcaagtagatgtttctcatattccatgtttttcagttttctcgccatattccaggtcctacagttgacatttctaaattttctacatttttaaattttcctcgccatatttcacgtcctaaagtgtgtatttctcatttttcgttattttcagttttctagccatattccaggtcctacaggatgcatttctcatttttcacgtttttcagtgatttcatcatttttcaagtcgtcaagtgtatgtttctcattttcaatgattttcatttttcttgccttattccacgtcctatagtggacatttctaaattttccacctttttcagtttttctcgccatatttcacgtcctaaagtgtgtatttctcattttctgtgattttcagttttctcaccatattccaggtcctacagtgtgcatttctcatttttcacgtttttcagtgatttcgtcatttttcaagttgtcaagtggaagtttctcattttccatgattttcagctttctagccatattccaggtcctacagtggacatttcctaattttcgacctttatcagttttcctcgccatatttcacgtcctaaagtgtgtatttctcattttccgtgattttcagttttcttgccatattccaggtcctacagtgtgcatttctcatttttcacgtttttcagtgattttgtcatttttcaatttgtcaactgcatgtttctcattttccatgatttttagttttcttgctatattccatgtcctacagtggaaatttctaaattttccacctttttcagttttcctcgccatatttcacgtcctaaagtgtgtatttctcattttccgtgattttcagttttcttgctatattccaagtcctacattgtgcatttctcatttttcacgtttttcagtgattttgtcatttttcaatttgtcaaaccacatgtttctcattttccatgattttcagtttttttgccatattccatgtcctacagtggaaatttctatattttccacctttttcagttttcctcgccatatttcacgtgctaaagtgtgtatttctcatttttcgtgtttttcaggtttctcgccatattccaggtcctacagtgtgcatttctcatttttcacgtttttcagtgattttgtcatttttcaagttgtcaagtggatgtttcccattttccttgattttcagttttcttaccatattccatgtcctacagtggacatttctaaattttccacctttttcagttttccttgccatatttcatgtcctaaagtgtgtatttctcattttcagtgattttcagtttcctcgccatattccaggtcctacagtgtgcatttctcattttttcacgtttttcagtgatttcgtcatttttcacgttgtcaagtggatgtttctcattttccatgattttcacttttcttgccatatttcatgtcctatagtggacatttctaaattttccacctttttcagtttttctcgccatatttcacgtcctaaagtgtgtatttctcattttctgtgattttcagttttctcaccatattccaggtcctacagtgtgcatttctcatttttcacgtttttcagtgatttcgtcatttttcaagtcgtcaagtagatgtttctcatattccatgtttttcagttttctcgccatattccaggtcctacagttgacatttctaaattttctacatttttaaattttcctcgccatatttcacgtcctaaagtgtgtatttctcatttttcgttattttcagttttctagccatattccaggtcctacaggatgcatttctcatttttcacgtttttcagtgatttcatcatttttcaagtcgtcaagtgtatgtttcttattttcaatgattttcatttttcttgccttattccacgtcctatagtggacatttctaaattttccaccttttttcagtttttctcgccatatttcacgtcctaaagtgtgtatttctcattttctgtgattatcagttttctcaccatattccaggtcctacagtgtgcatttctcatttttcacgtttttcagtgatttcgtcatttttcaagttgtcaagtggaagtttctcattttccatgattttcagctttctagccatattccaggtcctacagtggacatttcctaattttcgacctttatcagttttcctcgccatatttcacgtcccaaaatgtgtatttcttattttccatgattttcagtttcctcgccatattccaggtcctacagtgtgcatttctcatttttcacgtttttcagtgatttcgtcttttttcaagacgtcaagtggatgtttctcatttttcatgattttcagttttcttgccatattccatgtcctacagtggacatttctaaattttccacctttttctgttttcctcgccatatttcacgtcctaaagtgtgtatttctcattttccgtgattttcagttttcttgccatattcctggtcctacagtgtgcatttctcatttttcacgtttttcagtgattttgtcatttttcaatttgtcaactgcatgtttctcattttccatgattttcagttttcttgccatattccatgtcctacagtggacatttctaaattttccacctttttcagttttcctcgccatatttcacgtgctaaagtgtgtatttctcatttttcgtgtttttcaggtttctcgccatattccaggtcctacagtgtgcatttctcatttttcacgtttttcagtgattttgtcatttttcaagttgtcaagtggatgtttctcattttccttgattttcacttttcttgccatattccaagtcttacaggggcatttctcatttttcacgttttcagtgattttgtcattttcaatttgtcaactgcatgtttctcattttccatgattttcagtttttttgccatattccatgtcctacaggggaaatttctatattttccacctttttcagttttcctcgccatatttcatgtcctaaagtgtgtatttctcattttccgtgattttcagttttcttgccatattccaggtcctacagtgtgcatttctcatttttcacgtttttcagtgatttcgtcatttttcaagtcttcaagtagatgtttctcatattccatgtttttcagttttctcgccatattccaggtcctacagttgacatttctaaattttctacatttttaaattttcctcgccatatttcacgtcctaaagtgtgtatttctcatttttcgttattttcagttttctagccatattccaggtcctacaggatgcatttctcatttttcacgtttttcagtgatttcatcatttttcaagtcgtcaagtgtatgtttctcattttcaatgattttcatttttcttgccttattccacgtcctatagtggacatttctaaattttccacctttttcagtttttctcgccatatttcacgtcctaaagtgtgtatttctcattttctgtgattttcagttttctcaccatattccaggtcctacagtgtgcatttctcatttttcacgtttttcagtgatttcgtcatttttcaagttgtcaagtggaagtttctcattttccatgattttcagctttctagccatattccaagtcctacagtggacatttcctaattttcgacctttatcagttttcctcgccatatttcacgtcccaaaatgtgtattccttattttccatgattttcagtttcctcgccatattccaggtcctacagtgtgcatttatcatttttcacgtttttcagtgatttcgtcttttttcaagacgtcaagtggatgtttctcatttttcatgattttcagttttcttgccatattccatgtcctacagtggacatttctaaattttccacctttttctgttttcctcgccatatttcacgtcctaaagtgtgtatttctcattttccgtgattttcagttttcttgccatattcctggtcctacagtgtgcatttctcatttttcacgtttttcagtgattttgtcatttttcaagttgtcaagtggatgtttctcattttccttgattttcacttttcttgccatattccatgtcctacagtggacatttctatattttccacctttttccgttttccttgccatatttcacgtcctaaagtgtgtatttctcattttccgtgattttcaggtttctcgccatattccaggtcctacagtgtgcatttctcatttttcacgtttttcagtgattttgtcatttttcaagttgtcaagtggatgtttctcattttccttgattttcacttttcttgccatattccatgtcctacagtggacatttctaaattttccacctttttcagttttcctcgccatatttcatgtcctaaagtgtgtatttctcattttcagtgattttcagttttcttgccatattccaggtcctacagtgtgcatttctcatttttcacgtttttcagtgattttgtcatttttcaagttgtcaactgcatgtttctcattttctatgattttcagttttcttgctatattccatgtcctacagtggaaatttctaaattttccacctttttcagttttcctcgccatatttcacgtcctaaagtgtgtatttctcattttccgtgattttcagttttctcgccatattccaggtcctatgtgtacatttctcatttttcacgtttttcagtgattttgtcatttttcaagttgtgaagtggatgtttctcatttttcttgattttcatttttcttgccatattccatgtcctagagtggaaatttttaaattttccacctttttcagttttcctcgccatatttcacgtcctaaagtgtgaatttctcattttccgtgattttcagatttctcgccatattccaagtcctacagtgtgcatttctcatttttcacgtttttcagtgatttcgtcatttttcaagttgtcaagtggatgtttctcattttccatgattttcagctttcttgccatattcaaagtcctacagtggacatttctaaattttcgacctttatcagttttcctcgccatatttcatgtcccaaagtgtgtacttctcattttccgtgattttcagtttcctcgccatattctaggtcctacagtgtgcatttctcatttttcaggtttttcagtgatttcgtcttttttcaagtcgtcaagtggatgtttctcattttccatgattttcacttttcttgccatatttcatgtcctaaagtgtgtatttctcattttcagtgattttcagttttctcgctatattccaggtcctacagtgtgcatttctcattttttcacgtttttcagtgatttcgtcatttttcacgttgtcaagtggatgtttctcattttccatgattttcacttttcttgccatatttcatgtcctacagtggacatttctaaattttccacctttttctgttttcctcgccatatttcacatcctaaagtgtgtatttctcattttccgtgattttcagttttcttgccatattccaggtcctacagtgtgcatttctcatttttcacgtttttcagtgatttcgtcatttttcaagttgtcaagtggatgtttctcattttccttgattttcagttttcttgccatattccatgtcctactgtggacatttctaaattttccacctttttcagttttccttgccatatttcatgtcctaaagtgtgtatttctcattttcagtgattttcagttttctcgcaatattccaggtcctacagtgtgcatttctcattttttcaggtttttcagtgatttcgtcatttttcacgttgtcaagtggatgtttctcattttccatgattttcacttttcttgccatatttcatgtcctaaagtgtgtatttctcattttcagtgattttcagttttcctcgccatatttcacgtcccaaaatgtgtatttcttattttccatgattttcagtttcctcgccatattccaggtcctacagtgtgcatttctcatttttcacgtttttcagtgatttcgtcttttttcaagacgtcaagtggatgtttctcatttttcatgattttcagttttcttgccatattccatgtcctacagtggacatttctaaattttccacctttttctgttttcctcgccatatttcacgtcctaaagtgtgtatttctcattttccgtgattttcagttttcttgccatattcctggtcctacagtgtgcatttctcatttttcacgtttttcagtgattttgtcatttttcaatttgtcaactgcatgtttctcattttccatgattttcagttttcttgccatattccatgtcctacagtggacatttctaaattttccacctttttcagttttcctcgccatatttcacgtgctaaagtgtgtatttctcatttttcgtgtttttcaggtttctcgccatattccaggtcctacagtgtgcatttctcatttttcacgtttttcagtgattttgtcatttttcaagttgtcaagtggatgtttctcattttccttgattttcacttttcttgccatattccatgtcctacagtggacatttctaaattttccacctttttcagttttcctcgccatatttcatgtcctaaagtgtgtatttctcattttcagtgattttcagttttctcgccatattccaggtcctacagtgtgcatttctcatttttcacgtttttcagtgatttcgtcttttttcaagacgtcaagtggatgtttctcattttccatgattttcagttttcttgccatattccatgtcctacagtggacatttctaaattttccacctttttctgttttcctcgccatatttcacgtcctaaagtgtgtatttctcattttccgtgattttcagttttcttgccatattccaggtcctacagtgtgcatttctcatttttcacgtttttcagtgattttgtcatttttcaatttgtcaactgcatgtttctcattttccatgatttttagttttcttgctatattccatgtcctacagtggaaatttctaaattttccacctttttcagttttcctcgccatatttcacgtcctaaagtgtgtatttctcattttccgtgattttcagttttcttgctatattccaagtcctacattgtgcatttctcatttttcacgtttttcagtgattttgtcatttttcaatttgtcaaaccacatgtttctcattttccatgattttcagtttttttgccatattccatgtcctacagtggaaatttctatattttccacctttttcagttttcctcgccatatttcacgtgctaaagtgtgtatttctcatttttcgtgtttttcaggtttctcgccatattccaggtcctacagtgtgcatttctcatttttcacgtttttctgtgattttgtcatttttcaagttgtcaagtggatgtttctcattttccttgattttcagttttcttaccatattccatgtcctacagtggacatttctaaattttccaccttttctgttttcctcgccatatttcatgtcctaaagtgtgtatttctcattttccgtgattttcatttttcttgctatattccaagtcctacagtgtgcatttctcattttccatgattttcagttttcttgctatattccatgtcctacagtggaaatttctaaattttccacctttttcagttttcctcgccatatttcacgtcctaaagtgtgtatttctcattttccgtgattttcagttttttcgccatattacaggtcctatgtgtacatttctcatttttcacgtttttcagtgattttgtcatttttcaagttgtcaagtggatgtttctcatttttcttgattttcatttttcttgccatattccatgtcctacagtggaaatttctaaattttccacctttttcagttttcctcgccatatttcacgtcctaaagtgtgaatttctcattttccgtgattttcagttttctcgccatattccaggtctacagtgtgcatttctcatttttcacgttttcagtgattcgtcatttttcaagttgacaagtggatgtttctcattttccatgattttcagctttcttgccatattcaaagtcctacagtggacatttctaaattttcgacctttatcagttttcctcgccatatttcatgtcccaaagtgtgtacttctcattttccgtgattttcagttttcttgccatattccaagtcctacagtgtgcatttctcatttttcacgtttttcagtgattttgtcatttttcaatttgtcaactgcatgtttctcattttccatgattttcagttttcttgccatattccatgtcctacagtggaaatttctatattttccacctttttcagttttcctcgccatatttcacgtgctaaagtgtgtatttctcatttttcgtgtttttcaggtttctcgccatattccaggtcctacagtgtgcatttctcatttttcacgtttttcagtgattttgtcatttttcaagttgtcaagtggatgtttctcattttcaatgattttcatttttcttgccttattccacgtcctatagtggacatttctaaattttccacctttttcagtttttctcgccatatttcacgtcccaaaatgtgtattccttattttccatgattttcagtttcctcgccatattccaggtcctacagtgtgcatttctcatttttcacgtttttcagtgatttcgtcttttttcaagacgtcaagtggatgtttctcatttttcatgattttcagttttcttgccatattccctgtcctacagtggacatttctaaattttccacctttttctgttttcctcgccatatttcacgtcctaaagtgtgtatttctcattttccgtgattttcagttttctcgccagattccaggtcctacagtgtgcatttctcatttttcacgtttttcagtgattttgtcatttttcaatttgtcaactgcatgtttctctctttccatgattttcagttttcttgccatattccatgtcctacagtggacatttctaaattttccacctttttcagttttcctcgccatatttcacgtgctaaagtgtgtatttctcatttttcgtgtttttcaggtttctcgccatattccaggtcctacagtgtgcatttctcatttttcacgtttttcagtgattttgtcatttttcaagttgtcaagtggatgtttctcattttcaatgattttcatttttcttaccttattccacgtcctatagtggacatttctaaattttccacctttttcagtttttctcgccatatttcacgtcccaaaatgtgtattccttattttccatgattttcagtttcctcgccatattccaggtcctacagtgtgcatttctcatttttcacgtttttcagtgatttcgtcttttttcaagacgtcaagtggatgtttctcatttttcatgattttcagttttcttgccatattccctgtcctacagtggacatttctaaattttccacctttttctgttttcctcgccatatttcacgtcctaaagtgtgtatttctcattttccgtgattttcagttttctcgccagattccaggtcctacagtgtgcatttctcatttttcacgtttttcagtgatttcgtcatttttcaagtcttcaagtgtatgtttctcattttcaatgattttcatttttcttgccttattccacgtcctatagtggacatttctaaattttccacctttttcagtttttctcgccatatttcacgtcctaaagtgtgtatttctcattttctgtgattttcagttttcttaccatattccaggtcctacagtgtgcatttctcatttttcacgtttttcagtgatttcgtcatttttcaagttgtcaagtggaagtttctcattttccatgattttcagctttctagccatattccaggtattacagtggacatttccttattttcgacctttatcagttttcctcgccatatttcatgtcctaaagtgtgt	38399	1554	4%	7300	19%
9	3000001	3038400	Atcctacagtgtgcatttctcatttttcacgtttttcagtgatttcgtcatttttcaagtcatcaagtggctgtttctcattttccatgattttcagttttcttgccatattccttgtcctacagtggacatttctaaattttccacctttttcagttttccttgtcatatttcaggtcctacagtgtgtatttctcatttttcacgtttttcattgatttcgtcatttttcaagttgtcaagtgcatgtttctcattttccatgattttcagttttcttgccatattccatgtcctacaatggacatttctaaattttccaactttttcagttttcctcgccatatttcacgtcctaaagtgtgtatttctcattttccgtgattttcagttttctcgacatattccaggtcctacagtgtgcatttctcatttttcacgtttttcagtgatttcgtcatttttcacgtcgtcaagtggatgtttctcattttccatgattttcagttttcttgccatattccatgtcctacagtggacatttctaaattttccacctttttcagttttcctcgccatatttcacgtcctaaagtgtgtatttctcattttccgtgattttcagttttctcgacatattccaggtcttacagggtgcatttctcatttttcacgtttttcagtgatttcatcatttttcaagtcgtcaactgtatgtttctcattttcaatgattttcatttttcttgccatattccacgtcctatagtggacatttctaaattttccacctttttcagttttccttgccatatttcaggtcctacagtgtgcatttctcatttttcacgtttttcagtgatttcgtcatttttcaagtggtcaaatgcatgtttctcattttccatgattttcagttttcttgccatattccatgtcctacagtggacatttctaaattttccacctttttcagttttcctcgccatatttcacgtcctaaagtgtgtatttctcattttccgtgattttcagttttatcgccagattccaggtcctacggtgtgcatttttcatatttcacgtttttcagtgattttgtcatttttcaagttgtcaactgcatgtttctcattttccatgattttcagttttcttgccatattccatgtcctacagtggacatttctaaattttccacctttttcagttttcctcgccatatttcatgtcctaaagtgtgtatttctcattttcagtgattttctgttttctcgccatattccaggtcctacagtgtgcatttctcatttttcacgtttttcagtgatttcgtcatttttcaagttgtcaagtggatgtttctcattttccatgattttcagttttcttgccatattccatgtcctacaatggacatttctaaattttccacctttttcagttttcctcgccatatttcacgtcctaaagtgtgtatttctcattttccgtgattttcagttttctcgccatattccaggtcctatgtgtacatttctcatttttcacgtttttcagtgattttgtcatttttcaagttgtgaagtggatgtttctcatttttcttgattttcatttttcttgccatattccatgtcctagagtggaaatttttaaattttccacctttttcagttttcctcgccatatttcacgtcctaaagtgtgaatttctcattttccgtgattttcagttttctcgccatattccaagtcctacagtgtgcatttctcatttttcacgtttttcagtgatttcgtcatttttcaagttgtcaagtggatgtttctcattttccatgattttcagctttcttgccatattcaaagtcctacagtggacatttctaaattttcgacctttatcagttttcctcgccatatttcatgtcccaaagtgtgtacttctcattttccgtgattttcagtttcctcgccatattctaggtcctacagtgtgcatttctcatttttcaggtttttcagtgatttcgtcttttttcaagtcgtcaagtggatgtttctcattttccatgattttcagttttcttgccatattccatgtcctacagtggacatttctaaattttccaactttttcagttttcctcgccatatttcatgtcctaaagtgtgtatttctcattttcagtgattttcagttttctcgccatattccaggtcctacagtgtgcatttctcatttttcacgtttttcagtgatttcgtcatttttcaagttgtcaagtggatgtttctcatttttcatgattttcagttttcttgccatattccatgtcccacagtggacatttctaaatgttccacctttttctgttttccttgccatatttcatgtcctaaagtgtgtatttctcattttccgtgattttcagttttcttgctatattccaagtcctacagtgtgcatttctcatttttcacgtttttctgtgattttttcatttttcaatttgtcaactgcatgtttctcattttccatgattttcagttttcttgccatattccaggtcctacagtgtgcatttctcatttttcacgtttttcagtgattttgtcatttttcaagttgtcaactgcatgtttctcattttccatgattttcagttttcttgctatattccatgtcctacagtggaaatttctaaattttccacctttttcagttttcctcgccatatttcacgtcctaaagtgtgtatttctcattttccgtgattttcagttttctcgccatattccaggtcctatgtgtacatttctcatttttcacgtttttcagtgattttgtcatttttcaagttgtgaagtggatgtttctcatttttcttgattttcatttttcttgccatattccatgtcctagagtggaaatttttaaattttccacctttttcagttttcctcgccatatttcacgtcctaaattgtgaatttctcattttccgtgattttcagttttctcgccatattccaagtcctacagtgtgcatttctcatttttcacgtttttcagtgatttcgtcatttttcaagttgtcaagtggatgtttctcattttccatgattttcagctttcttgccatattcaaagtcctacagtggacatttctaaattttcgacctttatcagttttcctcgccatatttcatgtcccaaagtgtgtacttctcattttccgtgattttcagtttcctcgccatattctaggtcctacagtgtgcatttctcatttttcaggtttttcagtgatttcgtcttttttcaagtcgtcaagtggatgtttctcattttccatgattttcagttttcttgccatattccatgtcctacagtggacatttctaaattttccacctttttcagttttcctcgccatatttcatgtcctaaagtgtgtatttctcattttcagtgattttcagttttctcgccatattccaggtcctacagtgtgcatttctcatttttcacgtttttcagtgattttgtcatttttcaagttgtcaagtggatgtttctcattttccttgattttcagttttcttgccatattccatgtcctacagtggacatttctaaattttccacctttttcagttttccttgccatatttcatgtcctaaagtgtgtatttctcattttcagtgattttcagttttctcgccatattccaggtcctacagtgtgcatttctcattttttcaggtttttcagtgatttcgtcatttttcacgttgtcaagtggatgtttctcattttccatgattttcacttttcttgccatatttcatgtcctaaagtgtgtatttctcattttcagtgattttcagttttctcgccatattccaggtcctacagtgtgcatttctcattttttcacgtttttcagtgatttcgtcatttttcacgttgtcaagtggatgtttctcattttccattattttcacttttcttgccatatttcatgtcctacagtggacatttctaaattttccacctttttctgttttcctcgccatatttcacatcctaaagtgtgtatttctcattttccgtgattttcagttttcttgccatattccaggtcctacagtgtgcatttctcatttttcacgtttttcagtgatttcgtcatttttcaagtcgtcaagtggatgtttctcattttccatgattttcagttttctcgccatattccaggtcctacagttgacatttctaaattttccacattttttatgtttcctcgcgatatttcacatcctaaagtgtgtatttctcattttccgtgattttcagttttcttgccatattccaggtcctacagggtgcatttctcatttttcacgtttttcagtgatttcatcaatttcaagtcgtcaactgtatgtttctcattttcaatgattttcatttttcttgccatattccacgtcctatagtggacatttctacattttccacctttttcagttttcttcgccatatttcacgtcccaaagtgtgtatttctcattttccgtgattttcagtttcctcgccatattccaggtcctacagtgtgcatttctcatttttcacgtttttcagtgatttcgtcttttttcaagtcgtcaagtggatgtttctcattttccatgattttcagttttcttgccatattccatgtcctacagtggacatttctaaattttccacctttttctgttttcctcgccatatttcacgtcctaaagtgtgtatttctcatttaccgtgattttcagttttcttgctatattccaagtcctacagtgtgcatttctcatttttcacgtttttcactgattttgtcattgttcaagttgtcaactgcatgtttctcattttccatgattttcagttttcttgccatattccatgtcctacagtggaaatttctatattttccaactttttcagttttcctcgccatatttcacgtgctaaagtgtgtatttctcatttttcgtgtttttcaggtttctcgccatattccaggtcctacagtgtgcatttctcatttttcacgtttttcagtgattttgtaatttttcaagttgtcaagtggatgtttctcattttccttgattttcagttttcttgccatattccatgtcctactgtggacatttctaaattttccacctttttcagttttccttgccatatttcatgtcctaaagtgtgtatttctcattttcagtgattttcagttttctcgcaatattccaggtcctacagtgtgcatttctcattttttcaggtttttcagtgatttcgtcatttttcacgttgtcaagtggatgtttctcattttccatgattttcacttttcttgccatatttcatgtgctaaagtgtgtatttctcattttcagtgattttcagttttctgccatattccaggtcctacattgtgcatttctcattttttcacgtttttcagtgatttcgtcatttttcacgttgtcaagtggatgtttctcattttccatgattttcacttttcttgccatatttcatgttttacagtggacatttctaaattttccacctatttctgttttcctcgccatatttcacatcctaaagtgtgtatttctcattttccgtgattttcagttttctcgccatatgccaggtcatacagggtgcatttctcatttttcacgtttttcagtgatttcgtcatttttcacgtcgtcaagtggatgtttctcattttcaatgattttcatttttcttgccatattccacgtcctatagtggacatttctaaattttccacctttttcagttttccttgccatatttcaggtcctacagtgtgcatttctcttttttcacgtttttcagtgatttcgtcatttttcaagtggtcaagtgcatgtttctcattttccgtgattttcagttttcttgccatgttccaggtcctacagttgacgtttctaaaatttcactttttttaagttttcctcgccatatttcacttcctaaagtgtgtatttctcattttccgtgattttcagttttctcgccagattccaggtcctacagtgtgcatttttcatatttcacctttttcagtgattttgtcatttttcaagttgtcaactgcatgtttctcattttccatgattttcagttttcttgccatattccatgtcctactgtggacatttctaaattttccaactttttcagttttcctcgccatatttcatgtcctaaagtgtgtatttctcattttcagtgattttctgttttctcgccatattccaggtcctacagtgtgcatttctaatttttcacgtttttcagtgatttcgtcatttttcaagttgtcaagtggatgtttctcattttccatgattttcagttttcttgccatattccatgtcctacagtggacatttctaaattttccaactttttccattttcctcaccatatttcacgtcctaaagtgagtttttctcattttttgtgattttcagttttctcgacatattccaggtcctacagtgtgcatttctaattttttcttttttcagtgatttcgtcatttttcaagtggtcaagtgcatgtttctcattttccatgattttcagttttcttgccatattccatgtcctacaatggacatttctaaattttccaactttttcagttttcctcgccatatttcacgtcctaaagtgtgtatttctcattttccgtgattttcagttttctcgccatattccaggtcctacagtgtgcatttctcatttttcacgtttttcagtgatttcgtcatttttcaagttgtcaactgcatgtttctcattttccatgattttcagttttcttgccatattccatgtcttacagtggacatttttaaatttttcacatttttttaagttttcctccccatatttcacgttttaaagtgtgcatttctcattttcggtgattttcagttttctcgccagattccatgtcttacagtgtgcatttctcattttttcacgtttttcagtgatttcgtcatttttcaagtcgtcaagtggatgtttctcattttccatgattttcagttttcttgccatattccatgtcctacagtggaaatttctaaattttccacctttttcagttttccttgccatatttcaggtcctaaagtgtgtatttctcattttctgtgattttcagttttctcgccatattccaggtcctacagttgacatttctaaaatttccacattttttaagttttcctcgccatatttcacttcctaaagtgtgtatttctcattttccgtgattttcagttttctcgccatattccagatcctacagtgtacatttttcatttttcacgtttttcagtgattttgtcattttttagttgtcaactgcctgtttctcattttccatgattttcagttttcttgctatattccatgtcctacagtggaaatttctaaattttccacctttttcagttttcctcgccatatttcacgtcctaaagtgtgtatttctcattttccgtgattttcagttttctcgccatattccaggtcctatgtgtacatttctcatttttcacgtttttcagtgattttgtcatttttcaatttgtcaactgcatgtttctcattttccatgattttcagttttcttgccatattccatgtcctacagtggaaatttctatattttccaactttttcagttttcctcgccatatttcacgtgctaaagtgtgtatttctcatttttcgtgtttttcaggtttctcgccatattccaggtcctacagtgtgcatttctcatttttcacgtttttcagtgattttgtcatttttcaagttgtcaagtggatgtttctcattttccttgattttcagttttcttgccatattccatgtcctacagtggacatttctaaattttccacctttttcagttttccttgccatatttcatgtcctaaagtgtgtatttctcattttcagtgattttcagttttctcgccatattccaggtcctacagtgtgcatttctcattttttcaggtttttcagtgatttcgtcatttttcacgttgtcaagtggatgtttctcattttccatgattttcacttttcttgccatatttcatgtcctaaagtgtgtatttctcattttcagtgattttcagttttctcgctatattccaggtcctacagtgtgcatttctcattttttcacgtttttcagtgatttcgtcatttttcacgttgtcaagtggatgtttctcattttccatgattttcacttttcttgccatatttcatgtcctacaatggacatttctaaattttccacctttttctgttttcctcgccatatttcacatcctaaagtgtgtatttctcattttccgtgattttcagttttcttgccatattccaggtcctacagtgtgcatttctcatttttcacgtttttcagtgatttcgtcatttttcaagttgtcaagtggatgtttctcattttccttgattttcagttttcttgccatattccatgtcctactgtggacatttctaaattttccacctttttcagttttccttgccatatttcatgtcctaaagtgtgtatttctcattttcagtgattttcagttttctcgcaatattccaggtcctacagtgtgcatttctcattttttcaggtttttcagtgatttcgtcatttttcacgttgtcaagtggatgtttctcattttccatgattttcacttttcttgccatatttcatgtcctaaagtgtgtatttctcattttcagtgattttcagttttctgccatattccaggtcctacattgtgcatttctcattttttcacgtttttcagtgatttcgtcatttttcagttttctcgacatattccaggtcctacagtgtgcatttctaattttttcttttttcagtgatttcgtcatttttcaagttgtcaactgcatgtttctcattttccatgattttcagttttcttgccatattccatgtcttacagtggacatttttaaatttttcacatttttttaagttttcctccccatatttcacgttttaaagtgtgcatttctcattttcggtgattttcagttttctcgccagattccaggtcttacagtgtgcatttctcattttttcacgtttttcagtgatttcgtcatttttcaagtcgtcaagtggatgtttctcattttccatgattttcagttttcttgccatattccatgtcctacagtggaaatttctaaattttccacctttttcagttttccttgccatatttcaggtcctaaagtgtgtatttctcattttctgtgattttcagttttctcgccatattccaggtcctacagttgacatttctaaaatttccacattttttaagttttcctcgccatatttcacttcctaaagtgtgtatttctcattttccgtgattttcagttttctcgccatattccagatcctacagtgtgcatttttcatttttcacgtttttcagtgattttgtcattttttagttgtcaactgtctgtttctcattttccatgattttcagttttcttgccatattccatgtcctacactggacatttctaaattttccacctttttctgttttcctcgccatatttcacgtcctaaagtgtgtatttctcattttccgtgattttcagttttcttgccatattccaggtcctacagtgtgcatttctcatttttcacgtttttcagtgattttgtcatttttcaagttgtcaactgcatgtttctcattttctatgattttcagttttcttgctatattccatgtcctacagtggaaatttctaaattttccacctttttcagttttcctcgccatatttcacgtcctaaagtgtgtatttctcattttccgtgattttcagttttctcgccatattccaggtcctatgtgtacatttctcatttttcacgtttttcagtgattttgtcatttttcaagttgtgaagtggatgtttctcatttttcttgattttcatttttcttgccatattccatgtcctagagtggaaatttttaaattttccacctttttcagttttcctcgccatatttcacgtcctaaagtgtgaatttctcattttccgtgattttcagatttctcgccatattccaagtcctacagtgtgcatttctcatttttcacgtttttcagtgatttcgtcatttttcaagttgtcaagtggatgtttctcattttccatgattttcagctttcttgccatattcaaagtcctacagtggacatttctaaattttcgacctttatcagttttcctcgccatatttcatgtcccaaagtgtgtacttctcattttccgtgattttcagtttcctagccatattctaggtcctacagtgtgcatttctcatttttcaggtttttcagtgatttcgtcttttttcaagtcgtcaagtggatgtttctcattttccatgattttcacttttcttgccatatttcatgtcctaaagtgtgtatttctcattttcagtgattttcagttttctcgctatattccaggtcctacagtgtgcatttctcattttttcacgtttttcagtgatttcgtcatttttcacgttgtcaagtggatgtttctcattttccatgattttcacttttcttgccatatttcatgtcctacagtggacatttctaaattttccacctttttctgttttcctcgccatatttcacatcctaaagtgtgtatttctcattttccgtgattttcagttttcttgccatattccaggtcctacagtgtgcatttctcatttttcacgtttttcagtgatttcgtcatttttcaagttgtcaagtggatgtttctcattttccttgattttcagttttcttgccatattccatgtcctactgtggacatttctaaattttccacctttttcagttttccttgccatatttcatgtcctaaagtgtgtatttctcattttcagtgattttcagttttctcgcaatattccaggtcctacagtgtgcatttctcattttttcaggtttttcagtgatttcgtcatttttcacgttgtcaagtggatgtttctcattttccatgattttcacttttcttgccatatttcatgtcctaaagtgtgtatttctcattttcagtgattttcagttttctgccatattccaggtcctacattgtgcatttctcattttttcacgtttttcagtgatttcgtcatttttcacgttgtcaagtggatgtttctcattttccatgattttcacttttcttgccatatttcatgttttacagtggacatttctaaattttccacctttttctgttttcctcgccatatttcacatcctaaagtgtgtatttctcattttccgtgattttcagttttctcgccatatgccaggtcatacagggtgcatttctcatttttcacgtttttcagtgatttcgtcatttttcacgtcgtcaagtggatgtttctcattttcaatgattttcatttttcttgccatattccacgtcctatagtggacatttctaaattttccacctttttcagttttccttgccatatttcaggtcctacagtgtgcatttctcatttttcacgtttttcagtgatttcgtcatttttcaagtggtcaagtgcatgtttctcattttccgtgattttcagttttcttgccatgttccaggtcctacagttgacgtttctaaaatttcactttttttaagttttcctcgccatatttcacttcctaaagtgtgtatttctcattttccgtgattttcagttttctcgccagattccaggtcctacagtgtgcatttttcatatttcacctttttcagtgattttgtcatttttcaagttgtcaactgcatgtttctcattttccatgattttcagttttcttgccatattccatgtcctactgtggacatttctaaattttccaactttttcagttttcctcgccatatttcatgtcctaaagtgtgtatttctcattttcagtgattttctgttttctcgccatattccaggtcctacagtgtgcatttctaatttttcacgtttttcagtgatttcgtcatttttcaagttgtcaagtggatgtttctcattttccatgattttcagttttcttgccatattccatgtcctacagtggacatttctaaattttccaactttttccattttcctcaccatatttcacgtcctaaagtgtgtttttctcattttttgtgattttcagttttctcgacatattccaggtcctacagtgtgcatttctaattttttcttttttcagtgatttcgtcatttttcaagttgtcaactgcatgtttctcattttccatgattttcagttttcttgccatattccatgtcttacagtggacatttttaaatttttcacatttttttaagttttcctccccatatttcacgttttaaagtgtgcatttctcattttcggtgattttcagttttctcgccagattccaggtcttacagtgtgcatttctcattttttcacgtttttcagtgatttcgtcatttttcaagtcgtcaagtggatgtttctcattttccatgattttcagttttcttgccatattccatgtcctacagtggaaatttctaaattttccacctttttcagttttccttgccatatttcaggtcctaaagtgtgtatttctcattttctgtgattttcagttttctcgccatattccaggtcctacagttgacatttctaaaatttccacattttttaagttttcctcgccatatttcacttcctaaagtgtgtatttctcattttccgtgattttcagttttctcgccatattccagatcctacagtgtgcatttttcatttttcacgtttttcagtgattttgtcattttttagttgtcaactgtctgtttctcattttccatgattttcagttttcttgccatattccatgtcctacactggacatttctaaattttccacctttttctgttttcctcgccatatttcacgtcctaaagtgtgtatttctcattttccgtgattttcagttttcttgccatattccaggtcctacagtgtgcatttctcatttttcacgtttttcagtgattttgtcatttttcaagttgtcaactgcatgtttctcattttccatgattttcagttttcttgctatattccatgtcctacagtggaaatttctaaattttccacctttttcagttttcctcgccatatttcacgtcctaaagtgtgtatttctcattttccgtgattttcagttttctcgccatattccaggtcctatgtgtacatttctcatttttcacgtttttcagtgattttgtcatttttcaagttgtgaagtggatgtttctcatttttcttgattttcatttttcttgccatattccatgtcctagagtggaaatttttaaattttccacctttttcagttttcctcgccatatttcacgtcctaaagtgtgaatttctcattttccgtgattttcagatttctcgccatattccaagtcctacagtgtgcatttctcatttttcacgtttttcagtgatttcgtcatttttcaagttgtcaagtggatgtttctcattttccatgattttcagctttcttgccatattcaaagtcctacagtggacatttctaaattttcgacctttatcagttttcctcgccatatttcatgtcccaaagtgtgtacttctcattttccgtgattttcagtttcctcgccatattctaggtcctacagtgtgcatttctcatttttcaggtttttcagtgatttcgtcttttttcaagtcgtcaagtggatgtttctcattttccatgattttcagttttcttgccatattccatgtcctacagtggacatttctaaattttccacctttttcagttttcctcgccatatttcatgtcctaaagtgtgtatttctcattttcagtgattttcagttttctcgccatattccaggtcctacagtgtgcatttctcatttttcacgtttttcagtgatttcgtcatttttcaagttgtcaagtggatgtttctcattttccatgattttcagttttcttgccatattccatgtcccacagtggacatttctaaattttccacctttttctgttttccttgccatatttcatgtcctaaagtgtgtatttctcattttccgtgattttcagttttcttgctatattccaagtcctacagtgtgcatttctcatttttcacgtttttcagtgattttgtcatttttcaatttgtcaactgcatgtttctcattttccatgattttcagttttcttgccatattccatgtcctacagtggaaatttctatattttccaactttttcagttttcctcgccatatttcacgtgctaaagtgtgtatttctcatttttcgtgtttttcaggtttctcgccatattccaggtcctacagtgtgcatttctcatttttcacgtttttcagtgattttgtcatttttcaagttgtcaagtggatgtttctcattttccttgattttcagttttcttgccatattccatgtcctacagtggacatttctaaattttccacctttttcagttttccttgccatatttcatgtcctaaagtgtgtatttctcattttcagtgattttcagttttctcgccatattccaggtcctacagtgtgcatttctcattttttcaggtttttcagtgatttcgtcatttttcacgttgtcaagtggatgtttctcattttccatgattttcacttttcttgccatatttcatgtcctaaagtgtgtatttctcattttcagtgattttcagttttctcgctatattccaggtcctacagtgtgcatttctcattttttcacgtttttcagtgatttcgtcatttttcacgttgtcaagtggatgtttctcattttccatgattttcacttttcttgccatatttcatgtcctacagtggacatttctaaattttccacctttttctgttttcctcgccatatttcacatactaaagtgtgtatttctcattttccttgattttcagttttcttgccatattccaggtcctacagtgtgcatttctcatttttcacgtttttcagtgatttcgtcatttttcaagtcgtcaagtggatgtttctcattttccatgattttcagttttctcgccatattccaggtcctacagttgacatttctaaattttccacattttttaagtttcctcgcgatatttcacatcctaaagtgtgtatttctcattttccgtgattttcagttttcttgccatattccaggtcctacagggtgcatttctcatttttcacgtttttcagtgatttcatcaatttcaagtcgtcaactgtatgtttctcattttcaatgattttcatttttcttgccatattccatgtcctacagtggacatttctaaatttttcacctttttcagttttccttgccatatttcatgtcctaaagtgtgtatttctcattttcagtgattttcagttttctcgccatattccaggtcctacagtgtgcatttctcattttttcaggtttttcagtgatttcgtcatttttcacgttgtcaagtggatgtttctcattttccatgattttcacttttcttgccatatttcatgtcctaaagtgtgtatttctcattttcagtgattttcagttttctcgccatattccaggtcctacagtgtgcatttctcatttttcacgtttttcagtgatttcgtcatttttcaagttgtcaagtggatgtttctcattttccatgattttcacttttcttgccatattccatgtcccacagtggacatttctaaattttccacctttttctgttttcctcgccatatttcatgtcctaaagtgtgtatttctcattttccgtgattttcagttttcttgctatattccaagtcctacagtgtgcatttctcatttttcacgtttttcagtgattttgtcatttttcaatttgtcaactgcatgtttctcattttccatgattttcagttttcttgccatattccatgttctacagtggaaatttctatattttccaactttttcagttttcctcgccatatttcacgtgctaaagtgtgtatttctcatttttcgtgtttttcaggtttctcgccatattccaggtcctacagtgtgcatttctcatttttcacgtttttcagtgattttgtcatttttcaagttgtcaagtggatgtttctcattttccttgattttcagttttcttgccatattccatgtcctacagtggacatttctaaattttccacctttttcagttttccttgccatatttcatgtcctaaagtgtgtatttctcattttcagtgattttcagttttctcgccatattccaggtcctacagtgtgcatttctcattttttcaggtttttcagtgatttcgtcatttttcacgttgtcaagtggatgtttctcattttccatgattttcacttttcttgccatatttcatgtcctaaagtgtgtatttctcattttcagtgattttcagttttctcgctatattccaggtcctacagtgtgcatttctcattttttcacgttttgcagtgatttcgtcatttttcacgttgtcaagtggatgtttctcattttccatgattttcacttttcttgccatatttcatgtcctacagtggacatttctaaattttccacctttttctgttttcctcgccatatttcacatcctaaagtgtgtatttctcattttccgtgattttcagttttcttgccatattccaggtcctacagtgtgcatttctcatttttcacgtttttcagtgatttcgtcatttttcaagtcgtcaagtggatgtttctcattttccatgattttcagttttctcgccatattccaggtcctacagttgacatttctaaattttccacattttttaagtttcctcgcgatatttcacatcctaaagtgtgtatttctcattttccgtgattttcagttttcttgccatattccaggtcctacagggtgcatttctcatttttcacgtttttcagtgatttcatcaatttcaagtcgtcaactgtatgtttctcattttcaatgattttcatttttcttgccatattccatgtcctacagtggacatttctaaattttccacctttttcagttttccttgccatatttcatgtcctaaagtgtgtatttctcattttcagggattttcagttttctcgccatattccaggtcctacagtgtgcatttctcattttttcaggtttttcagtgatttcgtcatttttcacgttgtcaagtggatgtttctcattttccatgattttcacttttcttgccatatttcatgtcctaaagtgtgtatttctcattttcagtgattttcagttttctcgccatattccaggtcctacagtgtgcatttctcattttttcacgtttttcagtgatttcgtcatttttcacgttgtcaagtggatgtttctcattttccatgattttcacttttcttgccatatttcatgtcctacagtggacatttctaaattttccacctttttctgttttcctcgccatatttcacatcctaaagtgtgtatttctcattttccgtgattttcagttttcttgccatattccaggtcctacagtgtgcatttctcatttttcacgtttttcagtgatttcgtcatttttcaagtcgtcaagtggatgtttctcattttccatgattttcagttttctcgccatattccaggtcctacagttgacatttctaaattttccacattttttaagtttcctcgcgatatttcacatcctaaagtgtgtatttctcattttccgtgattttcagttttcttgccatattccaggtcctacagggtgcatttctcatttttcacgtttttcagtgatttcatcaatttcaagtcgtcaactgtatgtttctcattttcaatgattttcatttttcttgccatattccacgtcctatagtggacatttctaaattttccacctttttcagttttcttcgccatatttcacgtcccaaagtgtgtatttctcattttccgtgattttcagtttcctcgcaatattccaggtcctacagtgtgcatttctcatttttcacgtttttcagtgatttcgtcttttttcaagtcgtcaagtggatgtttctcattttccatgattttcagttttcttgccatattccatgtcctacagtggacatttctaaattttccacctttttctgttttcctcgccatatttcacgtcctaaagtgtgtatttctcattttccgtgattttcagttttcttgccatattccaggtcctacagtgtgcatttctcatttttcacgtttttcactgattttgtcattgttcaagttgtcaactgcatgtttctcattttccatgattttcaattttcttgccatattccatgtcctacagtggaaatttctatattttccaactttttcagttttcctcgccatatttcacgtgctaaagtgtgtatttctcatttttcgtgtttttcaggtttctcgccatattccaggtcctacagtgtgcatttctcatttttcacgtttttcagtgattttgtcatttttcaagttgtcaagtggttgtttctcattttccttgattttcagttttcttgccatattccatgtcctactgtggacatttctaaattttccacctttttcagttttccttgccatatttcatgtcctaaagtgtgtatttctcattttcagtgattttcagttttctcgcaatattccaggtcctacagtgtgcatttctcattttccgtgattttcagttttctcgccatatgccaggtcatacagggtgcatttctcatttttcacgtttttcagtgatttcgtcatttttcacgtcgtcaagtggatgtttctcattttcaatgattttcatttttcttgccatattccacgtcctatagtggacatttctaaattttccaactttttcagttttcttgccatatttcaggtcctacagtgtgcatttctcatttttcacgtttttcagtgatttcgtcatttttcaagtggtcaagtgcatgtttctgattttccgtgattttcagttttcttgccatgttccaggtcctacagttgacgtttctaaaatttcactttttttaagttttcctcgccatatttcacttcctaaagtgtgtatttctcattttccgtgattttcagttttctcgccagattccaggtcctacagtgtgcatttttcatatttcacctttttcagtgattttgtcatttttcaagttgtcaactgcatgtttctcattttccatgattttcagttttcttgccatattccatgtcctactgtggacatttctaaattttccaactttttcagttttcctcgccatatttcatgtcctaaagtgtgtatttctcattttcagtgtttttctgttttctcgccatattccaggtcctacagtgtgcatttctaatttttcacgtttttcagtgatttcgtcatttttcaagttgtcaagtggatgtttctcattttccatgattttcagttttcttgccatattccatgtcctacagtggacatttctaaattttccaactttttccattttcctcaccatatttcacgtcctaaagtgtgtttttctcattttttgtgattttcagttttctcgacatattccaggtcctacagtgtgcatttctaattttttcttttttcagtgatttcgtcatttttcaagtggtcaagtgcatgtttctcattttccatgattttcagttttcttgccatattccatgtcctacaatggacatttctaaattttccaactttttcagttttcctcgccatatttcacgtcctaaagtgtgtatttctcattttccgtgattttcagttttctcgccatattccaggtcctatgtgtacatttctcatttttcacgtttttcagtgattttgtcatttttcaagttgtgaagtggatgtttctcatttttcttgattttcatttttcttgccatattccatgtcctagagtggaaatttttaaattttccaactttttcagttttcctcgccatatttcacgtcctaaagtgtgtatttctcattttccgtgattttcagttttctcgccatattccaagtcctacagtgtgcatttctcatttttcacgtttttcagtgatttcgtcatttttcaagttgtcaagtggatgtttctcattttccatgattttcagctttcttgccatattcaaagtcctacagtggacatttctaaattttcgacctttatcagttttcctcgccatatttcatgtcccaaagtgtgtacttctcattttccgtgattttcagtttcctcgccatattctaggtcctacagtgtgcatttctcatttttcaggtttttcagtgatttcgtcttttttcaagtcgtcaagtggatgtttctcattttccatgattttcagttttcttgccatattccatgtcctacagtggacatttctaaattttccacctttttcagttttcctcgccatatttcatgtcctaaagtgtgtatttctcattttcagtgattttcagttttctcgccatattccaggtcctacagtgtgcatttctcatttttcacgtttttcagtgatttcgtcatttttcaagttgtcaagtggatgtttctcattttccatgattttcagttttcttgccatattccatgtcccacagtggacatttctaaattttccacctttttctgttttccttgccatatttcatgtcctaaagtgtgtatttctcattttccgtgattttcagttttcttgctatattccaagtcctacagtgtgcatttctcatttttcacgtttttaagtgattttgtcatttttcaatttgtcaactgcatgtttctcattttccatgattttcagttttcttgccatattccatgtcctacagtggaaatttctatattttccaactttttcagttttcctcgccatatttcacgtgctaaagtgtgtatttctcatttttcgtgtttttcaggtttctcgccatattccaggtcctacagtgtgcatttctcatttttcacgtttttcagtgattttgtcatttttcaagttgtcaagtggatgtttctcattttccttgattttcagttttcttgccatattccatgtcctacagtggacatttctaaattttccacctttttcagttttccttgccatatttcatgtcctaaagtgtgtatttctcattttcagtgattttcagttttctcgccatattccaggtcctacagtgtgcatttctcattttttcaggtttttcagtgatttcgtcatttttcacgttgtcaagtggatgtttctcattttccatgattttcacttttcttgccatatttcatgtcctaaagtgtgtatttctcattttcagtgattttcagttttctcgccatattccaggtcctacagtgtgcatttctcattttttcacgtttttcagtgatttcgtcatttttcacgttgtcaagtggatgtttctcattttccatgattttcacttttcttgccatatttcatgtcctacagtggacatttctaaattttccacctttttctgttttcctcgccatatttcacatcctaaagtgtgtatttctcattttccgtgattttcagttttcttgccatatttcaggtcctacagtgtgcatttctcatttttcacgtttttcagtgatttcgtcatttttcaagtcgtcaagaggatgtttctcattttccatgattttcagttttctcgccatattccaggtcctacagttgacatttctaaattttccacattttttaagtttcctcgcgatatttcacatcctaaagtgtgtatttctcattttccgtgattttcagttttcttgccatattccaggtcctacagggtgcatttctcatttttcacgtttttcagtgatttcatcaatttcaagtcgtcaactgtatgtttctcattttcaatgattttcatttttcttgccatattccacgtcctatagtggacatttctaaattttccacctttttctgttttcctcgccatatttcacgtcctaaagtgtgtatttctcattttccgtgattttcagttttcttgccatattccaggtcctacagtgtgcatttctcatttttcacgtttttcactgattttgtcattgttcaagttgtcaactgcatgtttctcattttccatgattttcagttttcttgccatattccatgtcctacagtggaaatttctatattttccacctttttcagttttcctcgccgtatttcatgtgctaaagtgtgtatttctcatttttcgtgtttttcaggtttctcgccatattccaggtcctacagtgtgcatttctcatttttcacgtttttcagtgattttgtcatttttcaagttgtcaactggatgtttctcattttccttgattttcagttttcttgccatattccatgtcctactgtggacatttctaaattttccacctttttcagttttccttgccatatttcatgtcctaaagtgtgtatttctcattttcagtgattttcagttttctcgcaatattccaggtcctacagtgtgcatttctcattttttcaggtttttcagtgatttcgtcatttttcacgttgtcaagtggatgtttctcattttccatgattttcacttttcttgccatatttcatgtcctaaagtgtgtatttctcattttcagtgattttcagttttctcgccatattccaggtcctacattgtgcatttctcattttttcacgtttttcagtgatttcgtcatttttcacgttgtcaagtggatgtttctcattttccatgattttcacttttcttgccatatttcatgttttacagtggacatttctaaattttccacctttttctgttttcctcgccatatttcacatcctaaagtgtgaatttctcattttccgtgattttcagttttcttgccatattccaggtcctacagtgtgcatttctcatttttcacgtttttcagtgatttcatcatttttcaagtcgtcaagtggatgtttctcattttccatgattttcagttttcttgccatattccatgtcctacagtggacatttctaaattttccacctttttctgttttcctcgccatatttcacgtcctaaagtgtgtatttctcattttccgtgattttcagttttcttgccatattccaggtcctacagtgtgcatttctcatttttcacgtttttcactgattttgtcatttttcaagttgtcaactgcatgtttctcattttccatgattttcagttttcttgctatattccatgtcctacagtggaaatttctaaattttccacctttttcagttttcctcgccatatttcacgtcctgaagtgtgtatttctcattttccgtgattttcagttttctcgccatattccaggtcctatgtgtacatttctcatttttcacgtttttcagtgattttgtcatttttcaagttgtgaagtggatgtttctcatttttcttgattttcatttttcttgccatattccatgtcctacagtggaaatttctaaattttccacctttttcagttttcctcgccatatttcacgtcctaaagtgtgtatttctcattttccgtgattttcagttttctcgccatattccaggtcctacagtgtgcatttctcatttttcacgtttttcagtgatttcgacatttttcaagttgtcaagtggatgtttctcattttccatgattttcagctttcttgccatattcaaagtcctacagtggacatttctaaattttcgacctttatcagttttcctcgccatatttcatgtcccaaagtgtgtacttctcattttccgtgattttcagtttcctcgccatattccaggtcctacagtgtgcatttctcatttttcacgtttttcagtgatttcgtcatttttcaagtcgtcaagtggatgtttctcattttccatgattttcagttttcttgccatattccatgtcctacagtggacatttctaaattttccacctttttctgttttcctcgccatatttcacgtcctaaagtgtgtatttctcattttccgtgattttcagttttcttgccatattccaggtcctacagtgtgcatttctcatttatcacgtttttcactgattttgtcatttttcaagttgtcaactgcatgtttctcattttccatgattttcagttttcttgctatattccatgtcctacagtggaatattctaaattttccacctttttcagttttcctcgccatatttcacgtcctgaagtgtgtatttctcattttccgtgattttcagttttctcgccatattccaggtcctatgtgtacatttctcatttttcacgtttttcagtgattttgtcatttttcaagttgtgaagtggatgtttctcatttttcttgattttcatttttcttgccatattccatgtcctacagtggaaatttctaaattttccacctttttcagttttcctcgccatatttcacgtcctaaagtgtgaatttctcattttccgtgattttcagttttctcgccatattccaggtcctacagtgtgcatttctcatttttcacgtttttcagtgatttcgacatttttcaagttgtcaagtggatgtttctcattttccatgattttcagctttcttgccatattcaaagtcctacagtggacatttctaaattttcgacctttatcagttttcctcgccatatttcatgtcccaaagtgtgtacttctcattttccgtgattttgagtttcctcgccatattccaggtcctacagtgtgcatttctcatttttcacgtttttcagtgatttcgtcttttttcaagttgtcaactgcatgtttctcattttccatgattttcagttttcttgccatattccatgtcctacagtggaaatttgtaaatttccacctttttcagttttcctcgccatatttcacgtcctaaagtatgtatttctcattttccgtgattttcagttttctcgccatattccaggtcctacagtgtgcatttctcatttttcacgtttttcagtgattttgtcattttttaagttttcaagtggatgtttctcattttccttgattttcagttttcttgccatattccatgtcctacagtggacatttctaaattttccacctttttcagttttcctcgccatatttcatgtcctaaagtgtgtatttctcattttcagtgattttcagttttctcgccatattccaggtcctacagtgtgcatttctcatttttcacgtttttcagtgatttcgtcatttttcaaggtgtcaagtggatgtttctcattttccatgattttcagttttcttgccatattccatgtcctacagtggacatttctaaattttccacctttttctgttttcctcgccatatttcatgtcctaaagtgtgtatttctcattttccgtgattttcagttttcttgctatattccaagtcctacagtgtgcatttctcatttttcacgtttttcagtgattttgtcatttttcaatttgtcaactgcatgtttctcattttccatgattttcagtttttttgccatattccatgtcctactgtggaaatttctatattttccacctttttcagttttcctcgccatatttcacgtgctaaagtgtgtatttctcatttttcgtgtttttcaggtttctcgccatattccaggtcctacagtgtgcatttctcatttttcacgtttttcagtgattttgtcatttttcaagttttcaagtggatgtttctcattttccttgattttcagttttcttgccatattccatgtcctacagtggacatttctaaattttccacctttttcagttttccttgccatatttcatgtcctaaagtgtgtatttctcattttcagtgattttcagtttccttgccatattccaggtcctacagtgtgcatttctcattttttcacgtttttcagtgatttcgtcatttttcacgttgtcaagtggatgtttctcattttccatgattttcacttttcttgccatatttcatgtcctacagtggacatttctaaattttccaactttttcaattttcctcgccatattttatgtcctaaagtgtgtatttctcatttttcgttattttcagttttcttgccatattccaggtcctacagtgtgcatttgtcatttttcacgtttttcagtgatttcgtcatttttcaagtcgtcaagtagatgtttctcatattccatgtttttcagttttctcgccatattccaggtcctacagttgacatttctaaattttctacatttttaaattttcctcgccatatttcacgtcctaaagtgtgtatttctcattttttgttattttcagttttctagccatattccaggtcctacaggatgcatttctcatttttcacgtttttcagtgatttcatcatttttcaagtcgtcaagtgtatgtttcttattttcaatgattttcatttttcttgccttattccacgtcctatagtggacatttctaaattttccacctttttcagtttttttcgccatatttcacgtcctaaagtgtgtatttctcattttctgtgattttcagttttctcaccatattccaggtcctacagtgtgcatttctcatttttcacgtttttcagtgatttcgtcatttttcaagttgtcaagtggaagtttctcattttccatgattttcagctttctagacatattccaggtcctacagtggacatttcctaattttcgacctttatcagttttcctcgtcatatttcacgtcccaaaatgtgtatttcttattttccatgattttcagtttcctcgccatattccaggtcctacagtgtgcaattctcatttttcacgtttttcagtgatttcgtcttttttcaagacgtcaagtggatgtttctcatttttcatgattttcagttttcttgccatattccatgtcctacagtggacatttctaaattttccacctttttctgttttcctcgccatatttcacgtcctaaagtgtgtatttctcattttccgtgattttcagttttcttgccatattcctggtcctacagtgtgcatttctcatttttcacgtttttcagtgattttgtcatttttcaatttgtcaactgcatgtttctcattttccattattttcagttttcttgccatattccatgtcctacagtggacatttctaaattttccacctttttctgttttcctcgccatatttcatgtcctaaagtgtgtatttctcattttccgtgattttcagttttcttgctatattccaagtcctacagtgtgcatttctcatttttcacgtttttcagtgattttgtcatttttcaatttgtcaactgcatgtttctcattttccatgattttcagtttttttgccatattccatgtcctacaggggaaatttctatattttccacctttttcagttttcctcgccatatttcatgtcctaaagtgtgtatttctcattttccgtgattttcagttttcttgccatattccaggtcctacagtgtgcatttctcatttttcacgtttttcagtgatttcgtcatttttcaagtcttcaagtagatgtttctcatattccatgtttttcagttttctcgccatattccaggtcctacagttgacatttctaaattttctacatttttaaattttcctcgccatatttcacgtcctaaagtgtgtatttctcatttttcgttattttcagttttctagccatattccaggtcctacaggatgcatttctcatttttcacgtttttcagtgatttcatcatttttcaagtcgtcaagtgtatgtttctcattttcaatgattttcatttttcttgccttattccacgtcctatagtggacatttctaaattttccacctttttcagtttttctcgccatatttcacgtcctaaagtgtgtatttctcattttctgtgattttcagttttctcaccatattccaggtcctacagtgtgcatttctcatttttcacgtttttcagtgatttcgtcatttttcaagttgtcaagtggaagtttctcattttccatgattttcagctttctagccatattccaggtcctacagtggacatttcctaattttcgacctttatcagttttcctcgccatatttcacgtcctaaagtgtgtatttctcattttccgtgattttcagttttcttgccatattccaggtcctacagtgtgcatttctcatttttcacgtttttcagtgattttgtcatttttcaatttgtcaactgcatgtttctcattttccatgatttttagttttcttgctatattccatgtcctacagtggaaatttctaaattttccacctttttcagttttcctcgccatatttcacgtcctaaagtgtgtatttctcattttccgtgattttcagttttcttgctatattccaagtcctacattgtgcatttctcatttttcacgtttttcagtgattttgtcatttttcaatttgtcaaaccacatgtttctcattttccatgattttcagtttttttgccatattccatgtcctacagtggaaatttctatattttccacctttttcagttttcctcgccatatttcacgtgctaaagtgtgtatttctcatttttcgtgtttttcaggtttctcgccatattccaggtcctacagtgtgcatttctcatttttcacgtttttcagtgattttgtcatttttcaagttgtcaagtggatgtttcccattttccttgattttcagttttcttaccatattccatgtcctacagtggacatttctaaattttccacctttttcagttttccttgccatatttcatgtcctaaagtgtgtatttctcattttcagtgattttcagtttcctcgccatattccaggtcctacagtgtgcatttctcattttttcacgtttttcagtgatttcgtcatttttcacgttgtcaagtggatgtttctcattttccatgattttcacttttcttgccatatttcatgtcctatagtggacatttctaaattttccacctttttcagtttttctcgccatatttcacgtcctaaagtgtgtatttctcattttctgtgattttcagttttctcaccatattccaggtcctacagtgtgcatttctcatttttcacgtttttcagtgatttcgtcatttttcaagtcgtcaagtagatgtttctcatattccatgtttttcagttttctcgccatattccaggtcctacagttgacatttctaaattttctacatttttaaattttcctcgccatatttcacgtcctaaagtgtgtatttctcatttttcgttattttcagttttctagccatattccaggtcctacaggatgcatttctcatttttcacgtttttcagtgatttcatcatttttcaagtcgtcaagtgtatgtttcttattttcaatgattttcatttttcttgccttattccacgtcctatagtggacatttctaaattttccaccttttttcagtttttctcgccatatttcacgtcctaaagtgtgtatttctcattttctgtgattatcagttttctcaccatattccaggtcctacagtgtgcatttctcatttttcacgtttttcagtgatttcgtcatttttcaagttgtcaagtggaagtttctcattttccatgattttcagctttctagccatattccaggtcctacagtggacatttcctaattttcgacctttatcagttttcctcgccatatttcacgtcccaaaatgtgtatttcttattttccatgattttcagtttcctcgccatattccaggtcctacagtgtgcatttctcatttttcacgtttttcagtgatttcgtcttttttcaagacgtcaagtggatgtttctcatttttcatgattttcagttttcttgccatattccatgtcctacagtggacatttctaaattttccacctttttctgttttcctcgccatatttcacgtcctaaagtgtgtatttctcattttccgtgattttcagttttcttgccatattcctggtcctacagtgtgcatttctcatttttcacgtttttcagtgattttgtcatttttcaatttgtcaactgcatgtttctcattttccatgattttcagttttcttgccatattccatgtcctacagtggacatttctaaattttccacctttttcagttttcctcgccatatttcacgtgctaaagtgtgtatttctcatttttcgtgtttttcaggtttctcgccatattccaggtcctacagtgtgcatttctcatttttcacgtttttcagtgattttgtcatttttcaagttgtcaagtggatgtttctcattttccttgattttcacttttcttgccatattccaagtcttacaggggcatttctcatttttcacgttttcagtgattttgtcattttcaatttgtcaactgcatgtttctcattttccatgattttcagtttttttgccatattccatgtcctacaggggaaatttctatattttccacctttttcagttttcctcgccatatttcatgtcctaaagtgtgtatttctcattttccgtgattttcagttttcttgccatattccaggtcctacagtgtgcatttctcatttttcacgtttttcagtgatttcgtcatttttcaagtcttcaagtagatgtttctcatattccatgtttttcagttttctcgccatattccaggtcctacagttgacatttctaaattttctacatttttaaattttcctcgccatatttcacgtcctaaagtgtgtatttctcatttttcgttattttcagttttctagccatattccaggtcctacaggatgcatttctcatttttcacgtttttcagtgatttcatcatttttcaagtcgtcaagtgtatgtttctcattttcaatgattttcatttttcttgccttattccacgtcctatagtggacatttctaaattttccacctttttcagtttttctcgccatatttcacgtcctaaagtgtgtatttctcattttctgtgattttcagttttctcaccatattccaggtcctacagtgtgcatttctcatttttcacgtttttcagtgatttcgtcatttttcaagttgtcaagtggaagtttctcattttccatgattttcagctttctagccatattccaagtcctacagtggacatttcctaattttcgacctttatcagttttcctcgccatatttcacgtcccaaaatgtgtattccttattttccatgattttcagtttcctcgccatattccaggtcctacagtgtgcatttatcatttttcacgtttttcagtgatttcgtcttttttcaagacgtcaagtggatgtttctcatttttcatgattttcagttttcttgccatattccatgtcctacagtggacatttctaaattttccacctttttctgttttcctcgccatatttcacgtcctaaagtgtgtatttctcattttccgtgattttcagttttcttgccatattcctggtcctacagtgtgcatttctcatttttcacgtttttcagtgattttgtcatttttcaagttgtcaagtggatgtttctcattttccttgattttcacttttcttgccatattccatgtcctacagtggacatttctatattttccacctttttccgttttccttgccatatttcacgtcctaaagtgtgtatttctcattttccgtgattttcaggtttctcgccatattccaggtcctacagtgtgcatttctcatttttcacgtttttcagtgattttgtcatttttcaagttgtcaagtggatgtttctcattttccttgattttcacttttcttgccatattccatgtcctacagtggacatttctaaattttccacctttttcagttttcctcgccatatttcatgtcctaaagtgtgtatttctcattttcagtgattttcagttttcttgccatattccaggtcctacagtgtgcatttctcatttttcacgtttttcagtgattttgtcatttttcaagttgtcaactgcatgtttctcattttctatgattttcagttttcttgctatattccatgtcctacagtggaaatttctaaattttccacctttttcagttttcctcgccatatttcacgtcctaaagtgtgtatttctcattttccgtgattttcagttttctcgccatattccaggtcctatgtgtacatttctcatttttcacgtttttcagtgattttgtcatttttcaagttgtgaagtggatgtttctcatttttcttgattttcatttttcttgccatattccatgtcctagagtggaaatttttaaattttccacctttttcagttttcctcgccatatttcacgtcctaaagtgtgaatttctcattttccgtgattttcagatttctcgccatattccaagtcctacagtgtgcatttctcatttttcacgtttttcagtgatttcgtcatttttcaagttgtcaagtggatgtttctcattttccatgattttcagctttcttgccatattcaaagtcctacagtggacatttctaaattttcgacctttatcagttttcctcgccatatttcatgtcccaaagtgtgtacttctcattttccgtgattttcagtttcctcgccatattctaggtcctacagtgtgcatttctcatttttcaggtttttcagtgatttcgtcttttttcaagtcgtcaagtggatgtttctcattttccatgattttcacttttcttgccatatttcatgtcctaaagtgtgtatttctcattttcagtgattttcagttttctcgctatattccaggtcctacagtgtgcatttctcattttttcacgtttttcagtgatttcgtcatttttcacgttgtcaagtggatgtttctcattttccatgattttcacttttcttgccatatttcatgtcctacagtggacatttctaaattttccacctttttctgttttcctcgccatatttcacatcctaaagtgtgtatttctcattttccgtgattttcagttttcttgccatattccaggtcctacagtgtgcatttctcatttttcacgtttttcagtgatttcgtcatttttcaagttgtcaagtggatgtttctcattttccttgattttcagttttcttgccatattccatgtcctactgtggacatttctaaattttccacctttttcagttttccttgccatatttcatgtcctaaagtgtgtatttctcattttcagtgattttcagttttctcgcaatattccaggtcctacagtgtgcatttctcattttttcaggtttttcagtgatttcgtcatttttcacgttgtcaagtggatgtttctcattttccatgattttcacttttcttgccatatttcatgtcctaaagtgtgtatttctcattttcagtgattttcagttttcctcgccatatttcacgtcccaaaatgtgtatttcttattttccatgattttcagtttcctcgccatattccaggtcctacagtgtgcatttctcatttttcacgtttttcagtgatttcgtcttttttcaagacgtcaagtggatgtttctcatttttcatgattttcagttttcttgccatattccatgtcctacagtggacatttctaaattttccacctttttctgttttcctcgccatatttcacgtcctaaagtgtgtatttctcattttccgtgattttcagttttcttgccatattcctggtcctacagtgtgcatttctcatttttcacgtttttcagtgattttgtcatttttcaatttgtcaactgcatgtttctcattttccatgattttcagttttcttgccatattccatgtcctacagtggacatttctaaattttccacctttttcagttttcctcgccatatttcacgtgctaaagtgtgtatttctcatttttcgtgtttttcaggtttctcgccatattccaggtcctacagtgtgcatttctcatttttcacgtttttcagtgattttgtcatttttcaagttgtcaagtggatgtttctcattttccttgattttcacttttcttgccatattccatgtcctacagtggacatttctaaattttccacctttttcagttttcctcgccatatttcatgtcctaaagtgtgtatttctcattttcagtgattttcagttttctcgccatattccaggtcctacagtgtgcatttctcatttttcacgtttttcagtgatttcgtcttttttcaagacgtcaagtggatgtttctcattttccatgattttcagttttcttgccatattccatgtcctacagtggacatttctaaattttccacctttttctgttttcctcgccatatttcacgtcctaaagtgtgtatttctcattttccgtgattttcagttttcttgccatattccaggtcctacagtgtgcatttctcatttttcacgtttttcagtgattttgtcatttttcaatttgtcaactgcatgtttctcattttccatgatttttagttttcttgctatattccatgtcctacagtggaaatttctaaattttccacctttttcagttttcctcgccatatttcacgtcctaaagtgtgtatttctcattttccgtgattttcagttttcttgctatattccaagtcctacattgtgcatttctcatttttcacgtttttcagtgattttgtcatttttcaatttgtcaaaccacatgtttctcattttccatgattttcagtttttttgccatattccatgtcctacagtggaaatttctatattttccacctttttcagttttcctcgccatatttcacgtgctaaagtgtgtatttctcatttttcgtgtttttcaggtttctcgccatattccaggtcctacagtgtgcatttctcatttttcacgtttttctgtgattttgtcatttttcaagttgtcaagtggatgtttctcattttccttgattttcagttttcttaccatattccatgtcctacagtggacatttctaaattttccaccttttctgttttcctcgccatatttcatgtcctaaagtgtgtatttctcattttccgtgattttcatttttcttgctatattccaagtcctacagtgtgcatttctcattttccatgattttcagttttcttgctatattccatgtcctacagtggaaatttctaaattttccacctttttcagttttcctcgccatatttcacgtcctaaagtgtgtatttctcattttccgtgattttcagttttttcgccatattacaggtcctatgtgtacatttctcatttttcacgtttttcagtgattttgtcatttttcaagttgtcaagtggatgtttctcatttttcttgattttcatttttcttgccatattccatgtcctacagtggaaatttctaaattttccacctttttcagttttcctcgccatatttcacgtcctaaagtgtgaatttctcattttccgtgattttcagttttctcgccatattccaggtctacagtgtgcatttctcatttttcacgttttcagtgattcgtcatttttcaagttgacaagtggatgtttctcattttccatgattttcagctttcttgccatattcaaagtcctacagtggacatttctaaattttcgacctttatcagttttcctcgccatatttcatgtcccaaagtgtgtacttctcattttccgtgattttcagttttcttgccatattccaagtcctacagtgtgcatttctcatttttcacgtttttcagtgattttgtcatttttcaatttgtcaactgcatgtttctcattttccatgattttcagttttcttgccatattccatgtcctacagtggaaatttctatattttccacctttttcagttttcctcgccatatttcacgtgctaaagtgtgtatttctcatttttcgtgtttttcaggtttctcgccatattccaggtcctacagtgtgcatttctcatttttcacgtttttcagtgattttgtcatttttcaagttgtcaagtggatgtttctcattttcaatgattttcatttttcttgccttattccacgtcctatagtggacatttctaaattttccacctttttcagtttttctcgccatatttcacgtcccaaaatgtgtattccttattttccatgattttcagtttcctcgccatattccaggtcctacagtgtgcatttctcatttttcacgtttttcagtgatttcgtcttttttcaagacgtcaagtggatgtttctcatttttcatgattttcagttttcttgccatattccctgtcctacagtggacatttctaaattttccacctttttctgttttcctcgccatatttcacgtcctaaagtgtgtatttctcattttccgtgattttcagttttctcgccagattccaggtcctacagtgtgcatttctcatttttcacgtttttcagtgattttgtcatttttcaatttgtcaactgcatgtttctctctttccatgattttcagttttcttgccatattccatgtcctacagtggacatttctaaattttccacctttttcagttttcctcgccatatttcacgtgctaaagtgtgtatttctcatttttcgtgtttttcaggtttctcgccatattccaggtcctacagtgtgcatttctcatttttcacgtttttcagtgattttgtcatttttcaagttgtcaagtggatgtttctcattttcaatgattttcatttttcttaccttattccacgtcctatagtggacatttctaaattttccacctttttcagtttttctcgccatatttcacgtcccaaaatgtgtattccttattttccatgattttcagtttcctcgccatattccaggtcctacagtgtgcatttctcatttttcacgtttttcagtgatttcgtcttttttcaagacgtcaagtggatgtttctcatttttcatgattttcagttttcttgccatattccctgtcctacagtggacatttctaaattttccacctttttctgttttcctcgccatatttcacgtcctaaagtgtgtatttctcattttccgtgattttcagttttctcgccagattccaggtcctacagtgtgcatttctcatttttcacgtttttcagtgatttcgtcatttttcaagtcttcaagtgtatgtttctcattttcaatgattttcatttttcttgccttattccacgtcctatagtggacatttctaaattttccacctttttcagtttttctcgccatatttcacgtcctaaagtgtgtatttctcattttctgtgattttcagttttcttaccatattccaggtcctacagtgtgcatttctcatttttcacgtttttcagtgatttcgtcatttttcaagttgtcaagtggaagtttctcattttccatgattttcagctttctagccatattccaggtattacagtggacatttccttattttcgacctttatcagttttcctcgccatatttcatgtcctaaagtgtgt	38399	1554	4%	7300	19%
9	4238701	4239150	gacgagaaaacccaggacgagaagacctgggacgagaaaatccgggaagaaaaaacccgggaaaagaaacatcttcaggcacgagcgaagaccccctgctacagggaggattcagaactgcatcacggggaaggagtggttaataaaagttcccgtaaaacagactgttgagaaggatctggcgtggattcagaactcttcagctggggaacggtactgatgaagagaaagaagaaagatgaggacggagtaaactgctgttagaaggactggtggtcgcgtcgttcttgctggtcgagagcgggcgtgacaattggtggcccgtacggggaaccgactcccccaccgagttcagaactttcagcagtcagtggttgccggcagggtaagttcacggtgagtgaaacttgcgaccccaggagtttaggaaggacctcggataaaataga	449	52	12%	40	9%
9	4492501	4492650	tatgcggagcccccgccctgcgtagtgcgtcagccctgcgcagagagacaatgcgcagagaggcaatgcgcagactcattcattcccagagaggaacaaaggaaaatacaacaggcatttccggtctttgaaggagccgagggtgggcg	149	20	13%	26	17%
9	7300501	7301100	aagctgtgttgctttggccaggaaggtggccggccgtctggagccgaagatggcgccgcctcagaagctttgtggctctcgccaggaaggtggtcggttgtctggagccgaagatggcgccgccccagaagctctgcgactctcgcctgtaccagaaacagctggcctctgtattccacacggtcacccgtgcagcctgccctccgcggagtcccggagccaagaaggctcccgccggcgcctgtgacacaaacctctcaggctgggcagacccccgtgctctcacccggaaggtggccggctgtctggagctgaagatggcgccgccccagaagctctgtggctctcgcctggaaggtggccggttgtctggagccgaagatggcgccgccccagaagctctgcgactctcgcccgtcccagaaacggctggcctctgtattccacacggtctcccgtgcagcctgccctccgcggagtcccagagccaagaaggctcccgccggcgcctgtgacacaaacctctcaggccgggcagaccccagtgctctcaccaggaaggtggccggctgtctggagctgaagatggcaccacctca	599	86	14%	68	11%
9	7374151	7374300	ttagcactgactccatagttacggaccgactcggcaagctctttaatctgtatatacgctaccggagcgtggacacgcccaccctcggctccttcaaagaccggaaatgcctgttgtattttcctttgttcctcctttggaatgaacga	149	20	13%	12	8%
9	11554201	11554800	cagggagtgatacgtcctaggcgaaggataactctcctaaatagggacggggtttcgctttcgtttttgggtttgagttttgcactcttgctcctgaagatgtaagcaataaagttttgccgcagaagattctggtttgttgtgtctttcctggccggtcgtgagaacgcgtgtaagagttggtgccgaaatccgggacgagaaaatccgggaagaaaaaacccgggacaagaaaactcgggacgggagttaaccatcaccggcgcaaggaagatccctcattccggaaccagaactgcgggttatggtaatgaaggttcccgtaaaacagactgttgagaaggattcaactgcgtgaattcagaactcttcagctggggaacagggtacccgtaagtatagctttacaaggtaagtctggtcttgaactttctaacgaaattcaagacagtctatcagaagtaaagtgggaaatagctttacaaggtacgcctggccttgaactttctaacaaaattcaagacagtctatcagaagtaaagtgggaaatagctttacaaggtatgtttgaccttgaactttttctagtgttaggagcc	599	52	9%	50	8%
9	11632501	11633100	agtgttgggagccgcccccacattcgccgtcacaagatggcgctgacatcctgtgttctaagtggtaaacaaataatctgcgcatgtgccaagggtattttacgactacttgtactctgcctttcccgtgacgtcagctcggccatgggctgcagccaatcagggagtgatgcgtcctaagcgaaggataactcctccttaaaggggacggggtttccgccattctctctctggctctggcgcctgctcgcttgctcctaaagatgtaaacaatagagcgcgctctgcgctttggcgcgccggagctctggctcctaaagatgtaagattggggtggctttcgcttttggggctgggggtttgcgctcctggctcctgaagatgtaagcaataaagttttgccgcagaagattctggtttgttgtgttctttcctggccgggggcgtgagaacgctattaagaattggtgccgaattccgggacgagaaattccgggacgagaaattccgggacgagaaaacccgggacgagaaaaccccgggaagagaaaacctgggacgaaaattaccatcaccggcgcaaggaagatccctcattc	599	80	13%	42	7%
9	11633701	11634150	gcagcccattaccagccagctaattggtcaagaaaaaagccaaaagcggctggcgaaagccagcgtactgttcaacctccgggcagtcggtttcaaggtccgccctatgcggagcccccgccctgcgtagtgcgtcagcaatgcgcagagaggcagtgcgcagagaggcagtgcgcagagaggcagtgcgcagactcattcattcccagagaggaacaaaggaaaatacaacaggcatttccagtctttgaaggagccgagggtgggcgtgtccacgctccggtagaatacgtacagattaaagaactcgccgagtcggtccgtaaatacggaaccaatgctaattttaccttggtgcagttagacaggctcgccggcatggcactaactcctgctgactggcaaacgattgtaaaagccgctctccctagtatgggcaaatatatgga	449	56	12%	72	16%
9	12472801	12472950	gtactctcgttccccagctgaaaagttctgaattcatacagttgaatccttcttaacagtctgctttacgggaacctttattaccgcgacccgcagttctggttctggaatgagggatcttccttgcgccagtcccgagttttttctcg	149	16	11%	12	8%
9	16947751	16948350	ggggagatataaacaggggagatataaacaagggagatataaacaagggagatatggagaaagaagaaacaggactgaataaacgtgtgcagaaggatcctgtagcagcgtcgttcttcctggccagttgagcgcgcgtaacaGttggtgccgaaacccgggaagaaaagacccgggacgagaaaacccgggacgagaagacctgggacgagaaatcctgggaaaagaaacatcttcaggcatgagcgaagaccccctgctacagggaggattcagaactgcatcacagggaagaaggggttaataaaggttcccataaaacagactgttgagaaggatccagcgtggattcagaactcttcagctggggaacggtactgatgaagagaaagaagaaagatgaagactgaataaactgctgttagaaggactggtggtcgtgtcgttcttgctggtcgagagcaggcgcgacaattggtggcccgtacggggaaccgactcccccaccgagttcagaactttcagcagtcagtggttgccggcagggtaagttcacggtgagtgaaacttgggaccccaggagtttgggaaggacctca	599	54	9%	64	11%
9	19017451	19017750	aatctgcacatattctaccggagcatggacacgcccaccctcggctccttcaaacactggaaatgcctgttgcattttcctttgttcctctctaggaatgaacgagtctgcacattgcctctctgtccattgcctctctgcgcagggctgacgccttacgcagggcgggggctccgcatagggcggaagtgcactatgaccttgaagccgactgcccggaggccgagcagcacactggccttcgccagccgcttttggctttttccttaactgattagctagcattttatctggctggt	299	30	10%	40	13%
9	19159951	19160400	tgtggaatacagagtgccagccatttctgggacgggcgagagtcgcagagcttctgggcggcgccatcttcagctccagacagccggccaccttcctggtgagagcacgggggtctgcccggcctgagaggtttgtggcacaggcgccggcgggagccttcttggctccgggactccgcggagggcaggctgcacgggtgaccgtgtggaatacagagtgccagccgtttctgggacgggcgagagtcgcagagcttctgggcggcgccatcttcagctccagatagccggccaccttcctggtgagagcacgggggtctgcccggcctgagaggtttgtggcacaggcgccggcgggagccttcttggctccgggactccgcggagggcaggctgcacgggtgaccgtgtggaatacagagtgccagccgtttctgggacgggcgaga	449	72	16%	56	12%
9	19214851	19215000	gtacaaccactctggaaaactcttaaacgcgttctcacgaccggccaggaagaacacaacaaaccagaatcttctgcggcaaaactttattgcttacatcttcaggagcaggagcgcaagccccaagccccaaaaacgaaaggcccccc	149	14	9%	30	20%
9	19868701	19869300	acaaaccagaatcttccacagcaagagctttattgcttgtttctcaggaagatcccgaaccgggaaaatggcgctgcttttataacccgcagcatgacgtttcagcacctgatatggcgtgacagctcctggttcgttgcttgcccatcaccccactattacaccccgagaatgggagtgactaggagtgaattcactctcgcacctgcgtacaaggcttgtttactagttaggcacagcggaggcccgccccatcttataatggcgattgctcgcggcacacacgactctcctcagagattactggcagcacgcacgcgattgctcggagcaagtaccgtctctccacagggtatagtagctgggtctggcatttgcgttctcttagggtctgtataacatctgtcagggatcatctggctttcataacctcttgtgagaagtctggtgtacttctaataggccagcgtttatatattacttgacctttttcccttactacttttaatattctatctttatttagtgcatttggtgttttgattattatgtgtcaggaggaatttcttttctggtccagtctatttggagttctgtag	599	46	8%	80	13%
9	19905601	19906650	taaacaaataatctgcgcatgtgccaagggtattttacgactacttgtactctgcctttcccgtgaacgtcagctcggccatgggctgcagccaatcagggagtgatgcgtcctaagcgaaggataactcctccttaaaggggacggggtttccgccattctctcttacttgcgttctctctcttgctctgcgcgccggcgctctggctcctaaagatgtaaacaatagagcgcgctctgcgctttggcgcgccggagctctggctcctaaagatgtaagaagggggctttcgtttttggggcttggggttttgcgctcctgctcctgaagatgtaagcaataaagttttgccgcagaagattctggtttgttgtgttctttcctggccgggcgtgagaacgcatgtaagattcaccctaggtcatttagtagttactgtcacatatcactgtggtatccagagacgggcaactttccttatgcacagatcaacctaagacacggggccggtggcgatagggttaccctatgacaggaaaggctgtgacattggaggaacgacctaagacaggagccacagcggatgggcataattacacaggcctagaccagcctcaaattttaataaaataaaaagggggagatgtggagagccgtgccgtgagcaatcgccattataagatggcgctggccttctgctgtgcctaactagtaaacaagccttgtacgcaggtgcgagagtgaactcactcctagtcactcccattctcggggtgtaatagtggggtgatgggcgagcaacgaatcaggagctgtcacgccatatcaggtggtgaaacgtcacactgcgggttataaaagtggcgccattttcctgtttcggggtcttcctgaagaagtaagcaataaagcttttgccacagaagattccggtttgttgcgtctttcttgccggtcgagtgggacgtaataCATGTGCACAATTTTATTCTTTGCAATAAATGAATTTTAAGTTTCTAATCTAAGTGGTCTGAGAGGGGGCAAGTGC	1049	102	10%	114	11%
9	20967601	20967900	TTCCCTCTCCGCCAGCACTGCAGGGGCCGCAGCACCTCCCTCCGAAGGTCCCGGCTACGCCACGTATAGATGACAGGATTGAGCAGTGAGTTAAGGGTGGCAAAGGCAAAAAAATAGTGGGCTTTGTAGAGGACAGGGCAGGCCCGAACGGGACAGGTGGAGTCTAAGAGAAGGATGCTAAAAGCCGGCAGCCAGCAGATGATGAAAACACCCAGTACGATGGTGACCGTCTTGAGCAGGGCTAGCGTCTGAGGACCAGCAACATCCGCGTGGCTGGAGCGGACTACAAAGTAGATTCG	299	32	11%	46	15%
9	21078001	21078150	gaatgtgtgtgcgagactctatatatgtgtgtaagactgtgtgtgcatgtgtgtgtgagactctatatatgtgtgtgagactgtatgtatagatgtgtgtgcatgtgtgtgtgagactatatatgtgtgtgagactgtgtgtgcatgtg	149	2	1%	6	4%
9	21521251	21521550	gaactcggtgggggagtcggttccccgtacgggccaccaattgtcgcgcctgctctcgaccagcaagaacgatgcgaccaccagtccttctaacagcagtttattccgtcttcatctttcttctttctcttcatcagtaccgttccccagctgaagagttctgaatccatgccggatccttctcaacagtctgttttacgggaacctttattaaccccttcttccccgtgatgcagttctgaatcctccctgtagcagggggtcttcgctcttgcctgaagatgtttcttttcccgggt	299	32	11%	34	11%
9	21793501	21793950	taaatacatgtgtatatgtgtgtgtgcacgcatgagtatgaatgtatgaatacatgtgtgtatgtgtgtgtgcatgcatgagtgtgaatgtgtaaatacatgtgtatatgtgtgtgtgcacgcatgagtatgaatgtgtgaatacatgtgtatatgtgtgtgtgcacgcatgagtatgaatgtgtaaatacatgtgtatatgtgtgtgcatgcatgagtgtgaatgtgtaaatacatgtgtatatgtgtgtgcacgcatgagtgtgaatgtgtaaatacatgtgtatgtgtgtgtgtgcacgcatgagtgtgaatgtgtaaatacatgtgtatgtgtatgtgtgcacacatgagtgtgaatgtgtatgtatgcatgtgcgtgtgtactatgtgtgtactatgtgcatatgtgtttaggccagaggtaaacagaggtggtgctcttcagg	449	12	3%	60	13%
9	21879151	21879300	tgctctacagtgtgcgtccctcatataccttgttTtgttgggagccgcgcccacattcgccgttacaagatggcgctgacagctgtgttctaagtggtaaacaaataaactgcgcatatgccgagggtggttctccactccatgtgctc	149	16	11%	20	13%
9	21921751	21922650	gcaggtgcaggtgatcataggtgtgcaacacgtgctcgcaggtgcatgttaccataggtgtacaacatgtgctcgcaggtgcaggtgatcataagtgtgcaacacgtgcttgcaggtgatcataggtgtgtaacacgtgctcgcaggtgcaggtgatcataagtgtgcaacacgtgcttgaaggtgatcataggtgtgtaacacgtgctcgcaggtgcatgtgaccataggtgtacaaaacgtgctcgcaggtgcatgtgatcataagtgtgcaacacgtgcttgcaggtgcaggtgattataggtgtgcaacacgtgctcgcaggtgcaggtgaccatatgtgtgcaacacgtgctcgcaggtgcatgtgatcataggtgtgcaacacgtgctcgcaggtgcatgtgatcataggtgtgtaacacgtgctcgcaggtacatgtgatcataggtatgcaacacgtgctcgcaggtgcatgtgatcataggtgtgtaacacgtgctcgcaggtacatgagatcataggtgtgcaacacgtgctcgcaggtgcatgtgatcataggtgtgcaacacgtgctcgcaggtacatgtgatcataggtgtgcaacacgtgctcgcaggtgcatgtgatcataggtgtgcaacacgtgctcgcaggtacatgtgatcataggtatgcaacacgtgctcgcaggtgcatgtgatcataggtgtgtaacacgtgctcgcaggtacatgtgatcataggtgtgcaacacgtgctcgcaggtgcatgtgatcataggtgtgcaacacgtgctcgcaggtacatgtgatcataggtgtgcaacacgtgcttgcaggtgcatgtgatcataggtgtataacacgtgctcgcaggtacatgtgatcataggtg	899	86	10%	224	25%
9	22183051	22183350	tgcgcttgtgcagcttcgtgccaaagcgctctccattccatatatttgcccatactagggagagcggcttttacaaccgtttgccagtcggcaggagttagtgccatgccggcaagcctgtctaactgcaccaaggtaaaattagcattggttccgtatttacggaccgactcggcaagttctttaatttgtaagtattctaccggagcgtggacacgcccaccctcggctccttcaaagaccggaaatgcctgttgtattttcctttgttcctctctgggaatgaatgagtctgcgca	299	34	11%	36	12%
9	22183951	22184550	tctaacactagaaaaaattcaaggccaaacattttccactttacttctgatagactgtcttgaatttccttagaaagttcaaggccaggcttacctcgtaaagctgtactcactggtactctcgttccccagctgaaaagttctgaattcatgcagttgaatccttcttaacagtctgctttacgggaacctttattaccgcgacccgcagttctggttctggaatgagggatcttccttgcaccggtgatggtaaactctcgtcccgagttttttctcgtcccggaattcggcaccaattgttattaacgcgttctcacgcccggccaggaagaacacagcaaaccagaatcttctgcggcaaaactttattgcttacatcttcaggagcaagagtgtaagaagcaagagagagagaaaacgaaaccccgtccctattaaggagaattatccttcgcctaggacgtgtcactccctgattggctgcagcccatcggccgagttgacgtcacggggaaggcagagcacatggagtggagaaccaccctcggcacatgcgcagattatttgtttaccacttagaacacagctgtcagcgc	599	56	9%	84	14%
9	24571801	24571950	aattccgggacgagaaattccgggacgagaaaaaaaactcgggactggcgcaaggaagatccctcattccagaaccagaactgcgggtcgcggtaataaaggttcccgtaaagcagactgttaagaaggattcaactgtatgaattcag	149	20	13%	14	9%
9	24572701	24572850	gttcattccaaaggaggaacaaaggaaaatacaacaggcatttccggtctttgaaggagccgagggtgggcgtgtccacgctccggtagcgtatatacagattaaagagcttgccgagtcggtccgtaactatggagtcagtgctaatt	149	18	12%	18	12%
9	25420201	25420350	cctatggtgagtggaacacagcgcctgccccaatccaatcgcgcggaacctgagactgcagtacatagggaagcaggctacccgggcctgatctggggcacaagtcccttctgctcgactcgagccccgggctaccttgccagcagagt	149	16	11%	22	15%
9	26101801	26102250	caaaagtccaatctctctgctctggagtcaaagcagctgcgtttgctcgggcctgcgcttgtgcagcttcgtgccaaagcgctctccattccatatatttgcccatactagggagagcggcttttacaaccgtttgccagtcagcaggagttagtgccatgccggcgagcctgtctaactgcaccaaggtaaaattagcattggttccgtatttacggaccgactcggcaatttctttaatttgtaagtattctaccggagcgtggacacgcccaccctcggctccttcaaagaccggaaatgcctgttgtattttcctttgttcctctctgggaatgaatgagtctgcgcactgcctctctgcgcactgcctctctgcgcatctctctgcgcattgctgacgcactacgcagggcgggggctccgcatagggcggaccttgaaaccga	449	56	12%	56	12%
9	26706451	26707800	ctctggagtcaaagcagctgcgtttgctcgggcctgcgcttgtgcagcttcgtgccaaagcgctctccattccatatatttgcccatactagggagagcggcttttacaaccgtttgccagtcggcaggagttagtgccatgccggcaagcctgtctaactgcaccaaggtaaaattagcattggttccgtatttacggaccgactcggcaatttctttaatttgtaagtattctaccggagcgtggacacgcccaccctcggctccttcaaagaccggaaatgcctgttgtattttcctttgttcctctctgggaatgaatgagtctgcgcactgcctctctgcgcactgcctctctgcgcatctctctgcgcattgcctctctgcgcattgctgacgcactacgcagggcggggactccgcatagggcggaccttgaagccgactgccctgaggccaatcagcaaactggccttcaccagccgcttttggcttccttaactgattagctagcactttacctggctggtacccttttttctcataatgagctgcttcttcctcccagtctgtttcctcagaggagaattcttcatctgcttcagagctactaagagctggcttcctgagctcatctagtgacgagtatctcctagagacctccgctaatcgatcttttttcttttcttttttcttttccttccttctaatctctccccaggtattcttacctgacctaaacttttcctcgggttcaagacccttggaaaggcctgtatacttattttgtgtaccatattttctctttgctcctactctctctccccgctttacttctgatagattgccctgaatttcatccagaatccgccctgccttaaccacttgataacatgtgaaaaggaacaaaagggcttctaacattagaaaaaattcaaggccaaacattttccactttacttctgatagactgtcttgaatttccttagaaagttcaagatcagacttacctcgtaaagctgtactcactggtactctcgttccccagctgaaaagttctgaattcatacagttgaatccttcttaacagtctgctttacgggaacctttattaccgcgacccgcagttctggttctggaatgagggatctttcttgcgccagtcccgagttttttctcgtcccggaattcggcaccaattgttattaaacgcgttctcacgaccggccaggaaagacgcaacaaaccagaatcttctgcggcaaagctttattgcttacatcttcaggagccagagtgcaagaagcaagagcgagagaaaacgaaaacccgtcccttttttaggagag	1349	112	8%	148	11%
9	27797251	27797850	agcacacacacacacacacacacacacacacacacacacacacacacacgtttgggtgtgctcatacatacactcacacacaGCCTTAGtgttgggagccgcgcccacattcgccgttacaagatggcgctgacagctgtgttctaagtggtaaacaaataatctgcgcatatgccgagggtggttctctactccatgtgctctgccttccccgtgacgtcaactcggccgatgggctgcagccaatcagggagtgacacgtcctaggcgaaggagaattctccttaatagggacggggtttcgttttctctcgctcttgcttcttgcactctggctcctgaagatgtaagcaataaagctttgccgcagaagattctggtttgttgcgtctttcctggccggtcgtgagaacgcgtctaataacaattggtgccgaattccgggacgagaaaaaactcgggactggcgcaaggaagatccctcattccagaaccagaactgcgggtcgcggtaataaaggttcccgtaaagcagactgttaagaaggattcaactgtatgaattcagaacttttcagctggggaacgagagtaccagt	599	66	11%	110	18%
9	27974551	27975000	gtaaacaaataatctgcgcatgtgccgagggtggttcttcactccatgtgctctgccttccccgtgacgtcaactcggccgatgggctgcagccaatcagggagtgacacgtcctaggcgaaatataactctcctaaaaaagggacggggtttcgttttctctctctcttgcttcttacactcttgctcctgaagatgtaagcaataaagttttgccgcagaagattctggtctgtggtgttcttcctggccgggcgtgagaacgcgtctaataacaattggtgccgaattccgggacgagaaaaaactcgggactggcgcaaggaagatccctcattccagaaccagaactgcgggtcgcggtaataaaggttcccgtaaagcagactgttaagaaggattcaactacatgaattcagaacttttcagctgggggaacgagagtacca	449	50	11%	46	10%
9	27975601	27975900	gcgtagtgcgtcagcaatgcgcagagaggcaatgcgcagagagatgcgcagagaggcaatgcgcagagagatgcgcagagaggcagtgcgcagagagatgcgcagagaggcagtgcgcagagaggcagtgcgcagagaggcagtgcgcagactcattcattcccagagaggaacaaaggaaaatacaacaggcatttccggtctttgaaggagccgagggtgggcgtgtccacgctccggtagaatacttacaaattaaagaaattgccgagtcggtccgtaaatacggaaccaatgct	299	42	14%	56	19%
9	30871951	30872250	gctggcaaggtagcccggggctcgagtggagcggaaggggtttgtgccccagatcaagcccgggtagcctgcttccctatgtaccgcagtctcaagttccccgcgattggattggggcaggcgctgtgttccactcaccagaggtcttagggtcccgtggggagtcccgtgtgggcccttgcgggtgttgggcaagactctgctggcaaggtagcccggggctcgagtctcgagtcgagcggaagggacttgtgccccagatcaggcccgggtagcctgcttccctatgtaccgcagtc	299	36	12%	28	9%
9	32286601	32287350	AGGGAAGGAAGAACAGGAAATATGAATTGAACTTTTTAAGAATGTAAATGATTTTTTATTTGTAGTACTGTTTTTGCAAATGTATGTGCATGTATGTATATGAATGCCTGTGCATGCCATGCGCATGTTGATGTATGTAGGTATGCCtgtgtgtgtgtctgtttgtgtgtctgtgtgtgtgtgtctgtgtttgtatgtgtgtgtgtgtgtgtgtctgtgtgtgtgtgtgtctctgtgtgtgtgtctgtgtgtgtgtgtgggtgtgtgagtgtgtgtgtgtgcctgtgtgtgtgtgcctgtgtgtgtgtctgtgtttgtatgtgtgtgtgtctgtgtgtgtgtgtctgtgtgtgtgtgtctgtgtatgtgtgtgtgtgtctgtgagtgtgtgtgtgcctgtgtgtgtgtctgtgtttgtgtgtctgtgtgtgtgtgtatgtgtttgtatgtgtgtgtgtctgtgtgtgtgtgtgtgtgtttgtgtgtgtgtgtgtgtgtgtgtgtgtgtgtgtgtgtgtgtgtgtgtgtgtgtgtgtgtgtgtgtgtgtgtgtgtgtgtgtgtgtgtgtgtgtgtgtgtgtgtgtgtgtgtgtgtgtgtgtgtgtgtgtctgtgtatgtgtgtgtgtgtctgtgagtgtgtgtgtgcctatgtgtgtgtctgtgtttgtatgtgtgtgtgtgtctgtgaatgtgcgtgtgcccgcgtgcacattctgctggtgggcgtcaggggatgctctggaatcagt	749	10	1%	20	3%
9	32354551	32354700	gtgtgtgtgagtgtgtgtgtgtgagagtgtgtgtgtgagtgtgtgtgtgagtgtgtgtgtgtgtgtgagtgtgtgtgtgtgtgtgtgtgtgtgtgtgtgtgtgtgtgtgtgtgtgtgtgtgtgtgtgtgtgtgtgtgtgtgtgtgtgcg	149	2	1%	0	0%
9	32355601	32356050	tgtgtgtgtgtgtgtgtgtgtgtgtgtgtgtgtgtgtgtgtgtgtgtgtgtgtgtgtgtgtgtgtgtgtgtgtgtgtgtgtgtgtgtgtgtgcgtgtgtgtgagcgtgtgtgtgtctgagtgtgtgtgtgtgtgtgagtgtgtgtgtgtgagagtgtgtgtgtgagtgtgtgtgtgtgagtgtgtgtgtgtgagtgtgtgtgtgtgtgagtgtgtgtgtgtgagtgtgtgtgtgtgtgagtgtgtgtgtgtgtgtgagtgtgtgtgtgtgtgagtgtgtgtgtgtgagtgtgtgagtgtgtgtgtgagtgtgtgtgtgtgagagagtgtgtgagtgtgtgtgtgtgagtgtgtgagtgtgtgagagtgtgtgtgtgtgtgtgtgtgtgagtgtgtgtgtgtgtgtgtgtgtgtgtgtgtgcgtgagtgtgtgtgtgtgtgtgtgtgtgt	449	6	1%	0	0%
9	32845951	32846550	agtctgctttacgggaacctttatcaccgtcgttccccagctgatgagttctgaattcggcagttgaatccttctcaacagtctgtgttacgggaacctttataaacgtgatccgcagttctggttctgaaatgaaggatcttccttgcgccagtcccgagtttttttctcgtcccggaattcggcaccaattgttattagacgcgttctcacgaccggccaggaagaacaccacagaccagaatcttctgcggcaaagctttattcttacatcttcaggaacagagtgcaagaagcaagagagcaagaagcaagagagagagaaaagcaagagagagagaaaacgaaaccccgtccctttttaaggagaattctccttcgcctcggacgtgtcactccttgattggctgcagcccatcggccgagttgacgtcacggggaaggcagagcacaagtagtcataagatacccttggcacatgcgcagattatttgtttaccacttagaacacagctgtcagcgccatcttgtaacggcgaatgtgggcgcggctcccaacaGTTCTTGGTGTTCTGTTCCATGACGAGGGGTAGCTGGCT	599	66	11%	86	14%
9	32890051	32890200	ctccggtagaatacttacaaattaaagaaattgccgagtcggtccgtaaatacggaaccaatgctaattttaccttggtgcagttagacaggctcgccggcatggcactaactcctgctgactggcaaacggttgtaaaagccgctctc	149	18	12%	14	9%
9	32953201	32953650	gctctgccttcctcgtgacgtcaactcggccgatgggctgcagccaatcagggagtgacacgtcctaggcgaaggagaattctccttaatagggacggggtttcgttttctctctctcttgcttcttgcactctggctcctgaagatgtaagcaataaagctttgccgcagaagattctggtctgtggtgttcttcctggccgggcgtgagaacgcgtctaataacaattggtgccgaattccgggacgagaaaaaaaactcgggactggcgcaaggaagatccctcattccagaaccagaactgcgggtcgcggtaataaaggttcccgtaaagcagactgttaagaaggattcaactgtatgaattcagaacttttcagctggggaacgagagtaccagtgagtacagctttacgaggtaagtctgatcttgaactttctaaggaaa	449	48	11%	38	8%
9	35304901	35305950	TCCCTTTGATCCTTACCATTCAAGGCGGGCGTTTATATGAATTTCATTACAGGTTAAGCAACGGGAGGAGGGATGAATTTTCCCAAGATTAGAAATGATCTGAACCCAAACCTAGTTCCAATGCATGCCCTTAACTGCTAGAATATATAGCCTTGTGTCCTCATCCATATTAGTGAAGAATGGGAAGGAGAGCTTCAGAGACTATACTGATAAAGAAATAGACATTAAAAGTGCAGATGTCAGTCAGACTCTCACTGTGTAACTAACAATACTGTTTTCCTAAATATATCTTGTCACACACTATaattttgaggtgcacactgaaggacctggaattatgcgagaaaactgaaaatcacggaaaatgagaaatacacactttaggacgtgaaaaatggcgaggaaaactgaaaaaggtggaaaatttagaaatgtcctctgtaggacatggaatatggcaagaaaactgaaaatcatggaaaatgagaaacatccacttgatgacttgaaaaatgacgaaatcattaaaaaacgtgaaaaatgagaaatgcccactgaaggacctggaatatggggagaaaactgaaaatcacggaaaatgagaaatacacactttaggacgtgaaatatggcgaggaaaactgaaaaaggtggaatatttagaaatgtccactgtaggacgtggaatataagtccagaaacctaagagactctgtgtgtgtgtgtgtgtgtgtgtgtgtgtgtgtgtgtggtgtgtgtgtgtgtATCTATAAACCTGTTAATACAGCAAGGTCGAAAGAAGCATTTAAAAGATTTTTCTCTAAGCAAATATATtgttatggtttgcatattcttgacccagggagtggcacgattagaaggtgtgactttgttggagtaggtgtggccttgttggaggaggtgtgtcattgtgagtgtgggctttaagaccctcatcctagctgcccggaagccagtattctgctagcagccttcagatgagcatgtagaactctcagctcctcctgcaccatacctgcttggatgct	1049	32	3%	108	10%
9	37331551	37332750	agagaatgctccttaagagggacggggtttcgttttctctctctcttgcttcttgctctcttgcttcttgctctcttgcttcctgcactctggctcctgaagatgtaagcaataaagctttgccgcagaagattctggtctgtggtgttcttcctggccggtcgtgagaacgcgtctaataacaattggtgccgaattccgggacgagaaaaaactcgggactggcgcaaggaagatccctcattccagaaccagaactgcgggtcgcggtaataaaggttcccgtaaagcagactgttaagaaggattcaactgtatgaattcagaacttttcagctggggaacgagagtaccagtgagtacagctttacgaggtaagtctgaccttgaactttctaaggaaattcaagacagtctatcagaagtaaagtggaatatgtttggccttgaattttttctagtgttagaagcccttttgttccttttcacatgttatcaagtggttaagatagggcggattctagatgaaattcaggacaagctatcagaagtaaagcggggagagagagtaggagcaaagaggaaatatggtacacaaaataagtatacaggcctttccaagggtcttgaacccgaggaaaagttaaggttaggtaggaatacctggagagagattagaagaaaaagaggaaaaagggaaaagaagaaagatcaattagcggaggtctctaggaaaaggagcctgtgctcatcgctggatgggctcggggagccagctcttagtagttctgaagcagatgaagaattctcctctgaggaaacagactgggaggaagaagcagcccattaccagccagctaattggtcaagaaaaaagccaaaagcggctggcgaaggccagtttgctgattggcctcagggcagtcggcttcaaggtccgccctatgcggagtccccgccctgcgtagtgcgtcagccctgcgcagagaggcagtgcgcagagaggcagtgcgcagactcattcattcccagagaggaacaaaggaaaatacaacaggcatttccggtctttgaaggagccgagggtgggcgtgtccacgctccggtagaatacttacaaattaaagaaattgccgagtcggttcgtaaatacggaaccaatgctaattttaccttggtgcagttagacaggctcgctg	1199	90	8%	122	10%
9	38171251	38171700	aagcgaaagccaccccttcttacatctttaggagccagagctccggcgcgccaaagcgcagagcgcgctctattgtttacatctttaggcagcgagagagcgcagggcgcgcagagccagagagatgccagcgagagagaatggcggaaaaccccgtccccttttttaggagcgttatatttcgcctaggacgcatcactccctgattggctgcagcccatggccgagctgacgttcacgggaaaggcagagtacaagtagtcgtaaaatacccttggcacatgcgcagattatttgtttaccacttagaacacaggatgtcagcgccatcttgtgacggcgaatgtgggggcggctcccaacacctatggtcacttgatctttgacaagggagctaaaaccatccagtggaaaaaagacagcattttcaacaaatggtgctggcacaa	449	52	12%	76	17%
9	44371051	44372250	ccatgccagcgagcctgtctaactgcaccaaggtaaaattagcattggttccgtatttacgaaccgactcagcaatttctttaatttgtaagtattctaccggagcgtggacacgcccaccctcggctccttcaaagaccggaaatgcctgttgtattttcctttgttcctctctgggaatgaatgagtctgcgcactgcctctctgcgcactgcctctctgcgcattgttgacgcactacgggctgacgcactacgcagggcggggactccgcatagggcgggagtgcacctggtagccgattgccctgaggccaattagcaaactggccttcgccagccgcttttggctttttccttaaatgactagttagcactttacttggcggctggtatccttttctttcataatgagccgcttttttctcccagtctgtttcttcagagcacaggctccttctcctagagacctccgctaattgatctttcttcttttccctttttcctctttttcttctaatctctctccaggtattcttacctaaccttaacttttcctcgggttcaagacccttggaaaggcctgtatacttattttgtgtaccatattttctctttgttcctactctctctccccgctttacttctgatagattgtcctgaatttcctctagaattttcagccctatcttaaccacttgataacatgtgaaaaggaacaaaagggctcctaacaccagaaaaaattcaaggccaaacatattccactttacttctgatagactgtcttgaatttcgttagaaagttcaagatcagacttacctcgttccccagctgaaaagttctgaattcatacagttgaatccttcttaacagtctgctttacgggaacctttatcaccgtcgttccccagctgatgagttctgaattcggcagttgaatccttctcaacagtctgtgttacgggaacctttataaacgtgatccgcagttctggttccggaatgagggatcctccttgcgccagtcccgagtttttttctcgtcccggaattcggcaccaattgttattagacgcgttctcacgaccggccaggaagaacaccacagaccagaatcttctgcggcaaagctttattcttacatcttcaggagccagggtgcaggaagcaagagagcaagaagcaagagagagaga	1199	94	8%	138	12%
9	46585351	46585500	ggggacggggtttccgccattctctctcttacttgcgctctcttgcttgcgcttttgcgctctggcgctggcgctctggctcctaaagatgtaagcggggggctttcgtttttgggcttgggggcttgcgctcctgctcctgaagatgt	149	20	13%	2	1%
9	46964701	46965300	agtgtttgtgttatgtatgtgtgtgagtgtgtgtatgtgagagtatgtgcatgtgtgtgtacatgtgagagagagttcgtatatgagagtgtgtatgtttttgttagtgtgtgtgtatgtgtgtgtgtgtgtgtgtgtgtatgtgagagtgtgttaatgtgcatgtttgtgagtgtgtgagtgtgtatgtgtgactgtgtatttgtgagtgtgtgtgcatatatgtgactgtgtgactgtgtgtgtgtatgtgtgtgagagagagtatgtatatgagagtgtatatgtTTTTGTTAGCGTCTATTTGTGTGTATATGTATGCGAGagtgtgtatgtatgcatgcatgacagtgtgtatttgtgagtgtgtgtgtatgtgtgtgtatgtgagagagagtatgtgtacgtgtAAGAGAGTACGTATATGAGCatgtgtatgtttttgttagtgtgtgtgtatgtgagagtgtgtgaatgtgcgtatgtgtgattgtgtgtatttgtgtgtatgtgtgattgtgtgtatttgtgtgtgtatgtgtgagtgtgtatgtttgagagtgtgtgtgtgagtgtgtatgtgtgagtgtgtatgtgtg	599	12	2%	14	2%
9	54019051	54020400	gtcaaagcagctgcgtttgctcgggcctgcgcttgtgcagcctcatgccaaagagctctccattccatatatttgcccatactagggagagcggcttttacaatcgtttgccagtcggcaggagttagtgccatgccggcaagcctgtctaactgcaccaaggtaaaattagcattggttccatatttacggaccgactcggcaagctctttaatctgcacatattctaccggagcgtggacacgcccaccctcggctccttcaaagaccggaaatgcctgttgtattttcctttgttcctctctgggaatgaatgagtctgcgcattgcctctctgcgcattgtctctctgcgcattgtctctctgcgcagggctgacgcactacgcagggcgggggctccgcatagggcggaagtgcaccttgaagccgactgcccggaggccaagcagtaaactggctttcgccagccgcttttggcttttttcttgaccaattagctcgcattttatctggctggcacttttttctctcaaaacgagctgcttcttcctcccagtctgtttcttcagaggagaattcgtcatctgattcagagctactaagagctggcttctctaattgatcttttttcttttcttttttcttttccttccttctaatctctccccaggtattcttacctgaccttaacttttcctcgggttcaagacccttggaaaggcctgtatacttattttgtgtaccatatttcctctttgctcctattctctctccccgctttacttctgatagactgccctgaacttcatccagaattttcagccctgccttaatcacttgataacatgtgaaaaggaacaaaaaggctcctaacactagaaaaagttcaaggccaaacataccttgtaaagctatttcccactttacttctgatagactgtcttgaatttcgttagaaagttcaagaccagacttaccttgtaaagctatttcccactttacttctgatagactgtcttgaatttcgttagaaagttcaaggccagacttaccttgtaaagctatacttacgggtaccctgttccccagctgaagagttctgaattcacgcagttgaatccttctcaacagtctgttttacgggaacctttatgaccgtgacccgcagttctggttccggaatgaggaatcttccttgcgccggtgatggttaactcccgtcccgagtttttcttcccgggtttccggcaccaaCtcttacacgcgttctcacgaccggccaggaaagacacaacaaaccagaatcttctgcggcaaaactttattgcttacatcttcaggagcaag	1349	104	8%	160	12%
9	58779601	58780050	gtcaagaaaaaagccaaaagcggctggcgaaggccagtttgctgattggcctcagggcagtcggcttcaaggtccgccctatgcggagtccccgccctgcgtagtgcgtcagcaatgcgcagagaggcagtgcgcagagaggcagtgcgcagactcattcattcccagagaggaacaaaggaaaatacaacaggcatttccggtctttgaaggagccgagggtgggcgtgtccacgctccggtagaatacttacaaattaaagaaattgctgagtcggttcgtaaatacggaaccaatgctaattttaccttggtgcagttagacaggctcgctggcatggcactaactcctgctgactggcaaacggttgtaaaagccgctctccctagtatgggcaaatacatggaatggaaagcgctttggcacgaagctgcacaagcgcaggccc	449	50	11%	68	15%
9	60728101	60728400	tgagacgtataagctggtccattatcagtcttaaggagtttgggtttcccccaagcactccatgcctcaagacaatgttgaatcacatgtgaggccttttctccggttaacggagaagcaaacatgatgccagaacatgtgtcaatggacacatggagatattgaagttttccaaaggaagaaacatgtgtaacatccatttgccagacctgtagaggtcgaataccacgtgggttaattcccacatgaggaactggcaagaactcacagcagctttgacattgagtaacaatgtcacg	299	12	4%	62	21%
9	61567201	61567350	attgtacacacgctatacacacacacacctacacacactatacacacactgtacacacacatacactgcacacacacatatacacacatacaatacacactatacacacattgcatacacacacactacacacacatacatacacacac	149	2	1%	90	60%
9	62668501	62668800	TGTGCTGGGTATAAACAGTGTTATTCCTGGCAtgcgttcgtgtgtgtgtgtgtgtgtgtgtgtgtgtgtgtgtgtgtgtgtgtgtgtgtctgggtgtgtctgtctgtgtggtattgtgtctgggtgtgtgtctgtctgtctatctgtctgtctgtgtggtgtgtggtgtgtgttagcgtctgtgatgtgtatgtgtctgtctgtctgggtggtgtctgggtggtatgtgtatctgtgtgtgtgtttgtgtctgtggtgtatgtctgtccgtggtgtgtgtatgtgcatgtatgagtgtc	299	8	3%	6	2%
9	66296401	66296550	ggccaggaagaacgacgctgctacaggatccttctgcacacatttattcagtcctgtttcttctttctccatatatctcccttgtttatatctcccttgtttatatatctcccttgtttttatatctcccttgtttttatatcttccct	149	4	3%	14	9%
9	75338401	75338700	atacacacacatatacacaggacacatacatacatacacacaacacatacacaaatacacatacacgcatacatgcacacacacacaaacacagggcacatacatacacacaaatacacatacatgcatacatatacacatacacaaacacagggcacatacacacacaacacatacacacaaatacacatacacgcatatatacacacacacacaaacacagggcacatacacacatacaacacatacacacaaatacacatacatgcatacatatacacatacacaaacacagggca	299	4	1%	186	62%
9	75509101	75509250	GAAAGGGAGTCACAGCTTACGTGGGTGCAGTGGGAGAcaccctgggaagtagaggcaggaaagcccggagctcaagaccattttcctgtacacagagccctggactgtgggagatcctgtctcacaaaCGAATTGGTTTAATCTCACTA	149	6	4%	24	16%
9	76737901	76738200	gccatgctggcgagcctgtctaactgcaccaaggtaaaattagcattggttccgtatttacggaccgactcggcaatttctttaatttgtaagtattctaccggagcgtggacacgcccaccctcggctccttcaaagaccggaaatgcctgttgtattttcctttgttcctctctgggaatgaatgagtctgcgcactgcctctctgcgcactgcctctctgcgcattgctgacgcactacgcagggcggggactccgcatagggcggaccttgaagccgactgccctgaggccaatc	299	38	13%	30	10%
9	78566851	78567900	tgacgcactacgcagggcggggactccgcatagggcggaccttgaagccgactgccctgaggccaatcagcaaactggccttcgccagccgcttttggcttccttaactgattagctagcactttacctggctggtacccttttttctcataatgagctgcttcttcctcccagtctgtttcttcagaggagaattcttcatctgcttcagagctactaagagctggctccccgagcccatccagcgatgagcacaggctccttttcctagagacctccgctaattgatctttcttcttttccctttttcctctttttcttctaatctctctccaggtattcctacctaaccttaacttttcctcgggttcaagacccttggaaaggcctgtatacttattttgtgtaccatatttcctctttgttcctactctctctccccgctttacttctgatagcttgtcctgaatttcatctagaatccgccctgccttaaccacttgataacatgtgaaaaggaacaaaagggcttctaacactagaaaaaatccaaggccaaacattttccactttacttctgatagactgtcttgaatttccttagaaagttcaagaccaggcttacctcgtaaagctgtactcactggtactctcgttccccagctgaaaagttctgaattcatacagttgaatccttcttaacagtctgctttacgggaacctttattaccgcgacccgcagttctggttctggaatgagggatcttccttgcgccagtcccgagttttttctcgtcccggaattcggcaccaattgttattagacgcgttctcacgaccggccaggaaagacgcaacagaccagaatcttctgcggcaaagctttattgcttacatcttcaggagccagagtgcaagaagcaagagagagagaaaacgaaaccccgtccctattaaggagaattctccttcgcctaggacgtgtcactccctgattggctgcagcccatcggccgagttgacgtcacgaggaaggcagagcacatgga	1049	78	7%	116	11%
9	78566851	78567900	tgacgcactacgcagggcggggactccgcatagggcggaccttgaagccgactgccctgaggccaatcagcaaactggccttcgccagccgcttttggcttccttaactgattagctagcactttacctggctggtacccttttttctcataatgagctgcttcttcctcccagtctgtttcttcagaggagaattcttcatctgcttcagagctactaagagctggctccccgagcccatccagcgatgagcacaggctccttttcctagagacctccgctaattgatctttcttcttttccctttttcctctttttcttctaatctctctccaggtattcctacctaaccttaacttttcctcgggttcaagacccttggaaaggcctgtatacttattttgtgtaccatatttcctctttgttcctactctctctccccgctttacttctgatagcttgtcctgaatttcatctagaatccgccctgccttaaccacttgataacatgtgaaaaggaacaaaagggcttctaacactagaaaaaatccaaggccaaacattttccactttacttctgatagactgtcttgaatttccttagaaagttcaagaccaggcttacctcgtaaagctgtactcactggtactctcgttccccagctgaaaagttctgaattcatacagttgaatccttcttaacagtctgctttacgggaacctttattaccgcgacccgcagttctggttctggaatgagggatcttccttgcgccagtcccgagttttttctcgtcccggaattcggcaccaattgttattagacgcgttctcacgaccggccaggaaagacgcaacagaccagaatcttctgcggcaaagctttattgcttacatcttcaggagccagagtgcaagaagcaagagagagagaaaacgaaaccccgtccctattaaggagaattctccttcgcctaggacgtgtcactccctgattggctgcagcccatcggccgagttgacgtcacgaggaaggcagagcacatgga	1049	78	7%	116	11%
9	78829051	78829200	taaaattagcattggttccatatttacggaccgactcggcaatttctttaatttgtaagtattctaccggagcgtggacacgcccaccctcggctccttcaaagaccggaaatgcctgttgtattttcctttgttcctctctgggaatg	149	16	11%	12	8%
9	85918801	85919100	cgttccccagctgaagagttctgaattcacgcagttgaatccttctcaacagtctgttttacgggaacctttatgaccgtgacccgcagttctggttccggaatgagggatcttccttgcgccggtgatggtaaattctgtcccggggttttctcgtcccaggatttctcgtctcgggtttcagcaccaaCtcttacacgcggtctcgaccggccaggaaagacgcaacaaaccggaatcttctgcggcaaaactttattgcttacatcttcaggagcaagagtgcaagagagcaagag	299	38	13%	40	13%
9	86069401	86069850	tacagttgaatccttcttaacagtctgctttacgggaacctttattaccgcgacccgcagttctggttctggaatgagggatcttccttgcgccagtcccgagttttttctcgtcccggaattcggcaccaattgttattagacgcgttctcacgcccggccaggaagaacaccacagaccagaatcttctgcggcaaaactttattgcttacatcttcaggagcaagagtgcaagaagcaagagagagagaaaacgaaaccccgtccctattaaggagaattctccttcgcctaggacgtgtcactccctgattggctgcagcccatcggccgagttgacgtcacggggaaggcagagcacatggagtggagaaccaccctcggcatatgcgcagattatttgtttaccacttagaacacagctgtcagcgccatcttgtaacggcga	449	54	12%	66	15%
9	90862951	90863400	ggcctgcgcctgtgcagcttcgtgccaaagcgctttccattccatatatttgcccatactagggagagcggcttttacaaccgtctgccaatcggcaggagttagtgccatgccagcgagcctgtctaactgcgccaaggtaaaattagcattggttccgtatttacgaaccgactcggcaatttccttaatctgtacgtattctaccggagcgtggacacgcccaccctcggctccttcaaagactggaaatgcctgttctattttcctttgttcctctcggggaatgaatgagtctgcgcactgcctctctgcgcattgctgacgcactacgggctgacgcactacgcagggcggggactccgcatagggcgggagtgcacctggtagccgattgccctgaggccaattagcaaactggccttcgccagccgcttttggcttttttc	449	60	13%	52	12%
9	90939001	90939750	cagcccactccaaacgttggccactcggaggcgcaaaaggtctgccacggaccctttctgacctccaccgactggttgtgggctctgacccgcacctccttccaatgctccagagtcagagaaaggggagtggacacagattgtcccatttctagaaaaacagtagtcacaacaagagcggacacgagactaagacaaaaaagaaaccagaaacggcggcgactctgcgtcgaccacaagcaactcaaagaatcagatggcctctctaaggccggccgattgagaccctctgcacgaggtgggactcgaacccacgatcccgtgaccaaacgcgaggtgggactcgaacccacggtctcgcaactgggcacgaggtgggactcaaacccacgatctcgcaaccccaaatgttctcttggcctccaaaggggtccaccaggcgtccctgttcctcccctgttcctcctgggacgtctcccagggtgaacggacggtggacacctggacacgtctatccttatccaccccgcattccctctcggagcgtggtctcactgagcgtccgcaaaaccgaaactgcgatcgcaccaaatttagaaacagaacacagacatcagaccaaaacagaacaaagaatcttacctctaagtgggtctaggacctctgggtggtcgcgctgattcccggccaatgcaccaaaAtgaaagacccccgaagggagaccctcactcaggccccgggacagccgc	749	92	12%	124	17%
9	92740351	92741850	agagctctccattccatatatttgcccatactagggagagcggcttttacaatcgtttgccagtcggcaggagttagtgccatgccggcaagcctgtctaactgcaccaaggtaaaattagcattggttccgtatttacggaccgactcggcaagttctttaatctgcacatattctaccggagcgtggacacgcccaccctcggctccttcaaagaccggaaatgcctgttgtattttcctttgttcctctctgggaatgaatgagtctgcgcattgcctctctgcgcattgtctctctgcgcagggctgacgcactacgcagggcgggggctccgcatagggcggaccttgaagccgactgcccggaggctgaacagcatgctggctttcgccagccgcttttggcttttttcttgaccgattagctagcactttatctggctggtaatgagctgcttcttcctcccagtctgtttcttcagaggaggattcttcatctgcttcagagctactaagagctggcttcctgagctcatctagtgacgagtatctcctagagacctccgctaattgatcttttttcttttcttttttcttttccttccttctaatctctccccaggtattcttacctgacctaaacttttccttgggttcaagacccttggaaaggcctgtatagttagtttgtgtaccatattttctctttgctcctactctctctccccgctttacttctgatagattgtcctgaatttcatccagaattttcagccctatcttaaccacttgataacatgtgaaaaagaacaaaagggctcctaacactagaaaaagttcaaggccaaacataccttgtaaagctattttccactttacttctgatagactgtcttgaatttcgttagaaagttcaagaccagacttaccttgtaaagctattccccactttacttctgatagactgtcttgaatttcgttagaaagttcaagaccagacttaccttgtaaagctatacttacgggtacccttttctccagctgaagagttctgaattcacgcagttgaatccttctcaacagtctgttttacgggaacactttattaccgccattccccagctgaagagttctgaattcacgcagttgaatccttctcaacagtctgttttatgggaaccttcattaccataacccgcagttctggttccggaatgagggatcttccttgcgccggtgatggttaactcccgtcccgagttttcttgtcccgggtttttttcttcccggattttctcgtcccggattttctcgtcccgggttttggcaccaaCtcttaaacgcgttctcacgaccggccaggaagaacacaacaaaccagaatcttctgcggcaaaactttattgcttacatcttcaggagcaggagcgcaagccccaagccccaaaaacgaaagccccccgcttacatctttaggagccagagcgccagagcgca	1499	116	8%	170	11%
9	92740351	92741850	agagctctccattccatatatttgcccatactagggagagcggcttttacaatcgtttgccagtcggcaggagttagtgccatgccggcaagcctgtctaactgcaccaaggtaaaattagcattggttccgtatttacggaccgactcggcaagttctttaatctgcacatattctaccggagcgtggacacgcccaccctcggctccttcaaagaccggaaatgcctgttgtattttcctttgttcctctctgggaatgaatgagtctgcgcattgcctctctgcgcattgtctctctgcgcagggctgacgcactacgcagggcgggggctccgcatagggcggaccttgaagccgactgcccggaggctgaacagcatgctggctttcgccagccgcttttggcttttttcttgaccgattagctagcactttatctggctggtaatgagctgcttcttcctcccagtctgtttcttcagaggaggattcttcatctgcttcagagctactaagagctggcttcctgagctcatctagtgacgagtatctcctagagacctccgctaattgatcttttttcttttcttttttcttttccttccttctaatctctccccaggtattcttacctgacctaaacttttccttgggttcaagacccttggaaaggcctgtatagttagtttgtgtaccatattttctctttgctcctactctctctccccgctttacttctgatagattgtcctgaatttcatccagaattttcagccctatcttaaccacttgataacatgtgaaaaagaacaaaagggctcctaacactagaaaaagttcaaggccaaacataccttgtaaagctattttccactttacttctgatagactgtcttgaatttcgttagaaagttcaagaccagacttaccttgtaaagctattccccactttacttctgatagactgtcttgaatttcgttagaaagttcaagaccagacttaccttgtaaagctatacttacgggtacccttttctccagctgaagagttctgaattcacgcagttgaatccttctcaacagtctgttttacgggaacactttattaccgccattccccagctgaagagttctgaattcacgcagttgaatccttctcaacagtctgttttatgggaaccttcattaccataacccgcagttctggttccggaatgagggatcttccttgcgccggtgatggttaactcccgtcccgagttttcttgtcccgggtttttttcttcccggattttctcgtcccggattttctcgtcccgggttttggcaccaaCtcttaaacgcgttctcacgaccggccaggaagaacacaacaaaccagaatcttctgcggcaaaactttattgcttacatcttcaggagcaggagcgcaagccccaagccccaaaaacgaaagccccccgcttacatctttaggagccagagcgccagagcgca	1499	116	8%	170	11%
9	93323401	93324150	TTAGATTAAAAATGCCTCTAACAGAATTTGAAACCTTTAGTAACATTGCTCAAGGGAAATGCTATGTGCTCATTCAGCCTTTATGACTATAAAACAAAACTATAGAGTAAAATTAGTACTAACAtgtggagagccgttacgtgctgcgagcaattgcatgcgtgctgccagtaatctctgaggagagccgtgtgtgccgcgagcaatcgccattataagatggcgcgggcctctgctgtgcctaactagtaaacacgccttgtacgcaggtgcaagagtgaattcactcctagtcactcccattctcggggtgtaatagtggggtgatgggcaagcaacgaaccaggagctgtcacgccatatcaggtgctgaaacgtcacgctgcgggttataaaagcagcgccattttcccggtttgggatcttcctgagaagcaagcaataaagcttttgccgcggaagattctggtttgttgcgtctttcttgccggtcgagcgggacgcaataagtggcgccgaagaaacccgggaactgtcatcacaccggcgcaaggaagatccctcgttcgcggggcagaatcagaaccgtgggacaaaaggctctacaaggtacgtacaatcttgaaatttctccagagttagaagcccttttgattgtttgcatggcgattatgaggattgtcagcgtatggtagaagcagggcagaaagttctggagaaattcaagaaagtctatcagaggtagagcg	749	80	11%	92	12%
9	93628651	93628950	gcttttacaaccgtttgccagtcagcaggagttagtgccatgccggcgagcctgtctaactgcaccaaggtaaaattagcattggttccgtatttacggaccgactcggcaatttctttaatttgtaagtattctaccggagcgtggacacgcccaccctcggctccttcaaagaccggaaatgcctgttgtattttcctttgttcctctctgggaatgaatgagtctgcgcactgcctctctgcgcactgcctctctgcgcatctctctgcgcattgctgacgcactacgcagggcgg	299	38	13%	36	12%
9	93645451	93645750	ctagctaatcagttaaggaaaaagccaaaagcggctggtgaaggccagcatgctgttcagcctccgggcagtcggcttcaaggtcatagtgcacttctgccctatgcggagcccccgccctgcgtaaggcgtcagccctgcgcagagaggcaatggacagagaggcaatgcacagactcgttcattccaaaggaggaacaaaggaaaatacaacaggcatttccggtctttgaaggagccgagggtgggtgtgtccacgctccggtagaatatgtgcagattaaagagcttgccgagtc	299	28	9%	48	16%
9	98766451	98766900	gacatcctgtgttctaagtggtaaacaaataatctgcgcatgtgccaagggtatcttatgactacttgtgctctgccttccccgtgacgtcaactcggccgatgggctgcagccaatcaaggagtgacacgtccgaggcgaaggagaatgctccttaagagggacggggttttcgttttttctctctcttgcttcttgctctcttttcctgaagatgtaagaataaagctttgccgcagaagattctggtctgtggtgttcttcctggccggtcgtgagaacgcgtcgaataacaattggtgccgaattccgggacgagaaaatccgggacgagaaaaaactccggactggcgcaggagggatacttcattccagaaccagaactgcgaatcaaggttataaggttcccgtaacacagactgttgagaaggattcaactgccgaattca	449	52	12%	40	9%
9	99382051	99382350	tatatacacactcacacacatactcatacactcacacacactcacgtatacacatagaattacacacacattcacactcacatacatacacactcacacacacacacacatagaatcacatatacactcacacacatatacaaacatagaattacacacacatacacactcacacacatatacacccacatacacacacgtatacacactcacatacacacttacacacatactcatacactcacacactcatgtacacacacacatacatagaatcacatacatatatacacatacac	299	4	1%	172	58%
9	101292601	101293050	ACCCCACAGtgttattagacgcgttctcacgaccggccaggaaagacgcaacaaaccagaatcttctgcggcaaagctttattgcttacatcttcaggagcaggagtgcaagaagcaagagagagagaaaacgaaaccccgtcccttttttaggagagttatatttcgcctaggacgtgtcactccctgattggctgcagcccatcggccgagttgacgtcacggggaaggcagagcacatggagtggagaaccaccctcggcatatgcgcagattatttgtttaccacttagaacacagctgtcagcgccatcttgtaacggcgaatgtgggcgcggctcccaacatctccccctttccttttaataagagcaaataggccacccatattaatgagagtggagatagaggtcaaatccccagtgtgtaggtaaaggagccatgtacag	449	42	9%	74	16%
9	101296801	101298300	cttgtgcagtttcatgccaaagagctctccattccatatatttgcccatactagggagagcggcttttacaaccgtttgccagtcggcaggagttagtgccatgccggcaagcctgtctaactgcaccaaggtaaaattagcattggttccatatttacggaccgactcggcgagttctttaatttgtaagtattctaccggagcgtggacacgcccaccctcggctccttcaaagactggaaatgcctgttgtattttcctttgttcctctctgggaatgaatgagtctgcgcactgcctctctgcgcactgcctctctgcgcatctctctgcgcattgcctctctgcgcatctctctgcgcattgcctctctgcgcattgctgacgcactacgcagggcgggggctccgcatagggcggaccttgaagccgactgccctgaggccaatcagcaaactggccttcgccagccgcttttggcttccttaactgattagctagcactttacctggctggtacccttttttctcataatgagctgcttcttcctcccagtctgtttcttcagaggagaattcttcatctgcttcagagctactaagagctggctccccgagcccatccagcgatgagcacaggctccttttcctagagacctccgctaattgatctttcttcttttccctttttcctctttttcttctaatctctctccaggtattcctacctaaccttaacttttcctcgggttcaagacccttggaaaggcctgtatacttattttgtgtaccatatttcctctttgttcctactctctctccccactttacttctgatagattgccctgaatttcatctagaatccgccctgccttaaccacttgataacatgtgaaaaggaacaaaagggcttctaacaccagaaaaaattcaaggccaaacatattccactttacttctgatagactgtcttgaatttccttagaaagttcaagatcagacttacctcgtaaagctgtactcactggtactctcgttccccagctgaaaagttctgaattcatacagttgaatccttcttaacagtctgctttacgggaacctttattaccgcgacccgcagttctggttctggaatgagggatcttccttgcgccagtcccgagttttttctcgtcccgggtttcggcaccaattgttattagacgcgttctcacgaccggccaggaaagacgcaacaaaccagaatcttctgcggcaaagctttattgcttacatcttcaggagcaggagtgcaagaagcaagagagagagaaaacgaaaccccgtcccttttttaggagagttatatttcgcctaggacgtgtcactccctgattggctgcagcccatcggccgagttgacgtcacggggaaggcagagcacatggagtggagaaccaccctcggcatatgcgcagattatttgtttaccacttagaacacagctgtcagcgc	1499	120	8%	184	12%
9	102757951	102758250	cacaacacacatgctcacacacacataccacatgcacacacacacagcacaacacccatacacattcaacacacaccacacaccctctcacacacactacacacacatctacacattcagcacatgtgcacaccatacatacgtgcataccaccacaatacccaccacgcacatacacacacatacacacaccacactcttacacacatacacacacCATGTACACTCCCTTCATACGTGTACAGAATGCAAAACTTCCGCTGGAATGAATGAAGAAATGACCCTCATACTTTCCCCCC	299	8	3%	154	52%
9	105607351	105607800	tgtgccaagggtattttaccactacatgtactctgcctttcccgtgacgtcaactcggccatgggctgcagccaatcagggagtgatgcgtcctaggcgaaggataattctccttaaagggaacggggtttccgccattctctctcttgcttgcgctctggcgctctacgctctggcgctctgcgctctggcgctctggctcctaaagatgtaagcagggggctttcgtttttggggcttggggcttgcgctcctgctcctgaagatgtaagcaataaagttttgccgcagaagattctggtttgttgtgtctttcctggccggtcgtgagaacgcgtttaagaGttggtgctgaaacccgggacgagaaaatacaagaaaactcgggacgggagttaaccatcaccggcgcaaggaagatccctcattccagaaccagaactgcgggt	449	54	12%	38	8%
9	106537951	106538100	acacacacagacacacacagacacacagacacacacacacatacacacacacacacacacacacacacacacacacacacacacacacacacacgtatggggggtacatctgtaactcctggtactggaacaacagagacaggccggct	149	4	3%	92	62%
9	110253451	110253600	agaggttccatctggtcctgtggaaacacacaaacagaccctctcgcccacgtcaacacctgatctggtcgatccCAGGGGGGATGGACACAATACCTCGTGGTGATGAGACCATAACCTCAATCACCTGTGTGTCCATCTGGGGAGTC	149	8	5%	30	20%
9	110922151	110922300	tgtttggtgtaagtatgtgtctgtgtctacgtatggtgtgtctgtgtggtgtgtgtgtgcatgtatgtgtggtatgtgtgtgtatatgtatggtgtctgtgtgtgtgtatatgtgtggtgtgtgtctgtgtgtgtgtatatgtgtggtg	149	2	1%	2	1%
9	111014851	111015000	gtatgtgtgtgtgagtgtgtgtctggtctgtatgtatgcgtagtatgcatttgtactggtctgtatgtatgtgtagtatgtatttgtacatgtgtatatatgtgtggtgtctgtgatatgtgtgtgtatggtatgtgtgcatgtatggt	149	2	1%	6	4%
9	113976451	113976600	TCTGTAGCAGGTGTGCCTGTGAGTCACGCGTGCACACGGCCATCACCTCTCCTCTCTCTCACGACCTCTCGTGAGGCCTGTGGCATATCCGAGTTTTTAAAAACTTCTTTCCATTTTAATTCTGTAGCATCTTTGCCCATTTGCTTAGC	149	12	8%	22	15%
9	114281551	114281850	GGGGATTTCCCCACACCCATTGTAACTTTTGAAATTATAATTTAGTTACAACATTTTCCTCTTCTCTTTTGGGAACAGATATTTAAATTGCtctgaggcgacgccatttccggctccagacaaccggccaccttcctggtcagagcacaggtgtccgcacagcccgggaggcttctgcctcacgttccgcgggggtcaccttggttccgagaccccgcggccggcggtctgcgggtgagagtgtggaacacagaggccagcagcttctggaacgggcgagagccacagagcctctgagg	299	34	11%	46	15%
9	114878701	114879000	acgtcagctcggccatgggctgcagccaatcagggagtgatgcgtcctaggcgaaatataacgctcctaaaaaaggggacgggtttttccgccattctctctcgctggcatctctctggctctgcgcgccctgcgctctctcgctgcctaaagatgtaaacaatagagcgcgctctgcgctttggcgcgccggagctctggctcctaaagattatagaaggggctttcgcttttggggctgggggtttgcgctcctagctcctgaagatgtaagcaataaagttttgccgcagaagatt	299	42	14%	20	7%
9	117979801	117980100	actctaaatcaacatatgtggagagccctgccgcgagcaatcgcgtgagtgccgtgggcaatcgccattataagatggtgctggcttccactgcgcctaactagtaaacaagccttatccgcaagtgcaagagtgaactcacgcctagtcactgcccatctcatggcgtagtaatggggtgatgggcgagcaacgaatcaggagctgtcacgccacatcaggtgctgaaacgtcacgctgtgggctatataagcagcgccattttcccggttcggggtcttccctcctgataagtaagc	299	36	12%	44	15%
9	119868001	119870100	ttccatatatttgcccatactagggagagcggcttttacaatcgtttgccagtcagcaggagttagtgccatgccggcgagcctgtctaactgcaccaaggtaaaattagcattggttccgtatttacggaccgactcggcgagttctttaatttgtaagtattctaccggagcgtggacacgcccaccctcggctccttcaaagactggaaatgcctgttgtattttcctttgttcctctctgggaatgaatgagtctgcgcactgcctctctgcgcactgcctctctgcgcactgcctctctgcgcactgcctctctgcgcatctctctgcgcattgcctttctgcgcatctctctgcgcattgtctctctgcgtatctctctgcgcattgcctctctgcgcatctctctgcgcattgcctctctgcgcatctctctgcgcattgcctctctgcgcattgctgacgcactacgcagggcgggggctccgcatagggcggaccttgaaaccgactgccgggaggttgaacagtacgctggctttcgccagccgcttttggcttttttcttgaccaattagctggctggtaatgggctgcttcttcctcccagtctgtttcctcagaggagaattcttcatctgcttcagagctactaagagctggcttcctgagctcatctagtgacgagtatctcctagagacctccgctaatcgatcttttttcttttcttttttcttttccttccttctaatctctccccaggtattcttacctgacctaaacttttcctcgggttcaagacccttggaaaggcctgtatacttattttgtgtaccatattttctctttgctcctactctctctccccgctttacttctgatagattgccctgaatttcatccagaattttcagccctatcttaatcacctgataacatgtgaaaaggaacaaaagggctcctaacattagaaaaaattcaaggccaaacattttccactttacttctgatagactgtcttgaatttccttagaaagttcaaggccaggcttacctcgtaaagctgtactcactggtactctcgttccccagctgaaaagttctgaattcatgcagttgaatccttcttaacagtctgctttacgggaacctttattaccgcgacccgcagttctggttctggaatgagggatcttccttgtgccggtcccgagttttcttgtattttttcgtcccggattttttctcgtcccggatttcagcaccaattcttaatagcgttctcacgcgaccggccaggaaagacgcaacaaaccaaaatcttctgcggcaaaactttattgcttacatctttgggagccaggagggcaagcgcccagcgcccagccccaaaaacgaaagccccttcaataatgaaaccgaaaccccttccctatttaggagagttatatttcgcctaggacgcatcactccctgattggctgcagcccatggccgagctgacgttcacgggaaaggtagagtacaagtagtcataaaatacccttggcacatgcgcagattatttgtttaccacttagaacacaggatgtcagcgccatcttgtgacggcgaatgtgggggcggctcccaacactatgcggagcccccgccctgcgtagtgcgtcagcaatgcgcagagagacaatgcgcagagaggcaatgcgcagagagacaatgcgcagagaggcaatgcgcagagaggcagtgcgcagagaggcagtgcgcagagaggcagtgcgcagagaggcagtgcgcagagaggcagtgcgcagactcattcattcccagagaggaacaaaggaaaatacaacaggcatttccggtctttgaaggagccgagggtgggcgtgtccacgctccggtagaatacttacaaattaaagaacttgccgagtcggtccgtaaatacggaaccaatgctaattttaccttggtgcagttagacaggctcgccggcatggcactaactcctgctgactggcaaacgattgtaaaagccgctctccctagtatgggcaaatatatggaatggagagcgctttggcacgaagct	2099	208	10%	262	12%
9	119868001	119870100	ttccatatatttgcccatactagggagagcggcttttacaatcgtttgccagtcagcaggagttagtgccatgccggcgagcctgtctaactgcaccaaggtaaaattagcattggttccgtatttacggaccgactcggcgagttctttaatttgtaagtattctaccggagcgtggacacgcccaccctcggctccttcaaagactggaaatgcctgttgtattttcctttgttcctctctgggaatgaatgagtctgcgcactgcctctctgcgcactgcctctctgcgcactgcctctctgcgcactgcctctctgcgcatctctctgcgcattgcctttctgcgcatctctctgcgcattgtctctctgcgtatctctctgcgcattgcctctctgcgcatctctctgcgcattgcctctctgcgcatctctctgcgcattgcctctctgcgcattgctgacgcactacgcagggcgggggctccgcatagggcggaccttgaaaccgactgccgggaggttgaacagtacgctggctttcgccagccgcttttggcttttttcttgaccaattagctggctggtaatgggctgcttcttcctcccagtctgtttcctcagaggagaattcttcatctgcttcagagctactaagagctggcttcctgagctcatctagtgacgagtatctcctagagacctccgctaatcgatcttttttcttttcttttttcttttccttccttctaatctctccccaggtattcttacctgacctaaacttttcctcgggttcaagacccttggaaaggcctgtatacttattttgtgtaccatattttctctttgctcctactctctctccccgctttacttctgatagattgccctgaatttcatccagaattttcagccctatcttaatcacctgataacatgtgaaaaggaacaaaagggctcctaacattagaaaaaattcaaggccaaacattttccactttacttctgatagactgtcttgaatttccttagaaagttcaaggccaggcttacctcgtaaagctgtactcactggtactctcgttccccagctgaaaagttctgaattcatgcagttgaatccttcttaacagtctgctttacgggaacctttattaccgcgacccgcagttctggttctggaatgagggatcttccttgtgccggtcccgagttttcttgtattttttcgtcccggattttttctcgtcccggatttcagcaccaattcttaatagcgttctcacgcgaccggccaggaaagacgcaacaaaccaaaatcttctgcggcaaaactttattgcttacatctttgggagccaggagggcaagcgcccagcgcccagccccaaaaacgaaagccccttcaataatgaaaccgaaaccccttccctatttaggagagttatatttcgcctaggacgcatcactccctgattggctgcagcccatggccgagctgacgttcacgggaaaggtagagtacaagtagtcataaaatacccttggcacatgcgcagattatttgtttaccacttagaacacaggatgtcagcgccatcttgtgacggcgaatgtgggggcggctcccaacactatgcggagcccccgccctgcgtagtgcgtcagcaatgcgcagagagacaatgcgcagagaggcaatgcgcagagagacaatgcgcagagaggcaatgcgcagagaggcagtgcgcagagaggcagtgcgcagagaggcagtgcgcagagaggcagtgcgcagagaggcagtgcgcagactcattcattcccagagaggaacaaaggaaaatacaacaggcatttccggtctttgaaggagccgagggtgggcgtgtccacgctccggtagaatacttacaaattaaagaacttgccgagtcggtccgtaaatacggaaccaatgctaattttaccttggtgcagttagacaggctcgccggcatggcactaactcctgctgactggcaaacgattgtaaaagccgctctccctagtatgggcaaatatatggaatggagagcgctttggcacgaagct	2099	208	10%	262	12%
9	120639601	120640200	tgtgcagtttcatgccaaagagctctccattccatatatttgcccatactagggagagcggcttttacaaccgtttgccagtcggcaggagttagtgccatgccggcgagcctgtctaactgcaccaaggtaaaattagcattggttccgtatttacggaccgactcggcgagttctttaatttgtaagtattctaccggagcgtggacacgcccaccctcggctccttcaaagactggaaatgcctgttgtattttcctttgttcctctctgggaatgaatgagtctgcgcactgcctctctgcgcactgcctctctgcgcactgcctctctgcgcatctctctgcgcactgcctctctgcgcatctctctgcgcactgcctctctgcgcatctctctgcgcattgcctctctgcgcatctctctgcgcattgcctctctgcgcatctctctgcgcattgcctctctgcgcattgctgacgcactacgcagggcgggggctccgcatagggcggaccttgaaaccgactgccgggaggttgaacagtacgctggctttcgccagccgcttttggcttttttcttgaccaattagctgg	599	76	13%	72	12%
9	121041001	121041450	gcctgcaatgtctgagccccattcacagccatcgtgggcacctactgtgttgtctgcttgataacgctggccagggatgcgatcgcctgcaatgtctgagccccattcacagccatcgtgggcacctactgtgttgtctgctcgataacgctggccagggatgcgatcgcctgcaatgtctgagccccattcacagccatcgtgggcacctactgtgttgtctgcttgataacgctggccagggatgcgatcgtctgcaatgtctgagccccattcacagccatcgtgggcacctactgtgttgtctgctcgataacgctggccagggatgcgatcgcctgcaatgtctgagccccattcacagccatcgtgggcacctactgtgttgtctgctcgataacgctggccagggatgcgatcgcctgcaatgtctgagccccattcacagc	449	46	10%	78	17%
9	121413151	121413450	cgggttttCGGCACCAATtgttattcgatgcgttctcacgaccggccaggaagaacacaacaaccagaatcttctacggcaaagctttattgcttacatcttatggggccagagtgtaagaagcaagagagagagaaaacgaaacccctttcctctttaaagagaacaacaattgcctaggacgcatcactccctgattggctgcagcccatggccgagctgacgttcacgggaaaaacagagtacaagtagtcgtaaatacccttggcacatgcgcagattatttgtttaccaactta	299	28	9%	50	17%
9	122439301	122439600	ggaggattcagaactgcatcacggggaaggagtggttaataaaagttcctgtaaaacagactgttgagaaggatccggcgtggattcagaactcttcagctggggaacggtactgatgaagagaaagaagaaagatgaagactgaataaactgctgttagaaggactggtggtcgcatcgttcttgctggtcgagagcaggcgcgacaattggtggcccgtacggggaaccgactcccccaccgagttcagaactttcagcagtcagtggttgccggcagggtaagttcaaggtgagtg	299	28	9%	32	11%
9	123197551	123198000	ttcaaggccaaacattttccactttacttctgatagactgtcttgaatttccttagaaagttcaaggccaggcgtacctcgtaaagctgtactcactggtactctcgttccccagctgaaaagttctgaattcatgcagttgaatccttcttaacagtctgctttacgggaacctttattaccgcgacccgcagttctggttctggaatgagggatcttccttgtgccggtcccgagttttcttgtattttttcgtcccggattttttctcgtcccgggtttcggcaccaattcttaatagcgttctcacgcccggccaggaaagacgcaacaaaccaaaatcttctgcggcaaaactttattgcttacatctttgggagccaggagggcaagcgcccagcgcccagccccaaaaacgaaagccccttcaataatgaaaccgaaacccc	449	46	10%	54	12%
9	123748501	123748650	taatttgtaagtattctaccggagcgtggacacgcccaccctcggctccttcaaagaccggaaatgcctgttgtattttcctttgttcctctctgggaatgaatgagtctgcgcactgcctctctgcgcactgcctctctgcgcattgc	149	16	11%	12	8%
9	123749251	123749700	caaggccaggcttacctcgtaaagctgtactcactggtactctcgttcccccagctgaaaagttctgaattcatacagttgaatccttcttaacagtctgctttacgggaacctttattaccgcgacccgcagttctggttctggaatgagggatcttccttgcgccagtcccgagttttttctcgtcccggaattcggcaccaattgttattagacgcgttctcacgaccggccaggaagaacaccacagaccagaatcttctgcggcaaagctttatttcttacatcttcaggagcaagcgtgtaagaagcaagagagcaagaagcaagagagagagaaaaacgaaaccccgtccctcttaaggagcattctccttcgcctcggacgtgtcactccctgattggctgcagcccatcggccgagttgacgtcacggggaaggcagagc	449	52	12%	60	13%
9	123924601	123925800	GGTCAGGTACGCACACCCGCCCCAGCAGAGCCTGCCGGGAGCTCAGCCTCCGcacacacggacagacagacagacagacagacagCCCCGCCTCTGCGTCCCCCTTGGCCGATGTGCGCGACACAGCGCCCCGGGCTTCCCGCCTCAGAGCGGCGCCGGCGGCCTCTGACTCTGTCCCGCGGGGCCGAGCCGGGACGCGGATCGCGTGAGCTCCTCGTTCAAGGCGGGGCGCGGAAGAGAGGAGCCGCGGCGACTCTGCTGTCCCCACCAGCCACGGCCCCGCCTCCTCCGCCGGCCGGGGGGGCCCCGCGTCCCCTGAGGGGGGACCTTCCGCGCAGGCGTCTCCCCGCCTCTGCCCGGTCGGCGCTGCCTGCGATCCCTTGTGTTCCAGAGTCCAGCACATTAACGAGTATTTGTGGCACACGTAGAgaggggcagaggcagggggattgctgagttggaggccagcctggtctacagagtgagctccaggacagccagggctacacagagaaaccctgtctcgaaaaaccaaaaaaagtttctgaggcagggggatgactgtgagtgtgtttctgaggcagggggatgaccaggaatgaatgtgtgaggcagggggatgaTCCCTGTGGCCTTTGGTCCTCACGGCGAGTGATTTTGGGGGTGGGGGAGGGGTCCCGCCCTGGGGAAAGCGAGACAGACGGGACCCGAGAATCCACACGGACAGTCTGGACCCCCGGCCCCTCCCGTCTGCAGCGCGGCCGCCATCGAGCCTCCCGGTGGTGACGTCATTTGAAAGAAGACAATGGAATCCTCACGACGGCCGCATTCTCCTCGGTCACCACCGGGTGGCGGCAGAGAGCACGCCGGGAAAAACTTCCGCTCCGGAAGTCCTCCAAGGGGTCGGATCTGCCCGTCGCCTCCCAGCCAGGGTGAGGGGAAGCCGGCCAGGCTGGCGGATCCGACCCGGTGAAGGGGTCGCGCTTTAAATCAGGGAGCACAGGCGCGGggagtgactgtctgaggcagggggttgatgctgagtgattgtttgaggcgggggaatgactgtgagtgagtttccgaggcagggagatgacctggattgaatgtgtgaggcagggggatgacgctgagtgactgtgtgaggcagggggatgactgtgagtgagtatctgaggcagggggatgacctggat	1199	178	15%	140	12%
9	123927301	123928200	ACGGAATGTGTTCAAGGATGAAAAGACAGAACCAGTAGGACTGGCTGGTTGTTACTCAGTAGCCATCACATTCTGCTTCCTCCCGAGAGCTCAAATAGCCTGTAGCCCCGCCTGTGCAGGGGTGATTGACATTCATATGACCAGTGAGTAACTGGATATCGTGTGCATTTCAAAAGCTCCCTTAGCACCTATTCAAGAGTAACCTCGCGAATCAACAACGGGGGACCTGTGAGGCAAGGTCAGAGTTGTAGGCAGTGATCCTCGGTGCGAGGCCGGCCCCACAGCCCTCGTTGGGCACAGCTGGCAGCACTGTAGCTGTGAGAGTCAGTGGTCATTTCACGTGTGGCGCCAGTGGAGGTCCAGTGGCACAGGGACTTGAGTCAATTATTTTGTTTAGGTGGAGAGAACCGTGCATGTGGAGGCAGATGTTTCCCCAAGCAAGGGAAAACAGAATCTGGGTCACTTCTGTTCTCAGAGATTGCCAGTGAGAGGAGCTGAGCTGGTGGCCCATCCATCTTGCTTGGGAATGGCTTCAGTGTCCCCCAACCTGACCTCTCTCATCTGCAGTCAATTGAAGAACTGGTGAACGATCAGCCTTTGCTCTGGGGTCCCACTGTGCGTCCTCTGTTGCTGTCTCTGAGCTTACTTTTCATTTGCATGATGAGCATATTACATATAAATAgtaaaaatcaccatgggacatcaggacttaaacaggaagcatgtattgtgtcatacagtcttgtgtgttgggaatttgagacatcttagtggggtcgtttcactacagtctctctcggacgagggagaacgtctactccgtcattaggagatttggctggaggtggggcttaattgctttcaggtgttcatgcctccggctgctcgcagagacctca	899	46	5%	144	16%
10	6080851	6081900	gcggacgctcagtgagaccgcgctccgagagggaacgcagggtggataaggatagacgtgtccaggtgtccaccgtccgttcgccctgggagacgtcccaggaggaacaggggaggaccagggacgcctggtggacccctttggaggccaagagaccatctggggttgcgagattgtgggttcgagtcccacctcgcgccttgttgcgagatcgtgggttcgagtcccaccttgtgttttgttgcgagatcgtgggtttgagtcccacctcgcgccttgttgcgagaccgtgtgtttgagtcccacctcgtgttttgttacgggatcgtgggttcgagtcccacctcgtgcagagggtctcaatcggccggccttagaaaggccatctgattctttgagttgcttgtggtcgatgcgaagtcgccgccgtttttggtttcttttttgtcttagtcttgtgttagctcttgttgtgtctactattattctagaaatgggacaatctgtgtccactcccctttctctaactctggagcattggaaggaggtgcaggtcagagcccacaaccagtcggtggaggtcagaaagggtccgtggcagaccttttgcgcctctgagtggccgacgtttggagtgggctggccaccagaaggtgcttttgacttgtcactaatcgctgccgtcaggcgaattgtttttcaggaggaagggggccaccctgatcagatcccctacattgtgacctggcagaatctcgtccaattcccacctccgtgggtcaagccttggaccccaaattcttcgaaactgacggtcgcggttgcccagtctgatgcagccggaaagtccggcccgtcagcaccccccaagatttatccagagattgacgacctcctctggatggactcccaacctcccccttaccccctgccccagcagccacctgcagccgccccaccacagggaccaatagcgagaggggctcagggaccggcgggggggactcggagccgccgaggccgaagccccggggaggaaggggggccgg	1049	130	12%	112	11%
10	6399301	6399900	TTTGGTGCATTGGCTGGGAATcagcgcgaccacccagaggtcctagacccacttagaggtaagattctttgttctgttttggtctgatgtctgtgttctgtttctaagtttggtgcgatcgcagtttcggttttgcggacgctcagtgagaccgcgctccgagagggaacgcggggtggataaggatagacgtgtccaggtgtccaccgtccgttcaccctgggagacgtcccagggggaacaggggaggaccagggatgcctggtggacccctttggaggccaagagaccatttggggttgcgagatcgtgggtttgagtcccacctcgtgcccagttgcgagatcgtgggttcgagtcccacctcgcgccttgttgcgagaccgtgggttcgagtcccacctcgcgtttggtcacgggatcgtgggttcgagtcccacctcgtgcagagggtctcaatcggccggccttagagaggccatctgattctttgagttgcttgtggtcgacgcagagtcgccgccgtttctggtttcttttttgtcttagtctcgtgtccgctcttgttgtgactactgtttttctagaaatgggacaat	599	84	14%	52	9%
10	7411651	7412100	cgaaagataattctccttaaaaggggacggggtttccgccattctctctcttacttgcgctcttgcgcttttgctctctggctctggcgcctgctcgcttgctccaaaagatgtaaacaatagagctcttgcttgcgctctggcgctctgcgcgctggcgctctggctcctaaagatgtaagaggggcgctttcatttttggggctgggggcttgcgctcctggctcctgaagatgtaagcaataaagttttgccgcagaagattctggtttgttgtgtctttcctggccggtcgtgagaacgcgtttaagaGTTGGTGCCGaaacccgggacgaaaaaatacaagaaaactcaggaccggcgcaaggaagatccctcatccggaaccaaaactgcgggtcacggtaataaaggttcccgtaaaacagactgttgagaaggattcaact	449	56	12%	28	6%
10	8401801	8402100	ggtctatagaaagtgctaagaattttcatcagctttatcatgtccctgcttctacattacgacaaaaatttaagctcacacgaacagaagcccgagatattgtcctacagtgtggtaaatgtgtagaatttattaatgcaccttccgtgggtgttaatcctcgtggattgcgacccctagatgtttggcaaatggacgtcacgcatatcccatcttttgggaaattacaatatgtacatgtatccattgataccagttctggtgtcctacatgcctctcccttgacaggggaaaaagca	299	16	5%	42	14%
10	8599351	8600700	aacgtcagctcggccatgggctgcagccaatcagggagtgatgcgtcctaggcgaaatataactctcctaaatagggaaggggtttcggtttcgatataggggtggctttcgcttttggggctgggggtttgcgctcctagctcctgaagatgtaagcaataaagttttgccgcagaagattctggtctgttgtgttcttcctggccgggcgtgagaacgcTattaagaattggtgctgaaatccgggacgaaaaaatacaagaaaactcgggaccggcgcaaggaagatccctcattccagaaccagaactgcgggtcgcggtaataaaggttcccgtaaagcagactgttgagaaggattcaactgcatgaattcagaacttttcagctggggaacgagagtaccagtgagtacagctttacgaggtaagtctggtcttgaactttctaaggaaattcaagacagtctatcagaagtaaagtggaaaatgtttggccttgaattttttctagtgttaggagcccttttgttccttttcacatgttatcaggtgattaagatagggctgaaaattctggatgaaattcagggcaatctatcagaagtaaagcggggagagagagtaggagcaaagagaaaatatggtacacaaaataagtatacaggcctttccacgggtcttgaacccgaggaaaagtttaggtcaggtaagaatacctggggagagattagaaggaaggaaaagaaaaaagaaaagaaaaaagatcgattagcggaggtctctaggagatactcgtcactagatgagctcaggaagccagctcttagtagctctgaagcagatgaagaattctcctctgaggaaacagactgggaggaagaagcagcccattaccagccagctaattggtcaagaaaaaagccaaaagcggctggcgaaagccagcgtactgttcaacctccgggcagtcggtttcaaggtccgccctatgcggagcccccgccctgcgtagtgcgtcagcaatgcgcagagagacaatgcgcagagaggcaatgcgcagagaggcaatgcgcagagaggcaatgcgcagagaggcagtgcgcagagaggcagtgcgcagagaggcagtgcgcagactcattcattcccagagaggaacaaaggaaaatacaacaggcatttccggtctttgaaggagccgagggtgggcgtgtccacgctccggtagaatacgtgcagattaaagaactcgccgagtcggtccgtaaatacggaaccaatgctaattttaccttggtgcagttagacaggctcgccggcatggcactaactcctgctgactggca	1349	120	9%	162	12%
10	11609251	11609400	GGCAAGTCGCTTCAGTGCTCGCCTCGGCCCGCGTGGTCGTGCCGGGATGGAGTCCTCCACGTCCTCTTCGGGCTCGGCTCTGGGCGCCGTGGACCCTCAGTTGCAGCATTTCATCGAGGTGGAGACGCAGAAGCAGCGCTTCCAGCAGC	149	30	20%	22	15%
10	18139201	18139500	atgtgccaagggtattttacgactacttgtactctgcctttcccgtgaacgtcagctcggccatgggctgcagccaatcagggagtgatgcgtcctaagcgaaggataactcctccttaaaggggacggggtttccgccattctctctcgctggcatctctctggctctgcgcgccctgcgctctctcgctgcctaaagatgtaaacaatagagcgcgctctgcgctttggcgcgccggagctctggctcctaaagatgtatatagaaggggctttcgcttttggggctgggggttttg	299	40	13%	18	6%
10	19538851	19539150	caatacctctcctgggcatatacccagaagatgttccaactgacaataaggacacatgtgttattaaacgcgttctcacgaccggccaggaaagacgcaacaaaccagaatcttctgcggcaaaactttattgcttacatcttcaggagcaagagtgtaagaagcaagagagagcgagaaaacgaaaccccgtccctattaaggagaattctccttcgcctaggacgtgtcactccctgattggctgcagcccatcggccgagttgacgtcacggggaaggcagagcacatggagtaga	299	30	10%	48	16%
10	19544551	19544850	tgcccatactagggagagcggcttttacaaccgtttgccagtcagcaggagttagtgccatgccggcgagcctgtctaactgcaccaaggtaaaattagcattggttccgtatttacggaccgactcggcaatttctttaatttgtaagtattctaccggagcgtggacacgcccaccctcggctccttcaaagaccggaaatgcctgttgtattttcctttgttcctctctgggaatgaatgagtctgcgcactgcctctctgcgcactgcctctctgcgcatctctctgcgcattgc	299	34	11%	34	11%
10	19545451	19545900	ccttagaaagttcaagatcagacttacctcgtaaagctgtactcactggtactctcgttccccagctgaaaagttctgaattcatacagttgaatccttcttaacagtctgctttacgggaacctttattaccgcgacccgcagttctggttctggaatgagggatcttccttgcgccagtcccgagttttttctcgtcccgggtttcggcaccaattgttattaaacgcgttctcacgaccggccaggaaagacgcaacaaaccagaatcttctgcggcaaaactttattgcttacatcttcaggagcaagagtgtaagaagcaagagagagcgagaaaacgaaaccccgtccctattaaggagaattctccttcgcctaggacgtgtcactccctgattggctgcagcccatcggccgagttgacgtcacggggaaggcagagcaca	449	52	12%	56	12%
10	19797451	19797900	aggtggaggataattctccttaaaaagggatggggtttcgccatttgcgggcttgctctcttgcttcttgcgggcttgctctcttgcactctggctcctgaagatgtaagcaataaagctttgccgcagaagattctggtttgttgcgtctttcctggccggtcgtgagaacgcgtctaataacaattggtgccgaaacccgggacgagaaaaaactcgggactggcgcaaggaagatccctcattccagaaccagaactgcgggtcgcggtaataaaggttcccgtaaagcagactgttaagaaggattcaactgtatgaattcagaacttttcagctggggaacgagagtaccagtgagtatagctttacgaggtaagcctggccttgaactttctaaggaaattcaagacagtctatcagaagtaaagtggaaaatagctttataa	449	40	9%	34	8%
10	19798501	19798800	cagagaggcaatgcacagactcgttcattccaaaggaggaacaaaggaaaatacaacaggcatttccggtctttgaaggagccgagggtgggcgtgtccacgctccggtagcgtatatacagattaaagagcttgccgagtcggtccgtaactatggagtcagtgctaatttcactatagcacaagtggaaaggcttgcgaatcacgctatgactcctggtgattggcaaacggttgtaaaagccgctctccctagtatgggcaaatatatggaatggagagcgctttggcacaaagct	299	30	10%	42	14%
10	22337701	22337850	gaacagggacctgaagaatggcagaaggacgctgagagaatgctgtccgtgtggagctccatgggaaaagcaaacggtcttcatattgggcaccggagcaacgaacaggtatatatgctagcacaagcttaaaatttcatttttttaaa	149	10	7%	22	15%
10	22689001	22689150	caccaaggtaaaattagcattggttccgtatttacgaaccgactcagcaatttctttaatttgtaagtattctaccggagcgtggacacgcccaccctcggctccttcaaagaccggaaatgcctgttgtattttcctttgttcctctc	149	16	11%	16	11%
10	23459251	23459850	AACCTTTTCCATGTAAATGAAGGGTGTCAGCAAATACTtgtggagagccgttacatgctgcgagcaattgcatgcgtgctgccagtaatctctgaggagagccgtgtgtgccgcgagcaatcgccattataagatggcgcgggcctccgctgtgcctaactagtaaacaagtcctgtacgcaggtgcaagagtgaattcactcctagtcactcccattctcggggtgtaatagtggggtgatgggcaagcaacgaaccaggagctgtcacgccatatcaggtgctgaaacgtcacgctgcgggttataaaagcagcgccattttcccggtttgggatcttcctgagaagcaagcaataaagcttttgccgtggaagattctggtttgttgcgtctttcttgccggtcgagcgggacgcaataagtggcaccgacgaacccgggaactgtcatcacaccggcgcaaggaagatccctcgtttgcggggcagaatcagaaccgtgggacaaaaggctctacaaggtacgtacaatcttgaaatttcttcagagttagaagcccttttgattgtttgcacggcgattatgaggactgtcagc	599	72	12%	80	13%
10	23726251	23726700	cGACAATATATGTTCTTAGTCACTGAGCCATCTCTCAAACTCAGTCTTCTAAATTGAAAATAAGATTGTATACACTGTAAACTGATCATtgttgggagccgcccccacattcgccgtcacaagatggcgctgacatcctgtgttctaagtggtaaacaaataatctgcgcatgtgccaagggtattttacgactacttgtactctgcctttcccgtgaacgtcagctcggccatgggctgcagccaatcagggagtgatgcgtcctaggcgaaatataacgctcctaaaaaaggggacggggtttgccgccattctctctctggctctgcgcgccctggcgcactgcgctctctcgctgccaaaagatgtaaacaatagagcgcgctctgcgctttggcgcgccggagctctggctcctaaagatgtaaggaggggtggctttcgcttt	449	52	12%	48	11%
10	23808151	23809050	GGACTGCCTTGTTTATTTTACCTTTAGTTAATTTTATGCAGCATAAAATCAGAAACGTATGAAATGGAATACAGAATATGGTAAATGTTTGACACATCGCATTGCTGTTCTGACTGCAAGCACACATCTGCCATCCAGGCACCCAGTGCCCGAGCTACTCCAAGACGGCTTCTTCCCAAGATTCCATATCTACGCatgcatacgaatacatatgcacacgtacacacaagtacatgtgcacacttatacacatgcagacaggtacatatgcacacgtacacacaagtacatgtgcacacttatacacatgcagacaggtacatatgcacacatacacacaagtacatgtgcacacttatacacatgcagacaggtacatatgcacacgtacacacaagtacatgtgcacacttatacacgtgcagacaggcacatatgcacacgtacacacaagtacatgtgcacacttatacacatgcagacaggtacatatgcacacgtacacacaagtacatgtgcacacttatacacatgcagacaggtacatatgcacacgtacacacaagtacatgtgcacacttatacacgtgcagacaggtacatatgcacacgtacacacaagtacatgtgcacacttatacacatgcagacaggtacatatgcacacgtacacacaagtacatgtgcacacttatacacgtgcagacaggtacatatgcacacgtacacacaagtacatgtgcacacttatacacatgcagacaggtacatatgcacacgtacacacaagtacatgtgcacacttatacacgtgcagacaggtacatatgcacacgtacacacaagtacatgtgcacacttttacacgtgcagataggtacatttgtatacacacacat	899	44	5%	352	39%
10	23871301	23871600	ggaggaaatatggaatcaaagtgtCttatacgcgttctcacgcgcccggccaggaaagaacacaacaaaccaaaatcttctgcggcaaaactttattgcttacatcttcaggagccaggagcgcaaacccccagccccaaaagcgaaagccaccccaataacgaaaccgaaaccccttccctatttaggagagttatatttcgcctaggacgcatcactccctgattggctgcagcccatggccgagctgacgttcacgggaaaggcagagtacaagtagtcgtaaaatacccttggca	299	32	11%	48	16%
10	23878051	23878350	ccggtcccgagttttcttgtattttttcgtcccggatttCAGCACCAATTCttattagcgttctcacgcgcccggccaggaaagaacacaacaaaccaaaatcttctgcggcaaaactttattgcttacatcttcaggagccaggagcgcaaacccccagccccaaaagcgaaagccaccccaataacgaaaccgaaaccccttccctatttaggagagttatatttcgcctaggacgcatcactccctgattggctgcagcccatggccgagctgacgttcacgggaaaggcagagta	299	36	12%	48	16%
10	25458601	25458900	gaggtcacatcagtcagggtcgggggcggagttcatatgacttgtgcgaggtcacgtcagtcagggtcgggggcggagttcatatgacttgtgcgaggtcacgtcagtcagggtcggggacggagttcatatgacttgtgcgaggtcacgtcagtcagggtcgggggcggagttcatatgacttgtgcgaggtcacgtcagtcagggtcgggggcggagttcatatgacttgtgcgaggtcacatcagtcagggtcgggggcggagttcatatgacttgtgcgaggtcacatcagtcag	299	44	15%	60	20%
10	25517851	25518150	gccaggaagaacgcaacaaaccggaatcttctgcggcaaaagctttattgcttacatcttcaggagccagagagcaagagggcaagagctctattgcttacatctttaggagccagagcacaagagcgcaagagctttattgcttacatcttcaggagcaagaagcaagagagagaatggcgaaaccccgtcccttttaaggagaattattctccgcctaggacgtattactccctgattggctgcagcccatcggctgagttgtcgtcacggggaaggcagagcacatggggtggaaa	299	22	7%	48	16%
10	25896601	25897050	aaggaccattggacggacgttagggctagaggacaaaatttgtcagtaaaagtgaagaaaaagccatggatgactttctgttcctcagaatggcctgtttttggagtaggttggccagcagaaggaactttttacttacccaccataagggctgtgaaggccattgtttttcaggaaggaccagggtcgcatccagaccaacaaccgtacatcatggtatgggaggacttggcacgctacccacccccgtgggttcgcccattcctcccgcctctccgccctggcaccaagattctagccatccgagaaaatggtgagaaagagaaaccgaaaccaccgctcgggagagatgatgatcgcagcacaccagtgacgaaaccccccaagatctattcagagattgaagaaccccctgagtggcccgatacccctcaacccccaccttatgc	449	32	7%	66	15%
10	25968601	25968900	aaatataactctcctaaaaaagggacggggtttcgttttctctctctcttgcttcttacactcttgctcctgaagatgtaagcaataaagttttgccgcagaagattctggtctgtggtgttcttcctggccgggcgtgagaacgcgtctaataacaattggtgccgaattccgggacgagaaaaaaactcgggactggcgcaaggaagatccctcattccagaaccagaactgcgggtcgcggtaataaaggttcccgtaaagcagactgttaagaaggattcaactgcatgaattca	299	32	11%	24	8%
10	26168401	26168700	tgtgtgcagaaggatcctgtagcagcgtcgttcttcctggcctgttgagtgcgcgcaacaagtggtgctgaaacccgggaaaagaaacatcttcaggcaagagcgaagggaggattcagaactgcataacggggaagaaggggttaataaaggttcctgtgaaacagactgttgagaaggatccggcgtggattcagaactattcagctggggaacggtactgatgaagagaaagaagaaagatgaagactgagtaaactgctgttagaaggactggtggtcgtgtcgttcttgctggt	299	24	8%	24	8%
10	29010451	29010750	agcaaaagcaagagtgcaagagcaagagctctattgcttacatctttaggagccagagcgcaagagcgcaagagtgcaagagcaaaagcaagagagagaatggcgaaaccccgtccctttttaaggagaattattctccgcctaggacgtattactccctgattggctgcagcccatcggccgagttgtcgtcacggggaaggcagagcacatgtagtggaaaactacccttggcacatgcgcagattatttgtttaccacttagaacacaggatgtcagcgccatcttgcaacggcga	299	28	9%	52	17%
10	30481651	30482850	cctgaagatgtaaacaataaagttttgccgcagaagattctggtttgttgtgttcttcctggccggtcgtgaaaacgcgtttaagaGttggtgccgagaacccgggaagagaaaacccgggacgggagttaaccatcaccggcgcaaggaagattcctcattccggaaccagaactgcgggtcacggtcataaaggttaccgtaaaacagactgttgagaaggattcaactgcgtgaattcagaactcttcagctggggaacagggtacccgtaagtatagctttacaaggtacgcctggccttgaactttctaacgaaattcaagacagtctatcagaagtaaagtgggaaatagctttacaaggtatgtttggccttaaattttttctagtgttaggagcccttttgttctttttcacatgttatcaagtgattaaggcagggctgaaaattctggatgaagttcagggcagtctatcagaagtaaagcggggagagagaataggagcaaagaggaaatatggtacacaaaataagtatacaggcctttccaagggtcttgaacccgaggaaaagttaaggtcaggtaagaatacctggggagagattagaaggaaggaaaagaaaaaagaaaagaaaaaagatcaattagagaagccagctcttagtagctctgaatcagatgacgaattctcctctgaagaaacagactgggaggaagaagcagctcgttttgagagagaaaaatgccagccagataaaatgcgagctaattggtcaagaaaaaagccaaaagcggctggcgaaggccagtttactgcttggcctccgggcagtcggcttcaaggtgcacttccgccctatgcggagcccccaccctgcgtagtgcgtcagccctgcgcagagagacaatgcgcagagagacaatgcgcagagaggcaatgcgcagactcattcattcccagagaggaacaaaggaaaatacaacaggcatttccggtctttgaaggagccgagggtgggcgtgtccacgctccggtagaatatgtgcagattaaagaacttgccgagtcggtccgtaaatacggaaccaatgctaattttaccttggtgcagttagacaggcttgccggcatggcactaactcctgccgactggcaaacgattgtaaaagccgctctccctagtatgggcaaat	1199	98	8%	140	12%
10	31088701	31089150	aactcggccgatgggctgcagccaatcaaggagtgacacgtccgaggcgaaggagaatgctccttaagagggacggggttttcgttttctctctctcttgcttcgctctcttgcttttctctctctcttgcttttctctctctcttgcttctctctcttgcttcttgctctcttttcctgaagatgtaagaataaagctttgccgcagaagattctggtctgtggtgttcttcctggccggtcgtgagaacgcgtcgaataacaattggtgccgaattccgggacgagaaaatccgggacgagaaaaaactccggactggcgcaggagggatacttcattccagaaccagaactgcgaatcaaggttataaggttcccgtaacacagactgttgagaaggattcaactgccgaattcagaactcatcagctggggaacgacggtgataa	449	52	12%	34	8%
10	31482601	31483050	TTTACAGGAGTTACACAATACTGTACATGtgttgggagccgcgcccacattcgccgttacaagatggcgctgacagctgtgttctaagtggtaaacaaataatctgcgcatgtgccgagggtggttctccactccatgtgctctgccttccccgtgacgtcaactcggccgatgggctgcagccaatcagggagtgacacgtcctaggcgaaggataattctccttaatagggacggggtttcgttttctctctctcttgcttcttacactcttgctcctgaagatgtaagcaataaagttttgccgcagaagattctggtctgtggtgttcttcctggccgggcgtgagaacgcgtttaataacaattggtgccgaaacccgggacgagaaaaaactcgggactggcgcaaggaagatccctcattccagaaccagaactgcgggtcg	449	54	12%	50	11%
10	31483651	31483950	gccaggtaaagtgctagctaatcagttaaggaagccaaaagcggctggcgaaggccagtttgctgattggcctcagggcagtcggcttcaaggtccgccctatgcggagtccccgccctgcgtagtgcgtcagccctgcgcagagagacaatgcgcagagaggcagtgcgcagactcattcattcccagagaggaacaaaggaaaatacaacaggcatttccggtctttgaaggagccgagggtgggcgtgtccacgctccggtagaatacttacagattaaagagcttgccgagtcgg	299	36	12%	44	15%
10	33886951	33887100	gacacgtccgaggcgaaggagaatgctccttaagagggacggggtttcgtttttctctctctcttgcttttctctctctcttgctttttcgctctcttgcttctcgctctctcttgcttcttgctctcttgcttcttgcactctgttcc	149	14	9%	4	3%
10	34351051	34351200	cacacacggacatacacatagggacatacacacatacagagacacagacacacacatggacatacacatagggacatacacacatacagagacacagacacacacatggacatacacatagggacatacacacatacagagacacagac	149	2	1%	82	55%
10	34747501	34749600	cttttacaaccgtttgccagtcggcaggagttagtgccatgccagcgagcctgtctaactgcaccaaggtaaaattagcattggttccgtatttacgaaccgactcggcaatttccttaatttgtaagtattctaccggagcgtggacacgcccaccctcggctccttcaaagaccggaaatgcctgttgtattttcctttgttcctctctgggaatgaatgagtctgcgcactgcctctctgcgcactgcctctctgcgcattgctgacgcactacgcagggcggggactccgcatagggcggaccttgaagccgactgccctgaggccaatcagcaaactggccttcgccagccgtttttggcttttttcttgaccaattagctggctggtaatgggctgcttcttcctcccagtctgtttcctcagaggaggattcttcacctgcttcagagctactaagagctggcttcccgagcccatccagcgatgagcacaggctccttttcctagagacctccgctaattgatctttcttcttttccctttttcctctttttcttctaatctctctccaggtattcctacctaaccttaacttttcctcgggttcaagacccttggaaaggcctgtatacttattttgtgtaccatattttctctttgctcctactctctctccccgctttacttctgatagcttgtcctgaatttcatctagaatcctccctatcttaaccacttgataacatgtgaaaaggaacaaaagggcttctaacactagaaaaaattcaaggccaaatataccttgcaaagccattttccactttacttctgatagactgtcttgaatttccttagaaagttcaagatcagacttacctcgtaaagctgtactcactggtactctcgttccccagctgaaaagttctgaattcatacagttgaatccttcttaacagtctgctttacgggaacctttattaccgcgacccgcagttctggttctggaatgagggatcttccttgcgccagtcccgagttttttctcgtcccggaattcggcaccaattgttattagacgcgttctcacgaccggccaggaagaacaccacagaccagaatcttctgcggcaaagctttatttcttacatcttcaggagccagggtgcaggaagcaagagagcaagaagcaagagagcgagaaaacgaaaccccgtccctcttaaggagcattctccttcgcctcggacgtgtcactccctgattggctgcagcccatcggccgagttgacgtcacggggaaggcagagcacaagtagtcataagatacccttggcacatgcgcagattatttgtttaccacttagaacacagcatgtcagcgccatcttgtaacggcgaatgtgggggcggctcccaacagttccccagctgaggagttctgaatccaggccggatccttctcaacagtctgttttacgggaacctttatgaccgtgacccgcagttctggttccggaatgagggatcttccttgcgccggtgatggtaaccgtccagggttttctcatcccaggatttctcgtcctgggttttctcgtcccaggtttcggcaccaactcttaCACGCGTTCTctggtacaaccactctggaaatcagtctggcagttcctcagaaagttagacacattactacctgaggacatagtactactggagagtccagcaatacctctcctaggcatagacccaaatgatgttccaacttataatgaggacacatgctccattatgttcatagtagccttatttataatagccagaagtcttacacgcgttctcgcgaccggccaggaaagacgcaacaaaccggaatcttctgcggcaaagctttattgcttacatcttcaggagtcagagagcaagagagcaagagctctattgcttacatctttaggagccagagcgcaagagagcaagagagtaagagtgcaagagagcaagagagagaatggcgaaaccccgtcccctttaaggagaattatcctccgcctaggacgtgtcactccctgattggctgcagcccatcggccgag	2099	174	8%	276	13%
10	39760951	39761100	gagtgcagagcaagagctctattgtttacatctttaggagcaagcgagcaagagccagagccagagagcaaaagcgcaagagcgcaagcaagagagagaatggcggaaaccccgtcccctttaaggagaattatccttcgcctaggaca	149	12	8%	24	16%
10	39764101	39764550	tggttccggaatgagggatcttccttgtgccggtgatggttaactcccgtcccgagttttcttgtattttctcgtcccgggttttttcttcccggattttttcgtcccagattttctcgtcccggattttttcgtcccgggtttcggcaccaACtcttaaacgcgttctcacgaccggccaggaagaacacaacaaaccagaatcttctgcggcaaaactttattgcttacatcttcaggagcaggagcgcaagccccaagccccaaaaacgaaaaagccccccgcttacatctttaggagccagagcgccagcgcgccagagcgccagagcgcagagcaagagctctattgtttacatctttaggagcaagcgagcaagagccagagccagagagcaaaagcgcaagagcgcaagcaagagagagaatggcggaaaccccgtcccctt	449	62	14%	64	14%
10	39971251	39972150	ctgcacacactgtctcatacttacacatgacgtaagatctctgcacacactgtctcgtacttacacatgacgtaagatctctgcacacactgtctcgtacttacacatgacgtaagatctctgcacacactgtctcgtacttacacatgatgtaagatctctgcacacactgtctcgtacttacacatgacgtaagatctctacacacaccgtctcatacttacacatgatgtaagatctctacacacaccgtctcatacttacacatgacgtaagatctctgcacacactgtctcgtacttacacatgacgtaagatctctgcacacactgtctcgtacttacacatgacgtaagatctctacacacaccgtctcatacttacacatgatgtaagatctctacacacaccgtctcatacttacacatgacgtaagatctctgcacacactgtctcgtacttacacatgacgtaagatctctacacacaccgtctcatacttacacatgatgtaagatctctacacacaccgtctcatacttacacatgacgtaagatctctgcacacactgtctcgtacttacacatgacgtaagatctctgcacacactgtctcgtacttacacatgacgtaagatctctacacacactgtctcatacttacacatgacgtaagatctctacacacactgtctcgtacttacacatgacgtaagatctctacacacactgtctcatacttacacatgatgtaagatctctacacacaccgtctcatacttacacatgacgtaagatctctacacacactgtctcatacttacacatgacgtaagatcgctgcacacactgtctcgtacttacacatgacAGCCAACCAGGCACATTAGCAAAGGCTT	899	70	8%	252	28%
10	41840401	41841900	TTTATTCCAGCTGGCCTCAAAGATTCTACttttttttttttAATGCCTCAAGGTTAGAATTAAATTTTCTTACACTTAGTTTTTAACTATAAGAGGTTCCTCAGATTGACTAGAATGTTAAGTTATTGTCtgttgggagccgcgcccacattcgccgttacaagatggcgctgacagctgtgttctaagtggtaaacaaataatctgcgcatgtgccgagggtggttcttcactccatgtgctctgccttcctcgtgacgtcaactcggccgatgggctgcagccaatcagggagtgacacgtcctaggcgaaggaaaattctccttaatagggacggggtttcgttttctctctctcttgcttcttacactcttgctcctgaagatgtaagcaataaagttttgccgcagaagattctggtctgtggtgttcttcctggccgggcgtgagaacgcgtttaataacaattggtgccgaattccgggacgagaaaaaactcgggactggcgcaaggaagatccctcattccagaaccagaactgcgggtcgcggtaataaaggttcccgtaaagcagactgttaagaaggattcaactgtatgaattcagaacttttcagctggggaacgagagtaccagtgagtacagctttacgaggtaagtctgatcttgaactttctaaggaaattcaagacagtctatcagaagtaaagtggaaaatggctttgcaaggtatatttggccttgaattttttctagtgttagaagcccttttgttccttttcacatgttatcaagtggttaaggcagggcggattctagatgaaattcaggacaagctatcagaagtaaagcggggagagagagtaggagcaaagagaaaatatggtacacaaaataagtatacaggcctttccaagggtcttgaacccgaggaaaagttaaggttaggtaggaatacctggagagagattagaagaaaaagaggaaaaagggaaaagaagaaagatcaattagcggaggtctctaggaaaaggagcctgtgctcatcgctggatgggctcggggagccagctcttagtagctctgaagcagatgaagaattctcctctgaggaaacagactgggaggaagaagcagctcattatgagaaaaaagggtaccagccaggtaaagtgctagctaatcagttaaggaagccaaaagcggctggcgaaggccagtttgctgattggcctcagggcagtcggtttcaaggtccgccctatgcggagcccccgccctgcgtagtgcgtcagcaatgcgcagagagatgcgcagagaggcagtgcgcagagaggcagtgcgcagactcattcattcccagagaggaacaaaggaaaatacaacaggcatttccggtctttgaaggagccgagggtgggcgtgtccacgctccggtagaatacttacaaattaaagaaattgccgagtcggtccgtaaatacggaaccaatgct	1499	116	8%	162	11%
10	43255501	43256100	tttcaggacagccaggtctaaatagaaaaaccctgtctcaaaaatcaaacacaccctccccaaaacaaaacaaaaaGCCATAGATCTAAGCATCAGGAAAAAATATGCAACtattgcgtctcgctcgaccggcaagaaagacgcaacaaaccagaatcttccgcggcaaaagctttattgcttgcttctcaggaagatcccgaactgggaaaatggcgctgcttttataacccgcagcgtgacgtttcagcacctgatatggcgtgacagctcccgattcgttgcttgcccatcaccccactattacaccccgagaatgggagtgactaggagtgaattcactcttgcacctgcgtacaaggcttgtttactagttaggcacagcggaggcccgcgccatcttataatggcgattgctcgcggcacacacggctctcctcagagattactggcagcatgcacgcaattgctcgcagcatgtaccggctctccacaTGCAACTGTTGATGTATCTTTTCTCCTCTTTTGTGACTTAAATACTAAGTGTTCTTTCCCCAGTACTGTTCACTGCTGCCCTGGTTGGTTATTCTATCCCATGG	599	54	9%	100	17%
10	43877401	43877700	ctggctcctaaagatgtaagcaatagagctcttgcgctcttgctctcttgctcctgaagatgtaagcaataaagcttttgccgcagaagattctggtttgctgcgttcttcctggccggtcgcgtgaacgcgtgtaagaGttggtgctgaaacccgagatgagaaaacccgggacggttaccatcacctgcgcaaggaagatccctcattccggaaccagaactgcgggtcatggtaatgaagtgttcccgtaaaacagactgttgagaaggattcaactgcgtgaattcagaactctt	299	32	11%	24	8%
10	45558751	45559050	taaaattagcattaattccatatttacgaaccgattcggcaatttctttaatttgtaagtattctaccggagcgtggacacgcccaccctcggctccttcaaagaccggaaatgcctgttgtattttcctttgttcctctctgggaatgaatgagtctgcgcactgcctctctgcgcactgcctctctgcgcattgctgacgcactacgcagggcggggactccgcatagggcggaccttgaagccgactgccctgaggccaatcagcaaactggccttcgccagccgcttttggcttt	299	38	13%	32	11%
10	51883201	51883350	ctaggcgaaatataactctcctaaaaaagggacggggtttcgttttctctctctcttgcttcttgcactctggctcctgaagatgtaagcaataaagctttgccgcagaagattctggtttgttgcgtctttcctggccggtcgtgaga	149	14	9%	6	4%
10	55635451	55636050	gagcgaacacgagactaagacaaaaaagaaaccaaaaacggcggcgacttcgcgtcgaccacaagcaactcaaagaatcagatggcctttctaaggccggctgattgagaccctctgcacgaggtgggactcgaacccactatcccgtaacaaaacacgaggtgggactcgaacccacggtctcgcaacaaggcgcgaggtgggactcgaacccacgatctcgcgacaaaacacgaggtgggactcgaacccacgatctcgcaacaaggcacgaggtgggactcgaacccacgatctcgcaaccccagatggtctcttggcctccaaaggggtccaccaggcgtccctggtcctcccctgttcctcctgggacgtctcccagggcgaacggacggtggacacctggacacgtctatccttatccaccccgcgttccctctcggagcgcggtctcactgagcgtccgcaaaaccgaaactgcgatcgcaccaaacttagaaacagaacacagacaccagaccaagacagaacaaagaatcttacctttaagtgggtctaggacctctgggtggtcgcgctgatcccggacgagcccccaa	599	100	17%	90	15%
10	56720851	56722050	actacttgtgctctgccttccccgtgacgtcaactcggccgatgggctgcagccaatcagggagtgacacgtccgaggcgaaggagaatgctccttaagagggacggggtttcgttttctctctctcttgcttctctctctcttgcttcttgctctcttgcttcctgcaccctggctcctgaagatgtaagaataaagctttgccgcagaagattctggtctgtggtgttcttcctggccggtcgtgagaacgcgtctaataacaattggtgccgaattccgggacgagaaattccgggacgagaaaaaactcgggactggcgcaaggaagatccctcattccagaaccagaactgcgggtcgcggtaataaaggttcccgtaaagcagactgttaagaaggattcaactgcatgaattcagaacttttcagctggggaacgagagtaccagtgagtacagctttacgaggtaagtctgatcttgaactttctaacgaaattcaagacagtctatcagaagtaaagtggaatatgtttggccttgaattttttctggtgttaggagcccttttgttccttttcacatgttatcaagtgattaagatagggctgaaaattctagaggaaattcaggacaagctatcagaagtaaagcggggagagagagtaggaacaaagaggaaatatggtacacaaaataagtatacaggcctttccaagggtcttgaacccgaggaaaagttaaggttaggtaggaatacctggagagagattagaagaaaaagaggaaaaagggaaaagaagaaagatcgattagcggaggtctctaggagatactcgtcactagatgagctcaggaagccagctcttagtagttctgaagcagatgaagaattctcctctgaggaaacagactgggaggaagaagcagcccattaccagccagctaattggtcaagaaaaaagccaaaagcggctggcgaaggccagtttgctgattggcctcagggcagtcggcttcaaggtccgccctatgcggagtccccgccctgcgtagtgcgtcagcaatgcgcagagaggcagtgcgcagagaggcagtgcgcagactcattcattcccagagaggaacaaaggaaaatacaacaggcatttccggtctttgaaggagccgagggtgggcgtgtccacgctccggtag	1199	98	8%	126	11%
10	57137701	57138150	tgttgggagccgcgcccacattcgccgttacaagatggcgctgacatcctgtgttctaagtggtaaacaaataatctgcgcatgtgccaagggtatcttatgactacttgtgctctgccttccccgtgacgtcaactcggccgatgggctgcagccaatcagggagtgacacgtccgaggcgaaggagaatgctccttaagagggacggggtttcgttttctcgctctcttgcttcttgctctcttgcttcctgcaccctggctcctgaagatgtaagaaataaagctttgccgcagaagattctggtctgtggtgttcttcctggccggtcgtgagaacgcgtctaataacaattggtgccgaattccgggacgagaaaaaactcgggactggcgcaaggaagatccctcattccagaaccagaactgcgggtcgcggtaataaaggt	449	58	13%	38	8%
10	58224151	58224750	tccaaattcagaggggctggagcaggctcttctacttggacttcatccagcagctgatcaaggaggggttccatagagcctgcgttgcctgcttgagtgggggcctcttgttggactgctccacggggctgtgccacttggaaaggctgggactctccgcaggaggagggcaagtcgctagggctcgaggtatccatgcccgtacttcctgcttcttcctgtggcaacaagctctcctgggcaccttcacgctctctgccTTCCGGACCTGCAGGGGCCCCATCCGACCCTTGTGACGCCAGCAAGTCTTGATCTTGAGCTGTGGGCCTGCCCCTCCTGTGGCGCCACCGAGCTCTTCGGTTTTGAAACCATATGTGGATCGTGTCCTCGGGCAACCCTGTGTCACGCGCCAGCTCCTCCCTGGTAGCAAAGCCTGGTCGTGGGTTCCTCTCAAAGGCTTGCCCTAGGATCCTGCGCTGTAGCGAGGTGAGTCGAGTGCGAGGCCTTCTGCCAGATGAGCGCATGCCTCTACCCTGTGGCCTGGATCCAAGCTCTTCCTGGAGCTGTGGCGAGGCTAGCCGCCTGGAGCCTCTGATGGA	599	50	8%	62	10%
10	58231801	58232400	cttcatgcaccctgccaccagggtctccatccaaattcagaggggctggagcaggctcttctacttggacttcatccagcagctgatcaaggaggggttccagagagcctgcgttgcctgcttgagtgggggcctcttgttggcctgctccacggggctgtgccacttggaaaggctgggactctctgcagaaggagggcaagtcgctagggctcgaggtatccatgcccgtacttcctgcttcttcctgtggcaacaagctctcctgggcaccttcacgctctctgccTTCCGGACCTGTAGGGGCCCCATCCGACCCTTGTGACGCCAGCAAGTCTTGATCTTGAGCTGTGGGCCTGCCCCTCCTGTGGCGCCGCCGAGCTCTTCGGTTTTGAAACCATATGTGGATCGTGTCCTCGGGCAACCCTGTGTCACGCGCCAGCTCCTCCCTGGTAGCAAAGCCTGGTCGTGGGTTCCTCTCAAAGGCTTGCCCTAGGATCCTGCGCTGTAGCGAGGTGAGTCGAGTGCGAGGCCTTCTGCCAGATGAGCGCAGGCCTCTACCCTGTGGCCTGGATCCAAGCTCTTCCTGGAGCTGTGGC	599	46	8%	68	11%
10	58233451	58233750	TGAACAGGCACACCCTCAGACcacacacacacatacacacatttgcatgcatgcacgcacacacgcacacacgcacacacaaacacgtacacacatgcgggcacacacaagcacaaacacacacacacacacaaacacacacacaTCATGCTCACAAATATCCTAAGGGAAGATAAAGTCACGACCATGGGTGGGGTTAGGGGCAGAGGAAGACACGAAGAGAGAGACAAACACAGATGTGGAGAGAAGGGGGGAAGGGATTTAGGGACAGAGGGTGGAGGGTGGTAGGGAGAGAGTGA	299	14	5%	120	40%
10	58237501	58237650	AGCCCCTAGGCACCTGGCAGCAACACACAGAGACAATTGTGAACAGGCACACCCTCAGACcacacacacacttacacacatttgcatgcatgcacgcacgcatgcacacacaaacacatgcacacatgcgggcacacacaagcacaaac	149	6	4%	78	52%
10	61283101	61283400	aattgccctgagctttgccacactaagtaagcactgtactatccccaggccccttcctcttttatttattattttagtttttattactattatatttttatattattataaatatattctcttacacgcgttcacgcgaccggccaggaagaacgcaacaaaccggaatcttctgcggcaaagctttattgcttacatcttcaggagccagagagcaagagagcaagagctctattgcttacatctttaggagccagagagcaagagcaagagagagaatggcgaaaccccgtcccttt	299	20	7%	38	13%
10	62223901	62224050	gtatatacacacacacacacacacacatatgaacacatacacacacacaagcacacacccgctcatacacatatatacacacacacatgaacacatacatatacacatacacacacacaagcacacacccgctcatacacatatataca	149	4	3%	90	60%
10	62608951	62609700	taaacaaataatctgcgcatgtgccaagggtattttatgactacttgtactctacctttcccgtgaacgtcagctcggccatgggctgcagccaatcagggagtgatgcgtcctaggcgaaatataacgctcctaaaaaaggggacggggttttccgccattctctctcgctggcatctctctggctctgcgcgccctgcgctctctcgctgcctaaagatgtaaacaatagagcacgctctgcgctttggcgcgccggagctctggctcctaaaaatatagaaggggctttcgtttttggggctgggcgctgggcgcttgccctcctggctcccaaagatgtaagcaataaagttttgccgcagaagattttggtctgttgtgttcttcctggccgggcgtgagaacgcTattaagaattggtgctgaaacccgggacgagaaaatccgggacgagaaattccgggacgaaaaaaaaatccgggaagaaaaaacccgggaggaaactcgggacgggagtttcaccggcgcaaggaagatccctcattccagaaccagaactgcgggtcgcggtaataaaggttcccgtaaagcagactgttaagaaggattcaactacatgaattcagaacttttcagctggggaacggcggtaacccgtaagtatagctttacgaggtaagcctggccttgaactttctaaggaaattcaagacagtctatcagaagtaaagtggaaaatagcttta	749	92	12%	56	7%
10	62613001	62613300	gccaatcagggagtgatgcgtcctaggcgaaatataacgctcctaaaaaaggggacggggttttccgccattctctctcgctggcatctctctggctctgcgcgccctgcgctctctcgctgcctaaagatgtaaacaatagagcacgctctgcgctttggcgcgccggagctctggctcctaaaaatatagaaggggctttcgtttttggggctgggcgctgggcgcttgccctcctggctcccaaagatgtaagcaataaagttttgccgcagaagattttggtctgttgtgttctt	299	38	13%	18	6%
10	63104101	63104400	agggagtgacacgtcctaggcgaaggataattctccttaatagggacggggtttcgttttcgcgcgctcttgcttcttacactcttgctcctgaagatgtaagcaataaagttttgccgcagaagattttggtttgctgtgttcttcctggccgggcgtgagaacgcgtttaataacaattggtgccgaattccgggacgagaaaaaactcgggactggcgcaaggaagatccctcattccagaaccagaactgcgggtcgcggtaataaaggttcccgtaaagcagactgttaagaag	299	42	14%	20	7%
10	66728101	66728400	ccattccatatatttgcccatactagggagagcggcttttacaaccgtttgccagtcggcaggagttagtgccatgccggcaagcctgtctaactgcaccaaggtaaaattagcattggttccatatttacggaccgactcggcaagctctttaatctgtaagtattctaccggagcgtggacacgcccaccctcggctccttcaaagactggaaatgcctgttgtattttcctttgttcctctctgggaatgaatgagtctgcgcactgcctctctgcgcactgcctctctgcgcact	299	28	9%	38	13%
10	66729151	66729600	acagtctgctttacgggaacctttattaccgcgacccgcagttctggttctggaatgagggatcttccttgcgccagtcccgagttttttctcgtcccggaattcggcaccaattgttattagacgcgttctcacgcccggccaggaagaacacggcaaaccagaatcttctgcggcaaaactttattgcttacatcttcaggagcaagagtgtaagaagcaagagagagagaaaacgaaaccccgtccctattaaggagaattatccttcgcctaggacgtgtcactccctgattggctgcagcccatcggccgagttgacgtcacggggaaggcagagcacatggagtggagaaccaccctcggcacatgcgcagattatttgtttaccacttagaacacagctgtcagcgccatcttgtaacagcgaatgtgggcgcggctcccaa	449	58	13%	66	15%
10	67942801	67943250	TCCTTCTTCTCTCCCCGACCGCCCTCCTTCCCTTTCCCCCTCttgtgtgtatgtgtgtatatgtgtatgtatgtttgtatgtgtatgtatgtgtggcatgtgtgtaaatgtgtgtgtatatgtatgtctgtatatgtgtgtgaatgtctgtgtgtgtgcatatacgtgtgttgtctatgtgtgaatgtgtgtgtgtgtgcatatacgtgtgttgtctatgtgtgaatgtctgtgtgtgtgcatatacttgtgttgtctatgtgtgaatgtgtgtgtgtgcatatacgtgtgttgtctatgtgtgaatgtctgtgtgtgggcatatacgtgtgttgtctatgtgtgaatgtgtgtgtgtgtgcatagacctgtgttgtctatgtgtgaatgtgtgtgtgtgtgcatatacgtgtgttgtctatgtgtgaatgtctgtgtatgtgcataga	449	14	3%	18	4%
10	68097451	68097600	GTGAGAAAGAAAGGCGCCGTTTTCGGATTCCTGGTACGCGTCCCTAGCGGCATACTTGGAGGACTGTTCGTTGTGAAGATGGTGCTCTGTGTGCCGGTAGAGGCTATGGAGATGCGGGGATGAGTAGAAGTCGGCCAGGAAACTGGGCA	149	20	13%	6	4%
10	69555601	69555750	catgcacactcacatacactgacacacacattctcatgcacacacatactcacacacacaggcacacatatgcatgcacatgcacacaaacacacagacacacatgcatgcacacacatactcacacacacaggcacacgtatgcatgc	149	2	1%	96	64%
10	70466251	70466550	GGACATGGGGCACCTTGGATTTGGTCACCTGCCCCATTCTTGGCTACAGAATGTATAGCTCATAGAAGGGGGTTCTGGGGTGGAGCCCATGTAGCAGTACGTGAGATCTGAGTGGATGCAGTGGTTGTAGTATGTAGTGTAAGCATTGGACCGTGGTGAATTACTAGTCATCAATCACGTGGCCTCATATTTTAAAAAAGGTTTAAGTTcaaatacgtgtgtgtgtatatacatacatacacacatatatatacacatacgcacacatatatacacatatacacacatatacatatata	299	10	3%	62	21%
10	71691301	71691900	gttataattctttaagttataattgttcaagtagcagggaaaatagcagttaaaatagcagggaaGAGAGATGCTCACCAGTTCTAAGAGAGTTGTTGGTATTtgttgggagccgcgcccacattcgccgttacaagatggcgctgacagctgtgttctaagtggtaaacaaataatctgcgcatgtgccgagggtggttcttcactccatgtgctctgccttccccgtgacgtcaactcggccgatgggctgcagccaatcagggagtgacacgtcctaggcgagggataactctcctaaaatagggacggggtttcgttttctctctctcttgcttcttgcactctggctcctgaagatgtaagcaataaagctttgccgcagaagattctggtctgttgcgtctttcctggccggtcgtgagaacgcgtctaataacaattggtgccgaattccgggacgagaaaaaactcgggacgagagtttaccatcaccggtgcaaggaagatccctcattccagaaccagaactgcgggtcgcggttatgaagtgttcccacaacacagactgttaagaaggattcaactgtatgaattca	599	60	10%	70	12%
10	72705601	72705750	aacttttgtcgtaatgtagaagcagggacatgataaagttgatgaaatttctttgcactttctatagaactttgaattaggaaaaccacgtctctggtggctgagtcagtaattgcatttcccttaaccataggtccaggtaatgatgt	149	4	3%	16	11%
10	73856701	73857450	taccctgttccccagctgaagagttctgaattcacgcagttgaatccttctcaacagtctgtgttgtgggaacacttcattaccaccgttccccagctgaagagttctgaattcacgcagttgaatccttctcaacagtctgttttacgggaacctttattaccatgacccgcagttctggttccggaatgagggatcttccttgcgccggtgatggtaaccgtcctgggttttctcgtcctaggtcttctcgtcccaggtcttctcgtcccaggtcttctcgtcctaggtcttctcgtcccgtcccgggtctcagcaccaACtcttacacgcgttctcgcaaccggccaggaagaacgcaacaaactggaatcttctgcggcaaaagctttattgcttacatcttcaggagccagagagcaagagagcaagagccagagcaagagagagaaaaagaacaagaacaagaaagcaagagagagaaagcaagagcaagaaaaagaacaagaacaagaaagcaagagagagaaaaagaatggcaaaaccccgtcccttttaaggagaattatcctccgcctaggacgtattactccctgattggctgcagcccatcggctcagttgtcatcacgagaaaggcagaacacatggcgggaaaactgcccctgcacgtgtgcagattatgtttactacttagaacacagctgtcagcgccatcttataatggcaaatgtgagggcggctccccac	749	62	8%	116	15%
10	77303701	77303850	agaggccacggagaagtgctgcttgctgttatgttctccacagcttgctcagcctgcttccttacacgggctacgcccacctgcctatacacatacacatctacacatatacacctgcctatacacatacacatctacacatatacacc	149	6	4%	40	27%
10	78867301	78867450	aggggtccaccaggcgtccctggtcctcccctgttcctcctgggacgtctcccagggcgaacggacggtggacacctggacacgtctatccttatccaccccgcgttccctctcggagcgcggtctcactgagcgtccgcaaaaccgaa	149	28	19%	16	11%
10	78937651	78938100	cctctcctaggcctatgtaagcagcgccagttctgggctcagggtctttcgcctctacaatcaagctctcccaataaacgtgtgcagaaggatcctgttgcagcgtcgttcttcctggccagtcgagcgcgcgcaagaagtggtgccgaaaacccggaaaaagaaacatcttcaggcacgagcgaagaccccctgctacagggaggattcagaactgcatcacggggaaggagcggttaataaaggttcccgtaaaacagactgttgagaaggatccagcatggattcagaactcttcagctggggaacggtggtaataaaggttcccgtaaaacagactgctgagaaggatccagcatggattcagaactcttcagctggggaacggtggtaataaaggttcccataaaacagactgctgagaaggatccggcgtggattcagaactc	449	42	9%	60	13%
10	79337101	79337550	ctcaggttccacgcgattggattggggcaggcgctgtgttccactcaccagaggtcttaggatcccgtggggagtcccgtgtgggcccttgcgggtgttggcaagactctgctggcaaggtagcccggggctcgagccgagcggaagggacttgtgccccagatcaggcccgggtagcctgcttccctatgtaccgcagtctcaggttccgcgcgattggattggggcaggcgctgtgttccactcaccataggtcttaggatcccgtggggagtcccgtgtgggcccttgcgggtgttggtcaagactctgctggcaaggtagcccggggctcgagccgagcggaagggacttgtgccccagatcaggcccgggtagcctgcttccctatgtaccgcagtctcaggttccgcgcgattggattggggcaggcgctgtgttccactcac	449	58	13%	50	11%
10	80973301	80973600	tacatacacacatgtacatgcacacatacatacacacacatatatatacatacatgcacaaaccatgcttacatgtgcatacatacacacatacatacatacacatacatatacacacacgtgcacataccatgtaccatgcacacaaacacatgcatacaccatgaacacaatacatgcacacaaattatacacacacacacacaaatgcacacaccatgcacacaaacatacacacatgcatgcacacacacacacacacacacgcacacacgcactacttggggcatgtctccatc	299	6	2%	170	57%
10	80976151	80976600	tgccttccccgtgacgtcaactcggccgatgggctgcagccaatcagggagtgacacgtccgaggcgaaggagaatgctccttaagagggacggggtttcgttttctctctctctttcttcttgctctcttgcttcttacactcttgctcctgaagatgtaagaaataaagctttgccgcagaagattctggtctgtggtgttcttcctggccggtcgtgagaacgcgtctaataacaattggtgccgaattccgggaCGAGaaaaaactcgggactggcgcaaggaagatccctcattccagaaccagaactgcgggtcgcggtaataaaggttcccgtaaagcagactgttaagaaggattcaactgtatgaattcagaacttttcagctggggaacggtggataccagtaagtatagctttacgaggtacgcctggccttgaactt	449	52	12%	34	8%
10	81968101	81968400	tttcgttttctcgctctcttgcttcttgcactctggctcctgaagatgtaagcaataaagttttgccgcagaagattttggtctgttgtgttcttcctggccgggcgtgagaacgcgtttaataacaattggtgccgaattccgggacgagaaaaaactcgggactggcgcaaggaagatccctcattccagaaccagaactgcgggtcgcggtaataaaggttcccgtaaagcagactgttaagaaggattcaactgcgtgaattcagaacttttcagctggggaacggcggtaaccc	299	38	13%	24	8%
10	84560701	84561000	TTGTATTTATTATGATTATTGTGTACTACATGTATGCTCAtgtgtgtgtgtgtgcttgtgtgtgtgatgtgtgtgtatggtatgtgtgtgtgcccgtgtgtgatgtgtgtgcatgtgtatatgtgcgtgtgcacacgagtgcatgtgcttgtgtgtggtatgtgtgtccatgtgtatatgtggtgtgtgtgtgcatgtatgtgtgtgtatatggtgcatgtgcatgtggggtgtgtgtgcaggtgtgtgcatgcgtgcatatgtgtggtgtgtgtgtatgtggtgtgtttgtgtgagtg	299	8	3%	26	9%
10	84744751	84745200	ggagtgacacgtccgaggcgaaggagaatgctccttaagagggacggggttttcgttttctctctctcttgtctctcgctctctctcttgctttttcgctctcttgcttttctctctctcttgcttttctctctctcttgcttcttgctctcttttcctgaagatgtaagaataaagctttgccgcagaagattctggtctgtggtgttcttcctggccggtcgtgagaacgcgtctaataacaattggtgccgaattccgggacgagaaaatccgggacgagaaaaaactccggactggcgcaggagggatacttcattccagaaccagaactgcgaatcaaggttataaggttcccgtaacacagactgttgagaaggattcaactgccgaattcagaactcatcagctggggaacgacggtgataaaggttcccgtaaagcagact	449	50	11%	30	7%
10	85715251	85715850	ttctaagtggtaaacaaataatctgcgcatgtgccgagggtggttctccactccatgtgctctgccttccccgtgacgtcaactcggccgatgggctgcagccaatcagggagtgacacgtcctaggcgaaggataattctccttaatagggacggggtttcgttttctcgctctcttgcttcttacactcttgctcctgaagatgtaagcaataaagttttgccgcagaagattctggtttgctgtgttcttcctggccgggcgtgagaacgcgttaataacaattggtgccgaattccgggacgagaaaaaactcgggactggcgcaaggaagatccctcattccagaaccagaactgcgggtcgcggtaataaaggttcccgtaaagcagactgttaagaaggattcaactgcatgaattcagaacttttcagctggggaacggcggtaacccgtaagtatagctttacaaggtacgcctggccttgaactttctaaggaaattcaagacagtctatcagaagtaaagtggaaaatagctttataagatatgtttggccttgaactttctctagtgttagaagcccttttgttcct	599	58	10%	52	9%
10	85772701	85773000	tgctttacgggaacctttattaccgcgacccgcagttctggttctggaatgagggatcttccttgcgccggtgatggtaattttcgtcccaggttttctcttcccggggttttctcgtcccggaatttctcgtcccggaatttctcgtcccggaattcggcaccaattcttacacgcgttctcacgaccggccaggaaagaacacaacaaaccagaatcttctgcggcaaaactttattgcttacatcttcaggagccaggagcgcaaacccccagccccaaaagcgaaagccacccca	299	44	15%	40	13%
10	85956151	85956450	tgaacgtctataccacacatagcgcttcattctgcataaacgtctataccacacatagcgcttcattctgcatgaacgtctataccacacatagcgcttcattctgcatgaacgtctataccacacatagcgcttcattctgcatgaacgtctataccacacatagcgcttcattctgcatgaacgtctataccacacatagtgcttcattctgcatgaacgtctataccacacaaagtgcttcattctgcatgaaGCTGCCACGTTGCGTCTTTTAAGAGGAAAACTTCCAGTCACAA	299	28	9%	78	26%
10	90326551	90326700	ggagtctgggtttcccccaagcactccatgcctcaagacaatgttgaatcacatgtgaggctttttctccggttaacggagaggcaaacatgatgccagaacatgtgtcaatggacacatggagatattgaagttttccaaaggaagaa	149	4	3%	30	20%
10	90329401	90329550	ttcgacgcgttctcacgaccggccaggaagaacaccacagaccagaatcttctgcggcaaagctttattcttacatcttcaggaaaagagagcaagaagcaagagagagaaaacgaaaaccccgtccctcttaaggagcattctccttc	149	16	11%	24	16%
10	94367701	94368150	aaagcgctctccattccatatatttgcccatactagggagagcggcttttacaaccgtttgccagtcggcaggagttagtgccatgccggcaagcctgtctaactgcaccaaggtaaaattagcattggttccgtatttacggaccgactcggcaagctctttaatttgtaagtattctaccggagcgtggacacgcccaccctcggctccttcaaagaccggaaatgcctgttgtattttcctttgttcctttctgggaatgaatgagtctgcgcattgcctctctgcgcattgcctctctgcgcactgcctctctgcgcactgcctctctgcgcatctctctgcgcattgcctctctgcgcatctctctgcgcattgcctctctgcgcattgctgacgcactacgcagggcgggggctccgcatagggcggaccttgaagccgactg	449	58	13%	54	12%
10	94368751	94369200	ttccccagctgaaaagttctgaattcatacagttgaatccttcttaacagtctgctttacgggaacctttattaccgcgacccgcagttctggttctggaatgagggatcttccttgcgccagtcccgagtttttttctcgtcccggaattcggcaccaattgttattagacgcgttctcacgaccggccaggaaagacgcaacagaccagaatcttctgcggcaaagctttattgcttacatcttcaggagccagagtgcaagaagcaagagagagagaaaacgaaaccccgtcccttttttaggagagttatatttcgcctaggacgtgtcactccctgattggctgcagcccatcggccgagttgacgtcacggggaaggcagagcacatggagtagagaaccaccctcggcatatgcgcagattatttgtttaccacttagaaca	449	50	11%	62	14%
10	94536301	94536450	gagtgcaagagagcaagagtgcaagagccagagcaagagcaagagctctattgcttacatctttaggagccagagcgcaagagtgcaagagagagaatggcgaaaccccgtcccttttaaggagaattattctccgcctaggacgtatt	149	10	7%	20	13%
10	95865301	95865600	tatatgggtgaatgtgtgtatgtaatcatgtgtgtgtgtatgcatgtgtgtttgcctgtgtgtatgtgtgtacatgtgagtgtgtgtttatgtgcatgagtgtgtgtatgcatgtgtatgtgtgtatgggtatgtgtatacctatgcgtgtgtgtatatgtccacatgtgtgtatgtgtgtatatgcgtgtctctgtgtgtgtatgtgtatacctacatgtgtgagtgtgtgtatacctacgtgtgagtttatgtgtatgtatgtgagtgcatgcatgtgtatataagtgtgtacatgt	299	6	2%	22	7%
10	96198301	96198600	cggaccgactcggcaatttctttaatttgtaagtattctaccggagcgtggacacgcccaccctcggctccttcaaagactggaaatgcctgttgtattttcctttgttcctctctgggaatgaatgagtctgcgcactgcctctctgcgcactgcctctctgcgcactgcctctctgcgcatctctctgcgcactgcctctctgcgcatctctctgcgcattgcctctctgcgcatctctctgcgcattgcctctctgcgcattgctgacgcactacgcagggcgggggctccgcata	299	42	14%	34	11%
10	96199201	96199800	aaaagttctgaattcatacagttgaatccttcttaacagtctgctttacgggaacctttattaccgcgacccgcagttctggttctggaatgagggatcttccttgcgccagtcccgagttttttctcgtcccggaattcggcaccaattgttattagacgcgttctcacgcccggccaggaagaacaccacagaccagaatcttctgcggcaaagctttattgcttacatcttcaggagccagagtgcaagaagcaagagagcaagaagcaagagagagagaaaacgaaaccccgtccctattaaggagaattctccttcgcctaggacgtgtcactccctgattggctgcagcccatcggccgagttgacgtcacggggaaggcagagcacatggagtagagaaccaccctcggcatatgcgcagattatttgtttaccacttagaacacagctgtcagcgccatcttgtaacggcgaatgtgggcgcggctcccaacactaaactttaattgttaagatatagctagttcctgctaaacatccctgaccactcaactgtagaagtggccactccccacccccacccccaccccaac	599	58	10%	92	15%
10	97328101	97328550	atttgcccatactagggagagcggcttttacaatcgtttgccagtcagcaggagttagtgccatgccggcgagcctgtctaactgcaccaaggtaaaattagcattggttccgtatttacggaccgactcggcgagttctttaatctgcacgtattctaccggagcgtggacacgcccaccctcggctccttcaaagactggaaatgcctgttgtattttcctttgttcctctctgggaatgaatgagtctgcgcactgcctctctgcgcactgtctctctgcgcactgcctctctgcgcactgcctctctgcgcattgcctctctgcgcactgcctctctgcgcattgctgacgcactacgcagggcgggggctccgcgtagggcggaccttgaaaccgactgcccggaggttgaacagtacgctggctttcgccagccgcttttggc	449	64	14%	48	11%
10	99340201	99340500	cgtagtgcgtcagcaatgcgcagagaggcagtgcgcagagagatgcgcagagaggcagtgcgcagagagatgcgcagagaggcagtgcgcagagagatgcgcagagaggcagtgcgcagagaggcagtgcgcagactcattcattcccagagaggaacaaaggaaaatacaacaggcatttccggtctttgaaggagccgagggtgggcgtgtccacgctccggtagaatacttacaaattaaggaaattgccgagtcggttcgtaaatacggaaccaatgctaattttaccttggtgc	299	40	13%	52	17%
10	99545701	99546150	tgctaggcttctcataaaagagaagcgccaagggaatctgactcctctggcctctgtggggactcataaacacgtacctgcacacacacacacacacacacacgcacacgcacacacacacacacgtacctgcacacacacacacacacacacaTGtcttatacgcgttctcacgaccggccaggaaagacacaacaaaccagaatcttctgcggcaaaactttattgcttacatcttcaggagccaggagcgcaagcccccagccccaaaaatgaaagccccctgcttacatctttaggagccagagcgccagcgcgccagagcgccagagcaagggggagaatggcggaaaccccgtcccctttttaggagagttattctccgcctaggacgcatcactccctgattggctgcagcccatggccgagttgttgccacgggaaaggca	449	42	9%	120	27%
10	100578901	100579500	TTTTTTATTCCTAAAAGTGAttattttatatataagtaaatatatatgtatatatctatgtatgtgtgtatatatatgttgggagccgcccccacattcgccgtcacaagatggcgctgacatcctgtgttctaagtggtaaacaaataatctgcgcatgtgccaagggtattttacgactacttgtactctgcctttcccgtgaacgtcagctcggccatgggctgcagccaatcagggagtgatgcgtcctaggcgaaatataactctcctaaatagggaaggggtttcggtttcattattgaaggggctttcgcttttggggctgggggtttgcgctcctagctcctgaagatgtaagcaataaagttttgccgcagaagattctggtctgttgtgttcttcctggccgggcgtgagaacgcTattaagaattggtgctgaaatccgggacgagaaaaaatccgggacgaaaaaatacaagaaaactcgggaccggcgcaaggaagatccctcattccagaaccagaactgcgggtcgcggtaataaaggttcccgtaaagcagactgttaagaaggattcaactgcatgaattca	599	58	10%	50	8%
10	104556451	104556600	gagagatgcgcagagaggcaatgcgcagagagatgcgcagagaggcaatgcgcagagagatgcgcagagaggcagtgcgcagagaggcagtgcgcagagaggcagtgcgcagactcattcattcccagagaggaacaaaggaaaataca	149	16	11%	36	24%
10	104666251	104666550	gtgtatgtgtgtgtgtatatgtgtgtgtatgtgcgtatgtgtgtgtatgtgtgtgtatgtgtgtgtatatgtgtgtgtatgtgtgtgtatgtatgtgtgtgtatgtgtgtgtatgtttgtgtatgtgtgtgtatgtgtgtatgtgtgtatatgtgtgtatgtgtgtatgtgtttgtgtgtgtatgtgtgtgtgtatgtgtgtgtgtatgtgtgtgtacctgtgtgtacgtgtgtgtatgtgtgtgtatctgtgtgtatctgtgtgtgtgtatgtgtgtatgtgtgtgtatatgtgtgtg	299	4	1%	0	0%
10	107999551	108000900	ttctaagtggtaaacaaataatctgcgcatgtgccaagggtatcttatgactacttgtgctctgccttccccgtgacgtcaactcggccgatgggctgcagccaatcagggagtgacacgtccgaggcgaaggagaatgctccttaagagggacggggtttcgttttctctctctcttgcttttctctctctcttgcttcttgctctctcttgcttcttacgctcttgcttcttgcactctggctcctgaagatgtaagcaataaagctttgccgcagaagattctggtctgtggtgttcttcctggccggtcgtgagaacgcgtctaataacaattggtgccgaattccgggacgagaaaaaaactcgggactggcgcaaggaagatccctcattccagaaccagaactgcgggtcgcggtaataaaggttcccgtaaagcagactgttaagaaggattcaactgtatgaattcagaacttttcagctggggaacgagagtaccagtgagtacagctttacgaggtaagtctgatcttgaactttctaacgaaattcaagacagtctatcagaagtaaagtggaatatgtttggccttgaattttttctagtgttagaagcccttttgttccttttcacatgttatcaagtggttaagatagggcggattctagatgaaattcaggacaagctatcagaagtaaagcggggagagagagtaggagcaaagagaaaatatggtacacaaaataagtatacaggcctttccaagggtcttgaacccgaggaaaagtttaggtcaggtaagaatacctggggagagattagaaggaaggaaaagaaaaaagaaaagaaaaaagatcaattagcggaggtctctaggagatactcgtcactagatgagctcaggaagccagctcttagtagttctgaagcagatgaagaattctcctctgaggaaacagactgggaggaagaagcagcccattaccagccagctaattggtcaagaaaaaagccaaaagcggctggcgaaggccagtttgctgattggcctcagggcagtcggcttcaaggtccgccctatgcggagtccccgccctgcgtagtgcgtcagcaatgcgcagagaggcagtgcgcagagaggcagtgcgcagactcattcattcccagagaggaacaaaggaaaatacaacaggcatttccggtctttgaaggagccgagggtgggcgtgtccacgctccggtagaatacttacaaattaaagaaattgccgagtcggttcgtaaatacggaaccaatgctaattttaccttggtgcagttagacaggctcgccggcatggca	1349	110	8%	148	11%
10	109321051	109321350	tcggctccttcaaagaccggaaatgcctgttgtattttcctttgttcctctctgggaatgaatgagtctgcgcactgcctctctgcgcactgcctctctgcgcatctctctgcgcattgctgacgcactacgcagggcggggactccgcatagggcggaccttgaagccgactgccctgaggccaatcagcaaactggccttcgccagccgcttttggcttccttaactgattagctagcactttacctggctggtacccttttttctcataatgagctgcttcttcctcccagtctgt	299	28	9%	30	10%
10	111002701	111003000	gtgatgacaactgggccgatgggctgcagccaatcagggagtaatacatcctaggcggaggataattctccttaaaagggacggggttttgccattctttttctctctcttgcactcttgctcctgaagatgtaagcaataaagttttgccgcagaagattctggtttgctgcgttcttcctggccggtcgcgtgaacgcgtgtaagaGGAAAGGtttctttttttccttttttcttaatttttaatttttGGTGGTACTAATTTAGGCAACTGGTGTGGCAATTCTTCCACATAGACA	299	20	7%	28	9%
10	112053751	112053900	gctctctcttgcttcttgctctctcttgcttcttgctctcttgcttcctgcaccctggctcctgaagatgtaagaaataaagctttgccgcagaagattctggtctgtggtgttcttcctggccggtcgtgagaacgcgtctaataaca	149	10	7%	6	4%
10	113728201	113729700	cccaatggtagtttgtttgatcagcagaataagctccctgacccgttaacaagtcaaaagtccaatctctctgctctggagtcaaagcagctgcgtttgctcgggcctgcgcttgtgcagcttcgtgccaaagcgctctccattccatatatttgcccatactagggagagcggcttttacaaccgtttgccagtcggcaggagttagtgccatgccggcaagcctgtctaactgcaccaaggtaaaattagcattggttccgtatttacggaccgactcggcaatttctttaatttgtaagtattctaccggagcgtggacacgcccaccctcggctccttcaaagaccggaaatgcctgttgtattttcctttgttcctctctgggaatgaatgagtctgcgcactgcctctctgcgcagggctgacgcactacgcagggcggggactccgcatagggcggaccttgaagccgactgccctgaggccaatcagcaaactggccttcgccagccgcttttggcttccttaactgattagctagcactttacctggctggtacccttttttctcataatgagctgcttcttcctcccagtctgtttcttcagaggagaattcatcatctgattcagagctaccaagagctggctccccgagcccatccagcgatgagcacaggctccttttcctagagacctccgctaattgatctttcttcttttccctttttcctctttttcttctaatctctctccaggtattcctacctaaccttaacttttcctcgggttcaagacccttggaaaggcctgtatacttattttgtgtaccatatttcctctttgttcctactctctctccccgctttacttctgatagattgtcctgaatttcatctagaatccgccctgccttaaccacttgataacatgtgaaaaggaacaaaagggcttctaacactagaaaaaattcaaggccaaacattttccactttacttctgatagactgtcttgaatttccttagaaagttcaaggccaggcttacctcgtaaagctgtactcactggtactctcgttccccagctgaaaagttctgaattcatacagttgaatccttcttaacagtctgctttacgggaacctttattaccgcgacccgcagttctggttctggaatgagggatcttccttgtaccggtgatggtaaactctcgtcccgagttttttctcgtcccggaattcggcaccaattgttattagacgcgttctcacgcccggccaggaagaacaccacagaccagaatcttctgtggcaaaactttattgcttacatcttcaggagcaggagtgcaagaagcaagagagagagaaaacgaaaccccgtcccttttttaggagagttatatttcgcctaggacgtgtcactccctgattggctgcagcccatcggccgagttgacgtcacggggaaggcagagcacatggagtggagaa	1499	118	8%	174	12%
10	115182151	115182300	tgtgtaggtatgtgtgttttgtatgtgcgttgtgtgtgtatatgtctgttgggtatgtgtgtgttctgtgtatgtgtgttttgtctatgtgtatgtgtatattgtgtatatgtgtgtattctgtatatgtgtatatgtatatgtatgta	149	2	1%	0	0%
10	116611951	116612250	gccagtcggcaggagttagtgccatgccagcgagcctgtctaactgcaccaaggtaaaattagcattggttccgtatttacgaaccgactcggcaatttccttaatttgtaagtattctaccggagcgtggacacgcccaccctcggctccttcaaagaccggaaatgcctgttgtattttcctttgttcctctctgggaatgaatgagtctgcgcactgcctctctgcgcactgcctctctgcgcattgctgacgcactacgcagggcggggactccgcatagggcggaccttgaagc	299	38	13%	34	11%
10	116613151	116613300	gagagaaaacgaaaccccgtccctcttaaggagcattctccttcgcctcggacgtgtcactccctgattggctgcagcccatcggccgagttgacgtcacggggaaggcagagcacaagtagtcataagatacccttggcacatgcgca	149	20	13%	24	16%
10	116714551	116714700	gagacacatgcacatgcacacacacacacagagacacacatacacacaggtgtagacacacggacacatgcatgtacacacatatacatacacacatacacacacatgcgcacagacacacagaatgcacacatgtacacacacagaga	149	4	3%	90	60%
10	117582151	117582450	ctgtacccacaccatgcccacacatatacatacatgtgcacatgtccacacaccccttatacatacttacacatacacacacacacccgtatacatacatacacatacacacacacagccccgtatacatacatacacatacacacacacagccccgtatacatacatacacatgcccacacacccccgtatacatacatacacatgcccccacacatacacccatatacatacatacacatgcccatacacccccgtatacatacatacacatacacacacacccccgtatacataca	299	12	4%	142	47%
10	117583051	117583200	catacatacacacacacacacacacacacacacacacacacatgtccaaacaccccatacacacacacactcatacactccatacacatacacacacatgcctacataccttatacatacatacgcatacccatacaccccatatacat	149	2	1%	88	59%
10	120885901	120886050	aactcttcagctggggaacggtactgatgaagagaaagaagaaagatgaagacggaataaactgctgttagaaggactggtggtcgcatcgttcttgctggtcgagagcaggcgtgacaattggtggcccgtacggggaaccgactccc	149	18	12%	8	5%
10	120886801	120886950	tggagccgagatgagagatcctttcggtattccagaagccgataccagctcgacatgacattcaattttttccacgctttttgatccctgaattccccttaaagagatagccccgctggctatctatcccttgctttagggaagatgag	149	12	8%	12	8%
10	121707151	121707300	acgggaccccccacgggatcctaagacctctggtgagtggaacacagcgcctgccccaatccaatcgcgcggaacctgagactgcggtacatagggaagcaggctacccgggcttgatctggggcacaaaccccttccgctccactcga	149	20	13%	20	13%
10	124680601	124680750	taaggagaattctccttcgcctaggacgtgtcactccctgattggctgcagcccatcggccgagttgacgtcacggggaaggcagagcacatggagtgaagaaccaccctcggcacatgcgcagattatttgtttaccacttagaacac	149	16	11%	26	17%
10	124685551	124686000	ccccagctgaaaagttctgaattcatacagttgaatccttcttaacagtctgctttacgggaacctttattaccgcgacccgcagttctggttctggaatgagggatcttccttgcgccagtcccgagttttttctcgtcccgggtttcagcaccaattgttattagacgcgttctcacgaccggccaggaaagacgcaacagaccagaatcttctgcggcaaaactttattgcttacatcttcaggagcaggagtgcaagaagcaagagagagagaaaacgaaaccccgtccctattaaggagaattctccttcgcctaggacgtgtcactccctgattggctgcagcccatcggccgagttgacgtcacggggaaggcagagcacatggagtgaagaaccaccctcggcacatgcgcagattatttgtttaccacttagaacacagc	449	48	11%	68	15%
10	126922201	126922350	tacaacacagacacaaacacacacacaacataaacatcacacacatacaacatagacaaaaacacgcatacacacacgcaacagagacacaaacatacatacccaacatacaacataaacactacatacacaccacatacaacacaaca	149	4	3%	88	59%
10	128018251	128018400	tgtcgtgagtgtcagtgggttgtgggtgtcagtatatctgtcatatgtgtcatgtgtgtcagtgtggtgtgtctccgtatgtcaatatgttgtatgtgtcagtgtggtgtatgtgtcagtgtggtgtgtgttatgtgtgtccatgtgtt	149	4	3%	18	12%
10	130045051	130045200	ccggagccaagaaggctcccgccggcgcctgtggcacaaacctctcaggccgggcagacccccgtgctctcaccaggaaggtggccggctgtctggagctgaagatggcgccgcctcagaagctccgtggctctcgccaggaaggtggc	149	22	15%	18	12%
10	130564651	130565850	gtttcatgccaaagagctctccattccatatatttgcccatactagggagagcggcttttacaaccgtttgccagtcggcaggagttagtgccatgccggccagcctgtctaactgcaccaaggtaaaattagcattggttccgtatttacggaccgactcggcaagttctttaatttgtaagtattctaccggagcgtggacacgcccaccctcggctccttcaaagactggaaatgcctgttgtatttttctttgttcctctctgggaatgaatgagtctgcgcactgcctctctgcgcattgtctctctgcgcagggctgacgcactacgcagggcggggactccgcatagggcggaccttgaagccgactgccctgaggccaatcagcaaactggccttcgccagccgcttttggcttccttaactgattagctagcactttacctggctggtacccttttttctcataatgagctgcttcttcctcccagtctgtttcctcagaggagaattcttcatctgcttcagagctactaagagctggcttcctgagttcatctagtgacgagtatctcctagagacctccgctaatcgatcttttttcttttcttttttcttttccttccttctaatctctccccaggtattcttacctgacctaaacttttcctcgggttcaagacccttggaaaggcctgtatacttattttgtgtaccatattttctctttgctcctactctctctccccgctttacttctgatagcttgccctgaatttcatctagaatccgccctgccttaaccacttgataacatgtgaaaaggaacaaaagggcttctaacattagaaaaaattcaaggccaaacattttccactttacttctgatagactgtcttgaatttccttagaaagttcaaggccaggcgtacctcgtaaagctgtactcactggtactctcgttccccagctgaaaagttctgaattcatacagttgaatccttcttaacagtctgctttacgggaacctttattaccgcgacccgcagttctggttctggaatgagggatcttccttgcgccagtcccgagttttttctcgtcccgggtttcggcaccaattgttattaacgcgttctcacgcccggccaggaagaacacagcaaaccagaatcttctgcggcaaaactttat	1199	92	8%	128	11%
11	3101101	3101400	agtgtttctcgccatattccagttcatgcagtgtttgtgtctcattttccacgtttttcagttttgtcgccaatacccaggtcctacttgtgtacttcacatttttcatgttttttgattgtttctcgccatattctaggtcctacagtgtgtgtttctcattttccatgactttcagttttctcgccttactccagttcctacaatgtgcatttctcattttccacgtttttgagtgtttctcacaataatgcaggtcaaacagtgtttgtgtttcattttccacctttttcagtttt	299	12	4%	60	20%
11	3150451	3151050	TCCAGCAGGGCCTGGTCCATCTTGTTCATCATCAGCATGGGCTTGATGCGCTCAGCAACGGCCTGGCGCAGAACCGTTTCTGTCTGcacacacacacacacacacgccaaacacacagtccaccaccaccaGAGCTCCATCGGTGACACGCAAGGCAGCTGTCACCTCTGAAGAGAAGTCCACATGGCCGGGAGTCAATGAGGTTGATGAGGAAGCCCGAGCCATCCTTGCTCTGCTTAATGAGGTTCAGATCGTTCTCAGAGAGCTCATAGAAGAGGGAGATGGCGGTGGACTTGATTGTGATGCAGCGCTCCAGCTCATCTTTGCGCGTGTCAGTGAAACGTGTCTCCCCAGCTCCGGCGGAGGCAATGATGCCAGCCTTGCACACAAGGGAGTTGTTCAGCGTGGACTTGCCGTGGTCCACATGGAGATGACTGACATGTTCTGGATGTTGGCTTTCCTGTCCATGATGGCACGGATCTGAACTACTGTGAAGTTCACCATGGTGGTGGATGGCGACAGATTCTCAGAGTCAGAGGTGAACAGGGAAGCGCGCCTACAGTGGCCTGGtttgttttcttgaaacagggacttatgta	599	46	8%	126	21%
11	3184651	3185100	GATATGTACTGGGAGTCACCAGAGGGCCACAGTTAGGAGGTACACAGTAGTGCAAAGCTGTCGGGTAGTTCAGTGAAGAACCAAGTAAGAAGGGTTAGAAGGAGCAAAGAGACAGGAGAGAAGCCATCAGACAAGAGTGATCCAGAAGCTGGGAAAGAAAGGACTCCTGGGAGACATAACGATGGCACTACAGTCTTGATAAGTGCCCTACACACACTCATCACTGAGGCGGCCAGGAAATACATGGAGTCACACCCGTGACTCCTTTGTGTTGTAGCTAAACTAACGCAATTGAAAGTTACAGCAGAAGGTAGTGGCTATCTTTATGGATCCTAACACGTATACCGATGTGTACGGGCTAAGGAGGAATAGTGTACAGCATGGGGATTTGTTCTTCACTGAAACCCCTTGGCCAATACCAACGTTTCCACGAGGTTCTGCCCTCTACA	449	20	4%	76	17%
11	3192901	3193950	CGATACACCTTCAGGAACTAAACCAGAAGAGGTTCCATGGTACAAACGCAACGTGAGCTCAGCTCCTTGCTTGGTCACTTGAGCTCAGTGTACCAACGAGCCCTACGCCCCGCCACACCCCTGAATCGAACGTGGATCTGCGCAGACTAGTAAGCGAAGCACGAGCTGGAGAATCACTCAGCGGAGCTCTCCACCAGGGGGAGAAGGATGCATAGACCCTGCAGAAACAGCGCGAGTGCAGCCGTGACTGCGAGCGACCTTACGCACGCCCTGCTCGCACTTCCACGCATGGACCAGAGCCTTGTGGGTAGGCAGCATCTCCTGCACTTCTACAGAAGAAAGCAGAAGCCCCGACCAAGCCGTTCCAGGACAAAGTTCCTAGGAACGCGCGCTCCGCCAACTTCAAAACGCAAGGGCGAGCCAGTCAAAAGCTGGAGGCGCTAGGCCGGGCCTCGTACCTGAGGGAGGTGACTCCTCAGCAGACGCTAGACAGAGGTGGTAGCAAAGGGCCCCAGCCCAGAGTTTCCGGCCCTGCGCCGACGGCGGCTCCTCCCCCGTCTCCACGGCAACGCGACCCGCGCCGGAAGCTGCTCTGTCCAGCTTAGTGCGCTCTGTCTTCCAGGAAACAGAGACTTCTCTCTAAGCTCGGCTTCCTACGGTTTTCTTGCCCTGAAGTTTCTGCGCTTCTGAGAAGCGGGTCACTAGTTACAACTCCTGCATGGGACCGGTGTGAGACGGAAAAGTGTCTCTTTTCATTGCGTGGTGGCTCACGTCGGTAATCTCCGCATCAAACAGCCGAATCTTTAAAGAGAACTTTCAGAACAAAGTATGAAGTTTCATACTAAGAACAGTGAAAACTAGTGGGTGGGTGTCTGAAGACGAAAACCAAGGGGCAGGAGATATGACTCACCAGTTAAATGCACTTTTCATTCATCCAGACTCCCAATACCCACACGGTGGCTCTTAAAACAGCCGTGACTCCCAAGTCGCGCTCCCGTTTGACCTATATGCAAGCAAAACATTCATACTCAAAATTTTTAAAAAGATTA	1049	126	12%	162	15%
11	3282601	3282750	acacctctgtctcctgcgggagatatgtgtcggcccggagctccgtcattaaactacctcatgcttttacatcaagatggtcgtctgttcgtgattcttgggtgcacgccgagtcgaaaattgagtgggggtttccccactaggttctt	149	18	12%	14	9%
11	3824701	3825150	ccgatcagggctaccgaggagtaccctacacatacacctcccggtcagggctaccgaggaataccctacacatacacctcccggtcagggctaccgaggagtaccctacacatacacctcccggtcagggctaccgaggaataccctacacatacacctcccggtcagggctaccgaggaataccctacacatacacctcccgatcagggctaccgaggagtaccctacacatacacctcccggtcagggctaccgaggaataccctacacatacacctcccgatcagggctaccgaggaataccctacacatacacctcccggtcagggctaccgaggaataccctacacatacacctcccggtcagggctaccgaggagtaccctacacatacacctcccggtcagggctaccgaggaataccctacacatacacctcccggtcagg	449	46	10%	90	20%
11	5169001	5170650	tgcctgacatgcacggtgcctgacatacacggtgcctgacatgcacaatgcctgacatacacggtgcctgacatacatggtgcctgacatgcacggtgcctgacatacacggtgcctgacatgcacaatgcctgacatgcacggtgcctgacatgcacaaggcctgacatacatggtgcctgacatgcacggtgcctgacatacacggtgcctgacatgcatggtgcctgacatgcacaatgcctgacatacacggtgcctgacatgcacggtgcctgacatgcacaatgcctgacatacacggtgcctgacatacatggttcctgacatgcacggtgcctgacatacacggtgcctgacatgcacaatgcctgacatacacggtgcctgacatacacggtgcctgacatgcacaatgcctgacatgcacagtgcctgacatacacggtgcctgacatacaccgtgcctgacatgcacggtgcctgacatgcacaatgcctgacatacacagtgcctgacatacacggtgcctgacatgcacggtgcctgacatacacggtgcctgacatgcacaatgcctgacatacacagtgcctgacatacacggtgcctgacatgcacggtgcctgacatgcacggtgcctgacatacacggtgcctgacatgcacgatgcctgacatgcacggtgcctgacatgcacacggtgcctgacatacacggtgcctgacatgcacaatgcctgacatacacggtgcctgacatacatggtgcctgacatgcacggtgcctgacatacacggtgcctgacatgcacaatgcctgacatgcacggtgcctgacatgaacaatgcctgacatacacagtgcctgacatacacggtgcctgacatacacggtgcctgacatgcacaatgcctgacatacacggtgcctgacataaacggtgcccgacatacacaaggcctgacatacacggtgcctgacatgcacaatgcctgacatgcacaatgcctgacatacacggtgcctgacatgcacaatgcctgacatacacggtgcctgacatacacggtgcctgacatgcacaatgcctgacatgcacaatgcctgacatacacggtgcctgacatgcacaatgcctgacatacacggtgcctgacatacacggtgcctgatatgcacaatgcctgacatacacggtgcctgacatacacggtgcctgacatgcacaatgcctgacatacacggtgcctgacatgcacaatgcctgacatacacggtgcctgacatgcacggtgcctgacatgcacggtgcctgacatgcacaatgcctgacatgcacggtgcctgacatacacggtgcctgacatgcacaatgcctgacatacacggtgcccgacatacacggtgcctgacatgcacaatgcctgacatacacggtgcctgacatacacggtgcctgacatacatggtgcctgccatgcacaaggcctcacatgcacgaggccttaggttccatcctcagtactttcattaTAACGATaataaagtgcagtgccactgaggaggaccccgacattggcctccagcccccactgtgtgcattcacagtgcacacaTCCATGAATGTGTACACACATCTTCATT	1649	122	7%	474	29%
11	5556901	5557350	agattgtcccatttctagaaaaacagtagtcacaacaagagcggacacgagactaagacaaaaaagaaaccagaagaatcagatggcctctccaaggccggccgattgagaccctctgcacgaggtgggactcgaacccacgatcccgtgaccagacgcgaggtgggactcgaacccacggtctcgcaacaaggtgcgaggtgggactcaaacccacgatctcgcaacaaaacacgaggtgggactcgaacccacgatctcgcaactgggcacgaggtgggactctaacccacgatctcgcaaccccaaatggtctcttggccttcaaaggggtccaccaggcgtccctgatcctcccctgttcctcctgggacgtctcccagggtgaacggacggtggacacctggacacgtctatccttatccaccccgcactccctctcggagcgc	449	62	14%	70	16%
11	5935501	5935950	aaacgtgtgcagaaggatcctgttgcagcgtcgttcttcctggccagttgggcacgcgcaaGAAGTGGTGCCGaaacccgggacaagaaacatcttcaggcacgagtgaagaccccctgctacagggaggattcagaactgcatcacggggaaggagtggttaataaaggttcccgtaaaacagactgttgagaaggatccggcgtggattcaaaactcttcagctggggaacggtactgatgaagagaaagaagaaagatgaagactgaataaactgttgttagaaggactggtggtcgtgtcgttcttgctggtcgagagcggacgcgacaattggtggcccgtacggggaaccgactcccccaccgagttcagaactttcagcagtcagtggttgcaggcagggtaagttcatggtgagtgaaatttacgaccccaggagtttgga	449	48	11%	52	12%
11	6141601	6141900	ccagagtgtaagaagcaagagagagagaaaacgaaacccctttcctctttaaagagaacaacaattgcctcggacgcatcactccctgattggctgcagcccatggccgagctgacgttcacgggaaaaacagagtacaagtagtcgtaaatacccttggctcatgcgcagattatttgtttaccaacttagaacacaggatgtcagcgccatcttgtgacggcgaatgtgggggcggcttcccacaGTtcccccttttctattaataagagcaaataggccacccatattaacgagag	299	26	9%	46	15%
11	6648601	6648900	AAATATATTTATAtgtgtgtgagtgttgtgtgtgtgcaagcgtatatgagtgtgtatgtgtatttgtgtgagtgtgtgcatgtgtatgtgtgagtgtgtaggtatgtgagtatgtatatgtgtgtgtatgaaagtgtatgtgtgattgtatttgtgtgtgagtgtgtatatgtgtgtgagtgtgtgtatgtgtgtatgaatgtgtatgtgtgtatatgtgtatatgtgattgtatttgtgtgtgagtgtgtatacgtgtgtatatgaatgtgtatgtgtgtgtgagtgtgtgtatgtgt	299	4	1%	4	1%
11	8273851	8274300	ttttaataaaatcaaaagggggagatgtggaaagccggtacgtgctgcgagcaatcgcatgtgtgccgccagtaatctctgaggagagccgtgtgtgccgcgagcaatcgccattataagatggcgcgggcctccgctgtgcctaactagtaaacaagccttgtacgcaggtgcaagagtgaattcactcctagtcactcccattctcggggtgtaatagtggggtgatgggcaagcaacgaatcgggagctgtcacgccatatcaggtgctgaaacgtcacgctgcgggctataaaagcagcgccattttcccggttcgggatcttcctgagaagcaagcaataaagcttttgccgcggaagattctggtttgttgcgtctttcttgccggtcgagcgggacgcaataGTCAGCTCCGTGGTTTTGCTTCTCTCTGCCTTTCCATGGG	449	62	14%	50	11%
11	12511951	12512550	gaattcatacagttgaatccttcttaacagtctgctttacgggaacctttatcaccgtcgttccccagctgatgagttctgaattcggcagttgaatccttctcaacagtctgctttacgggaacctttatcaccgtcgttccccagctgatgagttctgaattcggcagttgaatccttctcaacagtctgtgttacgggaaccttataaccttgattcgcagttctggttctggaatgaagtatccctcctgcgccagtccggagttttttctcgtcccggattttctcgtcccggaattcggcaccaattgttattcgacgcgttctcacgaccggccaggaagaacaccacagaccagaatcttctgcggcaaagctttattcttacatcttcaggaaaagagagcaagaagcaagagagagagaaaacgaaaaccccgtccctcttaaggagcattctccttcgcctcggacgtgtcactccttgattggctgcagcccatcggccgagttgacgtcacggggaaggcagagcacaagtagtcataagatacccttggcacatgcgcagattatttgtttaccacttagaacac	599	66	11%	84	14%
11	15228751	15229200	cagccagctaattggtcaagaaaaaagccaaaagcggctggcgaaggccagtttgctgattggcctcagggcagtcggcttcaaggtccgccctatgcggagtccccgccctgcgtagtgcgtcagcaatgcgcagagaggcagtgcgcagagaggcagtgcgcagactcattcattcccagagaggaacaaaggaaaatacaacaggcatttccggtctttgaaggagccgagggtgggcgtgtccacgctccggtagaatacttacaaattaaagaaattgccgagtcggtccgtaaatacggaaccaatgctaattttaccttggtgcagttagacaggctcgccggcatggcactaactcctgctgactggcaaacggttgtaaaagccgctctccctagtatgggcaaatatatggaatggagagcgctttggcacgaagctgc	449	52	12%	64	14%
11	15883801	15884250	gtgacgtcaactcggccgatgggctgcagccaatcagggagtgacacgtcctaggcgaaggataattctccttaatagggacggggtttcgttttctctctctcttgcttcttacactcttgctcctgaagatgtaagcaataaagttttgccgcagaagattctggtttgctgtgttcttcctggccgggcgtgagaacgcgtttaataacaattggtgccgaattccgggacgagaaaaaactcgggacgagagtttaccatcaccggtgcaaggaagatccctcattccagaaccagaactgcgggtcgcggtaataaaggttcccgtaaagcagactgttaagaaggattcaactgtatgaattcagaacttttcagctggggaacgagagtaccagtgagtacagctttacgaggtaagcctggccttgaactttctaaggaaa	449	48	11%	42	9%
11	19569151	19569600	ctgtctaactgcaccaaggtaaaattagcattggttccgtatttacggaccgactcggcaatttctttaatttgtaagtattctaccggagcgtggacacgcccaccctcggctccttcaaagactggaaatgcctgttgtattttcctttgttcctctctgggaatgaatgagtctgcgcactgcctctctgcgcagggctgacgcactacgcagggcggggactccgcatagggcggaccttgaagccgactgccctgaggccaatcagcaaactggccttcgccagccgcttttggcttccttaactgattagctagcactttacctggctggtacccttttttctcataatgagctgcttcttcctcccagtctgtttcttcagaggagaattcatcatctgattcagagctaccaagagctggctccccgagcccatccagcga	449	40	9%	52	12%
11	19788601	19789050	CCAGGAGAGTGCTGGTCTTGGTGCCACTAAAtcttattcgcgttctcacgtccggccaggaaagaacacaacaaaccagaatcttctgcggcaaaactttattgcttacatcttcaggagccaggagcgcaaacccccagccccaaaagcgaaagccaccttcttacatctttaggagccagagctccggcgcgccaaagcgcagagcgcgctctattgtttacatctttaggagcaagcgagcaggcgccagagccagagagagaatggcggaaaccccgtcccctttaaggaggagttatccttcgcttaggacgcatcactccctgattggctgcagcccatggccgagctgacgttcacgggaaaggcagagtacaagtagtcgtaaaatacccttggcacatgcccagattatttgtttaccacttagaacacaggatgtcagc	449	46	10%	78	17%
11	19793251	19793700	ctcacgcccggccaggaaagaacacaacaaaccagaatcttctgcggcaaaactttattgcttacatcttcaggagccaggagcgcaaacccccagccccaaaagcgaaagccaccttcttacatctttaggagccagagctccggcgcgccaaagcgcagagcgcgctctattgtttacatctttaggagcaagcgagcaggcgccagagccagagagagaatggcggaaaccccgtcccctttaaggaggagttatccttcgcttaggacgcatcactccctgattggctgcagcccatggccgagctgacattcacgggaaaggcagagtacaagtagtcgtaaaatacccttggcacatgcccagattatttgtttaccacttagaacacaggatgtcagcgccatcttgtgacggcgaatgtgggggcggctcccaacaACTAA	449	48	11%	82	18%
11	22339801	22340400	attcaaggccaaacctaacttgtaaagccattttccactttacttctgatagactgtcttgaatttccttagaaagttcaagatcagacttacctcgttccccagctgaaaagttctgaattcatacagttgaatccttcttaacagtctgctttacgggaacctttatcaccgtcgttccccagctgatgagttctgaattcggcagttgaatccttctcaacagtctgtgttacgggaaccttataaccttgattcgcagttctggttctggaatgagggatcttccttgcgccagtcccgagttttttctcgtcccggattttctcgtcccggaattcggcaccaattgttattcgacgcgttctcacgaccggccaggaagaacaccacagaccagaatcttctgcggcaaagctttattcttacatcttcaggaaaagagagcaagaagcaagagagcgagaaaagcaagagagcgaagcaagagagagagcgcgagacaagagagagagagaacgaaaccccgtccctcttaaggagcattctccttcgcctcggacgtgtcactccctgattggctgcagcccatcggccga	599	62	10%	74	12%
11	23218501	23218950	AGGTACAGATTCTGGAAGTCATTGCCTGGACGCAGTGGTAAGTCCACCAGGCTCCAGCGACCAAATATAGGGCTCTAATTCtgttattagacgcgttctcacgaccggccaggaaagacgcaacaaaccagaatcttctgcggcaaagctttattgcttacatcttcaggagccagagtgcaagaagcaagagagcaagaagcaagagagagagaaaacgaaaccccgtccctattaaagagaattctccttcgcctaggacgtgtcactccctgattggctgcagcccatcggccgagttgacgtcacggggaaggcagagcacatggagtgaagaaccaccctcggcacatgcgcagattatttgtttaccacttagaacacagctgtcagcgccatcttgtaacggcgaatgtgggcgcggctcccaacatctccccctttccttt	449	46	10%	76	17%
11	23224201	23225700	gcagcttcgtgccaaagagctctccattccatatatttgcccatactagggagagcggcttttacaaccgtttgccagtcagcaggagttagtgccatgccggcgagcctgtctaactgcaccaaggtaaaattagcattggttccgtatttacggaccgactcggcaatttctttaatttgtaagtattctaccggagcgtggacacgcccaccctcggctccttcaaagactggaaatgcctgttgtattttcctttgttcctctctgggaatgaatgagtctgcgcactgcctctctgcgcactgcctctctgcgcactgcctctctgcgcattgctgacgcactacgcagggcgggggctccgcatagggcggaccttgaaaccgactgccgggaggttgaacagtacgctggctttcgccagccgcttttggcttttttcttgaccaattagctggctggtaatgggctgcttcttcctcccagtctgtttcctcagaggagaattcttcatctgcttcagaactactaagagctggcttcctgagctcatctagtgacgagtatctcctagagacctccgctaatcgatcttttttcttttcttttttcttttccttccttctaatctctccccaggtattcttacctgacctaaacttttcctcgggttcaagacccttggaaaggcctgtatacttattttgtgtaccatattttctctttgctcctactctctctccccgctttacttctgatagcttgtcctgaatttcctctagaatccgccctatcttaaccacttgataacatgtgaaaaggaacaaaagggctcctaacaccagaaaaaattcaaggccaaacattttccactttacttctgatagactgtcttgaatttccttagaaagttcaagatcagacttacctcgtaaagctgtactcactggtactctcgttccccagctgaaaagttctgaattcatacagttgaatccttcttaacagtctgctttacgggaacctttattaccgcgacccgcagttctggttctggaatgagggatcttccttgcgccagtcccgagttttttctcgtcccggaattcggcaccaattgttattagacgcgttctcacgaccggccaggaaagacgcaacaaaccagaatcttctgcggcaaagctttattgcttacatcttcaggagccagagtgcaagaagcaagagagcaagaagcaagagagagagaaaacgaaaccccgtccctattaaagagaattctccttcgcctaggacgtgtcactccctgattggctgcagcccatcggccgagttgacgtcacggggaaggcagagcacatggagtgaagaaccaccctcggcacatgcgcagattatttgtttaccacttagaacacagctgtcagcgccatcttgtaacggcgaatgtgggcgcggctcccaacaTAATTCAACTAAATAGGTCCCAAAAA	1499	130	9%	176	12%
11	23224201	23225700	gcagcttcgtgccaaagagctctccattccatatatttgcccatactagggagagcggcttttacaaccgtttgccagtcagcaggagttagtgccatgccggcgagcctgtctaactgcaccaaggtaaaattagcattggttccgtatttacggaccgactcggcaatttctttaatttgtaagtattctaccggagcgtggacacgcccaccctcggctccttcaaagactggaaatgcctgttgtattttcctttgttcctctctgggaatgaatgagtctgcgcactgcctctctgcgcactgcctctctgcgcactgcctctctgcgcattgctgacgcactacgcagggcgggggctccgcatagggcggaccttgaaaccgactgccgggaggttgaacagtacgctggctttcgccagccgcttttggcttttttcttgaccaattagctggctggtaatgggctgcttcttcctcccagtctgtttcctcagaggagaattcttcatctgcttcagaactactaagagctggcttcctgagctcatctagtgacgagtatctcctagagacctccgctaatcgatcttttttcttttcttttttcttttccttccttctaatctctccccaggtattcttacctgacctaaacttttcctcgggttcaagacccttggaaaggcctgtatacttattttgtgtaccatattttctctttgctcctactctctctccccgctttacttctgatagcttgtcctgaatttcctctagaatccgccctatcttaaccacttgataacatgtgaaaaggaacaaaagggctcctaacaccagaaaaaattcaaggccaaacattttccactttacttctgatagactgtcttgaatttccttagaaagttcaagatcagacttacctcgtaaagctgtactcactggtactctcgttccccagctgaaaagttctgaattcatacagttgaatccttcttaacagtctgctttacgggaacctttattaccgcgacccgcagttctggttctggaatgagggatcttccttgcgccagtcccgagttttttctcgtcccggaattcggcaccaattgttattagacgcgttctcacgaccggccaggaaagacgcaacaaaccagaatcttctgcggcaaagctttattgcttacatcttcaggagccagagtgcaagaagcaagagagcaagaagcaagagagagagaaaacgaaaccccgtccctattaaagagaattctccttcgcctaggacgtgtcactccctgattggctgcagcccatcggccgagttgacgtcacggggaaggcagagcacatggagtgaagaaccaccctcggcacatgcgcagattatttgtttaccacttagaacacagctgtcagcgccatcttgtaacggcgaatgtgggcgcggctcccaacaTAATTCAACTAAATAGGTCCCAAAAA	1499	130	9%	176	12%
11	23246551	23247000	tactctctctccccgctttacttctgatagcttgtcctgaatttcctctagaatcctccctatcttaaccacttgataacatgtgaaaaggaacaaaagggctcctaacaccagaaaaaattcaaggccaaacattttccactttacttctgatagactgtcttgaatttccttagaaagttcaagatcagacttacctcgtaaagctatactcactggtactctcgttccccagctgaaaagttctgaattcatacagttgaatccttcttaacagtctgctttacgggaacctttattaccgcgacccgcagttctggttctggaatgagggatcttccttgcgccagtcccgagtttttttctcgtcccgggtttcagcaccaattgttattagacgcgttctcacgaccggccaggaaagacgcaacaaaccagaatcttctgcg	449	34	8%	52	12%
11	27955651	27956850	caaccgtttgccagtcagcaggagttagtgccatgccggcgagcctgtctaactgcaccaaggtaaaattagcattggttccgtatttacggaccgactcggcaatttctttaatttgtaagtattctaccggagcgtggacacgcccaccctcggctccttcaaagaccggaaatgcctgttgtattttcctttgttcctctctgggaatgaatgagtctgcgcactgcctctctgcgcattgctgacgcactacgcagggcggggactccgcatagggcggaccttgaagccgactgccctgaggccaatcagcaaactggccttcgccagccgcttttggcttttttcttgaccaattagctggctggtaatgggctgcttcttcctcccagtctgtttcctcagaggaggattcttcacctgcttcagagctactaagagctggctccccgagcccatccagcgatgagcacaggctccttttcctagagacctccgctaattgatctttcttcttttccctttttcctctttttcttctaatctctctccaggtattcctacctaaccttaacttttcctcgggttcaagacccttggaaaggcctgtatacttattttgtgtaccatattttctctttgctcctactctctctccccactttacttctgatagcttgtcctgaatttcatctagaatccgccctgccttaaccacttgataacatgtgaaaaggaacaaaagggcttctaacattagaaaaaattcaaggccaaacattttccactttacttctgatagactgtcttgaatttccttagaaagttcaaggccaggcttacctcgtaaagctgtactcactggtactctcgttccccagctgaaaagttctgaattcatacagttgaatccttcttaacagtctgctttacgggaacctttattaccgcgacccgcagttctggttctggaatgagggatcttccttgcgccagtcccgagttttttttctcgtcccgggtttcggcaccaattgttattagacgcgttctcacgaccggccaggaagaacaccacagaccagaatcttctgcggcaaagctttatttcttacatcttcaggagccagggtgcaggaagcaagagagcaagaagcaagagagagagaaaagcaagagagagagaaaacgaaacc	1199	88	7%	138	12%
11	27955651	27956850	caaccgtttgccagtcagcaggagttagtgccatgccggcgagcctgtctaactgcaccaaggtaaaattagcattggttccgtatttacggaccgactcggcaatttctttaatttgtaagtattctaccggagcgtggacacgcccaccctcggctccttcaaagaccggaaatgcctgttgtattttcctttgttcctctctgggaatgaatgagtctgcgcactgcctctctgcgcattgctgacgcactacgcagggcggggactccgcatagggcggaccttgaagccgactgccctgaggccaatcagcaaactggccttcgccagccgcttttggcttttttcttgaccaattagctggctggtaatgggctgcttcttcctcccagtctgtttcctcagaggaggattcttcacctgcttcagagctactaagagctggctccccgagcccatccagcgatgagcacaggctccttttcctagagacctccgctaattgatctttcttcttttccctttttcctctttttcttctaatctctctccaggtattcctacctaaccttaacttttcctcgggttcaagacccttggaaaggcctgtatacttattttgtgtaccatattttctctttgctcctactctctctccccactttacttctgatagcttgtcctgaatttcatctagaatccgccctgccttaaccacttgataacatgtgaaaaggaacaaaagggcttctaacattagaaaaaattcaaggccaaacattttccactttacttctgatagactgtcttgaatttccttagaaagttcaaggccaggcttacctcgtaaagctgtactcactggtactctcgttccccagctgaaaagttctgaattcatacagttgaatccttcttaacagtctgctttacgggaacctttattaccgcgacccgcagttctggttctggaatgagggatcttccttgcgccagtcccgagttttttttctcgtcccgggtttcggcaccaattgttattagacgcgttctcacgaccggccaggaagaacaccacagaccagaatcttctgcggcaaagctttatttcttacatcttcaggagccagggtgcaggaagcaagagagcaagaagcaagagagagagaaaagcaagagagagagaaaacgaaacc	1199	88	7%	138	12%
11	29332201	29332650	tggccggctgtctggagctgaagatggcgccgcccagaagctctgcgactctcgcccgtcccagaaacggctggcactctgtattccacacggtcacccgtgcagcctgccctccgcggagtcccggagccaagaaggctcccgccggcgcctgtgccacaaacctctcaggcctggcagacccccgtgctctcaccaggaaggtggccggctatctggagctgaagatggcgccgcccagaagctctgcgactctcgcccgtcccagaaacggctggcactctgtattccacacggtcacccgtgcagcctgccctcctcggagtcccggagccaagaaggctcccgccggcgcctgtgccacaaacctctcaggccgggcagacccccgtgctctcaccaggaaggtggccggctgtctCtattgaacatttctttaggtgcttctc	449	66	15%	58	13%
11	31447501	31447950	aactttattgcttacatcttcaggagctaggagcgcaaacccccagccccaaaagcgaaagccccttctatcttacatctttaggagccagagctccggcgccgccaaagcgcagagcgcgctctattgtttacatctttaggcagcgagagagcgcagggcgcgcagagccagagagatgccagcgagagagaagagaatggtggaaacccccgtcccctttttaggagagttatatttcgcctaggacgcatcactccctgattggctgcagcccatggccgagctgacgttcacgggaaaagcagagtacaagtagtcgtaaaatacccttggcacatgcgcagattatttgtttaccacttagaacacaggatgtcagcgccatcttgtgacggcgaatgtgggggcggctcccaacatctccccctttccttttaataagagca	449	50	11%	66	15%
11	31453051	31453500	ttgggcataagctccccaatggtagtttgtctgatcagcagaataagctccctgacccgttaacaagtcaaaagtccaatctctctgctctggagtcaaagcagctgcgtttgttcgggcctgcgcttgtgcagcttcgtgccaaagcgctctctatttcatatatttgcccatactagggagagcggcttttacaatcgtttgccagtcagcaggagttagtgccatgccggcgagcctgtctaactgtaccaaggtaaaattagcattggttccgtatttacggaccgactcggcgagttctttaatctgtacgtattctaccggagcgtggacacgcccaccctcggctcctttaaagactggaaatgcctgttgtattttcctttgttcctctctgggaatgaatgagtctgcgcactgcctctctgcgcactgcctctctgcgc	449	46	10%	48	11%
11	31454101	31454850	cttagaaagttcaagatcagacttacctcgtaaagttgtactcactggtactctcgttccccagctgaaaagttctgaattcatgcagttgaatccttcttaacagtctgctttacgggaacctttattaccgcgacccgcagttctggttctggaatgagggatcttccttgcgccggtgaaactcccgtcccgagtttcctcccgggttttttctttccggattttttctcgtcccgggtttcggcaccaattcttaatAgcgttctcacgcccggccaggaaagacgcaacaaaccagaatcttctgcggcaaaactttattgcttacatcttcaggagctaggaacgcaaacccccagccccaaaagcgaaagccccttctatcttacatctttaggagccagagctccggctccgccaaagcgcagagcgcgctctattgtttacatctttaggcagcgagagagcgcagggcgcgcagagccagagagatgccagcgagagagaagagaatggcggaaacccccgtcccctttttaggagagttatatttcgcctaggacgcatcactccctgattggctgcagcccatggccgagctgacgttcacgggaaaagcagagtacaagtagtcgtaaaatacccttggcacatgcgcagattatttgtttaccacttagaacacaggatgtcagcgccatcttgtgacggcgaatgtgggggcggctcccaacaTGTGCCTCCCT	749	90	12%	96	13%
11	31774651	31775100	tggtgccgaaacgcgtgtaagagttggtgccgaaacccgggaggacaagaaaacccgggaagaaagaacccgggacgaaaaaacccgggacaagaaaactcgggacgggacgagaaatcccgggacgggacgagaagacccgggacgagaagacctgggacgagaaaacctgggacgagaagacctgggacggttaccatcacaggcgcaaggaagatccctcattccggaaccagaactgcgggtcatggtaatgaagtgttcccacaaaacagactgttgagaaggattcaactgcgtgaattcagaactcttcagctggggaacggtggtaatgaagtgttcccgtaaaacagactgttgagaaggattcaactgcgtgaattcagaactcttcagctggggaacggtggtaatgaagtgttcccgtaaaacagactgttgagaag	449	58	13%	40	9%
11	32725801	32727000	accaccttacggcaggtacggcaggtattagagagggcacctgtgtgtgacaccaccttacggcaggtacggcaggtattagagagggcgcctgtgtgtgacaccaccttacggcaggtacggcaggtattagagagggcacctgtgtgtgacaccaccttacggcaggtacggcaggtattagagagggcacctgtgtgtgacaccaccttacggcaggtacggcaggtattagagagggcacctgtgtgtgacaccaccttacggcaggtacggcaggtattagagagggcacctgtgtgtgacaccaccttacggcaggtacggcaggtattagagagggcacctgtgtgtgacaccaccttacggcaggcacggcaggtattagagagggcacctgtgtgtgacaccaccttacggcaggtacggcaggtattagagagggcacctgtgtgtgacaccaccttacggcaggtacggcaggtattagagagggcacctgtgtgtgacaccaccttacggcaggtacggcaggtattagagagggcacctgtgtgtgacaccaccttacggcaggtacggcaggtattagagagggcacctgtgtgtgacaccaccttacggcaggtacggcaggtattagagagggcacctgtgtgtgacaccaccttacggcaggtacggcaggtattagagagggcgcctgtgtgtgacaccaccttacggcaggtacggcaggtattagagagggcgcctgtgtgtgacaccaccttacggcaggtacggcaggtattagagagggcgcctgtgtgtgacaccaccttacggcaggtacggcaggtattagagagggcgcctgtgtgtgacaccaccttacggcaggtacggcaggtattagagagggcacctgtgtgtgacaccaccttacggcaggtacggcaggtattagagagggcacctgtgtgtgacaccaccttacggcaggtacggcaggtattagagagggcacctgtgtgtgacaccaccttacggcaggtacggcaggtattagagagggcacctgtgtgtgacaccaccttacggcatggtacggcaggtattagagagggcacctgtgtgtgacTGGCCTCGACGCGGCCTCACTGGGGTAGTAGCTGAGTTCCACGTGAAGGCTGAGCACCTTGATGGTCCTTCCAGGA	1199	106	9%	218	18%
11	49445401	49445550	gctccgtttcttcttttgccccgtctagattcctctcttacagctcgagcggccttctcagtcgaaccgttcacgttgcgagctgctggcggccgcaacattttggcgcccgaacagggacctgaagaatggcagagagatgctaagag	149	24	16%	14	9%
11	51437551	51439200	TGCCTTTCCCCTTCATGAAGTCAGAAGGCAGCTTTCCTCCCATGCAAGCGGTCGGTCGGTGTATTTGCATTGCGCGTTAGGAGAGTCCACAGCATCCCAGCTACGGGCGGGCAGGcagctcaaaagagaggatgttcagctcaaaagagaggatgttcCGTCCTtgttgggagccgcgcccacattcgccgttacaagatggcgctgacagctgtgttctaagtggtaaacaaataatctgcgcatgtgccgagggtggttcttcactccatgtgctctgccttccccgtgacgtcaactcggccgatgggctgcagccaatcagggagtgacacgtcctaggcgaaggagaattctccttaagagggacggggtttcgttttctctctctcttgcttcttgctctcttgcttcttgcactctggctcctgaagatgtaagcaataaagttttgccgcagaagattttggtctgtggtgttcttcctggccggtcgtgagaacgcgtctaataacaattggtgccgaattccgggacgagaaaaaactcgggactggcgcaaggaagatccctcattccagaaccagaactgcgggtcgcggtaataaaggttcccgtaaagcagactgttaagaaggattcaactgtatgaattcagaacttttcagctggggaacgagagtaccagtgagtacagctttacgaggtaagtctgatcttgaactttctaaggaaattcaagacagtctatcagaagtaaagtggaatatgtttggccttgaattttttctggtgttagaagcccttttgttccttttcacatgttatcaagtggttaaggcagggcggattctagatgaaattcaggacaatctatcagaagtaaagtggggagagagagtaggagcaaagagaaaatatggtacacaaaataagtatacaggcctttccaagggtcttgaacccgaggaaaagttaaggttaggtaggaatacctggagagagattagaagaaaaagaggaaaaagggaaaagaagaaagatcaattagcggaggtctctaggaaaaggagcctgtgctcatcgctggatgggctcggggagccagctcttagtagctctgaagcaggtgaagaatcctcctctgaggaaacagactgggaggaagaagcagctcattatgagaaaaaagggtaccagccaggtaaagtgctagctaatcagttaaggaagccaaaagcggctggcgaaggccagtttgctgattggcctcagggcagtcggcttcaaggtccgccctatgcggagtccccgccctgcgtagtgcgtcagccctgcgcagagaggcagtgcgcagactcattcattcccagagaggaacaaaggaaaatacaacaggcatttccggtctttgaaggagccgagggtgggcgtgtccacgctccggtagaatacttacaaattaaagaaattgccgagtcggtccgtaaatacggaaccaatgctaattttaccttggtgcagttagacaggctcgccggcatggcactaactcctactgactggcaaacggttgtaaaagccgctctccctagtatgggcaaatatatggaatggagagcgctttggcacgaagctgcacaagcgca	1649	140	8%	192	12%
11	51519601	51520050	CGTCTTACACTCTTCCCTGAATGCCCAACTCCCAGCAGCTGAAGGGACCTGCGTGTCCTGCCTGTTACGTGCCTCATtcttacacgcgttcacgcgactggccaggaagaacgcaacaaaccggaatcttctgcggcaaaactttattgcttacatcttcaggagccagagagcaagagagcaagagctctattgcttacatctttaggagccagagcgcaagagcgcaagagagcaagagccagagcaagagagagaactctattgcttacatctttaggagccagagcgcaagagagagaatggcgaaaccccgtcccttttaaggagaattattctccgcctaggacgtattactccttgattggctgcagcccatcggccgagttgtcgtcacggggaaggcagagcacatggggtggaaaactacccttggcacatgcgcagat	449	44	10%	70	16%
11	51668701	51670200	tctgctctggagttaaagcagcagcgtttgctcggtcctgcgcctgtgccgcctcctgccacagagctcgccattccacatatttggccatactagggagagcggcttttgcaatcatttgccagtcggcaggagttagtgccatgctggcaagcctgtctaactgtaccaaggtaaaattagcattgattccgtatttacgaaccgactcagcaatttctttaatctgcacatattctaccggagcgtggacacgcccaccctcggctccttcaaagactggaaatgcctgttctattttcctttgttcctctcggggaatgaatgagtctgcgcactgcctctctgcgcattgctgacgcactacgggctgacgcactacgcagggcggggactccgcatagggcgggagtgcacctggtagccgattgccctgaggccaattagcaaactggccttcgccagccgcttttggcttttttcttgaccgattagctggctggtaatgggctgcttcttcctcccagtctgtttcctcagaggaggattcttcacttgcttcagagctactaagagctggcttcctgagctcatctagtgacgagtatctcctagagacctccgctaatcgatcttttttcttctccctttttcctctttttcttctaatctctctccaggtattcctacctaaccttaacttttcctcgggttcaagacccttggaaaggcctgtatacttattttgtgaaccatattttctctttgttcctactctttcttcccgctttacttctgatagcttgtcctgaatttcctctagaattttcagccctatcttaatcacttgatagcatgtgaaaaagaacaaaagggctcctaacaccagaaaaaattcaaggccaaacatactcactggtactctcgttccccagctgaaaagttctgaattcatacagttgaatccttcttaacagtctgctttacgggaacctttatcaccgtcgttccccagctgatgagttctgaattcggcagttgaatccttctcaacagtctgtgttacgggaaccttataaccttgattcgcagttctggttctggaatgaagtatccctcctgcgccagtccggagttttttctcgtcccggattttctcgtcccggaattcggcaccaattgttattagacgcgttctcacgaccggccaggaagaacaccacagaccagaatcttctgcggcaaagctttattcttacatcttcaggaaaagagagcaagaagcaagagagagagaaaacgaaaaccccgtccctcttaaggagcattctccttcgcctcggacgtatcactccttgattggctgcagcccatcggccgagttgacgtcacggggaaggcagagcacaagtagtcataagatacccttggcacatgcgcagattatttgtttaccacttagaacacaggatgtcagcgccatcttgtaacggcgaatg	1499	130	9%	184	12%
11	53237101	53237700	TTCCCTTCTGTCTCCCCAACAAAGATTCCAAGCCTTTCTGTGAGGGGTGGTTGCTCTCtgtagtggttttaataaggacagtttccataggctcatatattgaatccttagtcatcagggtgtggtactctcttaatcgcgttctcacgcccggccaggaaagacgcaacaaaccaaaatcttctgcggcaaaactttattgcttacatctttgggagccaggagggcaagcgcccagcgcccagccccaaaaacgaaagcccccttcttacatctttaggagccagagctccggcgcgccggggcgcagagcgcgctctattgtttacatctttaggcagcgagcgagcgcaggggcgcagagccagagagatgccagcgagagagaatggcggaaaacccgtccccttttttaggagcgttatatttcgcctaggacgcatcactccctgattggctgcagcccatggccgagctgacgttcacgggaaaggtagagtacaagtagtggagaaccaccctcggcacatgcgcagattatttgtttaccacttagaacacagctgtcagcgccatcttgtaacggcgaatgtgggcgc	599	70	12%	88	15%
11	55240801	55241250	ATCTGGGAAAGTGCACAAAAGAAGGCGGTTGGGTTTTTGGACTGGGAGGTGCCCTCTTCAGAGTGAGTGCTTCTCTGAGGAGCTTGGAGTAGAACATGACTAATTCGATGTTCCCAAAACACAGTtgttattagacgcgttctcacgaccggccaggaagaacaccacagaccagaatcttctgcggcaaagctttattcttacatcttcaggagcagagtgcaagaagcaagagagcaagaagcaagagagagagaaaagcaagagagagagaaaacgaaaccccgtccctttttaaggagaattctccttcgcctcggacgtgtcactccttgattggctgcagcccatcggccgagttgacgtcacggggaaggcagagcacaagtagtcataagatacccttggcacatgcgcagattatttgtttaccacttagaacacagctg	449	34	8%	72	16%
11	55247551	55248000	tctgctttacgggaacctttattaccgcgacccgcagttctggttctggaatgagggatcttccttgcgccagtcccgagtttttttctcgtcccggaattcggcaccaattgttattagacgcgttctcacgaccggccaggaagaacaccacagaccagaatcttctgcggcaaagctttattcttacatcttcaggagcagagtgcaagaagcaagagagcaagaagcaagagagagagaaaagcaagagagagagaaaacgaaaccccgtccctttttaaggagaattctccttcgcctcggacgtgtcactccttgattggctgcagcccatcggccgagttgacgtcacggggaaggcagagcacaagtagtcataagatacccttggcacatgcgcagattatttgtttaccacttagaacacagctgtcagcgccatcttg	449	50	11%	70	16%
11	61594201	61594350	tgttgagaaggatccggcgtggattcagaactcttcagctggggaacggtactgatgaagagaaagaagaaagatgaagactgaataaactgctgttagaaggactggtggtcgcatcgttcttgctggtcgagagcaggcgcgacaat	149	16	11%	10	7%
11	65457451	65457900	ggagagcggcttttacaaccgtttgccagtcggcaggagttagtgccatgccggcaagcctgtctaactgcaccaaggtaaaattagcattggttccgtatttacggaccgactcggcgagttctttaatttgtaagtattctaccggagcgtggacacgcccaccctcggctccttcaaagactggaaatgcctgttgtattttcctttgttcctctctgggaatgaatgagtctgcgcactgcctctctgcgcactgcctctctgcgcactgcctctctgcgcatctctctgcgcattgcctctctgcgcatctctctgcgcattgcctctctgcgcatctctctgcgcattgcctctctgcgcatctctctgcgcattgcctctctgcgcattgctgacgcactacgcagggcgggggctccgcatagggcggaccttgaaaccga	449	62	14%	52	12%
11	67678801	67678950	tatgtatgtgtgtgtctatgtgtgtctgtgtgtatgtatgtgcgtgtatatgtgtgtatctgtgtatgtgtgtgtatgtgtgtgtgtctgtgtgtgtatgtgtatgtatctgtatgtgtatgtatgagagtgtgtctgtgtctctgtgt	149	2	1%	0	0%
11	72467701	72468150	cccctcacactatctctcacacacagtcacacacacgcacacatgcacacatactctcacacacacgcacacacactctcacacacacacattatctctcatacacagtcacacacatgcacacatgcacacatactctctcacacaacacacgaacacacacatactctctcacacacacatactctctcacatacatactcacacacacatgcacacacacatactctctcacacactcacacacacatactctcacacacacacatactctctcacacacattctctcacacacacacactatctcttacacacagtcacacatactctcacacacacacgcacacacactctctctctcacacacacacacacaagcacacacacatactctcacacacactgacacacacacacacacacacacagaggcacgcacacactgtc	449	10	2%	282	63%
11	73740151	73740750	ccaggcgtaccttgtaaagctattccccactttacttctgatagactgtcttgaatttcgttagaaagttcaaggccaggcgtacctcgtaaagctatacttactggtatccaccgttccccagctgaaaagttctgaattcatgcagttgaatccttcttaacagtctgctttacgggaacctttattaccgcgacccgcagttctggttctggaatgagggatcttccttgcgccagtgatggtaaactctcgtcccgagttttttctcgtcccggaattcggcaccaattgttattagacgcgttctcacgaccggccaggaagaacaccacagaccagaatcttctgcggcaaagctttatttcttacatcttcaggagcaagcgtgtaagaagcaagagagcaagaagcaagagagagaagcaagagagagagaaaacgaaaccccgtccctattttaggagaattctccttcgcctcggacgtgtcactccctgattggctgcagcccatcggccgagttgacgtcacggggaaggcagagcacaagtagtcataagatacccttggcacatgcgcagattatttgtttacca	599	62	10%	78	13%
11	74129101	74130300	cttaatagggacgggtttcgttttctctctctcttgcttcttacactcttgctcctgaagatgtaagcaataaagttttgccgcagaagattctggtctgtggtgttcttcctggccgggcgtgagaacgcgtctaataacaattggtgccgaattccgggacgagaaaaaactcgggactggcgcaaggaagatccctcattccagaaccagaactgcgggtcgcggtaataaaggttcccgtaaagcagactgttaagaaggattcaactgtatgaattcagaacttttcagctggggaacgagagtaccagtgagtatagctttacgaggtaagcctggccttgaactttctaaggaaattcaagacagtctatcagaagtaaagtggaaaatgtttggccttgaattttttctagtgttagaagcccttttgttccttttcacatgttatcaagtggttaaggcagggcggattctagatgaaattcaggacaatctatcagaagtaaagcggggagagagagtaggagcaaagagaaaatatggtacacaaaataagtatacaggcctttccaagggtcttgaacccgaggaaaagtttaggtcaggtaagaatacctggggagagattagaaggaaggaaaagaaaaaagaaaagaaaaaagatcgattagcggaggtctctaggagatactcgtcactagatgagctcaggaagccagctcttggtagctctgaatcagatgatgaattctcctctgaagaaacagactgggaggaagaagcagctcattatgagaaaaaagggtaccagccaggtaaagtgctagctaatcagttaaggaagccaaaagcggctggcgaaggccagtttgctgattggcctcagggcagtcggtttcaaggtccgccctatgcggagcccccgccctgcgtagtgcgtcagcaatgcgcagagaggcaatgcgcagagagatgcgcagagaggcaatgcgcagagagatgcgcagagaggcagtgcgcagagagacaatgcgcagagaggcagtgcgcagactcattcattcccagagaggaacaaaggaaaatacaacaggcatttccggtctttgaaggagccgagggtgggcgtgtccacgctccggtagaatacttacagattaaagagcttgccgagtcggtccgtaaatacggaa	1199	98	8%	136	11%
11	74129101	74130300	cttaatagggacgggtttcgttttctctctctcttgcttcttacactcttgctcctgaagatgtaagcaataaagttttgccgcagaagattctggtctgtggtgttcttcctggccgggcgtgagaacgcgtctaataacaattggtgccgaattccgggacgagaaaaaactcgggactggcgcaaggaagatccctcattccagaaccagaactgcgggtcgcggtaataaaggttcccgtaaagcagactgttaagaaggattcaactgtatgaattcagaacttttcagctggggaacgagagtaccagtgagtatagctttacgaggtaagcctggccttgaactttctaaggaaattcaagacagtctatcagaagtaaagtggaaaatgtttggccttgaattttttctagtgttagaagcccttttgttccttttcacatgttatcaagtggttaaggcagggcggattctagatgaaattcaggacaatctatcagaagtaaagcggggagagagagtaggagcaaagagaaaatatggtacacaaaataagtatacaggcctttccaagggtcttgaacccgaggaaaagtttaggtcaggtaagaatacctggggagagattagaaggaaggaaaagaaaaaagaaaagaaaaaagatcgattagcggaggtctctaggagatactcgtcactagatgagctcaggaagccagctcttggtagctctgaatcagatgatgaattctcctctgaagaaacagactgggaggaagaagcagctcattatgagaaaaaagggtaccagccaggtaaagtgctagctaatcagttaaggaagccaaaagcggctggcgaaggccagtttgctgattggcctcagggcagtcggtttcaaggtccgccctatgcggagcccccgccctgcgtagtgcgtcagcaatgcgcagagaggcaatgcgcagagagatgcgcagagaggcaatgcgcagagagatgcgcagagaggcagtgcgcagagagacaatgcgcagagaggcagtgcgcagactcattcattcccagagaggaacaaaggaaaatacaacaggcatttccggtctttgaaggagccgagggtgggcgtgtccacgctccggtagaatacttacagattaaagagcttgccgagtcggtccgtaaatacggaa	1199	98	8%	136	11%
11	74225401	74226750	aattagcattggttccgtatttacgaaccgactcggcaatttccttaatttgtaagtattctaccggagcgtggacacgcccaccctcggctccttcaaagaccggaaatgcctgttgtattttcctttgttcctctctgggaatgaatgagtctgcgcactgcctctctgcgcactgcctctctgcgcattgctgacgcactacgcagggcggggactccgcatagggcggaccttgaagccgactgccctgaggccaatcagcaaactggccttcgccagccgcttttggcttttttcttgaccaattagctggctggtaatgggctgcttcttcctcccagtctgtttcctcagaggaggattcttcacctgcttcagagctactaagagctggctccccgagcccatccagcgatgagcacaggctccttttcctagagacctccgctaattgatctttcttcttttccctttttcctctttttcttctaatctctctccaggtattcctacctaaccttaacttttcctcgggttcaagacccttggaaaggcctgtatacttattttgtgtaccatattttctctttgctcctactctctctccccgctttacttctgatagcttgtcctgaatttcctctagaattttcagccctatcttaatcacttgataacatgtgaaaaggaacaaaagggctcctaacaccagaaaaaattcaaggccaaacattttccactttacttctgatagactgtcttgaatttcgttagaaagttcaagatcagacttacctcgtaaagctgtactcactggtactctcgttccccagctgaaaagttctgaattcatacagttgaatccttcttaacagtctgctttacgggaacctttattaccgcgacccgcagttctggttctggaatgagggatcttccttgcgccagtcccgagttttttctcgtcccggaattcggcaccaattgttattagacgcgttctcacgaccggccaggaagaacaccacagaccagaatcttctgcggcaaagctttatttcttacatcttcaggagcaagagtgtaagaagcaagagagcaagaagaaagagagagagaaaacgaaaccccgtcccttttttaggagaattctccttcgcctcggacgtgtcactccctgattggctgcagcccatcggccgagttgacgtcacggggaaggcagagcacaagtagtcataagatacccttggcacatgcgcagattatttgtttaccacttagaacacagctgtcagcgccatcttgtaacggcgaatgtgggcgcggctcccaacaCttgagct	1349	114	8%	156	12%
11	74376301	74376900	AAATACTAGCTGTTAATAATGACGTCCTCAAATTaaagtcttaataacaataacacaagtacacacacacacacaaatacacatactcacacatagatgcatgcacacacatatacacacacttgcacatgcatacatgcaacatacacatacatacaaatgcctgtgtatatacatatacacatatacacatactctcacatacatacacacacatacacatgtacttacacactcacatacacacatacacatgcatacacataaaaacacaaacatgcatacatatacacacaccacatacacatgcaaatgtacacatacatacatgcacataaaaacacacatacacacacagatacatgcacacacataaatacacacacagaacacatgcacacacacagcatacacatacaacatacacaaacacacatgcgtacaacacacacatatacacaTCCTTTCCTACTGTATTCAGTATTATGCTTGAAGAGTAAAGCCGAATTTCACCTATACCCTATAGTCCACTTTTCTAGCATTTTCCTCACATTTCTTATTAGTAATAAATTTTTATAAAACTTAGAGATCTGTATTTT	599	6	1%	250	42%
11	75599701	75600150	CCAATTTTCAGATCATCTCTTAAACTTTCTTCATTCTGTTAAAGGGATGAATTAAATATCCTTATTTTTTAAGTAGCTGGTGTCTTACTATAAAGAAAGGTGCGGCAAACCCAGATCCAAAGTACACGGTCATCATAGCCAGCAACCGCCACTTGTTTTCCACTGAAAATGGCAAATTCTTCCCCGGACCCTCCTCATAGTGGCTGCGACGGACCACGGAGGTCGTGAACCTCCGGATACTCTGGCCCAACATGTCGCTGCTGGAAGTTCTGCGAGGGCCGCAGACACGGAAGGCGGAAGAAATGGCCGTACCACCTAACTCCCCTTTCTACACGACCTTGCTCTGCTAGTAAAAGAATTTTTTTGTCCAGTATTTTCAAATAACTTTGGAAATCATTTGTGTACTAGAACTTAGGATTAAACCAGACACATTTGCTGATTCCAAAATC	449	32	7%	60	13%
11	79232701	79233150	caggaaagacgcaacagaccagaatcttctgcggcaaaactttattgcttacatcttcaggagcaggagtgcaaaaacccccagccccaaaaacgaaagccccttcaataattttaggagccagagctccggcgcgccaaagcgcagagcgtgctctattgtttacatctttaggcagcgagagagcgcagggcgcgcagagccagagagatgccagcgagagagaatggcggaaaaccccgtccccttttttaggagagttatatttcgcctaggacgcatcactccctgattggctgcagcccatggccgagctgacgttcacgggaaaggtagagtacaagtagtcataaaatacccttggctcatgcgcagattatttgtttaccacttagaacacaggatgtcagcgccatcttgtgacggcgaatgtgggggcggctcccaac	449	50	11%	72	16%
11	79744501	79744650	tccatagttacggaccgactcggcaagctctttaatctgtatatacgctaccggagcgtggacacgcccaccctcggctccttcaaagaccggaaatgcctgttgtattttcctttgttcctcctttggaatgaacgagtctgtgcatt	149	20	13%	12	8%
11	79874101	79874250	acaagtggaaaggcttgcgaatcacgctatgactcctggtgattggcagacggtagtaaaagctgtagcccccagtatgggaatgtatcttgagtggaaagccttgtggcaggactcctgccagacgcaggcaagggccaatgccacca	149	8	5%	22	15%
11	81015901	81016050	tctctctcttgctcttgctctcttgctcctgaagatgtaagcaataaagcttttgccgcagaagattccggtttgttgcgttcttcctaatcggtcgcgcgaacgcgtgtaaaaGTCCCCAACTTAtggtgctggaagagctcaggatt	149	18	12%	8	5%
11	82336951	82338450	agttagtgccatgccggcgagcctgtctaactgcaccaaggtaaaattagcattggttccgtatttacggaccgactcggcaatttctttaatttgtaagtattctaccggagcgtggacacgcccaccctcggctccttcaaagaccggaaatgcctgttgtattttcctttgttcctctctgggaatgaatgagtctgcgcactgcctctctgcgcagggctgacgcactacgcagggcggggactccgcatagggcggaccttgaagccgactgccctgaggccaatcagcaaactggccttcgccagccgcttttggcttccttaactgattagctagcactttacctggctggtacccttttttctcataatgagctgcttcttcctcccagtctgtttcttcagaggagaattcttcatctgcttcagagctactaagagctggctccccgagcccatccagcgatgagcacaggctccttttcctagagacctccgctaattgatctttcttcttttccctttttcctctttttcttctaatctctctccaggtattcctacctaaccttaacttttcctcgggttcaagacccttggaaaggcctgtatacttattttgtgtaccatatttcctctttgttcctactctctctccccgctttacttctgatagcttgtcctgaatttcctctagaattttcagccctatcttaatcacttgataacatgtgaaaaggaacaaaagggctcctaacaccagaaaaaattcaaggccaaacatattccactttacttctgatagactgtcttgaatttccttagaaagttcaagatcagacttacctcgtaaagctgtactcactggtactctcgttccccagctgaaaagttctgaattcatacagttgaatccttcttaacagtctgctttacgggaacctttattaccgcgacccgcagttctggttctggaatgagggatcttccttgcgccagtcccgagttttttctcgtcccggaattcggcaccaattgttattagacgcgttctcacgaccggccaggaaagacgcaacaaaccagaatcttctgcggcaaaactttattgcttacatcttcaggagcaggagtgtaagaagcaagagagagcgaaaacgaaaccccgtccctattaaggagaattctccttcgcctaggacgtgtcactccctgattggctgcagcccatcggccgagttgacgtcacggggaaggcagagcacatggagtagagaaccaccctcggcatatgcgcagattatttgtttaccacttagaacacagctgtcagcgccatcttgtaacggcgaatgtgggcgcggctcccaacaCAGGCCCAGAGGCTGAGACGCATGCCAGGGTTTCTTTAGCTCCACAGTCAACATTCTTAGCTGTTTCCCTGGCTTCATGAAATGAGCACTCCCTGtgtggcagttcgactgagaaatactc	1499	122	8%	178	12%
11	83071651	83071800	gtttctgcaactggttacgtggccttaattggtatttataactaccttcctctactacccattctgtatttccttctccttcagccagcacctcagcaggtcttggctcttttcctggaggattgacccataccttcattcctgatggg	149	2	1%	18	12%
11	86815201	86815800	ctctctaaggccggccaattgagaccctctgcacgaggtgggactcgaacccacgatcccgtgaccagacgcgaggtgggactcgaacccacgatctcgcaacaaaacacgaggtgggactcgaacccacgatcccgtgaccagacgcgaggtgggactcgaacccacgatctcgcaacaaaacacgaggtgggactcgaacccacgatcccgtgaccagacgcgaggtgggactcgaacccacgatctcgcaacaaaacacgaggtgggactcgaacccacgatctcgcaacaaaacacgaggtgggactcgaacccacgatctcgcaactgggcacgaggtgggactctaacccacgatctcgcaaccccaaatggtctcttggccttcaaaggggtccaccaggcgtccctgatcctcccctgttcctcctgggacgtctcccagggcgaacggacggtggacacctggacacgtctatccttatccaccccgcactccctctcggagcgcggtctcactgagcatccgcaaaactgaaactgcgatcgcaccagacttagaaacagaacacagacattagaacacagacatcaga	599	104	17%	102	17%
11	86845951	86847150	gccggtcgtgagaacgcgtctaataacaattggtgccgaattccgggacgagaaaaaactcgggactggcgcaaggaagatccctcattccagaaccagaactgcgggtcgcggtaataaaggttcccgtaaagcagactgttaagaaggattcaactacatgaattcagaacttttcagctgggggaacgagagtaacccgtaagtatagctttacgaggtaagtctgatcttgaactttctaaggaaattcaagacagtctatcagaagtaaagtggaaaatgtttggccttgaattttttctagtgttagaagcccttttgttccttttcacatgttatcaagtggttaaggcagggcggattctagatgaaattcaggacaagctatcagaagtaaagcggggagagagagtaggaacaaagaggaaatatggtacacaaaataagtatacaggcctttccaagggtcttgaacccgaggaaaagttaaggttaggtaggaatacctggagagagattagaagaaaaagaggaaaaagggaaaagaagaaagatcaattagcggaggtctctaggaaaaggagcctgtgctcatcgctggatgggctcggggagccagctcttagtagctctgaagcagatgaagaattctcctctgaagaaacagactgggaggaagaagcagctcattatgagaaaaaagggtaccagccaggtaaagtgctagctaatcagttaaggaagccaaaagcggctggcgaaggccagtttgctgattggcctcagggcagtcggcttcaaggtccgccctatgcggagcccccgccctgcgtagtgcgtcagcagtgcgcagagaggcagtgcgcagagaggcagtgcgcagactcattcattcccagagaggaacaaaggaaaatacaacaggcatttccggtctttgaaggagccgagggtgggcgtgtccacgctccggtagaatacttacaaattaaagaaattgccgagtcggtccgtaaatacggaaccaatgctaattttaccttggtgcagttagacaggcttgccggcatggcactaactcctgccgactggcaaacggttgtaaaagccgctctccctagtatgggcaaatatatggaatggagagcgctttggcacgaagctgcacaagcgcaggcccgagcaaacgcagctgc	1199	102	9%	138	12%
11	90507901	90508350	cttgcgctctggctcctaaagatgtaagcaatagagctcttgctctcttgcactcttgctcctgaagatgtaagcaataaagttttgccgcagaagattctggtttgctgtgttcttcctggccggtcgtgaacgcgtgtaagaGttggtgctgaaacccgagacgagaaaacccgggacgagaaatcctgggatgagaaaacccgggacggttaccatcaccggcgcagggaagatccctcattccggaaccagaactgcgggtcacggtcataaaggttcccgtaaaacagactgttgagaaggattcaactgcgtgaattcagaactcttcagctggggaacggtggtaatgaagtgttcccgtaacacagactgttgagaaggattcaactgcgtgaattcagaactcttcagctggggaacagggtacccgtaagtatagcttt	449	46	10%	42	9%
11	90902851	90903150	ccccgccctgcgtagtgcgtcagcaatgcgcagagaggcagtacgcagagaggcagtgcgcagactcattcattcccagagaggaacaaaggaaaatacaacaggcatttccggtctttgaaggagccgagggtgggcgtgtccacgctccggtagaatacttacaaattaaggaaattgccgagtcggttcgtaaatacggaaccaatgctaattttaccttggtgcagttagacaggctcgctggcatggcactaactcctgccgactggcaaacggttgtaaaagccgctctccct	299	38	13%	44	15%
11	90965851	90966000	ttttacaaccgtttgccagtcggcaggagttagtgccatgccggcaagcctgtctaactgcaccaaggtaaaattagcattggttccgtatttacggaccgactcggcaatttctttaatttgtaagtattctaccggagcgtggacac	149	18	12%	20	13%
11	90973201	90973350	tcttcttcactctgccaggcaacagccaggtcctcctgactgttccgtaccccgggcactccagggtctccctcggaatgtcttccaagggtgcagcctgtggggaaatagaccgtcgtcttcccacagccactagggtccttacggtc	149	12	8%	24	16%
11	97639951	97640250	tgtgcacctgcttacatggatgcttgtcctgtgcatgtgtgcacctgcttgcatggatgcttgtcgtgtgcatgtgtgcacctgcttgcatggatgcttgtcgtgtgtgtgcacctgcttgcatggatgcttgtcctgtgcgtgtgtgcacctgcgtgcatggatgcttgtcgtgtgtgtgtgtgtgtgtgtgtgtgtgtgtgtgtgtgcacctgcttgcatggatacttgtcatgtgtttgtgtgtgtgtgtgtgtgtgtgtgtgtgtgtgtgtgtgtgcacctgcttgcatggatac	299	10	3%	34	11%
11	98613301	98613750	ccgttacaagatggcgctgacagctgtgttctaagtggtaaacaaataatctgcgcatgtgccgagggtggttcttcactccatgtgctctgccttccccgtgacgtcaactcggccgatgggctgcagccaatcagggagtgacacgtcctaggcgaaatataactctcctaaaaaagggacggggtttcgttttctctctctcttgcttcttgcactctggctcctgaagatgtaagcaataaagctttgccgcagaagattctggtttgttgcgtctttcctggccggtcgtgagaacgcgtctaataacaattggtgccgaattccgggacgagaaaaaactcgggacgagagtttaccatcaccggtgcaaggaagatccctcattccagaaccagaactgcgggtcgcggttatgaagtgttcccacaacacagactgttaag	449	54	12%	50	11%
11	98614351	98614650	aaaagcggctggcgaaggccagtttgctgattggcctcagggcagtcggcttcaaggtccgccctatgcggagtccccgccctgcgtagtgcgtcagccctgcgcagagaggcagtgcgcagagaggcagtgcgcagactcattcattcccagagaggaacaaaggaaaatacaacaggcatttccggtctttgaaggagccgagggtgggcgtgtccacgctccggtagaatacttacaaattaaagaaattgccgagtcggtccgtaaatacggaaccaatgctaattttaccttgg	299	40	13%	40	13%
11	99712651	99712800	tatttttctttttaatacaatttattgcagcaaaagacacattttattTTAGATTTTAACCTAAAAAGtgttattagacgcgttctcacgaccggccaggaaagacgcaacaaaccagaatcttctgcggcaaagctttattgcttaca	149	12	8%	24	16%
11	99716701	99717300	ctcactggtactctcgttccccagctgaaaagttctgaattcatacagttgaatccttcttaacagtctgctttacgggaacctttattaccgcgacccgcagttctggttctggaatgagggatcttccttgcgccagtcccgagttttttctcgtcccggaattcggcaccaattgttattagacgcgttctcacgaccggccaggaaagacgcaacaaaccagaatcttctgcggcaaagctttattgcttacatcttcaggagccagagtgcaagaagcaagagagagagaaaacgaaaccccgtccctattaaggagaattttccttcgcctaggacgtgtcactccctgattggctgcagcccatcggccgagttgacgtcacggggaaggcagagcacatggagtagagaaccaccctcggcatatgcgcagattatttgtttaccacttagaacacagctgtcagcgccatcttgtaacggcgaatgtgggcgcggctcccaacaAAAAAGttctctcaactatctgaaatcataaaatttaaattttatttgaatcaaatcaggaattatgtaatgtcactatgaaggac	599	62	10%	84	14%
11	104859451	104859900	GTATCCACCAGAGCTGTCTTGACCGAGGTAGTCTTTTTTCTTTGTGTACTAGGAACCTCTGCTGGAGACACTTAGCCTTGCATTCTGTAGGTTGGGCCGATTCCCTCCCTGTCTCGAGACTCCAGAGATCATGTGAAAGCTAATGATTTAACTAGAGGATGTCtcttacacgcgttctcgcgaccggccaggaagaacgcagcaaaccggaatcttctgcggcaaaactttattgcttacatcttcaggagccagaagcaagagccagagcaagagagcaagagagagaatggcgaaaccccgtcccttttaaggaaaattattctccgcctaggacgtattactctttgattggctgcagcccatcggccgagttgtcgtcacggggaaggcagagcacatggagtgaagaactacccttggcacatgcgcagattatttgtttacca	449	40	9%	56	12%
11	106292701	106293000	aaaGTTCGTTtgttattagacgcgttctcacgaccggccaggaaagacgcaacagaccagaatcttctgcggcaaagctttattgcttacatcttcaggagccagagtgcaagaagcaagagagagagaaaacgaaaccccgtccctattaaggagaattctccttcgcctaggacgtgtcactccctgattggctgcagcccatcggccgagttgacgtcacggggaaggcagagcacatggagtagagaaccaccctcggcatatgcgcagattatttgtttaccacttagaacaca	299	34	11%	48	16%
11	106297051	106297500	cttacctcgtaaagctgtactcactggtactctcgttccccagctgaaaagttctgaattcatacagttgaatccttcttaacagtctgctttacgggaacctttattaccgcgacccgcagttctggttctggaatgagggatcttccttgcgccagtcccgagttttttctcgtcccgggtttcagcaccaattgttattagacgcgttctcacgaccggccaggaaagacgcaacagaccagaatcttctgcggcaaagctttattgcttacatcttcaggagccagagtgcaagaagcaagagagagagaaaacgaaaccccgtccctattaaggagaattctccttcgcctaggacgtgtcactccctgattggctgcagcccatcggccgagttgacgtcacggggaaggcagagcacatggagtagagaaccaccctcggca	449	50	11%	60	13%
11	106631101	106631250	atggcgattgagggctaagagattcctgctcgcatgttgtaaggttcctgaataaactgctttgagaagaacactgtgtcgtcgcttttttctgctggtcggagacagaagcgacaagtggtggcccatacggagaaccttctcttcgc	149	16	11%	10	7%
11	107954851	107955000	agcggctcctatgatgctcacactcggatggccgttacacagcagctcctatgatgctcacactcagatggccgttacacagtggttcctatgatgctcacactcggatggccgttacacagtggttcctatgatgctcacactcggat	149	14	9%	32	21%
11	111182551	111183000	tgacagctgtgttctaagtggtaaacaaataatctgcgcatgtgccgagggtggttcttcactccatgtgctctgccttccccgtgacgtcaactcggccgatgggctgcagccaatcagggagtgacacgtcctaggcgaaggagaattctccttaagagggacggggtttcgttttctctctctcttgcttcttgcactcctgctcctgaagatgtaagcaataaagttttgccgcagaagattttggtctgtggtgttcttcctggccggtcgtgagaacgcgtctaataacaattggtgccgaattccgggacgagaaaaaactcgggactggcgcaaggaagatccctcattccagaaccagaactgcgggtcgcggtaataaaggttcccgtaaagcagactgttaagaaggattcaactgtatgaattcagaacttttcagc	449	48	11%	44	10%
11	111221401	111221700	attggttccgtatttacggaccgactcggcgagttctttaatttgtaagtattctaccggagcgtggacacgcccaccctcggctccttcaaagaccggaaatgcctgttgtattttcctttgttcctctctgggaatgaatgagtctgcgcactgcctctctgcgcactgcctctctgcgcactgcctctctgcgcatctctctgcgcattgcctctctgcgcattgctgacgcactacgcagggcgggggctccgcatagggcggaccttgaagccgactgccctgaggccaatcag	299	44	15%	28	9%
11	115046851	115047450	aagccaaataagccttttactctccaaggtttttttttgttggtcgatgtctttatcacagtaacagaaaGCAAACACGCAGCCTAGAGACATGAAGCGagtatgtggaagagacatctccccttgtgtttactatggcagtgttcacagtagccatggcacagagtcacgtagatacaagtgaacagatagcagatcgtggtgcatgaatgtaatggagaatcatcgtgaagggattgagttctgccatttgcagcccacgggagagacttgaggaactgaaataaatcagatacaggaagatgctgccacacattcctattgatgtgtgaaagctaaaaagttactctcTGTGGCTAGggagccagggagacagacctgtctggaaagcgtttctgtgtaatctgagtttggatccccagaacaggtggaagaaaagccaggtgaggtgggggtgcctgtaaccccaatgacagggggatcctggaggtcacaggccagatgggctgaatctgtgagctcaggagcagcgggagaccatgtctgaacaaacaaggtggagagtgatagagaaaacgacccaatgtcaatctcCACAT	599	20	3%	98	16%
11	115046851	115047450	aagccaaataagccttttactctccaaggtttttttttgttggtcgatgtctttatcacagtaacagaaaGCAAACACGCAGCCTAGAGACATGAAGCGagtatgtggaagagacatctccccttgtgtttactatggcagtgttcacagtagccatggcacagagtcacgtagatacaagtgaacagatagcagatcgtggtgcatgaatgtaatggagaatcatcgtgaagggattgagttctgccatttgcagcccacgggagagacttgaggaactgaaataaatcagatacaggaagatgctgccacacattcctattgatgtgtgaaagctaaaaagttactctcTGTGGCTAGggagccagggagacagacctgtctggaaagcgtttctgtgtaatctgagtttggatccccagaacaggtggaagaaaagccaggtgaggtgggggtgcctgtaaccccaatgacagggggatcctggaggtcacaggccagatgggctgaatctgtgagctcaggagcagcgggagaccatgtctgaacaaacaaggtggagagtgatagagaaaacgacccaatgtcaatctcCACAT	599	20	3%	98	16%
11	116745601	116746800	gtgcatgtgctgtggtgtgtgcatgtgttctgttgtgtgcatgtgctgtggtgtgtgcatgtgctgtgatatgtgcgtgtgctgtggtgtgtgcatgtgctgtggtatgtgcatgtgctgtggtgtgtgcatgtgctgtggtgtgtgcatgtgctgtggtgtgtgcctgtgctgtggtatgtgcatgtgctgtggtgtgtgcatgtgctgtggtatgtgcatgtgttgtgttgtgtgcatgtgttgtgttgtgtgcatgtgctatggtgtgtgcatgagctctggtgtgtgcatgtgctgtggtgtgtgcatgtgctgtggtatgtgcatgtgctgtggtgtgtgcatgtgctgtggtatgtgcatgtgctgtggtgtgtgcatgtgctgtggtgtgtgcatgtgctgtggtgtgcgcatgtgctgtggtatgtgcatgtgttgtgttgtgtgcatgtgctgtggtgtgtgcatgagctctggtgtgtgcatgtgctgtggtgtgtgcatgtgctgtggtatgtgcatgtgctgtggtgtgtgcatgtgctgtggtatgtgcatgtgctgtggtgtgtgcatgtgctgtggtgtgtgcatgtgctgtggtatgtgcatgtgctatggtgtgtgcatgtgctgtggtatgtgcatgtgttgtgtgcatgtgttgtgttgtgtgcatgtgctgtggtatgtgcatgagctctggtgtgtgcgtgtgctgtggtgtgtgcatgtgctgtggtgtgtgtatgtgttctgttgtgtgcatgtgctctgttgtgtgcatgtgctgtggtgcgtgcatgtgctatggtgtgtgcatgtgctgtggtgcatgcatgtgctgtggtgcgtgcatgtgctgtggtgtgtgcatgtgctgtggtgcgtgcatgtgctgtggtgtgtgcatgagctctggtgtgtgcatgtgctgtggtgtgtgcatgagctctggtgtgtgcatgtgctctggtgtgtacatctgctcttgtgtgtTTTTGTCCTCTGgtacgtgcatgcctgtggagaccacacgttgacctctgttgtcttctagaaaccaccttctgtgctttttgagatagagtctgtcgttggcttagagcttgctaagaaagctttctggccattgatcccctaggatccccctgtctctgcactgggattctgagctctccccaccatgcctg	1199	18	2%	122	10%
11	116944051	116944200	cacacacagtcgcacatacacacgcacacacacagacatacagtcacatatacacacacagaaatgtacacacacagttacagtcacacactcacacacatagtcacacatactcatacacacacacaatacaccacacagacacacac	149	4	3%	98	66%
11	117307501	117307800	tgtgtacgtgtgtgcaatcgcatatatgtgtgtgcatgagtgtttatgtatgtgtgcgtgagtatttaggtatgtgtgtgtgcatctgcacatgtgtgtgcatgtgtgtacgtgtgtgcaatcgcatatatgtgtgtgcatgagtgtttatgtatgtgtgcgtgagtatttatgtatgtgtgtgtacgtggcagatgcactgggcacccttgtcagcatcttcctttacgtttccagacagggtattctcactgaccatggctaggttgcttggccagcaacctcagggatctccctgg	299	16	5%	44	15%
11	117500851	117501300	agttaaggaagccaaaagcggctggcgaaggccagtttgctgattggcctcagggcagtcggcttcaaggtccgccctatgcggagcccccgccctgcgtagtgcgtcagcaatgcgcagagaggcaatgcgcagagagatgcgcagagaggcaatgcgcagagagatgcgcagagaggcaatgcgcagagagatgcgcagagaggcagtgcgcagagaggcagtgcgcagactcattcattcccagagaggaacaaaggaaaatacaacaggcatttccggtctttgaaggagccgagggtgggcgtgtccacgctccggtagaatacttacagattaaagagcttgccgagtcggtccgtaaatatggaaccaatgctaattttaccttggtgcagttagacaggcttgccggcatggcactaactcctgccgactggcaaacggtt	449	56	12%	72	16%
11	117632851	117633000	acaaacacatacacaccacactcacacatacatacacacacggttatacacacacaatacatacattcacacagagtcatatacacaccacactcacaaacacacacacacacacactcatacacaccacactcaaaaacacacagtca	149	2	1%	96	64%
11	120114751	120114900	cagtgcagtgcagtcacagcacagtcatgtgtgccacgtgagagtgcagtgcagtcacagcgcagtcacgtgtaccatgtgagagtacagtgcagtcacagcacGTGCTGGGCTCTCACTAGAACAAGCAGATTCCTACTGGGACCCCA	149	6	4%	50	34%
11	120280501	120280650	TCACCCCACCGGCCAGCCCTGGCCCCTTGCATGCAGGGCAGCGTTGCGTAAAAGGCTCTTTATCTGCACTGTATAAAGTCGTTGGTCACGCTGCGCTGCTGCTCACGGCTGCCGCGCGATGTTATTATCCATTACCCGCCCGGCGCAGT	149	26	17%	22	15%
11	121318801	121319400	ttagagaaaggggagtggacacagattgtcccatttccagaataatagtagacacaacaagagcgaacacgagactaagacaaaaaagaaaccaaaagcggcggcgacttcgtgtcgaccacaagcaactcaaagaatcagatggcctttctaaggccggccgattgagaccctctgcacgaggtgggacttgaacccacgatcccgtaaccaaacatgaggtgggactcgaacccacggtctcgcaacaaggcgcgaggtgggactcgaacccacggtctcgcaacaaaacacgaggtgggactcgaacccacgatctcgcaacagggcacgaggtgggactcgaacccacgatctcgcaaccccagatggtctcttggcctccaaaggggtccaccaggcgtccctgttcctcccctgttcctcctgggacgtctcccagggcaaacggacggtggacacctggacacgtctatccttatccaccccgcgttccctctcggagcgcggtctcactgagcgtccgcaaaaccgaaactgcgatcgcaccaaacttagaaacagaacacagacaccagaccaagacaggtcaaagaatc	599	86	14%	106	18%
11	121399351	121399500	ccatttgccaaacatctaggggtcgcaatccgcgaggattaacacccacggaaggtgcattaacaaattctacacatttaccacactgtaagacaatatttcgggcttcttttcgtgtgagcttaaacttttgtcgtaatgtagaagca	149	14	9%	28	19%
12	3002401	3002850	aaacaaataatctgcgcatatgccgagggtggttctccactccatgtgctctgccttccccgtgacgtcaactcggccgatgggctgcagccaatcagggagtgacacgtcctaggcgaaatataactctcctaaaaaagggacggggtttcgttttctctctctcttgcttcttacactcttgctcctgaagatgtaagcaataaagttttgccgcagaagattctggtctgtggtgttcttcctggccgggcgtgagaacgcgtctaataacaattggtgccgaattccgggacgagaaaaaacttgggactggcgcaaggaagatccctcattccagaaccagaactgcgggtcgcggtaataaaggttcccgtaaagcagactgttaagaaggattcaactgtatgaattcagaacttttcagctgggggaacgagagtaccagt	449	48	11%	44	10%
12	3003601	3003750	gactcattcattcccagagaggaacaaaggaaaatacaacaggcatttccagtctttgaaggagccgagggtgggcgtgtccacgctccggtagaatacttacaaattaaagaactcgccgagtcggtccgtaaatacggaaccaatgc	149	18	12%	22	15%
12	3063001	3063300	acgactacttgtactctgcctttcccgtgaacgtcagctcggccatgggctgcagccaatcagggagtgatgcgtcctaggcgaaatataactcctccttaagggggacggggttttccgccattctctctcgctggcatctctctggctctgcgcgccctgcgctctctcgctgcctaaagatgtaaacaatagagcgcgctctgcgctttggcgcgccggagctctggctcctaaagatgttattggggtggctttcgcttttggggctgggggtttgcgctcctggctcctgaaga	299	42	14%	16	5%
12	4437001	4437150	cacagacgtgcaaaggaccactagaaagtacgctaaagaagtgcatgccacagacgtgcaaaggaccactagaaagtatgctaaacaagtgcatgccacaggcgtgcaaaggaccactagaaagtacgctaaagaagtgcatgccacag	149	10	7%	36	24%
12	4801501	4801950	cgctctgagagggaacgcggggtggataaggatagacgtgtccaggtgtccaccgtccgttcgccctgagagacgtcccaggaggaacaggggaggaccagggacgcctggtggacccctttggaggccaagagaccatctggggttgcgagatcatgggttcgagtcccacctcgtgcctggttgcgagatcgtgggttcaagtcccacctcgtgttttgttgcgagatcgtgggttcgagtcccacctcgcgccttgttgcgagaccgtgggttcgagtcccacctcgtgttttgttacgggatcgtgggttcgagtcccacctcgtgcagagggtctcaatcggccggccttagaaaggccatctgattctttgagttgcttgtggtcgacgcgaagtcgccgccgtttttggtttcttttttgtcttagtctcgtgttcgctctt	449	76	17%	34	8%
12	5054251	5055450	tctaacagcagtttattccgtcttcatctttcttctttctcttcatcagtaccgttccccagctgaagagttctgaatccacgccagatccttctcaacagtctgttttacgggaacctttattaaccacttcttccccgttatgcagttctgaatccttcctgtagcaggggctcttcgctcttgcctgaagatgtttcttttcccgggtttctcgtcccgtgttttctcgtcccaggtcttctcgtcccATCCCGAGTTTTTCTTCCCGGGTTTCGGCACCACTtgttgcgcgcgctcaacaggccaggaagaacgacgctgctacaggatccttctgcacacatttattcagtcctgtttcttctttctccatatatctcccttgtttatatctcccttgtttatatatctcccttgtttttatatctcccttgtttatatatctcccttgtttttatatctcccccctaatagtaatcctctctcgaataataatcctccctctaacccgggcctctcactccttttatactctctctcatccacgaaccgcaggccacgccccctcgccagtcacgaggcttcagctaatcagggcagcaggggcaaatctccaccaaattggattcacctgtatcctggtacacctgcgcagctctcaagatgtttgtggtttatatgaggaagtcaggtgcaagtcatatgacttagctgcagtctctggcgcctttgggactgccgccacacccgctccccacagggaaggggatcccttggtatcctagcttccgggaaaggagtcctttggtagcctggtttccgggttggaatctttggtagcctgctttccgggaatggagtcctgtggtagcctggcttccgggaaggggacccattggtatcctagcttcggggaagggagtactttggtagcctagcttccgggaatggagtcatttggtagcctggtttccgggaagggattcctgtgttagcctggcttccgggaaggggatcccttggtatcctaccttccgggaagggagtacttcggtagcctagcttccgggaatggtttcctttgttagcctggtatccggggagggagtcctgtggtagcctggcttccgggaggggaccccatggtatactagcttccgggaagggagtactttggtagcctaacttctgggaat	1199	88	7%	108	9%
12	5054251	5055450	tctaacagcagtttattccgtcttcatctttcttctttctcttcatcagtaccgttccccagctgaagagttctgaatccacgccagatccttctcaacagtctgttttacgggaacctttattaaccacttcttccccgttatgcagttctgaatccttcctgtagcaggggctcttcgctcttgcctgaagatgtttcttttcccgggtttctcgtcccgtgttttctcgtcccaggtcttctcgtcccATCCCGAGTTTTTCTTCCCGGGTTTCGGCACCACTtgttgcgcgcgctcaacaggccaggaagaacgacgctgctacaggatccttctgcacacatttattcagtcctgtttcttctttctccatatatctcccttgtttatatctcccttgtttatatatctcccttgtttttatatctcccttgtttatatatctcccttgtttttatatctcccccctaatagtaatcctctctcgaataataatcctccctctaacccgggcctctcactccttttatactctctctcatccacgaaccgcaggccacgccccctcgccagtcacgaggcttcagctaatcagggcagcaggggcaaatctccaccaaattggattcacctgtatcctggtacacctgcgcagctctcaagatgtttgtggtttatatgaggaagtcaggtgcaagtcatatgacttagctgcagtctctggcgcctttgggactgccgccacacccgctccccacagggaaggggatcccttggtatcctagcttccgggaaaggagtcctttggtagcctggtttccgggttggaatctttggtagcctgctttccgggaatggagtcctgtggtagcctggcttccgggaaggggacccattggtatcctagcttcggggaagggagtactttggtagcctagcttccgggaatggagtcatttggtagcctggtttccgggaagggattcctgtgttagcctggcttccgggaaggggatcccttggtatcctaccttccgggaagggagtacttcggtagcctagcttccgggaatggtttcctttgttagcctggtatccggggagggagtcctgtggtagcctggcttccgggaggggaccccatggtatactagcttccgggaagggagtactttggtagcctaacttctgggaat	1199	88	7%	108	9%
12	5056051	5056800	agcctagcttccgggaatggagtcctttggtagcctggtatcgggaagggagttcttttgtagcctggcttccgggaaggggatcccttggtatactagcttccgggatgggagtactttggtagcctagcttccgggaatggagtcctttggtagcctggtatccggggagggagtcctgtcgtagcctgtcttccaggaagaggaccccttggtataatagcgtccgggaaaggagtactttggtagcctagcttccgggaatggagtcctttggtagcctagtatccgggaagggagtcctgtggtagcctggcttttgtgaagggattccttggtatcctagcttccgggaagtgagtactttggtagcctagcttccgggaatggagtcctttggtagcctggtttccgggaagggagtcctgtggtagcctgccttccgggaaggggatcccttggtatcctagcttccgggaagggagtactttgggagcctagcttccgggaatggagtcctttggtagcctagtttccgggaaggtagtcctgcggtagcctggcttccggcaaggggatcccttggtatcctagcttccgggaagggagtactttggtaaccttgcttccaggaatggagtcctctgtttgccgggtttccaggaagggagtcctttggtagcctggcttcaggataggggattccttggtattcttgcttccgggaagggaatactttggtagcctac	749	46	6%	10	1%
12	5613751	5614350	TCTAATTTCTGTACAAATGTAGGGGtattgcgtcccgctcgaccggcaagaaagacgcaacaaaccagaatcttccgcggcaaaagctttattgcttgcttctcaggaagattccgaaccgggaaatggcgctgcttttataacccgcagcgtgacgtttcagcacctgatatggcgtgacagctcccgattcgttgcttgcccatcaccccactattacaccccgagaatgggagtgactaggagtgaattcactcttgcacctgcgtacaaggcttgtttactagttaggcacagcggaggcccgcgccatcttataatggcgattgctcgcggcacacacggctctcctcagagattactggcggcacacatgcgattgctcgcagcacgcaccggctttccacatctcccccttttgattttattaaaatttaaggctggtctaggcctgtgtaattatgcccatccgctgtggctcctgtcttaggtcgttcctccaatgtcacagcctttcctgtcatagggtaaccctatcgccaccgggccccgtgtcttaggttgatctgtgcatgaggaaagttgcccgtccctggata	599	72	12%	80	13%
12	7143901	7144350	gacccctttggaggccaagagaccatttggggttgcgagatcgtgggtttgagtcccacctcgtgcccagttgcgagatcgtgggttcgagtcccacctcgcgttttgttgcgagaccgtgggtttgagtcccacctcgcgccttgttgcgagaccgtgggttcgagtcccacctcgcgtttggtcacgggatcgtgggttcgagtcccacctcgtgcagagggtctcaatcggccggccttagagaggccatctgattctttgagttgcttgtggtcgacgcagagtcgccgccgtttctggtttcttttttgtcttagtctcgtgtccgctcttgttgtgactactgttttttctagaaatgggacaatctgtgtccactcccctttctctgactctggagcattggaaggaggtgcgggtcagagcccacaaccagtcggtggagg	449	64	14%	40	9%
12	8404501	8404650	cgtcagcaatgcgcagagaggcagtgcgcagagaggcagtgcgcagactcattcattccccgagaggaacaaaggaaaatacaacaggcatttccagtctttgaaggagccgagggtgggcgtgtccacgctccggtagaatacttaca	149	18	12%	32	21%
12	8583451	8584200	attggccgggaactcgagggtctttcatttggtgcattggccgggaaAcagcgcgaccacccagaggtcctagacccacttagaggtaagattctttgttctgttttggtctgatgtctgtgttctgatgtctgtgttctgtttctaagtctggtgcgatcgcagtttcagttttgcggacgctcagtgagaccgcgctccgagagggagtgcggggtggataaggatagacgtgtccaggtgtccaccgtccgttcaccctgggagacgtcccaggaggaacaggggaggatcagggacgcctggtggacccctttgaaggccaagagaccatttggggttgcgagatcgtgggttagagtcccacctcgtgcccagttgcgagatcgtggattcgagtcccacctcgtgttttgttgcgagatcgtgggtttgagtcccacctcgcaccttgttgcgagaccgtgggttcgagtcccacctcgcgtctggtcacgggatcgtgggttcgagtcccacctcgtgcagagggtctcaatcggccggccttggagaggccatctgattcttctggtttcttttttgtcttagtctcgtgtccgctcttgttgtgactactgtttttctaaaaatgggacaatctgtgttcactcccctttctctgactctggagcattggaaggaggtgcgggtcagagcccacaaccagtcggtggaggtcagaaagggtcagtggcagaccttttgcg	749	88	12%	76	10%
12	8583451	8584200	attggccgggaactcgagggtctttcatttggtgcattggccgggaaAcagcgcgaccacccagaggtcctagacccacttagaggtaagattctttgttctgttttggtctgatgtctgtgttctgatgtctgtgttctgtttctaagtctggtgcgatcgcagtttcagttttgcggacgctcagtgagaccgcgctccgagagggagtgcggggtggataaggatagacgtgtccaggtgtccaccgtccgttcaccctgggagacgtcccaggaggaacaggggaggatcagggacgcctggtggacccctttgaaggccaagagaccatttggggttgcgagatcgtgggttagagtcccacctcgtgcccagttgcgagatcgtggattcgagtcccacctcgtgttttgttgcgagatcgtgggtttgagtcccacctcgcaccttgttgcgagaccgtgggttcgagtcccacctcgcgtctggtcacgggatcgtgggttcgagtcccacctcgtgcagagggtctcaatcggccggccttggagaggccatctgattcttctggtttcttttttgtcttagtctcgtgtccgctcttgttgtgactactgtttttctaaaaatgggacaatctgtgttcactcccctttctctgactctggagcattggaaggaggtgcgggtcagagcccacaaccagtcggtggaggtcagaaagggtcagtggcagaccttttgcg	749	88	12%	76	10%
12	17122351	17123700	taaagagggaaggggtttcggtttcatgattgaggggctttcgtttctggggctgggcgctgggcgcttgctctcctggctcccaaagatgtaagcaataaagttttgccgcagaagattttggtctgtggtgttcttcctggccggtcgtgagaacgcgtctaataacaattggtgctgaaacccgggacgagaaaaaactccggactggcgcaaggaagatccctcattccagaaccagaactgcgggtcgcagtaataaaggttcccgtaaagcagactgttaagaaggattcaactgtatgaattcagaacttttcagctggggaacgagagtaccagtgagtacagctttacgaggtaagtctgatcttgaactttctaaggaaattcaagacagtctatcagaagtaaagtggaatatgtttggccttgaattttttctagtgttagaagcccttttgttccttttcacatgttatcaagtggttaaggcagggcggattctagatgaaattcaggacaagctatcagaagtaaagtggggagagagagtaggagcaaagagaaaatatggtacacaaaataagtatacaggcctttccaagggtcttgaacccgaggaaaagttaaggttaggtaggaatacctggagagagattagaagaaaaagaggaaaaagggaaaagaagaaagatcgattagcggaggtctctaggagatactcgtcactagatgagctcggggagccagctcttagtagctctgaagcaggtgaagaatcctcctctgaggaaacagactgggaggaagaagcagcccattaccagccagctaattggtcaagaaaaaagccaaaagcggctggcgaaagccagcgtactgtccaacctcccggcagccggtttcaaggtccgccctatgcggagcccccgccctgcgtagtgcgtcagcaatgcgcagagaggcaatgcgcagagagatgcgcagagaggcagtgcgcagagacatgcgcagagaggcagtgcgcagagagatgcgcagagaggcagtgcgcagagaggcagtgcgcagagaggcagtgcgcagactcattcattcccagagaggaacaaaggaaaatacaacaggcatttccggtctttgaaggagccgagggtgggcgtgtccacgctccggtagaatatttacaaattaaagaaattgccgagtcggttcgtaaatacggaaccaatgctaattttaccttggtgcagttagacaggctcgctggcatggcactaactcctgccgactggcaaacggttgtaaaagccgctctccctagtatgggcaaatatatggaatgg	1349	114	8%	160	12%
12	17961001	17961150	cagccctgcgcagagaggcaatgcgcagactcgttcattccaaaggaggaacaaaggaaaatacaacaggcatttccggtctttgaaggagccgagggtgggcgtgtccacgctccggtagaatatgtgcagattaaagagcttgccga	149	18	12%	24	16%
12	18129751	18131700	gtgtgcgtgtgtctgtgtgtgtgtctgtgtgtgtgtgtctgtgtgtgtctgtgtgtgtctgtgtgtgtgtgtgtctgtgtatatgtgtgtgtgtctgtgtgtgtgtgtctgtgtgtgtgtgtctgtgtgtgtatgggcctgtgtgtatgtgagtgtatgtatgtctgtgtctgtgtctgtgtttcagtgtgtgtgtctgtgtgtgtctgtgtgtttgtatgtgtctgtgtgtgtgtgtgtgggaagccgcccccacatttgccgttgcaagatggcgctgacatcctgtgttctaagtggtaaacaaataatctgcgcatgtgccaagggtagttctccaccccatgtgctctgccttccccgtgacgacaacttggccgatgggccgcagccaatcagggagtgacacgtcctaggcgaaggataattctccttaatagggacggggtttcgcttttctctctcttgctctcttgctcttgcgctctggctcctgaagatgtagcgctcttgctctcttgagctctggctcctaaagatgtaagcaatagagctcttgcgctcttgcactcttgctcctgaagatgtaagcaataaagttttgccgcagaagattctggtttgctgcgtctttcctggccggtcgcgaacgcgtgtaagaGttggtgctggaacccgggaggaaaaaacccgggacgagaaaactcgggacggttaccatcaccggcgcaagaaagattcctcattccggaaccagaactgcgggtcacggtcagaaaggtttccgtaaaacagactgttgagaaggatccagcctggattcagaactcctcagctggggaacggtggtaatgaagtgttcccgtaaaacagactgttgagaaggattcaactgcgtgaattcagaactcttcagctggggaacaggggtaccagtgagtacagctttacaaggtaagtctggtcttgaactttctaacgaaattcaagacagtctatcagaagtaaagtgggaaatagctttacaagttacgtctggccttgaactttctaacgaaattcaagacagtctatcagaagtaaagtgggaaatagctttacaaggtatgtttggccttgaactttctctagtgttaggagcctttttgttccttttcacatgttatcaagcggttaaggcagggctgaaaattctggatgaaattcagggcaatctatcagaagtaaagcggggagagagagtaggagcaaagaggaaatatggtacacaaaataagtatacaggcctttccaagggtcttgaacccgaggaaaagttaaggtcaggtaagaatacctggggagagattagaaggaaggaaaagaaaaaagatcaattagcggaggtctctaggagaaggagcctatattcatcactagatgagctcaaggagccagctcttggtagctctgaatcagatgatgaattctcctctgaagaaacagacttggaggaagaagcagctcattatgagggaaaagggtaccagccagataaaatgctagctaatcagttaaggaaaaagccaaaagcggctggcaaaggccagtttgctgcttggcctccggacagtcggcttcaaggtcatagtgcactcctgccctatgcggagcccccgccctgcgtagtgcgtcagccctgcgcagagaggcaatggacagagaggcaatgcgcagactcgttcattccaaaggaggaacaaaggaaaatacaacaggcatttccggtctttgaaggagctgagggtgggcgtgtccacgctccggtagaatatgtgcagattaaagagcttgccgagtcggtccgtaaatatggaaccaatgctaattttaccttggtgcagttagacaggcttgccggcatggcactaactcctgccgactggcaaatgattgcaaaagccgctctc	1949	128	7%	198	10%
12	18129751	18131700	gtgtgcgtgtgtctgtgtgtgtgtctgtgtgtgtgtgtctgtgtgtgtctgtgtgtgtctgtgtgtgtgtgtgtctgtgtatatgtgtgtgtgtctgtgtgtgtgtgtctgtgtgtgtgtgtctgtgtgtgtatgggcctgtgtgtatgtgagtgtatgtatgtctgtgtctgtgtctgtgtttcagtgtgtgtgtctgtgtgtgtctgtgtgtttgtatgtgtctgtgtgtgtgtgtgtgggaagccgcccccacatttgccgttgcaagatggcgctgacatcctgtgttctaagtggtaaacaaataatctgcgcatgtgccaagggtagttctccaccccatgtgctctgccttccccgtgacgacaacttggccgatgggccgcagccaatcagggagtgacacgtcctaggcgaaggataattctccttaatagggacggggtttcgcttttctctctcttgctctcttgctcttgcgctctggctcctgaagatgtagcgctcttgctctcttgagctctggctcctaaagatgtaagcaatagagctcttgcgctcttgcactcttgctcctgaagatgtaagcaataaagttttgccgcagaagattctggtttgctgcgtctttcctggccggtcgcgaacgcgtgtaagaGttggtgctggaacccgggaggaaaaaacccgggacgagaaaactcgggacggttaccatcaccggcgcaagaaagattcctcattccggaaccagaactgcgggtcacggtcagaaaggtttccgtaaaacagactgttgagaaggatccagcctggattcagaactcctcagctggggaacggtggtaatgaagtgttcccgtaaaacagactgttgagaaggattcaactgcgtgaattcagaactcttcagctggggaacaggggtaccagtgagtacagctttacaaggtaagtctggtcttgaactttctaacgaaattcaagacagtctatcagaagtaaagtgggaaatagctttacaagttacgtctggccttgaactttctaacgaaattcaagacagtctatcagaagtaaagtgggaaatagctttacaaggtatgtttggccttgaactttctctagtgttaggagcctttttgttccttttcacatgttatcaagcggttaaggcagggctgaaaattctggatgaaattcagggcaatctatcagaagtaaagcggggagagagagtaggagcaaagaggaaatatggtacacaaaataagtatacaggcctttccaagggtcttgaacccgaggaaaagttaaggtcaggtaagaatacctggggagagattagaaggaaggaaaagaaaaaagatcaattagcggaggtctctaggagaaggagcctatattcatcactagatgagctcaaggagccagctcttggtagctctgaatcagatgatgaattctcctctgaagaaacagacttggaggaagaagcagctcattatgagggaaaagggtaccagccagataaaatgctagctaatcagttaaggaaaaagccaaaagcggctggcaaaggccagtttgctgcttggcctccggacagtcggcttcaaggtcatagtgcactcctgccctatgcggagcccccgccctgcgtagtgcgtcagccctgcgcagagaggcaatggacagagaggcaatgcgcagactcgttcattccaaaggaggaacaaaggaaaatacaacaggcatttccggtctttgaaggagctgagggtgggcgtgtccacgctccggtagaatatgtgcagattaaagagcttgccgagtcggtccgtaaatatggaaccaatgctaattttaccttggtgcagttagacaggcttgccggcatggcactaactcctgccgactggcaaatgattgcaaaagccgctctc	1949	128	7%	198	10%
12	18797401	18797700	atgctgaattccacacccctaagccccttaccccataaaaacccctagctttcgagcctcgtggccaacatccgttatctcctgtgtgggatgcatgtcggtccggagctccgtaattaaacatcctcatgtatttacatcaagatggtccttcgtgatttcttgggcgcatgccgaatagggaattgggtgggggtttccccactaggtgatatcactttctttagttttcttagtttatttagttttctttggtttttttttttttttttcgttttcAGGTTAGACTCAACTTTCTT	299	20	7%	28	9%
12	19520701	19521150	aggtccatgttctttggtccccttccatggcggcattggcccttgcctgcgtctggcagaaatcttgccacaacgctttccactcgagatacattcccatattcagaaccgcagctttcactaccgtcgtccagtctctgggagtcattgctaaagcagcaagccttttgacttgcactacagtaaaattagcattgactccatagttatggacagactcagtgagctccttaatctgtatatactccaccggagtgtgaacgcgctcgccctcggcgccttcaaagaccggaaacgcttgttgcatttttctttgttcctcttttggaataaacaagtctgaatagtgcctctctgcgcaaggcggcctctccgcgttgggcggaggtacactaggatcctgaagccaacggcccggagaccgagcagcaagctgactttccttagct	449	46	10%	62	14%
12	20232751	20234550	gggctcagctggcccctgcataacttcccttaccttagccaaatttgtgggcttacgagcagcccctctgagacccgcgactagtgcccgccggtaattggacagccgttccctaccttgtgctgtattataatcccattgggggcgagtcaagggaaatccttcgtctatctcaaccgaggtttggaccggccgcccggctccatctcggacgttcttccgtgcctcgaggagaattctctctctctcctcggtggtaaacagggtttgtaggagctgttggcaatcatcccaggtgggctggtgcgagtacatcagggattctatcaaccctgtaagccctgtaggattttctgagaaagaaggatggttaactttccaattataaaggtcagaagacgaaaacggccaatattgtagaagctgtaggtcattctggctggtggggggtgctcccacagctctaagtggaagcgccacggtagaatcgctggcccctctgggagcactccccgccggcttctcgttcctgctgaggggcctccctccccactccccggaaccaaaggtggcggtgcaggagctgagggttgggcggaggcgctggggaggggtacaggttggagggctgggggataaggtgggggtagagagttgggccattccggaggttcctctatctctggatagattttagaaacggccgctggttgcgaaggggtggatttctcgctggctccttcaggaaatggttttaatttctccttctcagcattctctcgaactgtcaaaaccttggtacctggacgtaggggcgggagaaatggacgaacccaggcaggtgggaatcgcgctaaatcttcccacactgtgatataaggctgctgatctggatatgatccggagccttcctgaaagacaatggcctttacggccctaatggtggggagatgaaacgtcccttccggaggccaacccactccgaaggtgggccattccaaggtgcagtaagactgccagggcttctttttaactattaccgataaattttgtcctcttgccctaacgtccgtccaatggtcctcagtcaaagataacggggtagagacgctctgtcccatgacaagaaacagaaacagagacaaaacgaggacagagacaaaggacaccagaacgtccaagcacactcgtccctgcctggacttgtacaaccagccgaacgctacctctgacggggtgggattccgcgtccactcccgttctggcagaaagagcaccttatcttcctcactctgccaaaggacagccgggtcctcccgactgtccctgaccctgggcagttcctccagggtcgccccagaaacgtctccccggggctgcagctttgcgggctcaggacgtctccctccgcactgactggatcctcacggatctcagcagcagctgccggaatactagcacttgaaaaccgagacacagattcagcggcgccgcactcagacacaccaactcacacagacgtacctccaaggggtattcttggggttcggggtgcccccaaaatcccggacgagcccccaCGAtgtaggaccccaaatttagggaccccgctctaatccaggaacaggcggcacccacaaacacaagaatcctctcttgttgcaagacgcatgaggtttatttggcagagctctgggtcaacacgtacctcgcacaggaggcaggggagtcgacccccagactcggagcctaggggcttttaaagacgcaaaaggttgggaatacaaggaattttggca	1799	174	10%	224	12%
12	20250301	20250450	acattaacacacaccacaaacatactgcatacatgcaccacacatacaccaaacacacacacaTAATCATGCCCCCACAAAAGCACGcacacgcacatataccacatacttacattcacacacacacatataccacacatacacatgca	149	4	3%	86	58%
12	21023101	21023250	acatacattaacacatatacacacacaccacacacataaacatacatgcaccacacatacaccaaacacacacacataaccatgcccccacaaaaacacgcacacgcacaTatactacatacttacattcacacccatacatacacata	149	4	3%	82	55%
12	22042201	22042500	agaggataattctctttaaaaagggatggggttttgccattctctctcttgctcctgtagatgtaagcaataaagcatttgtcgcagaagattcggtttgttgcgtctttcctggccggttaagcgtgggtaaTAAGtggtgctgaaacccgggaattaccatcaccggcgcaaggaagatccctcattccggaaccagaactgcaggtcacggtcacgttacagctttacaaggtaggtttggccttaaactttctaatgaaattcaagacagtctatcagaagtaaagtgggaaaca	299	22	7%	36	12%
12	22440601	22441050	AAATCATTGTTAAGCAAAATGAAGCAGAATCAAAAAGGGAggtgtgtgtggtgtgtttctatgtatgcgtgtgaatgtatgtatatggtatgtgtgtgcatgtgctgtggtgtatgtgtgtgaatgtgtgcatgtgtatgtgtggtgtatgtgtatatgtgtgaatgtatgtatgtggtatgtatgtgactgtgtgagggtattgtggtgtgtctgtgttactgtacatggtgtgtgtgcatgtgtatctgtggtgtatgtgtatgtatgggtgtgaatgtaagtatgtggtatatgtgcgtgtgcgtgtttttgtgggggcatggttatgtgtgtgtgtttggtgtatgtgtggtgcatgtatgtttatgtgtgtgtggtgtgtgtatatgtgttaatgtatgtatgtagtatgtgtgtgtgtgcatgtttgtgtgggggtatgtgta	449	6	1%	22	5%
12	23775001	23775150	GAAGGAACTAGAAATCATTGTTAAGCAAAATGAAGCAGAATCAAAAAGGGACgtatgtgtggtgtgtttgtatgtatgtgtgtgaatgaatgtatatggtgtgtgtgtgcatgtgttgtgtggtgtatgtgtgtgaaagtaagtatgtg	149	0	0%	10	7%
12	23801851	23802150	AGttggtgccgaaacccgggacaagaaacatcttcaggcacgagcgaagaccccctgctacagggaggattcagaactgcatcacggggaagaagcggttaataaaagttcctgtaaaacagactgttgagaaggatccggcgtggattcagaactcttcagctggggaacggtactgatgaagagaaagaagaaagatgaagactgaataaactgctgttagaaggactggtggtcgcatcgttcttgctggtcgagagcagacgcgacaattggtggcccgtacggggaaccgactc	299	34	11%	28	9%
12	31363801	31364100	atttgcccatactagggagagcggcttttacaaccgtttgccagtcagcaggagttagtgccatgccggcgagcctgtctaactgcaccaaggtaaaattagcattggttccgtatttacggaccgactcggcaatttctttaatttgtaagtattctaccggagcgtggacacgcccaccctcggctccttcaaagaccggaaatgcctgttgtattttcctttgttcctctctgggaatgaatgagtctgcgcactgcctctctgcgcactgcctctctgcgcattgctgacgcact	299	34	11%	34	11%
12	31364701	31365000	ctggtactctcgttccccagctgaaaagttctgaattcatacagttgaatccttcttaacagtctgctttacgggaacctttattaccgcgacccgcagttctggttctggaatgagggatcttccttgcgccagtcccgagttttttctcgtcccggaattcggcaccaattgttattagacgcgttctcacgaccggccaggaagaacaccacagaccagaatcttctgcggcaaagctttatttcttacatcttcaggagccagggtgcaggaagcaagagagcaagaagcaagag	299	30	10%	44	15%
12	32029201	32029500	gcgcagagaggcagtgcgcagactcattcattcccagagaggaacaaaggaaaatacaacaggcatttccggtctttgaaggagccgagggtgggcgtgtccacgctccggtagaatacttacaaattaaggaaattgccgagtcggttcgtaaatacggaaccaatgctaattttaccttggtgcagttagacaggctcgctggcatggcactaactcctgccgactggcaaacggttgtaaaagccgctctccctagtatgggcaaatatatggaatggagagcgctttggcacgaa	299	34	11%	40	13%
12	32596651	32596950	gtgacacgtcctaggcgaaggataattctccttaatagggacggggtttcgttttctcgcgctcttgcttcttacactcttgctcctgaagatgtaagcaataaagttttgccgcagaagattttggtttgctgtgttcttcctggccgggcgtgagaatgcgtctaataacaattggtgccgaattccgggacgagaaaaaactcgggacgagagtttaccatcaccggtgcaaggaagatccctcattccagaaccagaactgcgggtcgcggtaataaaggttcccgtaaagcaga	299	40	13%	24	8%
12	36105301	36106500	ctctacatgcaagacctactatggtcaccttagcgcaagagcacgcggatctgtacctcaacgtcctaactgaactctacatgcaagacctactatggtcaccttagcgcaagagcacgcggatctgtacctcaacgtcctaactgaactctacatgcaagacctactatggtcaccttagcgcaagagcacgcggatctgtacctcaacgtcctaactgaactctacatgcaagacctactatggtcaccttagcgcaagagcacgcggatctgtacctcaacgtcctaactgaactctacatgcaagacctactatggtcaccttagcgcaagagcacgcggatctgtacctcaacgtcctaactgaactctacatgcaagacctactatggtcaccttagcgcaagagcacgcgattctgtacctcaacgtcctaactgaactctacatgcaagacctactgtggtcaccttagcgcaagagcacgcggatctgtacctcaacgtcctaactgaactctacatgcaagacctactgtggtcaccttagcgcaagagcacgcggatctgtacctcaacgtcctaactgaactctacatgcaagacctactatggtcaccttagcgcaagagcatgcggatctgtacctcaacgtcctaactgaactctacatgcaagacctactatggtcaccttagcgcaagagcacgcggatctgtacctcaacgtcctaactgaactctacatgcaagacctactatggtcaccttagcgcaagagcacgcggatctgtacctcaacgtcctaactgaactctacatgcaagacctactatggtcaccttagcgcaagagcacgcggatctgtacctcaacgtcctaactgaactctacatgcaagacctactatggtcaccttagcgcaagagcacgcggatctgtacctcaacgtcctaactgaactctacatgcaagacctactatggtcaccttagcgcaagagcacgcggatctgtacctcaacgtcctaactgaactctacatgcaagacctactatggtcaccttagcgcaagagcacgcggatctgtacctcaacgtcctaactgaactctacatgcaagacctactatggtcaccttagcgcaagagcatgcggatctgtacctcaacttcctaactgaactctacatgcatgat	1199	122	10%	196	16%
12	36105301	36106500	ctctacatgcaagacctactatggtcaccttagcgcaagagcacgcggatctgtacctcaacgtcctaactgaactctacatgcaagacctactatggtcaccttagcgcaagagcacgcggatctgtacctcaacgtcctaactgaactctacatgcaagacctactatggtcaccttagcgcaagagcacgcggatctgtacctcaacgtcctaactgaactctacatgcaagacctactatggtcaccttagcgcaagagcacgcggatctgtacctcaacgtcctaactgaactctacatgcaagacctactatggtcaccttagcgcaagagcacgcggatctgtacctcaacgtcctaactgaactctacatgcaagacctactatggtcaccttagcgcaagagcacgcgattctgtacctcaacgtcctaactgaactctacatgcaagacctactgtggtcaccttagcgcaagagcacgcggatctgtacctcaacgtcctaactgaactctacatgcaagacctactgtggtcaccttagcgcaagagcacgcggatctgtacctcaacgtcctaactgaactctacatgcaagacctactatggtcaccttagcgcaagagcatgcggatctgtacctcaacgtcctaactgaactctacatgcaagacctactatggtcaccttagcgcaagagcacgcggatctgtacctcaacgtcctaactgaactctacatgcaagacctactatggtcaccttagcgcaagagcacgcggatctgtacctcaacgtcctaactgaactctacatgcaagacctactatggtcaccttagcgcaagagcacgcggatctgtacctcaacgtcctaactgaactctacatgcaagacctactatggtcaccttagcgcaagagcacgcggatctgtacctcaacgtcctaactgaactctacatgcaagacctactatggtcaccttagcgcaagagcacgcggatctgtacctcaacgtcctaactgaactctacatgcaagacctactatggtcaccttagcgcaagagcacgcggatctgtacctcaacgtcctaactgaactctacatgcaagacctactatggtcaccttagcgcaagagcatgcggatctgtacctcaacttcctaactgaactctacatgcatgat	1199	122	10%	196	16%
12	38981701	38981850	cctccctgtagcagggggtcttcgctcttgcctgaagatgtttcttttcccgggttttctcgtcctaggtcttctcgtcccaggtcttctcgtcccgtcccgggtttcggcaccaattcttgcgcgcgctcaacaggccaggaagaacg	149	24	16%	14	9%
12	40402201	40402650	gctctgccttccccgtgacgtcaactcggccgatgggctgcagccaatcagggagtgacacgtcctaggcgaaatataactctcctaaaaaagggacggggtttcgttttctctctctcttgcttcttgcactcctgctcctgaagatgtaagcaataaagctttgccgcagaagattctggtctgtggtgttcttcctggccgggcgtgagaacgcgtctaataacaattggtgccgaattccgggacgagaaaaaactcgggactggcgcaaggaagatccctcattccagaaccagaactgcgggtcgcggtaataaaggttcccgtaaagcagactgttaagaaggattcaactgtatgaattcagaacttttcagctggggaacgagagtaccagtgagtacagctttacgaggtaagtctgatcttgaactttctaaggaaat	449	48	11%	38	8%
12	41363701	41363850	cagggagtgacacgtccgaggcgaaggagaatgctccttaagagggacggggtttcgttttctctctctcttgcttctcgctcgctcttgcttcttgcactctggctcctgaagatgtaagcaataaagctttgccgcagaagattctg	149	16	11%	10	7%
12	43570051	43570350	tacgggccaccaattgtcgcgcccgctctcgaccagcaagaacgatgcgaccaccagtccttctaacagcagtttactcagtcttcatctttcttctttctcttcatcagtaccgttccccagctgaagagttctgaatccacgccggatccttctcaacagtctgttttacgggaacttttattaaccactccttccccgtgatgcagttctgaatcctccctgtagcagggggtcttcgctcatgcctgaagatgtttcttttcccgggttttctcgtcccaggtcttctcgtccta	299	32	11%	42	14%
12	43670701	43671150	ttggtgcgatcgcagtttcggttttgcggacgctcagtgagaccgcgctccgagagggaacgcggggtggataaggatagacgtgtccaggtgtccaccgtccgttcgccctgggagacgtcccaggaggaacaggggaggaccagggacgcctggtggacccctttggaggccaagagaccatctggggttgcgagatcgtgggttcgagtcccacctcgtattttgtcgcgagatcgtgggttcgagtcccacctcgcaccttgttgcgagaccgtgggttcgagtcccacctcgtgttttgttacgggatcgtgggttcgagtcccacctcgtgcagagggtctcaatcggccggccttagaaaggccatctgattctttgagttgcttgtggtcgacgcgaagtcaccgccgcttttggtttcttttttgtcttagtctcgtgtt	449	82	18%	36	8%
12	44155951	44156700	actttacttctgatagactgtcttgaatttcgttagaaagttcaagaccagacttaccttgtaaagctgtactcactggtactcctgttccccagctgaagagttctgaattcatgcagttgaatccttctcaacagtcttttttacgggaacctttattactgtgacccgcagttctggttccggaatgagggatcttccttgcaccggtgatggttaactcccgtcccgagttttcttgtattttctcgtcccggattttctcgtcccgggttctcggcaccaaCtcttaaacgcgttctcacgaccggccaggaagaacacaacaaaccagaatcttctgcggcaaaactttattgcttacatcttcaggagcaggagcgcaagcccccagccccaaaaacgaaagccccccgcttacatctttaggagccagagcgccagagcgtcagagcgccagagcgcagagcaagagagagaatggcggaaaccccgtccccttttaaggagaattattctttgcctaggacgcatcactccctgattggctgcagcccatggccgagttgacgtcacgggaaaggcagagtacatgtagtggtaaaatacccttggcacatgcgcagattatttgtttaccacttagaacacaggatgtcagcgccatcttgtgacggcgaatgtgggggcggctcccaacaTAAATAGGTTGAAAGTAAAGAAAATTAAATACACACATGTTGCCTCCT	749	70	9%	104	14%
12	44770951	44771250	tctaccggagcgtggacacgcccaccctcggctccttcaaagactggaaatgcctgttgtattttcctttgttcctctctgggaatgaatgagtctgcgcactgcctctctgcgcattgtctctctgcgcagggctgacgcactacgcagggcggggactccgcatagggcggaccttgaagccgactgccctgaggccaatcagcaaactggccttcgacagccgcttttggcttccttaactgattagctagcactttacctggctggtacccttttttctcataatgagctgcttc	299	30	10%	30	10%
12	46045051	46045200	agggcccacacgggactccccacgggatcctaagacctctggtgagtggaacacagcgcctgccccaatccaatcgcgcggaacttgagactgcggtacatagggaagcaggctacccgggcctgatctggggcacaagtcccttccgc	149	18	12%	22	15%
12	49001551	49001850	agatgttgggagccgcgcccacattcgccgttacaagatggcgctgacagctgtgttctaagtggtaaacaaataatctgcgcatatgccgagggtggttctctactccatgtgctctgccttccccgtgacgtcaactcggccgatgggctgcagccaatcagggagtgacacgtcctaggcgaaggagaattctccttaatagggacggggtttcgttttctctctctcttgcttcttacactcttgctcctgaagatgtaagcaataaagttttgccgcagaagattctggtctgt	299	32	11%	30	10%
12	52733701	52734150	tcttccattgatacctcttatcaggttcagcagaataagctctctgacccgttaacaagtcaaaagtccaatctctctgctctggagttaaagcagcagcgtttgctcgggcctgcgcctgtgccgcctcctgccacagagctcgccattccacatatttggccatactagggagagcgacttttgcaatcatttgccagtcggcaggcgttagtgccataccagcgagcctgtctaactgcaccaaggtgaaattagcattggttccgtatttacgaaccgactcggcaatttccttaatctgtacgtattctaccggagcgtggacacgcccaccctcggctccttcaaagactggaaatgcctgctgtattttcctttgttcctctcggggaatgaatgagtctgcgcactgcctctctgcgcactgcccctctgcgcattgctga	449	46	10%	62	14%
12	54625051	54625350	aattctccttaaaaggggacggggtttccgccattctctctcttacttgcgctctcttgcttgcgcttttgcgctctgtgctctggcgctctcttgctctgcgccctggcgctctggcgcgctggcgctctggctcctaaagatgtaagcggggggcctttcgtttttggggcttggggcttgcgctcctggctcctgaagatgtaagcaataaagttttgccgcagaagattctggtttgttgtgttcttcctggccggtcgtgagaacgcgtttaagaGttggtgctgaaacccggg	299	40	13%	6	2%
12	54625951	54626400	ggagatactcgtcactagatgagctcaggaagccagctcttagtagctctgaagcagatgaagaattctcctctgaagaaacagactgggaggaagaagcagctcattaccagccagataaagtgctagctaatcggtcaagaaaaaagccaaaagcggctggcgaaagccagcatgctgttcagcctccgggcagttggcttcaaggtccgccctatgcggagcccccgccctgcgtagtgcgtcagccctgcgcagagagacaatgcgcagagagacaatgcgcagagagacaatgcgcagagaggcaatgcgcagactcattcattcccagagaggaacaaaggaaaatacaacaggcatttccggtctttgaaggagccgagggtgggcgtgtccacgctccggtagaatacgtgcagattaaagaacttgccgagtcagtccgt	449	46	10%	72	16%
12	56750851	56751150	ttccatatttacggaccgactcggcaagctctttaatctgtaagtattctaccggagcgtggacacgcccaccctcggctccttcaaagactggaaatgcctgttgtattttcctttgttcctctctgggaatgaatgagtctgcgcactgcctctctgcgcagggctgacgcactacgcagggcggggactccgcatagggcggaccttgaagccgactgccctgaggccaatcagcaaactggccttcgccagccgcttttggcttccttaactgattagctagcactttacctggc	299	34	11%	30	10%
12	59223301	59223750	ggtctgatgtctgtgttctgatgtctgtgttctgtttctaagtctggtgcgatcgcagtttcagttttgcggacgctcagtgagaccgcgctccgagagggagtgcggggtggataaggatagacgtgtccaggtgtccaccgtccgttcaccctgggagacgtcccaggaggaacaggggaggatcagggacgcctggtggacccctttgaaggccaagagaccatttggggttgcgagatcgtgggttagagtcccacctcgtgcccagttgcgagatcgtgggttcgagtcccacctcgcgttttgttgcgagatcgtgggtttgagtcccacctcgcaccttgttgcgagaccgtgggttcgagtcccgcctcgcgtctggtcacgggatcgtgggttcgagtcccacctcgtgcagagggtctcaatcggccggccttggagag	449	72	16%	40	9%
12	61292251	61293750	gtcagcaggagttagtgccatgccggcgagcctgtctaactgcaccaaggtaaaattagcattggttccgtatttacggaccgactcggcaagctctttaatttgtaagtattctacctgagcgtggacacgccccccctcggctccttcaaagactggaaatgcctgttgtattttcctttgttcctctctgggaatgaatgagtctgcgcactgcctctctgcgcactgcctctctgcgcatctctctgcgcattgcctctctgcgcatctctctgcgcagggctgacgcactacgcagggcggggactccgcatagggcggaccttgaagccgactgccctgaggccaatcagcaaactggccttcgccagccgcttttggcttccttaactgattagctagcactttacctggctggtacccttttttctcataatgagctgcttcttcctcccagtctgtttcttcagaggagaattcttcatctgcttcagagctactaagagctggctccccgagcccatccagcgatgagcacaggctccttttcctagagacctccgctaattgatctttcttcttttccctttttcctctttttcttctaatctctctccaggtattcctacctaaccttaacttttcctcgggttcaagacccttggaaaggcctgtatacttattttgtgtaccatattttctctttgctcctactctctctccccgctttacttctgatagattgccctgaatttcatccagaatccaccctgccttaaccacttgataacatgtgaaaaggaacaaaagggcttctaacactagaaaaaattcaaggccaaacataacttgtaaagccattttccactttacttctgatagactgtcttgaatttccttagaaagttcaaggccaggcttacctcgtaaagctgtactcactggtactctcgttccccagctgaaaagttctgaattcatacagttgaatccttcttaacagtctgctttacgggaacctttattaccgcgacccgcagttctggttctggaatgagggatcttccttgcgccagtcccgagttttttctcgtcccggaattcggcaccaattgttattagacgcgttctcacgaccggccaggaaagacgcaacagaccagaatcttctgcggcaaagctttattgcttacatcttcaggagccagagtgcaagaagcaagagagagagaaaacgaaaccccgtccctattaaggagaattctccttcgcctaggacgtgtcactccctgattggctgcagcccatcggccgagttgacgtcacggggaaggcagagcacatggagtagagaaccaccctcggcatatgcgcagattatttgtttaccacttagaacacagctgtcagcgccatcttgtaacggcgaatgtgggcgcggctcccaacacccttcttattcctcctccctatctcctatgagagagtgagtaaca	1499	120	8%	174	12%
12	62535001	62535150	tgacgtcaactcggccgatgggctgcagccaatcagggagtgacacgtcctaggcgaaggagaattctccttaatagggacggggtttcgttctctctctctcttgcttcttgcactctggctcctgaagatgtaagcaataaagcttt	149	14	9%	14	9%
12	62535901	62536350	gtaaagtgctagctaatcagttaaggaagccaaaagcggctggcgaaggccagtttgctgattggcctcagggcagtcggcttcaaggtccgccctatgcggagtccccgccctgcgtagtgcgtcagccctgcgcagagaggcagtgcgcagactcattcattcccagagaggaacaaaggaaaatacaacaggcatttccagtctttgaaggagccgagggtgggcgtgtccacgctccggtagaatacttacaaattaaagaaattgccgagtcggtccgtaaatacggaaccaatgctaattttaccttggtgcagttagacaggcttgccggcatggcactaactcctgccgactggcaaacggttgtaaaagccgctctccctagtatgggcaaatatatggaatggagagcgctttggcacgaagctgcacaagcgcaggcc	449	50	11%	62	14%
12	63289951	63290250	aagcaataaagttttgctgcagaagattctggtttgttgcattcttcctggccggtcgcgagaacgcgtgtaagaGTtggtgctgaaacccgagacgagaaaacccgggacgagaagacctgggacgagaaatcccgggacgagaagacctgggacgagaagacctgggacgagaaatcccgggacgagaaaacctgggacggttaccatcaccggcgcaaggaagatccctcattcccgaaccagaactgcgggtcatggtaatgaagtgttcccgtaaaacagactgttgagaagga	299	44	15%	20	7%
12	65634301	65634600	cagggcagtcggcttcaaggtccgccctatgcggagcccccgccctgcgtagtgcgtcagcaatgcgcagagagatgcgcagagaggcaatgcgcagagagatgcgcagagaggcaatgcgcagagaggcagtgcgcagagaggcagtgcgcagagaggcagtgcgcagagaggcagtgcgcagagaggcagtgcgcagactcattcattcccagagaggaacaaaggaaaatacaacaggcatttccagtctttgaaggagccgagggtgggcgtgtccacgctccggtagaatactt	299	40	13%	62	21%
12	65806951	65807400	agcctgtctaactgcaccaaggtaaaattagcattggttccgtatttacggaccgactcggcaatttctttaatttgtaagtattctaccggagcgtggacacgcccaccctcggctccttcaaagaccggaaatgcctgttgtattttcctttgttcctctctgggaatgaatgagtctgcgcactgcctctctgcgcactgtctctctgcgcactgctgacgcactacgcagggcggggactccgcatagggcggaccttgaagccgactgccctgaggccaatcagcaaactggccttcgccagccgcttttggcttccttaactgattagctagcactttacctggctggtacccttttttctcataatgagctgcttcttcctcccagtctgtttcttcagaggagaattcttcatctgcttcagagctactaagagctggctc	449	40	9%	46	10%
12	68921701	68922000	acacgaggtgggactcgaacccacgatctcgcaactgggcacgaggtgggactcaaacccacgatctcgcaaccccaaatggtctcttggcctccaaaggggtccaccaggcgtccctggtcctcccctgttcctcctgggacgtctcccagggtgaacggacggtggacacctggacacgtctatccttatccaccccgcgttccctctcggagcgcggtctcactgagcgtccgcgaaaccgaaactgcgatcgcaccaaacttagaaacagaacacagacatcagaccaaaacaga	299	46	15%	50	17%
12	69460051	69460200	acaacacacagaaacacacacatacatcacacacaaacaccacatacatatacaacatacacaacacacagaaacaaacacatacaccgcacacaaacacatacatacaccacaatacatgcatcacacacatgtacaacattcacaac	149	2	1%	94	63%
12	70923751	70924950	aaggtaaaattagcattggttctatatttacggaccgactcggcaagctctttaatctgcacatattctaccggagcgtggtcacgcccaccctcggctccttcaaagaccggaaatgcctgttgtattttcctttgttcctctctgggaatgaatgagtctgcgcattgcctctctgcgcattgtctctctgcgcagggctgacgcactacgcagggcgggggctccgcatagggcggaagtgcaccttgaagccgactgcccggaggccaagcagtaaactggccttcgccagccgcttttggcttttttcttgaccaattagctcgcattttatctggctggcacttttctctctcataacgagctgcttcttcctcccagtctgtttcttcagaggagaattcgtcatctgattcagagctactaagagctggcttctctaattgatcttttttcttttcttttttcttttccttccttctaatctctccccaggtattcttacctgaccttaacttttcctcgggttcaagacccgtggaaaggcctgtatacttattctgtgtaccatatttcctctttgctcctactctctctccccgctttacttctgatagattgccctgaatttcatccagaattttcagccctgccttaaccacttgataacatgtgaaaaggaacaaaagggctcctaacactagaaaaagttcaaggtcaaacataccttgtaaagctatttcccactttacttctgatagactgtcttgaatttcgttagaaagttcaaggccaggcgtaccttgtaaagctatttcccactttacttctgatagaccgtcttgaatttcgttagaaagctcaaggccagacttaccttgtaaagctatacttacgggtaccctgttccccagctgaagagttctgaattcacgcagttgaatccttctcaacagtctgttttacgggaacctttatgaccgtgacccgcagttctggttccggaatgaggaatcttccttgcgcggtgatggttaactcccgtcccgagtttttcttcccgggtttccggcaccaactcttacacgcgttctcacgaccggccaggaaagacacaacaaaccagaatcttctgcggcaaaactttattgcttacatcttcaggagcaagagtgcaaaactcaaaccccaaaaac	1199	94	8%	132	11%
12	76653301	76653750	gctcctaaaaatgtaagcaatagagctcttgctctcttgctctctggctcctaaagatgtaagcaatagagctcttgctctcttgcactcttgctcctgaagatgtaagcaataaagttttgccgcagaagattccggtttgttgcgttcttcctggccggtcgcgagaacgcgtgtaagaGttggtgccgaaacccgggacgagaaaacccgggacgagaaatcctgggacgagaaaacccgggacggttaccatcaccggcgcaaggaagatccctcattccggaacaagaactgcgggtcatggtaatgaagtgttcccgtaaaacagactgttgagaaggattcaactgcgtgaattcagaactcttcagctggggaacggtggtaatgaagtgttcccgtaaaacagactgttgagaaggattcaactgcgtgaattcagaact	449	50	11%	36	8%
12	79114501	79115100	agggacggggttttgccattctttctctctctcttgttcttgctttttctctctcttgttcttgctttctctctcttgctttcttgttcttgttctttttctctctcttgctctcttgctcctgaagatgtaagcaataaagcttttgccgcagaagattccggtttgctgcgttcttcctggccggtcgcgagaacgcgtgtaagaGTtggtgctgagacccgggacgggacgaaaagacctgggacgagaaatcctgggatgagaaaacctgggacggttaccatcactggcgcaaggaagatccctcattccggaaccagaactgcgggtcatggtaatgaagtgttcccgtaaaacagactgttgagaaggattcaactgcgtgaattcagaactcttcagctggggaatggtggtaatgaagtgttcccacaacacagactgttgagaaggattcaactgcgtgaattcagaactcttcagctggggaacagggtacccgtaagtatagctttacaaggtaagtctggtcttgaactttctaacgaaattcaagacagtctatcagaagtaaagtgggaaatagctttacaagg	599	44	7%	52	9%
12	80417251	80417850	GCTTAGTGGATtgttgggagccgcccccacattcgccgttacaagatggcgctgacagctgtgttctaagtggtaaacaaataatctgcgcatgtgccaagggtatcttatgactacttgtgctctgccttccccgtgacgtcaactcggccgatgggctgcagccaatcagggagtgacacgtccgaggcgaaggagaatgctccttaagagggacggggtttcgttttttctctctcttgcttcttgctctcttgcttcctgcaccctggctcctgaagatgtaagaaataaagctttgccgcagaagattctggtctgtggtgttcttcctggccggtcgtgagaacgcgtctaataacaattggtgccgaattccgggacgagaaaaaactcgggactggcgcaaggaagatccctcattccagaaccagaactgcgggtcgcggtaataaaggttcccgtaaagcagactgttaagaaggattcaactacatgaattcagaacttttcagctggggaacggtggataccagtaagtatagctttacgaggtacgcctggccttgaactttctaacgaaattcaagacagtctat	599	64	11%	54	9%
12	85003651	85003800	ttacatctttaggagccagagctccggcgcgccaaagtgcagagcgcgctctattgtttacatctttaggcagcgagagagcgcagggcgcgcagagccagcgagatgccagcgagagcgaatggcggaaaacccgtccccttttttag	149	28	19%	20	13%
12	85137451	85137600	TGGAGTACAGAGGCTAAAACCTGGCCAAGTGGGTGgtgtgtatatgtatatgtgtgtgtatgtatgtgtatatgtatatatgtgtatgtatgtgtgtatgtttgcgtgtatgtgtgtgtatgtgtatatgtgtgtatatgtatgtgtaa	149	2	1%	4	3%
12	85406701	85408350	ttacaatcgtttgccagtcagcaggagttagtgccatgccggcgagcctgtctaactgcaccaaggtaaaattagcattggttccatatttacggaccgactcggcaagctctttaatctgtaagtattccaccggagcgtggacacgcccaccctcggctccttcaaagactggaaatgcctgttgtattttcctttgttcctctctgggaatgaatgagtctgcgcactgcctctctgcgcactgcctctctgcgcatctctctgcgcattgcctctctgcgcatctctctgcgcattgcctctctgcgcattgctgacgcactacgcagggcgggggctccgcatagggcggaccttgaaaccgactgccctgaggccaatcagcaaactggccttcgccagccgcttttggcttccttaactgattagctagcactttacctggctggtacccttttttctcataatgagctgcttcttcctcccagtctgtttcctcagaggagaattcttcatctgcttcagagctactaagagctggcttcctgagctcatctagtgacgagtatctcctagagacctccgctaatcgatcttttttcttttcttttttcttttccttccttctaatctctccccaggtattcttacctgacctaaacttttcctcgggttcaagacccttggaaaggcctgtatacttattttgtgtaccatattttctctttgctcctactctctctccccgctttacttctgatagattgccctgaatttcatccagaatcctccctgccttaaccacttgataacatgtgaaaaggaacaaaagggcttctaacactagaaaaaattcaaggccaaacattttccactttacttctgatagactgtcttgaatttccttagaaagttcaaggccaggcttacctcgtaaagctatactcactggtactctcgttccccagctgaaaagttctgaattcatgcagttgaatccttcttaacagtctgctttacgggaaactttattaccgcgacccgcagttctggttctggaatgagggatcttccttgtaccggtgatggtaaactctcgtcccgagttttttctcgtcccggaatttggcaccaattgttattaaacgcgttctcacgcccggccaggaagaacaccacagaccagaatcttctgcggcaaaactttattgcttacatcttcaggagcaagagtgtaagaagcaagagagcgagaaaacgaaaccccgtccctattaaggagaattatccttcgcctaggacgtgtcactccctgattggctgcagcccatcggccgagttgacgtcacggggaaggcagagcacatggagtggagaaccaccctcggcacatgcgcagattatttgtttaccacttagaacacagctgtcagcgccatcttgtaacggcgaatgtgggcgcggctcccaacaAGAGATTTACATAATTTGAAGTTACAAACATACAGGTAAAGTCAATAAAAATGACCTTGATGGTACAAATTGACCTGCTATTCCCAAACACATGGAAGAATGCCTATTGGGGGGAGGTCCGTGGAAGCCTTGGTTTTGGttttgtttgtttaacagggtcttgttatataact	1649	126	8%	194	12%
12	87863401	87863550	GTGCTCGATGGCCGGACAGAGAACCTGGAGGGTTTTGTGCGCACTTTCCAGAAGGAGTTGCCCAAAGATGCCCATGCGGGGGTCTTTGCTCTCGACTGTGAGATGTCCTACACTACATATGGCCTGGAGGTGACCCGAGTCACAGTCGT	149	14	9%	18	12%
12	92883751	92883900	gctcatccgcgtgcacgcagacgggtcgtccttggtgggaaacaaccccttggctgcttctctcctaagtgtaggacactctcgggagttcaaccatttctgctgcaggcgcggcatttcccccttttttcttttttaaaagaagcacg	149	18	12%	20	13%
12	92890951	92891250	acctacctcttctccgtaggcgggactgcagctccctgtggtgagtccgttccgctcttgtgatgatagccagacaagaaagagacaatacaagacgaacaccaaatagtagaaatagagacaagggtcactactccgagggtccctgttcgggcgccagctgccgcagtcggccgacctgagggtcaccggggtctgcggggggaccctctgaaaagtgaaggataagtgacgagcggagacgggatggcgaacagacacaaacacacgagaggtgaatgttaggactgttgcaagtt	299	36	12%	36	12%
12	93509551	93510000	gcgctgacagctgtgttctaagtggtaaacaaataatctgcgcatgtgccgagggtggttctccactccatgtgctctgccttccccgtgacgtcaactcggccgatgggctgcagccaatcagggagtgacacgtcctaggcgaaggataattctccttaatagggacggggtttcgttttctctctctcttgcttcttacactcttgctcctgaagatgtaagcaataaagttttgccgcagaagattctggtctgtggtgttcttcctggccgggcgtgagaacgcgtctaataacaattggtgccgaattccgggacgagaaaaaactcgggacgagagtttaccatcactggcgcaaggaagatccctcattccagaaccagaactgcgggtcgcggtaataaaggttcccgtaaagcagactgttaagaaggattcaactgca	449	52	12%	46	10%
12	93538651	93539100	tttctcaggaagatcccgaaccgggaaaatggcgctgcttttataacccgcagcgtgacgtttcagcacctgatatggcgtgacagctcccgattcgttgcttgcccatcaccccactattacaccccgagaatgggagtgactaggagtgaattcactctcgcacctgcgtacaaggcttgtttactagttaggcacagcggaggcccgcgccatcttataatggcgattgctctcggcacacacggctctcctcagagattactggcggcacacatgcgattgctcgcagcacgtaccggctttccacatctcccccttttgattttattaaaatttaaggctggtctaggcctgtgtaattatgcccatccgctgtggctcctgtcttaggtcgttcctccaatgtcacagcctttcctgtcatagggtaaccctatcgccaccgg	449	54	12%	64	14%
12	93542101	93542850	acttttactttctctccccgctctacctctgatagactttcttgaattttgtccagaactttctgccctgcttctaccatttgctgacaatcctcataatcgtcgtgcaaacaatcaaaagggcttctaactctggagaaatttcaagattgtacgtaccttgtagagccttttgtcccacggttctgattctgccccgcgaacgagggctcttccttgcgcaggtgtgatgacagttcccgggttcttcggcgccacttattgcgtcccgctcgaccggcaagaaagacgcaacaaaccagaatcttccgcggcaaaagttttattgcttgtttctcaggaagatcccgaaccgggaaaatggcgctgcttttataacccgcagcgtgacgtttcagcacctgatatggcgtgacagctcccgattcgttgcttgcccatcaccccactattacaccccgagaatgggagtgactaggagtgaattcactctcgcacctgcgtacaggacttgtttactagttaggcacagcggaggccagcgccatcttataatggcgattgctctcggcacacacggctctcctcagagattactggcggcacacatgcgattgctcgcagcacgtaccggctttccacaCATGCACCGTGTTTTACAGCAATTTTTCCAGTAAAGTACAATCTTGAAAATGGCATCTTGTGATTTCAAGGGAAGAGATGTAAGTATATTTAAGCAGTGTTAGTAG	749	84	11%	106	14%
12	94042201	94043550	ccagtcagcaggagttagtgccatgccagcgagcctgtctaactgcaccaaggtaaaattagcattggttccgtatttacgaaccgactcggcaatttctttaatttgtaagtattctaccggagcgtggacacgcccaccctcggctccttcaaagactggaaatgcctgttctattttcctttgttcctctcggggaatgaatgagtctgcgcactgcctctctgcgcactgcctctctgcgcattgctgacgcactacgggctgacgcactacgcagggcggggactccgcatagggcgggagtgcacctggtagccgattgccctgaggccaatcagcaaactggccttcgccagccgcttttggcttttttcttgaccaattagctggctggtaatgggctgcttcttcctcccagtctgtttcctcagaggagaattcttcatctgcttcagaactactaagagctggcttcctgagctcatccagcgatgagcacaggctccttttcctatagacctccgctaattgatctttcttcttttccctttttcctctttttcttctaatctctctccaggtattcttacctgacctaaacttttcctcgggttcaagacccttggaaaggcctgtatacttaccgtttctccttgctcctactctctctccccgctttacttctgatagactgccctgaatttcctctagaattttcagccctatcttaatcacttgataacatgtgaaaaggaacaaaagggctcctaacaccagaaaaaattcaaggccaaacattttccactttacttctgatagactgtcttgaatttcgttagaaagttcaagatcagacttatcttgtaaagctatacttacgggttaccgccgttccccagctgaaaagttctgaattcatacagttgaatccttcttaacagtctgctttacgggaacctttatcaccgtcgttccccagctgatgagttctgaattcggcagttgaatccttctcaacagtctgtgttacgggaacctttataaacgtgatccgcagttctggttccggaatgagggatcctccttgcgccagtcccgagtttttttctcgtcccggaattcggcaccaattgttattagacgcgttctcacgaccggccaggaagaacaccacagaccagaatcttctgcggcaaagctttattcttacatcttcaggagccagagtgtaagcagcaagagagcaagaagcaagagagagcgaagcaagagagagaagcaagagagagcgaaaagcaagagagcgaaaaagcaagagagagagcgagagacaagagagagagaga	1349	108	8%	158	12%
12	94042201	94043550	ccagtcagcaggagttagtgccatgccagcgagcctgtctaactgcaccaaggtaaaattagcattggttccgtatttacgaaccgactcggcaatttctttaatttgtaagtattctaccggagcgtggacacgcccaccctcggctccttcaaagactggaaatgcctgttctattttcctttgttcctctcggggaatgaatgagtctgcgcactgcctctctgcgcactgcctctctgcgcattgctgacgcactacgggctgacgcactacgcagggcggggactccgcatagggcgggagtgcacctggtagccgattgccctgaggccaatcagcaaactggccttcgccagccgcttttggcttttttcttgaccaattagctggctggtaatgggctgcttcttcctcccagtctgtttcctcagaggagaattcttcatctgcttcagaactactaagagctggcttcctgagctcatccagcgatgagcacaggctccttttcctatagacctccgctaattgatctttcttcttttccctttttcctctttttcttctaatctctctccaggtattcttacctgacctaaacttttcctcgggttcaagacccttggaaaggcctgtatacttaccgtttctccttgctcctactctctctccccgctttacttctgatagactgccctgaatttcctctagaattttcagccctatcttaatcacttgataacatgtgaaaaggaacaaaagggctcctaacaccagaaaaaattcaaggccaaacattttccactttacttctgatagactgtcttgaatttcgttagaaagttcaagatcagacttatcttgtaaagctatacttacgggttaccgccgttccccagctgaaaagttctgaattcatacagttgaatccttcttaacagtctgctttacgggaacctttatcaccgtcgttccccagctgatgagttctgaattcggcagttgaatccttctcaacagtctgtgttacgggaacctttataaacgtgatccgcagttctggttccggaatgagggatcctccttgcgccagtcccgagtttttttctcgtcccggaattcggcaccaattgttattagacgcgttctcacgaccggccaggaagaacaccacagaccagaatcttctgcggcaaagctttattcttacatcttcaggagccagagtgtaagcagcaagagagcaagaagcaagagagagcgaagcaagagagagaagcaagagagagcgaaaagcaagagagcgaaaaagcaagagagagagcgagagacaagagagagagaga	1349	108	8%	158	12%
12	95415001	95415600	cttggaaagatcaggaattcaaggcccatacctaaacatgataaaagcaatatacatcaaaccagtagccaacatcaaagtaaatggtgagaagctgtattgcgtcccgctcaaccggcaagaaagacgcaacaaaccagaatcttccgcggcaagagctttattgcttgtttctcaggaagattccgaaccgggaaaatggcgctgcttttataacccgcagcgtgacgtttcagcacctgatatggcgtgacagctcccgattcgttgcttgcccatcaccccactattacaccccgagaatgggagtgactaggagtgaattcactcttgcacctgcgtacaaggcttgtttactagttaggcacagcggaggcccgcgccatcttataatggcgattgctcgcggcacacacggctctcctcagagattactggcggcacacatgcgattgctcgcagcacgcaccggctttccacaaagctggaagcaatcccactaaaatcagggactagacatggctgttcactctctccctacctattcaacattgtacttgaagtcctagccagagcaattaaacaacaaaaggagatca	599	58	10%	112	19%
12	97819951	97821150	ggctccgggactccgcggagggcaggctgcacgggtgaccgtgtggaatacagagtgccagccgtttctgggacgggcgagagagtcgcagagcttctgggcggcgccatcttcagctccagacagccggccaccttcctggtgagagcacgggggtctgcctggcctgagaggtttgtggcacaggcgccggcgggagccttcttggctccgggactccgcggagggcaggctgcacgggtgaccgtgtggaatacagagtgccagccgtttctgggacgggcgagagagtcgcagagcttctgggcggcgccatcttcagctccagacagccggccaccttcctggtgagagcacgggggtctgcctggcctgagaggtttgtggcacaggcgccggcgggagccttcttggctccgggactccgcggagggcaggctgcacgggtgaccgtgtggaatacagagtgccagccgtttctgggacgggcgagagagtcgcagagcttctgggcggcgccatcttcagctccagacagccggccaccttcctggtgagagcacgggggtctgcctggcctgagaggtttgtggcacaggcgccggcgggagccttcttggctccgggactccgcggagggcaggctgcacgggtgaccgtgtggaatacagagtgccagccgtttctgggacgggcgagagagtcgcagagcttctgggcggcgccatcttcagctccagacagccggccaccttcctggtgagagcacgggggtctgcctggcctgagaggtttgtggcacaggcgccagcgggagccttcttggctccgggactccgcggagggcaggctgcacgggtgaccgtgtggaatacagagtgccagccgtttctgggacgggcgagagagtcgcagagcttctgggcggcgccatcttcagctccagacagccggccaccttcctggtgagagcacgggggtctgcctggcctgagaggtttgtggcacaggcgccggcgggagccttcttggctccgggactccgcggagggcaggctgcacgggtgaccgtgtggaatacagagtgccagccgtttctgggacgggcgagagagttgcagagcttctgggcggcgccatcttcagctccagacagccggccaccttcctggtgagagcacgggggtctgcctggcctg	1199	182	15%	154	13%
12	98174251	98174550	ataaagtgttcccgtaaaacagactgttgagaaggatccggcgtggattcagaactcttcagctgggaacggtactgatgaagagaaagaagaaagatgaagactgaataaactgctgttagaaggactggtggtcgcgtcgttcttgctggtcgagagcaggcgcgacaattggtggcccgtacggggaaccgactcccccaccgagttcagaactttcagcagtcagtggttgctggcagggtaagttcacggtgagtgaaacttgcaaccccaggagtttgggaaggacctcggat	299	32	11%	28	9%
12	98355451	98356500	ttcgatataggggtggctttcgcttttggggctgggggtttgcgctcctagctcctgaagatgtaagcaataaagttttgccgcagaagattctggtctgttgtgttcttcctggccgggcgtgagaacgcTattaagaattggtgctgaaacccgggacgaaaaaatacaagaaaactcgggaccggcgcaaggaagatccctcattccagaaccagaactgcgggtcgcggtaataaaggttcccgtaaagcagactgttgagaaggattcaactgcatgaattcagaacttttcagctggggaacgagagtaccagtgagtacagctttacgaggtaagtctggtcttgaactttctaaggaaattcaagacagtctatcagaagtaaagtggaaaatgtttggccttgaattttttctagtgttaggagcccttttgttccttttcacatgttatcaggtgattaagatagggctgaaaattctggatgaaattcagggcaatctatcagaagtaaagcggggagagagagtaggagcaaagagaaaatatggtacacaaaataagtatacaggcctttccacgggtcttgaacccgaggaaaagtttaggtcaggtaagaatacctggggagagattagaaggaaggaaaagaaaaaagaaaagaaaaaggatcgattagcggaggtctctaggagatactcgtcactagatgagctcaggaagccagctcttagtagctctgaagcagatgaagaattctcctctgaggaaacagactgggaggaagaagcagcccattaccagccagctaattggtcaagaaaaaagccaaaagcggctggcgaaagccagcgtactattcaacctccgggcagtcggtttcaaggtccgtcctatgcggagcccccgccctgcgtagtgcgtcagcaatgcgcagagaggcagtgcgcagagaggcagtgcgcagagagacagtgcgcagagaggcagtgcgcagactcattcattcccagagaggaacaaaggaaaatacaacaggcatt	1049	78	7%	124	12%
12	98355451	98356500	ttcgatataggggtggctttcgcttttggggctgggggtttgcgctcctagctcctgaagatgtaagcaataaagttttgccgcagaagattctggtctgttgtgttcttcctggccgggcgtgagaacgcTattaagaattggtgctgaaacccgggacgaaaaaatacaagaaaactcgggaccggcgcaaggaagatccctcattccagaaccagaactgcgggtcgcggtaataaaggttcccgtaaagcagactgttgagaaggattcaactgcatgaattcagaacttttcagctggggaacgagagtaccagtgagtacagctttacgaggtaagtctggtcttgaactttctaaggaaattcaagacagtctatcagaagtaaagtggaaaatgtttggccttgaattttttctagtgttaggagcccttttgttccttttcacatgttatcaggtgattaagatagggctgaaaattctggatgaaattcagggcaatctatcagaagtaaagcggggagagagagtaggagcaaagagaaaatatggtacacaaaataagtatacaggcctttccacgggtcttgaacccgaggaaaagtttaggtcaggtaagaatacctggggagagattagaaggaaggaaaagaaaaaagaaaagaaaaaggatcgattagcggaggtctctaggagatactcgtcactagatgagctcaggaagccagctcttagtagctctgaagcagatgaagaattctcctctgaggaaacagactgggaggaagaagcagcccattaccagccagctaattggtcaagaaaaaagccaaaagcggctggcgaaagccagcgtactattcaacctccgggcagtcggtttcaaggtccgtcctatgcggagcccccgccctgcgtagtgcgtcagcaatgcgcagagaggcagtgcgcagagaggcagtgcgcagagagacagtgcgcagagaggcagtgcgcagactcattcattcccagagaggaacaaaggaaaatacaacaggcatt	1049	78	7%	124	12%
12	105300151	105300450	ttattgcttacatcttcaggagcaggagcgcaagccccaagccccaaaaacgaaaagcctccctgcttacatctttaggagccagagcgccagcgcgccagagcgccagagcgcagagcaagagctctattgtttacatctttaggagcaagcgagcaagagccagagccagagagcaaaagcgcaagagcgcaagcaaaagagagaatggcggaaaccccgtcccctttaaggagaattatccttcgcctaggacgtatcactccctgattggctgcagcccatggccgagttgttgc	299	30	10%	50	17%
12	105305851	105306300	gccaaagagctctccattccatatatttgcccatactagggagagcggcttttacaatcgtttgccagtcggcaggagttagtgccatgccggcaagcctgtctaactgcaccaaggtaaaattagcattggttccgtatttacggaccgactcggcaagttctttaatctgcacatattctaccggagcgtggacacgcccaccctcggctccttcaaagaccggaaatgcctgttgtattttcctttgttcctctctgggaatgaatgagtctgcgcattgcctctctgcgcattgtctctctgcgcattgtctctctgcgcattgtctctctgcgcagggctgacgcactacgcagggcgggggctccgcatagggcggaccttgaagccgactgcccggaggctgaacagcatgctggccttcgccagccgcttttggctttttt	449	54	12%	58	13%
12	105628201	105628800	tgggctgcagccaatcggagtgacacgtcctaggcagaggatgattctccttaaaagggacggggtttcaccattctccttcttgctctggctcttgcactctagcgctcttgcgctctggctcctaaagatgtaagcaatagagctcttgctctcttgctctctggctcctgaagatgtaagcaataaagctttgccgcagaagattccggtttgttgcgttctttcctggccggtagtgaacgcgggtaagaGttggtgctgagacccggtacgagaagacctgggacgagaaaatcctgggacaagaaaacccgggacggaaactaccatcaccggcgcaaggaagatccctcattccagaaccagaacttcgggtcatggtaatgaagtgttcccgtaaaacagactgttgagaaggatccagcgtggattcagaactcctcagctggggaacggtggtaatgaagtgttcccgtaaaacagactgttgagaaggattcaactgcgtgaattcagaactcttcagctggggaacagggtacccgtaagtatagatttacaaggtaagtctggtcttgaactttctaacgaaattc	599	52	9%	56	9%
12	105910501	105911250	tacacgtggctgtgagatctatacacgtggctgtgagatctatgcatgtgactgtgagatctatacacgtgactgtgagacctatgcatgtgactgtgagatctatacacgtgactgtgagatctatacacgtgactgtgaaatctatacacgtgactgtgaaatctatgcatgtgactgtgaaatctatgcatgtgactgtgaaatctatacacgtgactgtgaaatctatacacgtgactgtgaaatctatacacgtgactgtgagatctatacacgtgactgtgaaatctatgcatgtgactgtgaaatctatacacgtgactgtgagatctatacacgtgactgtgagatctatacacgtggctgtgagatctatacacgtgactatgaaatctatacacgtgactgtgaaatctatacacgtgactgtgaaatctatacacgtgactgtgaaatctatacacgtgactgtgagatctatacacgtgactgtgagatctatacacgtgactgtgagatctatgcacgtgactgtgagatctatgcacgtgactgtgagatctatacacgtgactgtgagatctatacacgtgactatgaaatctatacacgtgactgtgaaatctatacacgtgactgtgaaatctatgcatgtgactgtgTTGGCTCCACGTCTTGGCCCGATATGGCTCTGCATGCTACCCTTTGCTCTATTTGAACgctggcttggccaggaagatataaga	749	56	7%	70	9%
12	109902151	109902300	aattctctttaatagggacggggtttcgttttctctctctcttgcttcttgctctcttgcttcttgcactctggctcctgaagatgtaagcaataaagctttgccgcagaagattctggtctgtggtgttcttcctggccggtcgtgag	149	10	7%	6	4%
12	109908901	109909050	ttctctctctcttgcttcttgctctcttgcttcttgcactctggctcctgaagatgtaagcaataaagctttgccgcagaagattctggtctgtggtgttcttcctggccggtcgtgagaacgcgtctaataacaCATTATGAAGGGGG	149	10	7%	10	7%
12	110883301	110883600	catgctgcaagcaatcgcgtgcgtgccctgagcaatcgccattataagatggcgctggcttccactgcacctaactagtaaacaagccttatgcgcaagtgcaagagtgaactcactagtcactgcccatctcgcggcgtagtaatggggtgatgggcgagcaacgagaatcaggagctgtcacgccacatcaggtgctgaaacgtcacacagcgccattttcccccggttcggggtcttccctcctgataagtaaggaataaaagctttgccgcagaagattccggttgtcctgagtg	299	36	12%	48	16%
12	111388351	111389550	ggctgcagccaatcaaggagtgacacgtccgaggcgaaggagaatgctccttaagagggacggggtttcgttttctctctctcttgcttttctctctctcttgcttcttgctctcttgcttcctgcaccctggctcctgaagatgtaagaataaagctttgccgcagaagattctggtctgtggtgttcttcctggccggtcgtgagaacgcgtctaataacaattggtgccgaattccgggacgagaaaaaactcgggactggcgcaaggaagatccctcattccagaaccagaactgcgggtcgcggtaataaaggttcccgtaaagcagactgttaagaaggattcaactgtatgaattcagaacttttcagctggggaacgagagtaccagtgagtacagctttacgaggtaagtctgatcttgaactttctaacgaaattcaagacagtctatcagaagtaaagtggaatatgtttggccttgaattttttctggtgttaggagcccttttgttccttttcacatgttatcaagtggttaagatagggcggattctagatgaaattcaggacaagctatcagaagtaaagcggggagagagagtaggagcaaagagaaaatatggtacacaaaataagtatacaggcctttccaagggtcttgaacccgaggaaaagttaaggttaggtaggaatacctggagagagattagaagaaaaagaggaaaaagggaaaagaagaaagatcaattagcggaggtctctaggagatactcgtcactagatgagctcaggaagccagctcttagtagttctgaagcaggtgaagaattctcctctgaggaaacagactgggaggaagaagcagcccattaccagccagctaattggtcaagaaaaaagccaaaagcggctggcgaaggccagtttgctgattggcctcagggcagtcggcttcaaggtccgccctatgcggagtccccgccctgcgtagtgcgtcagcaatgcgcagagaggcagtgcgcagagaggcagtgcgcagactcattcattcccagagaggaacaaaggaaaatacaacaggcatttccggtctttgaaggagccgagggtgggcgtgtccacgctccggtagaatacttacaaattaaagaaattgccgagtcggttcgtaaatacggaaccaatgctaatt	1199	94	8%	128	11%
12	111730201	111730650	cacacccacatctgtatggttcacttagcacacccacatctgtacggttcacctagcacacccacatctgtacagttcacctagcacacccacatctgtacggttcacctagcacacccacatctgtacggttcacctagcacacccacatctgtacggttcacctagcacacccacatctgtacggttcacctagcacacccacatctgtacggttcacctagcacacccacatctgtacggttcacctagcacacccacatctgtacggttcacctagcacacccacatctgtacggttcacttagcacacccacatctgtacggttcacctagcacacccacatctgtacagttcacctagcacacccacatctgtacggttcacctagcacacccacatctgtacggttcacctagcacacccacatctgtacggttcacctagc	449	26	6%	164	37%
12	111867601	111868500	ctgtgagtgtgtatgtaactgtgtaactgcagaatcccacccgtgagagtgtatgtaactgtataagtgtggaatcccacccgtgagtgtgtatgtaactgtgtaactgcagaatcccacccgtgagagtgtatgtaactgtataagtgtggaatcccacccgtgagtgtgtatgtaactgtgtaactgcagaatcccacccgtgagagtgtatgtaactgtataagtgtggaatcccacccgtgagtgtgtatgtaactgtgtaagtgcagaatcccacccgtgagagtgtatgtaactgtgtaagtgtggaatcccacccgtgagagtgtatgtaactgtgtaactgcggaatcccacccgtgagagtgtatgtaactgtgtaactgcggaatcccacccgtgagtgtgtatgtaactgtgtaagtgcagaatcccacccgtgagtgtgtatgtaactgtgtaagtgcagaatcccacccgtgagagtgtatgtaactgtgtaactgcggaatcccacccgtgagagtgtatgtaactgtgtaactgcggaatcccacccgtgagtgtgtatgtaactgtgtaagtgcagaatcccacccgtgagagtgtatgtaactgtgtaagtgtggaatcccacccatgagagtgtatgtaactgtgtaactgcggaatcccacccgtgagagtgtatgtaactgtgtaagtgcggaatcccacccgtgagagtgtatgtaactgtgtaagtgcagaatcccacccgtgagtgtgtatgtaactgtgtaactgcagaatcccacccatgagagtgtatgtaactgtgtaagtgcagaatcccacccgtgagtgtgtatgtaactgtataactgcagaatcccacccatgagagtgtatgtaac	899	50	6%	72	8%
12	112492651	112492800	ccacacacacataccacacacacattcacacacaaaacactcacattcacataccccacatacactcatacacaccatacacattcacacacatatacacacatgcacacgtacacacacacacactacattcatacacaccatagaca	149	2	1%	98	66%
12	112776151	112784850	CAGAGAGGCCTCCAGGCTGGGCTTGCCAGGCGCGGACACGCCGAAGGAgggcatcttgaacttgggcatcttgaacttgCTGTCTTTGGCCGCCACGTCCTTGTCGGCCAGGGAGAGCTCCCCCTCCAGCTTGGCACCGGGCGCCTGGATGTCCACCTCCACGCCGGGCAGGGACACCTCCAGGTCGGGGGCGCtcacctcgcccttggcgcccttcacgtccactttggggcccttcaggtccacgtggggccccttgaggtccaccttgggcatcttgaggCTGGGCATCTGCACCTTGGGCAGGTGGCCCTTCAGGCCGGCCCCAGCAGCAGCAGCAGCCTGGGCGGcgggcagctctgcctcgggcagctgtccctcgggcagctTCACGCCCACCTGGCCGGCCTTGAGCTCCAGGTCGGCGGACCGCAGCTGAACGCTCAGGTCAGGGGTCTTCAGGTCGCCCTGCACTTGGGGCGGGGCCACGTCCGCCTCCACCTTGGGCGCACCCACCTCCAGAGAGGCCTCCAGGCTGGGCTTGCCAGGCGCGGACACGCCGAAGGAgggcatcttgaacttgggcatcttgaacttgCTGTCTTTGGCCGCCACGTCCTTGTCGGCCAGGGCCAGCTCCCCCTCCAGCTTGGCACCGGGCGCCTGGATGTCCACCTCCACGCCGGGCAGGGACACCTCCAGGTCGGGGGCGCtcacctcgcccttggcgcccttcacgtccactttggggcccttcaggtccacgtggggccccttgaggtccaccttgggcatcttgaggCTGGGCATCTGCACCTTGGGCAGGTGGCCCTTCAGGCCGGCCCCAGCAGCAGCAGCAGCCTGGGCGGcgggcagctctgcctcgggcagctgtccctcgggcagctTCACGCCCACCTGGCCGGCCTTGAGCTCCAGGTCGGCGGACGGCAGCTGAACGCTCAGGTCAGGGGTCTTCAGGTCGCCCTGCACTTGGGGCGGGACCACGTCTGCCTCCACCTTGGGCGCACCCACCTCCAGAGAGGCCTCCAGGCTGGGCTTGCCAGGCGCGGACACGCCAAAGGAgggcatcttgaacttgggcatcttgaacttgCTGTCTTTGGCCGCCACGTCCTTGTCGGCCAGGGCCAGCTCCCCCTCCAGCTTGGCACCGGGCGCCTGGATGTCCACCTCCACGCCGGGCAGGGACACCTCCAGGTCGGGGGCGCtcacctcgcccttggcgcccttcacgtccactttggggcccttcaggtccacgtggggcccctgaggtccaccttgggcatcttgaggCTGGGCATCTGCACCTTGGGCAGGTGGCCCTTCAGGCCGGCCCCAGCAGCAGCAGCAGCCTGGGCGGcgggcagctctgcctcgggcagctgtccctcgggcagctTCACGCCCACCTGGCCGGCCTTGAGCTCCAGGTCGGCGGACCGCAGCTGAACGCTCAGGTCAGGGGTCTTCAGGTCGCCCTGCACTTGGGGCGGGGCCACGTCCGCCTCCACCTTGGGCGCACCCACCTCCAGAGAGGCCTCCAGGCTGGGCTTGCCAGGCGCGGACACGCCGAAGGAgggcatcttgaacttgggcatcttgaacttgCTGTCTTTGGCCGCCACGTCCTTGTCGGCCAGGGAGAGCTCCCCCTCCAGCTTGGCACCGGGCGCCTGGATGTCCACCTCCACGCCGGGCAGGGACACCTCCAGGTCGGGGGCGCtcacctcgcccttggcgcccttcacgtccactttggggcccttcaggtccacgtggggccccttgaggtccaccttgggcatcttgaggCTGGGCATCTGCACCTTGGGCAGGTGGCCCTTCAGGCCGGCCCCAGCAGCAGCAGCAGCCTGGGCGGcgggcagctctgcctcgggcagctgtccctcgggcagctTCACGCCCACCTGGCCGGCCTTGAGCTCCAGGTCGGCGGACCGCAGCTGAACGCTCAGGTCAGGGGTCTTCAGGTCGCCCTGCACTTGGGGCGGGGCCACGTCCGCCTCCACCTTGGGCGCACCCACCTCCAGAGAGGCCTCCTGGCTGGGCTTGCCAGGCGCGGACACGCCGAAGGAgggcatcttgaacttgggcatcttgaacttgCTGTCTTTGGCCGCCACGTCCTTGTCGGCCAGGGCCAGCTCCCCCTCCAGCTTGGCACCGGGCGCCTGGATGTCCACCTCCACGCCGGGCAGGGACACCTCCAGGTCGGGGGCGCtcacctcgcccttggcgcccttcacgtccactttggggcccttcaggtccacgtggggccccttgaggtccaccttgggcatcttgaggCTGGGCATCTGCACCTTGGGCAGGTGGCCCTTCAGGCCGGCCCCAGCAGCAGCAGCAGCCTTGGCGGcgggcagctctgcctcgggcagctgtccctcgggcagctTCACGCCCACCTGGCCGGCCTTGAGCTCCAGGTCGGCGGACGGCAGCTGAACGCTCAGGTCAGGGGTCTTCAGGTCGCCCTGCACTTGGGGCGGGGCCACGTCCGCCTCCACCTTGGGCGCACCCACCTCCAGAGAGGCCTCCAGGCTGGGCTTGCCAGGCGCGGACACGCCGAAGGAgggcatcttgaacttgggcatcttgaacttgCTGTCTTTGGCAGCCACGTCCTTGTCGGCCAGGGCCAGCTCCCCCTCCAGCTTGGCACCGGGCGCCTGGATGTCCACCTCCACGCCGGGCAGGGACACCTCCAGGTCGGGGGCACtcacctcgcccttggcgcccttcacgtccactttggggcccttcaggtccacgtggggccccttgaggtccaccttgggcatcttgaggCTGGGCATCTGCACCTTGGGCAGGTGGCCCTTCAGGCCGGCCCCAGCAGCAGCAGCAGCCTGGGCGGcgggcagctctgcctcgggcagctgtccctcgggcagctTCACGCCCACCTGGCCGGCCTTGAGCTCCAGGTCGGCGGACGGCAGCTGAACGCTCAGGTCAGGGGTCTTCAGGTCGCCCTGCACTTGGGGCGGGGCCACGTCCGCCTCCACCTTGGGCGCACCCACCTCCAGAGAGGCCTCCAGGCTGGGCTTGCCAGGCGCGGACACGCCGAAGGAgggcatcttgaacttgggcatcttgaacttgCTGTCTTTGGCCGCCACGTCCTTGTCGGCCAGGTGTCCCTCGAGCAGCTTAACGCCCACCTGGCCGACATTGAGCTCCAAGTCGGCGGACGGCAGCTGAACGCTCAGGTCAGGGGTCTTCAGGTCGCCCTGCACTTGGGGCGGGACCACGTCTGCCTCCACATTGGGCGCACCCACCTCCAGAGAGGCCTCCAGGCTGGGCTTGCCAGGCGCGGACACGCCAAAGGAgggcatcttgaacttgggcatcttgaacttgCTGTCTTTGGCCGCCACGTCCTTGTCGGCCAGGGCCAGCTCCCCCTCCAGCTTGGCACCGGGCGCCTGGATGTCCACCTCCACGCCGGGCAGGGACACCTCCAGGTCGGGGGCGCtcacctcgcccttggcgcccttcacgtccactttggggcccttcaggtccacgtggggtcccttgaggtccaccttgggcatcttgaggCTGGGCATCTGCACCTTGGGCAGGTGGCCCTTCAGGCCGGCCCCAGCAGCAGCAGCCTGGGCGGCGggcagctctgcctccggcagctgtccctcgggcagctTCACGCCCACCTGGCGGGCCTTGAGCTCCAGGTCGGCGGACGGCAGCTGAACGCTCAGGTCAGGGGTCTTCAGGTCGCCCTGCACTTGGGGCGGGGCCACGTCCGCCTCCACCTTGGGCGCACCCACCTCCAGAGAGGCCTCCAGGCTGGGCTTGCCAGGCGCGGACACGCCGAAGGAGGGCATCTTGAACTCGGGCATCTTGAACTTGCTGTCTTTGGCCGCCACGTCCTTGTCGGCCAGGGCCAGCTCCCCCTCCAGCTTGGCACCGGGCGCCTGGATGTCCACCTCCACGCCGGGCAGGGACACCTCCAGGTCGGGGGCGCtcacctcgcccttggcgcccttcacgtccactttggggcccttcaggtccacgtggggccccttgaggtccaccttgggcatcttgaggCTGGGCATCTGCACCTTGGGCAGGTGGCCCTTCAGGCCGGCCCCAGCAGCAGCAGCAGCCTGGGCGGcgggcagctctgcctcgggcagctgtccctcgggcagctTCACGCCCACCTGGCCGGCCTTGAGCTCCAGGTCGGCGGACGGCAGCTGAACGCTCAGGTCAGGGGTCTTCAGGTCGCCCTGCACTTGGGGCGGGGCCACGTCCGCCTCCACCTTGGGCGCACCCACCTCCAGAGAGGCCTCCAGGCTGGGCTTGCCAGGCGCGGACACGCCGAAGGAgggcatcttgaacttgggcatcttgaacttgCTGTCTTTGGCCGCCACGTCCTTGTCGGCCAGGGCCAGCTCCCCCTCCAGCTTGGCCCCGGGCGCCTGGATGTCCACCTCCACGCCGGGCAGGGACACCTCCAGGTCGGGGGCGCtcacctcgcccttggcgcccttcacgtccactttggggcccttcaggtccacgtggggccccttgaggtccaccttgggcatcttgaggCTGGGCATCTGCACCTTGGGCAGGTGGCCCTTCAGGCCGGCCCCAGCAGCAGCAGCAGCCTGGGCGGcgggcagctctgcctcgggcagctgtccctcgggcagctTCACGCCCACCTGGCCGGCCTTGAGCTCCAGGTCGGCGGACGGCAGCTGAACGCTCAGGTCAGGGGTCTTCAGGTCGCCCTGCACTTGGGGCGGGACCACGTCTGCCTCCACCTTGGGCGCACCCACCTCCAGAGAGGCCTCCAGGCTGGGCTTGCCAGGCGCGGACACGCCAAAGGAgggcatcttgaacttgggcatcttgaacttgCTGTCTTTGGCCGCCACGTCCTTGTCGGCCAGGGCCAGCTCCCCCTCCAGCTTGGCACCGGGCGCCTGGATGTCCACCTCCACGCCGGGCAGGGACACCTCCAGGTCGGGGGCGCtcacctcgcccttggcgcccttcacgtccactttggggcccttcaggtctacgtggggtcccttgaggtccaTCTTGGGCATCTTGAGGCTGGGCATCTGCACCTTGGGCAGGTGGCCCTTCAGGCCGGCCCCAGCAGCAGCAGCCTGGGCGGCGGGCAGCTCTGCCTCCGGCAGCTGTCCTTCGGGGCAGCTTCACGCCCACCTGGCCGGCCTTGAGCTCCAGGTCGGCGGACGGCAGCTGAACGCTCAGGTCAGGGGTCTTCAGGTCGCCCTGCACTTGGGGCGGGGCCACGTCCGCCTCCACCTTGGGCGCACCCACCTCCAGAGAGGCCTCCAGGCTGGGCTTGCCAGGCGCGGACACGCCGAAGGAgggcatcttgaacttgggcatcttgaacttgCTGTCTTTGGCCGCCACGTCCTTGTCGGCCAGGGCCAGCTCCCCCTCCAGCTTGGCACCGGGCGCCTGGATGTCCACCTCCACGCCGGGCAGGGACACCTCCAGGTCGGGGGCGCtcacctcgcccttggcgcccttcacgtccactttggggcccttcaggtccacgtggggccccttgaggtccaccttgggcatcttgaggCTGGGCATCTGCACCTTGGGCAGGTGGCCCTTCAGGCCGGCCCCAGCAGCAGCAGCAGCCTGGGCGGcgggcagctctgcctcgggcagctgtccctcgggcagctTCACGCCCACCTGGCCGGCCTTGAGCTCCAGGTCGGCGGACGGCAGCTGAACGCTCAGGTCAGGGGTCTTCAGGTCGCCCTGCACTTGGGGCGGGGCCACGTCCGCCTCCACCTTGGGCGCACCCACCTCCAGAGAGGCCTCCAGGCTGGGCTTGCCAGGCGCGGACACGCCGAAGGAgggcatcttgaacttgggcatcttgaacttgCTGTCTTTGGCCGCCACGTCCTTGTCGGCCAGGGCCAGCTCCCCCTCCAGCTTGGCACCGGGCGCCTGGATGTCCACCTCCACGCCGGGCAGGGACACCTCCAGGTCGGGGGCGCtcacctcgcccttggcgcccttcacgtccactttggggcccttcaggtccacgtggggccccttgaggtccaccttgggcatcttgaggCTGGGCATCTGCACCTTGGGCAGGTGGCCCTTCAGGCCGGCCCCAGCAGCAGCAGCAGCCTGGGCGGcgggcagctctgcctcgggcagctgtccctcgggcagctTCACGCCCACCTGGCCGGCCTTGAGGTCCAGGTCGGCGGACGGCAGCTGAACGCTCAGGTCAGGGGTCTTCAGGTCGCCCTGCACTTGGGGCGGGGCCACGTCCGCCTCCACCTTGGGCGCACCCACCTCCAGAGAGGCCTCCTGGCTGGGCTTGCCAGGCGCGGACACGCCGAAGGAgggcatcttgaacttgggcatcttgaacttgCTGTCTTTGGCCGCCACGTCCTTGTCGGCCAGGGCCAGCTCCCCCTCCAGCTTGGCACCGGGCGCCTGGATGTCCACCTCCACGCCGGGCAGGGACACCTCCAGGTCGGGGGCGCtcacctcgcccttggcgcccttcacgtccactttggggcccttcaggtccacgtggggccccttgaggtccaccttgggcatcttgaggCTGGGCATCTGCACCTTGGGCAGGTGGCCCTTCAGGCCGGCCCCAGCAGCAGCCTGGGCAGcgggcagctctgcctcggggagctgtccctcgggcagctTCACGCCCACCTGGCCGGCCTTGAGCTCCAGGTCGGCGGACCGCAGCTGAACGCTCAGGTCAGGGGTCTTCAGGTCGCCCTGCACTTGGGGCGGGGCCACGTCCGCCTCCACCTTGGGCGCACCCACCTCCAGAGAGGCCTCCTGGCTGGGCTTGCCAGGCGCGGACACGCCGAAGGAgggcatcttgaacttgggcatcttgaacttgCTGTCTTTGGCCGCCACGTCCTTGTCGGCCAGGGCCAGCTCCCCCTCCAGCTTGGCACCGGGCGCCTGGATGTCCACCTCCACGCCGGGCAGGGACACCTCCAGGTCGGGGGCGCtcacctcgcccttggcgcccttcacgtccactttggggcccttcaggtccacgtggggccccttgaggtccaccttgggcatcttgaggCTGGGCATCTGCACCTTGGGCAGGTGGCCCTTCAGGCCGGCCCCAGCAGCAGCAGCAGCCTTGGCGGcgggcagctctgcctcgggcagctgtccctcgggcagctTCACGCCCACCTGGCCGGCCTTGAGCTCCAGGTCGGCGGACGGCAGCTGAACGCTCAGGGGCGGGGCCACGTCCGCCTCCACCTTGGGCGCACCCACCTCCAGAGAGGCCTCCAGGCTGGGCTTGCCAGGCGCGGACACGCCGAAGGAgggcatcttgaacttgggcatcttgaacttgCTGTCTTTGGCCGCCACGTCCTTGTCGGCCAGGGCCAGCTCCCCCTCCAGCTTGGCACCGGGCGCCTGGATGTCCACCTCCACGCCGGGCAGGGACACCTCCAGGTCGGGGGCGCtcacctcgcccttggcgcccttcacgtccactttggggcccttcaggtccacgtggggccccttgaggtccaccttgggcatcttgaggCTGGGCATCTGCACCTTGGGCAGGTGGCCCTTCAGGCCGGCCCCAGCAGCAGCAGCAGCCTGGGCGGcgggcagctctgcctcgggcagctgtccctcgggcagctTCACGCCCACCTGGCCGGCCTTGAGCTCCAGGTCGGCGGACGGCAGCTGAACGCTCAGGTCAGGGGTCTTCAGGTCGCCCTGCACTTGGGGCGGGGCCACGTCCGCCTCCACCTTGGGCGCACCCACCTCCAGAGAGGCCTCCAGGCTGGGCTTGCCAGGCGCGGACACGCCGAAGGAgggcatcttgaacttgggcatcttgaacttgCTGTCTTTGGCCGCCACGTCCTTGTCGGCCAGGGCCAGCTCCCCCTCCAGCTTGGCACCGGGCGCCTGGATGTCCACCTCCACGCCGGGCAGGGACACCTCCAGGTCGGGGGCGCtcacctcgcccttggcgcccttcacgtccactttggggcccttcaggtccacgtggggccccttgaggtccaccttgggcatcttgaggCTGGGCATCTGCACCTTGGGCAGGTGGCCCTTCAGGCCGGCCCCAGCAGCAGCAGCAGCCTGGGCGGcgggcagctctgcctcgggcagctgtccctcgggcagctTCACGCCCACCTGGCCGGCCTTGAGCTCCAGGTCGGCGGACGGCAGCTGAACGCTCAGGTCAGGGGTCTTCAGGTCGCCCTGCACTTGGGGCGGGGCCACGTCCGCCTCCACCTTGGGCGCACCCACCTCCAGAGAGGCCTCCAGGCTGGGCTTGCCAGGCGCGGACACGCCGAAGGAgggcatcttgaacttgggcatcttgaacttgCTGTCTTTGGCCACCACGTCCTTGTCGGCCAGGGTCAGCTCCCCCTCCAGCTTGGCACTAGGGACCTGTATATTTACTTCCATGTTTTCTTCTGGTGTGT	8699	1088	13%	1556	18%
12	112776151	112784850	CAGAGAGGCCTCCAGGCTGGGCTTGCCAGGCGCGGACACGCCGAAGGAgggcatcttgaacttgggcatcttgaacttgCTGTCTTTGGCCGCCACGTCCTTGTCGGCCAGGGAGAGCTCCCCCTCCAGCTTGGCACCGGGCGCCTGGATGTCCACCTCCACGCCGGGCAGGGACACCTCCAGGTCGGGGGCGCtcacctcgcccttggcgcccttcacgtccactttggggcccttcaggtccacgtggggccccttgaggtccaccttgggcatcttgaggCTGGGCATCTGCACCTTGGGCAGGTGGCCCTTCAGGCCGGCCCCAGCAGCAGCAGCAGCCTGGGCGGcgggcagctctgcctcgggcagctgtccctcgggcagctTCACGCCCACCTGGCCGGCCTTGAGCTCCAGGTCGGCGGACCGCAGCTGAACGCTCAGGTCAGGGGTCTTCAGGTCGCCCTGCACTTGGGGCGGGGCCACGTCCGCCTCCACCTTGGGCGCACCCACCTCCAGAGAGGCCTCCAGGCTGGGCTTGCCAGGCGCGGACACGCCGAAGGAgggcatcttgaacttgggcatcttgaacttgCTGTCTTTGGCCGCCACGTCCTTGTCGGCCAGGGCCAGCTCCCCCTCCAGCTTGGCACCGGGCGCCTGGATGTCCACCTCCACGCCGGGCAGGGACACCTCCAGGTCGGGGGCGCtcacctcgcccttggcgcccttcacgtccactttggggcccttcaggtccacgtggggccccttgaggtccaccttgggcatcttgaggCTGGGCATCTGCACCTTGGGCAGGTGGCCCTTCAGGCCGGCCCCAGCAGCAGCAGCAGCCTGGGCGGcgggcagctctgcctcgggcagctgtccctcgggcagctTCACGCCCACCTGGCCGGCCTTGAGCTCCAGGTCGGCGGACGGCAGCTGAACGCTCAGGTCAGGGGTCTTCAGGTCGCCCTGCACTTGGGGCGGGACCACGTCTGCCTCCACCTTGGGCGCACCCACCTCCAGAGAGGCCTCCAGGCTGGGCTTGCCAGGCGCGGACACGCCAAAGGAgggcatcttgaacttgggcatcttgaacttgCTGTCTTTGGCCGCCACGTCCTTGTCGGCCAGGGCCAGCTCCCCCTCCAGCTTGGCACCGGGCGCCTGGATGTCCACCTCCACGCCGGGCAGGGACACCTCCAGGTCGGGGGCGCtcacctcgcccttggcgcccttcacgtccactttggggcccttcaggtccacgtggggcccctgaggtccaccttgggcatcttgaggCTGGGCATCTGCACCTTGGGCAGGTGGCCCTTCAGGCCGGCCCCAGCAGCAGCAGCAGCCTGGGCGGcgggcagctctgcctcgggcagctgtccctcgggcagctTCACGCCCACCTGGCCGGCCTTGAGCTCCAGGTCGGCGGACCGCAGCTGAACGCTCAGGTCAGGGGTCTTCAGGTCGCCCTGCACTTGGGGCGGGGCCACGTCCGCCTCCACCTTGGGCGCACCCACCTCCAGAGAGGCCTCCAGGCTGGGCTTGCCAGGCGCGGACACGCCGAAGGAgggcatcttgaacttgggcatcttgaacttgCTGTCTTTGGCCGCCACGTCCTTGTCGGCCAGGGAGAGCTCCCCCTCCAGCTTGGCACCGGGCGCCTGGATGTCCACCTCCACGCCGGGCAGGGACACCTCCAGGTCGGGGGCGCtcacctcgcccttggcgcccttcacgtccactttggggcccttcaggtccacgtggggccccttgaggtccaccttgggcatcttgaggCTGGGCATCTGCACCTTGGGCAGGTGGCCCTTCAGGCCGGCCCCAGCAGCAGCAGCAGCCTGGGCGGcgggcagctctgcctcgggcagctgtccctcgggcagctTCACGCCCACCTGGCCGGCCTTGAGCTCCAGGTCGGCGGACCGCAGCTGAACGCTCAGGTCAGGGGTCTTCAGGTCGCCCTGCACTTGGGGCGGGGCCACGTCCGCCTCCACCTTGGGCGCACCCACCTCCAGAGAGGCCTCCTGGCTGGGCTTGCCAGGCGCGGACACGCCGAAGGAgggcatcttgaacttgggcatcttgaacttgCTGTCTTTGGCCGCCACGTCCTTGTCGGCCAGGGCCAGCTCCCCCTCCAGCTTGGCACCGGGCGCCTGGATGTCCACCTCCACGCCGGGCAGGGACACCTCCAGGTCGGGGGCGCtcacctcgcccttggcgcccttcacgtccactttggggcccttcaggtccacgtggggccccttgaggtccaccttgggcatcttgaggCTGGGCATCTGCACCTTGGGCAGGTGGCCCTTCAGGCCGGCCCCAGCAGCAGCAGCAGCCTTGGCGGcgggcagctctgcctcgggcagctgtccctcgggcagctTCACGCCCACCTGGCCGGCCTTGAGCTCCAGGTCGGCGGACGGCAGCTGAACGCTCAGGTCAGGGGTCTTCAGGTCGCCCTGCACTTGGGGCGGGGCCACGTCCGCCTCCACCTTGGGCGCACCCACCTCCAGAGAGGCCTCCAGGCTGGGCTTGCCAGGCGCGGACACGCCGAAGGAgggcatcttgaacttgggcatcttgaacttgCTGTCTTTGGCAGCCACGTCCTTGTCGGCCAGGGCCAGCTCCCCCTCCAGCTTGGCACCGGGCGCCTGGATGTCCACCTCCACGCCGGGCAGGGACACCTCCAGGTCGGGGGCACtcacctcgcccttggcgcccttcacgtccactttggggcccttcaggtccacgtggggccccttgaggtccaccttgggcatcttgaggCTGGGCATCTGCACCTTGGGCAGGTGGCCCTTCAGGCCGGCCCCAGCAGCAGCAGCAGCCTGGGCGGcgggcagctctgcctcgggcagctgtccctcgggcagctTCACGCCCACCTGGCCGGCCTTGAGCTCCAGGTCGGCGGACGGCAGCTGAACGCTCAGGTCAGGGGTCTTCAGGTCGCCCTGCACTTGGGGCGGGGCCACGTCCGCCTCCACCTTGGGCGCACCCACCTCCAGAGAGGCCTCCAGGCTGGGCTTGCCAGGCGCGGACACGCCGAAGGAgggcatcttgaacttgggcatcttgaacttgCTGTCTTTGGCCGCCACGTCCTTGTCGGCCAGGTGTCCCTCGAGCAGCTTAACGCCCACCTGGCCGACATTGAGCTCCAAGTCGGCGGACGGCAGCTGAACGCTCAGGTCAGGGGTCTTCAGGTCGCCCTGCACTTGGGGCGGGACCACGTCTGCCTCCACATTGGGCGCACCCACCTCCAGAGAGGCCTCCAGGCTGGGCTTGCCAGGCGCGGACACGCCAAAGGAgggcatcttgaacttgggcatcttgaacttgCTGTCTTTGGCCGCCACGTCCTTGTCGGCCAGGGCCAGCTCCCCCTCCAGCTTGGCACCGGGCGCCTGGATGTCCACCTCCACGCCGGGCAGGGACACCTCCAGGTCGGGGGCGCtcacctcgcccttggcgcccttcacgtccactttggggcccttcaggtccacgtggggtcccttgaggtccaccttgggcatcttgaggCTGGGCATCTGCACCTTGGGCAGGTGGCCCTTCAGGCCGGCCCCAGCAGCAGCAGCCTGGGCGGCGggcagctctgcctccggcagctgtccctcgggcagctTCACGCCCACCTGGCGGGCCTTGAGCTCCAGGTCGGCGGACGGCAGCTGAACGCTCAGGTCAGGGGTCTTCAGGTCGCCCTGCACTTGGGGCGGGGCCACGTCCGCCTCCACCTTGGGCGCACCCACCTCCAGAGAGGCCTCCAGGCTGGGCTTGCCAGGCGCGGACACGCCGAAGGAGGGCATCTTGAACTCGGGCATCTTGAACTTGCTGTCTTTGGCCGCCACGTCCTTGTCGGCCAGGGCCAGCTCCCCCTCCAGCTTGGCACCGGGCGCCTGGATGTCCACCTCCACGCCGGGCAGGGACACCTCCAGGTCGGGGGCGCtcacctcgcccttggcgcccttcacgtccactttggggcccttcaggtccacgtggggccccttgaggtccaccttgggcatcttgaggCTGGGCATCTGCACCTTGGGCAGGTGGCCCTTCAGGCCGGCCCCAGCAGCAGCAGCAGCCTGGGCGGcgggcagctctgcctcgggcagctgtccctcgggcagctTCACGCCCACCTGGCCGGCCTTGAGCTCCAGGTCGGCGGACGGCAGCTGAACGCTCAGGTCAGGGGTCTTCAGGTCGCCCTGCACTTGGGGCGGGGCCACGTCCGCCTCCACCTTGGGCGCACCCACCTCCAGAGAGGCCTCCAGGCTGGGCTTGCCAGGCGCGGACACGCCGAAGGAgggcatcttgaacttgggcatcttgaacttgCTGTCTTTGGCCGCCACGTCCTTGTCGGCCAGGGCCAGCTCCCCCTCCAGCTTGGCCCCGGGCGCCTGGATGTCCACCTCCACGCCGGGCAGGGACACCTCCAGGTCGGGGGCGCtcacctcgcccttggcgcccttcacgtccactttggggcccttcaggtccacgtggggccccttgaggtccaccttgggcatcttgaggCTGGGCATCTGCACCTTGGGCAGGTGGCCCTTCAGGCCGGCCCCAGCAGCAGCAGCAGCCTGGGCGGcgggcagctctgcctcgggcagctgtccctcgggcagctTCACGCCCACCTGGCCGGCCTTGAGCTCCAGGTCGGCGGACGGCAGCTGAACGCTCAGGTCAGGGGTCTTCAGGTCGCCCTGCACTTGGGGCGGGACCACGTCTGCCTCCACCTTGGGCGCACCCACCTCCAGAGAGGCCTCCAGGCTGGGCTTGCCAGGCGCGGACACGCCAAAGGAgggcatcttgaacttgggcatcttgaacttgCTGTCTTTGGCCGCCACGTCCTTGTCGGCCAGGGCCAGCTCCCCCTCCAGCTTGGCACCGGGCGCCTGGATGTCCACCTCCACGCCGGGCAGGGACACCTCCAGGTCGGGGGCGCtcacctcgcccttggcgcccttcacgtccactttggggcccttcaggtctacgtggggtcccttgaggtccaTCTTGGGCATCTTGAGGCTGGGCATCTGCACCTTGGGCAGGTGGCCCTTCAGGCCGGCCCCAGCAGCAGCAGCCTGGGCGGCGGGCAGCTCTGCCTCCGGCAGCTGTCCTTCGGGGCAGCTTCACGCCCACCTGGCCGGCCTTGAGCTCCAGGTCGGCGGACGGCAGCTGAACGCTCAGGTCAGGGGTCTTCAGGTCGCCCTGCACTTGGGGCGGGGCCACGTCCGCCTCCACCTTGGGCGCACCCACCTCCAGAGAGGCCTCCAGGCTGGGCTTGCCAGGCGCGGACACGCCGAAGGAgggcatcttgaacttgggcatcttgaacttgCTGTCTTTGGCCGCCACGTCCTTGTCGGCCAGGGCCAGCTCCCCCTCCAGCTTGGCACCGGGCGCCTGGATGTCCACCTCCACGCCGGGCAGGGACACCTCCAGGTCGGGGGCGCtcacctcgcccttggcgcccttcacgtccactttggggcccttcaggtccacgtggggccccttgaggtccaccttgggcatcttgaggCTGGGCATCTGCACCTTGGGCAGGTGGCCCTTCAGGCCGGCCCCAGCAGCAGCAGCAGCCTGGGCGGcgggcagctctgcctcgggcagctgtccctcgggcagctTCACGCCCACCTGGCCGGCCTTGAGCTCCAGGTCGGCGGACGGCAGCTGAACGCTCAGGTCAGGGGTCTTCAGGTCGCCCTGCACTTGGGGCGGGGCCACGTCCGCCTCCACCTTGGGCGCACCCACCTCCAGAGAGGCCTCCAGGCTGGGCTTGCCAGGCGCGGACACGCCGAAGGAgggcatcttgaacttgggcatcttgaacttgCTGTCTTTGGCCGCCACGTCCTTGTCGGCCAGGGCCAGCTCCCCCTCCAGCTTGGCACCGGGCGCCTGGATGTCCACCTCCACGCCGGGCAGGGACACCTCCAGGTCGGGGGCGCtcacctcgcccttggcgcccttcacgtccactttggggcccttcaggtccacgtggggccccttgaggtccaccttgggcatcttgaggCTGGGCATCTGCACCTTGGGCAGGTGGCCCTTCAGGCCGGCCCCAGCAGCAGCAGCAGCCTGGGCGGcgggcagctctgcctcgggcagctgtccctcgggcagctTCACGCCCACCTGGCCGGCCTTGAGGTCCAGGTCGGCGGACGGCAGCTGAACGCTCAGGTCAGGGGTCTTCAGGTCGCCCTGCACTTGGGGCGGGGCCACGTCCGCCTCCACCTTGGGCGCACCCACCTCCAGAGAGGCCTCCTGGCTGGGCTTGCCAGGCGCGGACACGCCGAAGGAgggcatcttgaacttgggcatcttgaacttgCTGTCTTTGGCCGCCACGTCCTTGTCGGCCAGGGCCAGCTCCCCCTCCAGCTTGGCACCGGGCGCCTGGATGTCCACCTCCACGCCGGGCAGGGACACCTCCAGGTCGGGGGCGCtcacctcgcccttggcgcccttcacgtccactttggggcccttcaggtccacgtggggccccttgaggtccaccttgggcatcttgaggCTGGGCATCTGCACCTTGGGCAGGTGGCCCTTCAGGCCGGCCCCAGCAGCAGCCTGGGCAGcgggcagctctgcctcggggagctgtccctcgggcagctTCACGCCCACCTGGCCGGCCTTGAGCTCCAGGTCGGCGGACCGCAGCTGAACGCTCAGGTCAGGGGTCTTCAGGTCGCCCTGCACTTGGGGCGGGGCCACGTCCGCCTCCACCTTGGGCGCACCCACCTCCAGAGAGGCCTCCTGGCTGGGCTTGCCAGGCGCGGACACGCCGAAGGAgggcatcttgaacttgggcatcttgaacttgCTGTCTTTGGCCGCCACGTCCTTGTCGGCCAGGGCCAGCTCCCCCTCCAGCTTGGCACCGGGCGCCTGGATGTCCACCTCCACGCCGGGCAGGGACACCTCCAGGTCGGGGGCGCtcacctcgcccttggcgcccttcacgtccactttggggcccttcaggtccacgtggggccccttgaggtccaccttgggcatcttgaggCTGGGCATCTGCACCTTGGGCAGGTGGCCCTTCAGGCCGGCCCCAGCAGCAGCAGCAGCCTTGGCGGcgggcagctctgcctcgggcagctgtccctcgggcagctTCACGCCCACCTGGCCGGCCTTGAGCTCCAGGTCGGCGGACGGCAGCTGAACGCTCAGGGGCGGGGCCACGTCCGCCTCCACCTTGGGCGCACCCACCTCCAGAGAGGCCTCCAGGCTGGGCTTGCCAGGCGCGGACACGCCGAAGGAgggcatcttgaacttgggcatcttgaacttgCTGTCTTTGGCCGCCACGTCCTTGTCGGCCAGGGCCAGCTCCCCCTCCAGCTTGGCACCGGGCGCCTGGATGTCCACCTCCACGCCGGGCAGGGACACCTCCAGGTCGGGGGCGCtcacctcgcccttggcgcccttcacgtccactttggggcccttcaggtccacgtggggccccttgaggtccaccttgggcatcttgaggCTGGGCATCTGCACCTTGGGCAGGTGGCCCTTCAGGCCGGCCCCAGCAGCAGCAGCAGCCTGGGCGGcgggcagctctgcctcgggcagctgtccctcgggcagctTCACGCCCACCTGGCCGGCCTTGAGCTCCAGGTCGGCGGACGGCAGCTGAACGCTCAGGTCAGGGGTCTTCAGGTCGCCCTGCACTTGGGGCGGGGCCACGTCCGCCTCCACCTTGGGCGCACCCACCTCCAGAGAGGCCTCCAGGCTGGGCTTGCCAGGCGCGGACACGCCGAAGGAgggcatcttgaacttgggcatcttgaacttgCTGTCTTTGGCCGCCACGTCCTTGTCGGCCAGGGCCAGCTCCCCCTCCAGCTTGGCACCGGGCGCCTGGATGTCCACCTCCACGCCGGGCAGGGACACCTCCAGGTCGGGGGCGCtcacctcgcccttggcgcccttcacgtccactttggggcccttcaggtccacgtggggccccttgaggtccaccttgggcatcttgaggCTGGGCATCTGCACCTTGGGCAGGTGGCCCTTCAGGCCGGCCCCAGCAGCAGCAGCAGCCTGGGCGGcgggcagctctgcctcgggcagctgtccctcgggcagctTCACGCCCACCTGGCCGGCCTTGAGCTCCAGGTCGGCGGACGGCAGCTGAACGCTCAGGTCAGGGGTCTTCAGGTCGCCCTGCACTTGGGGCGGGGCCACGTCCGCCTCCACCTTGGGCGCACCCACCTCCAGAGAGGCCTCCAGGCTGGGCTTGCCAGGCGCGGACACGCCGAAGGAgggcatcttgaacttgggcatcttgaacttgCTGTCTTTGGCCACCACGTCCTTGTCGGCCAGGGTCAGCTCCCCCTCCAGCTTGGCACTAGGGACCTGTATATTTACTTCCATGTTTTCTTCTGGTGTGT	8699	1088	13%	1556	18%
12	112776151	112784850	CAGAGAGGCCTCCAGGCTGGGCTTGCCAGGCGCGGACACGCCGAAGGAgggcatcttgaacttgggcatcttgaacttgCTGTCTTTGGCCGCCACGTCCTTGTCGGCCAGGGAGAGCTCCCCCTCCAGCTTGGCACCGGGCGCCTGGATGTCCACCTCCACGCCGGGCAGGGACACCTCCAGGTCGGGGGCGCtcacctcgcccttggcgcccttcacgtccactttggggcccttcaggtccacgtggggccccttgaggtccaccttgggcatcttgaggCTGGGCATCTGCACCTTGGGCAGGTGGCCCTTCAGGCCGGCCCCAGCAGCAGCAGCAGCCTGGGCGGcgggcagctctgcctcgggcagctgtccctcgggcagctTCACGCCCACCTGGCCGGCCTTGAGCTCCAGGTCGGCGGACCGCAGCTGAACGCTCAGGTCAGGGGTCTTCAGGTCGCCCTGCACTTGGGGCGGGGCCACGTCCGCCTCCACCTTGGGCGCACCCACCTCCAGAGAGGCCTCCAGGCTGGGCTTGCCAGGCGCGGACACGCCGAAGGAgggcatcttgaacttgggcatcttgaacttgCTGTCTTTGGCCGCCACGTCCTTGTCGGCCAGGGCCAGCTCCCCCTCCAGCTTGGCACCGGGCGCCTGGATGTCCACCTCCACGCCGGGCAGGGACACCTCCAGGTCGGGGGCGCtcacctcgcccttggcgcccttcacgtccactttggggcccttcaggtccacgtggggccccttgaggtccaccttgggcatcttgaggCTGGGCATCTGCACCTTGGGCAGGTGGCCCTTCAGGCCGGCCCCAGCAGCAGCAGCAGCCTGGGCGGcgggcagctctgcctcgggcagctgtccctcgggcagctTCACGCCCACCTGGCCGGCCTTGAGCTCCAGGTCGGCGGACGGCAGCTGAACGCTCAGGTCAGGGGTCTTCAGGTCGCCCTGCACTTGGGGCGGGACCACGTCTGCCTCCACCTTGGGCGCACCCACCTCCAGAGAGGCCTCCAGGCTGGGCTTGCCAGGCGCGGACACGCCAAAGGAgggcatcttgaacttgggcatcttgaacttgCTGTCTTTGGCCGCCACGTCCTTGTCGGCCAGGGCCAGCTCCCCCTCCAGCTTGGCACCGGGCGCCTGGATGTCCACCTCCACGCCGGGCAGGGACACCTCCAGGTCGGGGGCGCtcacctcgcccttggcgcccttcacgtccactttggggcccttcaggtccacgtggggcccctgaggtccaccttgggcatcttgaggCTGGGCATCTGCACCTTGGGCAGGTGGCCCTTCAGGCCGGCCCCAGCAGCAGCAGCAGCCTGGGCGGcgggcagctctgcctcgggcagctgtccctcgggcagctTCACGCCCACCTGGCCGGCCTTGAGCTCCAGGTCGGCGGACCGCAGCTGAACGCTCAGGTCAGGGGTCTTCAGGTCGCCCTGCACTTGGGGCGGGGCCACGTCCGCCTCCACCTTGGGCGCACCCACCTCCAGAGAGGCCTCCAGGCTGGGCTTGCCAGGCGCGGACACGCCGAAGGAgggcatcttgaacttgggcatcttgaacttgCTGTCTTTGGCCGCCACGTCCTTGTCGGCCAGGGAGAGCTCCCCCTCCAGCTTGGCACCGGGCGCCTGGATGTCCACCTCCACGCCGGGCAGGGACACCTCCAGGTCGGGGGCGCtcacctcgcccttggcgcccttcacgtccactttggggcccttcaggtccacgtggggccccttgaggtccaccttgggcatcttgaggCTGGGCATCTGCACCTTGGGCAGGTGGCCCTTCAGGCCGGCCCCAGCAGCAGCAGCAGCCTGGGCGGcgggcagctctgcctcgggcagctgtccctcgggcagctTCACGCCCACCTGGCCGGCCTTGAGCTCCAGGTCGGCGGACCGCAGCTGAACGCTCAGGTCAGGGGTCTTCAGGTCGCCCTGCACTTGGGGCGGGGCCACGTCCGCCTCCACCTTGGGCGCACCCACCTCCAGAGAGGCCTCCTGGCTGGGCTTGCCAGGCGCGGACACGCCGAAGGAgggcatcttgaacttgggcatcttgaacttgCTGTCTTTGGCCGCCACGTCCTTGTCGGCCAGGGCCAGCTCCCCCTCCAGCTTGGCACCGGGCGCCTGGATGTCCACCTCCACGCCGGGCAGGGACACCTCCAGGTCGGGGGCGCtcacctcgcccttggcgcccttcacgtccactttggggcccttcaggtccacgtggggccccttgaggtccaccttgggcatcttgaggCTGGGCATCTGCACCTTGGGCAGGTGGCCCTTCAGGCCGGCCCCAGCAGCAGCAGCAGCCTTGGCGGcgggcagctctgcctcgggcagctgtccctcgggcagctTCACGCCCACCTGGCCGGCCTTGAGCTCCAGGTCGGCGGACGGCAGCTGAACGCTCAGGTCAGGGGTCTTCAGGTCGCCCTGCACTTGGGGCGGGGCCACGTCCGCCTCCACCTTGGGCGCACCCACCTCCAGAGAGGCCTCCAGGCTGGGCTTGCCAGGCGCGGACACGCCGAAGGAgggcatcttgaacttgggcatcttgaacttgCTGTCTTTGGCAGCCACGTCCTTGTCGGCCAGGGCCAGCTCCCCCTCCAGCTTGGCACCGGGCGCCTGGATGTCCACCTCCACGCCGGGCAGGGACACCTCCAGGTCGGGGGCACtcacctcgcccttggcgcccttcacgtccactttggggcccttcaggtccacgtggggccccttgaggtccaccttgggcatcttgaggCTGGGCATCTGCACCTTGGGCAGGTGGCCCTTCAGGCCGGCCCCAGCAGCAGCAGCAGCCTGGGCGGcgggcagctctgcctcgggcagctgtccctcgggcagctTCACGCCCACCTGGCCGGCCTTGAGCTCCAGGTCGGCGGACGGCAGCTGAACGCTCAGGTCAGGGGTCTTCAGGTCGCCCTGCACTTGGGGCGGGGCCACGTCCGCCTCCACCTTGGGCGCACCCACCTCCAGAGAGGCCTCCAGGCTGGGCTTGCCAGGCGCGGACACGCCGAAGGAgggcatcttgaacttgggcatcttgaacttgCTGTCTTTGGCCGCCACGTCCTTGTCGGCCAGGTGTCCCTCGAGCAGCTTAACGCCCACCTGGCCGACATTGAGCTCCAAGTCGGCGGACGGCAGCTGAACGCTCAGGTCAGGGGTCTTCAGGTCGCCCTGCACTTGGGGCGGGACCACGTCTGCCTCCACATTGGGCGCACCCACCTCCAGAGAGGCCTCCAGGCTGGGCTTGCCAGGCGCGGACACGCCAAAGGAgggcatcttgaacttgggcatcttgaacttgCTGTCTTTGGCCGCCACGTCCTTGTCGGCCAGGGCCAGCTCCCCCTCCAGCTTGGCACCGGGCGCCTGGATGTCCACCTCCACGCCGGGCAGGGACACCTCCAGGTCGGGGGCGCtcacctcgcccttggcgcccttcacgtccactttggggcccttcaggtccacgtggggtcccttgaggtccaccttgggcatcttgaggCTGGGCATCTGCACCTTGGGCAGGTGGCCCTTCAGGCCGGCCCCAGCAGCAGCAGCCTGGGCGGCGggcagctctgcctccggcagctgtccctcgggcagctTCACGCCCACCTGGCGGGCCTTGAGCTCCAGGTCGGCGGACGGCAGCTGAACGCTCAGGTCAGGGGTCTTCAGGTCGCCCTGCACTTGGGGCGGGGCCACGTCCGCCTCCACCTTGGGCGCACCCACCTCCAGAGAGGCCTCCAGGCTGGGCTTGCCAGGCGCGGACACGCCGAAGGAGGGCATCTTGAACTCGGGCATCTTGAACTTGCTGTCTTTGGCCGCCACGTCCTTGTCGGCCAGGGCCAGCTCCCCCTCCAGCTTGGCACCGGGCGCCTGGATGTCCACCTCCACGCCGGGCAGGGACACCTCCAGGTCGGGGGCGCtcacctcgcccttggcgcccttcacgtccactttggggcccttcaggtccacgtggggccccttgaggtccaccttgggcatcttgaggCTGGGCATCTGCACCTTGGGCAGGTGGCCCTTCAGGCCGGCCCCAGCAGCAGCAGCAGCCTGGGCGGcgggcagctctgcctcgggcagctgtccctcgggcagctTCACGCCCACCTGGCCGGCCTTGAGCTCCAGGTCGGCGGACGGCAGCTGAACGCTCAGGTCAGGGGTCTTCAGGTCGCCCTGCACTTGGGGCGGGGCCACGTCCGCCTCCACCTTGGGCGCACCCACCTCCAGAGAGGCCTCCAGGCTGGGCTTGCCAGGCGCGGACACGCCGAAGGAgggcatcttgaacttgggcatcttgaacttgCTGTCTTTGGCCGCCACGTCCTTGTCGGCCAGGGCCAGCTCCCCCTCCAGCTTGGCCCCGGGCGCCTGGATGTCCACCTCCACGCCGGGCAGGGACACCTCCAGGTCGGGGGCGCtcacctcgcccttggcgcccttcacgtccactttggggcccttcaggtccacgtggggccccttgaggtccaccttgggcatcttgaggCTGGGCATCTGCACCTTGGGCAGGTGGCCCTTCAGGCCGGCCCCAGCAGCAGCAGCAGCCTGGGCGGcgggcagctctgcctcgggcagctgtccctcgggcagctTCACGCCCACCTGGCCGGCCTTGAGCTCCAGGTCGGCGGACGGCAGCTGAACGCTCAGGTCAGGGGTCTTCAGGTCGCCCTGCACTTGGGGCGGGACCACGTCTGCCTCCACCTTGGGCGCACCCACCTCCAGAGAGGCCTCCAGGCTGGGCTTGCCAGGCGCGGACACGCCAAAGGAgggcatcttgaacttgggcatcttgaacttgCTGTCTTTGGCCGCCACGTCCTTGTCGGCCAGGGCCAGCTCCCCCTCCAGCTTGGCACCGGGCGCCTGGATGTCCACCTCCACGCCGGGCAGGGACACCTCCAGGTCGGGGGCGCtcacctcgcccttggcgcccttcacgtccactttggggcccttcaggtctacgtggggtcccttgaggtccaTCTTGGGCATCTTGAGGCTGGGCATCTGCACCTTGGGCAGGTGGCCCTTCAGGCCGGCCCCAGCAGCAGCAGCCTGGGCGGCGGGCAGCTCTGCCTCCGGCAGCTGTCCTTCGGGGCAGCTTCACGCCCACCTGGCCGGCCTTGAGCTCCAGGTCGGCGGACGGCAGCTGAACGCTCAGGTCAGGGGTCTTCAGGTCGCCCTGCACTTGGGGCGGGGCCACGTCCGCCTCCACCTTGGGCGCACCCACCTCCAGAGAGGCCTCCAGGCTGGGCTTGCCAGGCGCGGACACGCCGAAGGAgggcatcttgaacttgggcatcttgaacttgCTGTCTTTGGCCGCCACGTCCTTGTCGGCCAGGGCCAGCTCCCCCTCCAGCTTGGCACCGGGCGCCTGGATGTCCACCTCCACGCCGGGCAGGGACACCTCCAGGTCGGGGGCGCtcacctcgcccttggcgcccttcacgtccactttggggcccttcaggtccacgtggggccccttgaggtccaccttgggcatcttgaggCTGGGCATCTGCACCTTGGGCAGGTGGCCCTTCAGGCCGGCCCCAGCAGCAGCAGCAGCCTGGGCGGcgggcagctctgcctcgggcagctgtccctcgggcagctTCACGCCCACCTGGCCGGCCTTGAGCTCCAGGTCGGCGGACGGCAGCTGAACGCTCAGGTCAGGGGTCTTCAGGTCGCCCTGCACTTGGGGCGGGGCCACGTCCGCCTCCACCTTGGGCGCACCCACCTCCAGAGAGGCCTCCAGGCTGGGCTTGCCAGGCGCGGACACGCCGAAGGAgggcatcttgaacttgggcatcttgaacttgCTGTCTTTGGCCGCCACGTCCTTGTCGGCCAGGGCCAGCTCCCCCTCCAGCTTGGCACCGGGCGCCTGGATGTCCACCTCCACGCCGGGCAGGGACACCTCCAGGTCGGGGGCGCtcacctcgcccttggcgcccttcacgtccactttggggcccttcaggtccacgtggggccccttgaggtccaccttgggcatcttgaggCTGGGCATCTGCACCTTGGGCAGGTGGCCCTTCAGGCCGGCCCCAGCAGCAGCAGCAGCCTGGGCGGcgggcagctctgcctcgggcagctgtccctcgggcagctTCACGCCCACCTGGCCGGCCTTGAGGTCCAGGTCGGCGGACGGCAGCTGAACGCTCAGGTCAGGGGTCTTCAGGTCGCCCTGCACTTGGGGCGGGGCCACGTCCGCCTCCACCTTGGGCGCACCCACCTCCAGAGAGGCCTCCTGGCTGGGCTTGCCAGGCGCGGACACGCCGAAGGAgggcatcttgaacttgggcatcttgaacttgCTGTCTTTGGCCGCCACGTCCTTGTCGGCCAGGGCCAGCTCCCCCTCCAGCTTGGCACCGGGCGCCTGGATGTCCACCTCCACGCCGGGCAGGGACACCTCCAGGTCGGGGGCGCtcacctcgcccttggcgcccttcacgtccactttggggcccttcaggtccacgtggggccccttgaggtccaccttgggcatcttgaggCTGGGCATCTGCACCTTGGGCAGGTGGCCCTTCAGGCCGGCCCCAGCAGCAGCCTGGGCAGcgggcagctctgcctcggggagctgtccctcgggcagctTCACGCCCACCTGGCCGGCCTTGAGCTCCAGGTCGGCGGACCGCAGCTGAACGCTCAGGTCAGGGGTCTTCAGGTCGCCCTGCACTTGGGGCGGGGCCACGTCCGCCTCCACCTTGGGCGCACCCACCTCCAGAGAGGCCTCCTGGCTGGGCTTGCCAGGCGCGGACACGCCGAAGGAgggcatcttgaacttgggcatcttgaacttgCTGTCTTTGGCCGCCACGTCCTTGTCGGCCAGGGCCAGCTCCCCCTCCAGCTTGGCACCGGGCGCCTGGATGTCCACCTCCACGCCGGGCAGGGACACCTCCAGGTCGGGGGCGCtcacctcgcccttggcgcccttcacgtccactttggggcccttcaggtccacgtggggccccttgaggtccaccttgggcatcttgaggCTGGGCATCTGCACCTTGGGCAGGTGGCCCTTCAGGCCGGCCCCAGCAGCAGCAGCAGCCTTGGCGGcgggcagctctgcctcgggcagctgtccctcgggcagctTCACGCCCACCTGGCCGGCCTTGAGCTCCAGGTCGGCGGACGGCAGCTGAACGCTCAGGGGCGGGGCCACGTCCGCCTCCACCTTGGGCGCACCCACCTCCAGAGAGGCCTCCAGGCTGGGCTTGCCAGGCGCGGACACGCCGAAGGAgggcatcttgaacttgggcatcttgaacttgCTGTCTTTGGCCGCCACGTCCTTGTCGGCCAGGGCCAGCTCCCCCTCCAGCTTGGCACCGGGCGCCTGGATGTCCACCTCCACGCCGGGCAGGGACACCTCCAGGTCGGGGGCGCtcacctcgcccttggcgcccttcacgtccactttggggcccttcaggtccacgtggggccccttgaggtccaccttgggcatcttgaggCTGGGCATCTGCACCTTGGGCAGGTGGCCCTTCAGGCCGGCCCCAGCAGCAGCAGCAGCCTGGGCGGcgggcagctctgcctcgggcagctgtccctcgggcagctTCACGCCCACCTGGCCGGCCTTGAGCTCCAGGTCGGCGGACGGCAGCTGAACGCTCAGGTCAGGGGTCTTCAGGTCGCCCTGCACTTGGGGCGGGGCCACGTCCGCCTCCACCTTGGGCGCACCCACCTCCAGAGAGGCCTCCAGGCTGGGCTTGCCAGGCGCGGACACGCCGAAGGAgggcatcttgaacttgggcatcttgaacttgCTGTCTTTGGCCGCCACGTCCTTGTCGGCCAGGGCCAGCTCCCCCTCCAGCTTGGCACCGGGCGCCTGGATGTCCACCTCCACGCCGGGCAGGGACACCTCCAGGTCGGGGGCGCtcacctcgcccttggcgcccttcacgtccactttggggcccttcaggtccacgtggggccccttgaggtccaccttgggcatcttgaggCTGGGCATCTGCACCTTGGGCAGGTGGCCCTTCAGGCCGGCCCCAGCAGCAGCAGCAGCCTGGGCGGcgggcagctctgcctcgggcagctgtccctcgggcagctTCACGCCCACCTGGCCGGCCTTGAGCTCCAGGTCGGCGGACGGCAGCTGAACGCTCAGGTCAGGGGTCTTCAGGTCGCCCTGCACTTGGGGCGGGGCCACGTCCGCCTCCACCTTGGGCGCACCCACCTCCAGAGAGGCCTCCAGGCTGGGCTTGCCAGGCGCGGACACGCCGAAGGAgggcatcttgaacttgggcatcttgaacttgCTGTCTTTGGCCACCACGTCCTTGTCGGCCAGGGTCAGCTCCCCCTCCAGCTTGGCACTAGGGACCTGTATATTTACTTCCATGTTTTCTTCTGGTGTGT	8699	1088	13%	1556	18%
12	112776151	112784850	CAGAGAGGCCTCCAGGCTGGGCTTGCCAGGCGCGGACACGCCGAAGGAgggcatcttgaacttgggcatcttgaacttgCTGTCTTTGGCCGCCACGTCCTTGTCGGCCAGGGAGAGCTCCCCCTCCAGCTTGGCACCGGGCGCCTGGATGTCCACCTCCACGCCGGGCAGGGACACCTCCAGGTCGGGGGCGCtcacctcgcccttggcgcccttcacgtccactttggggcccttcaggtccacgtggggccccttgaggtccaccttgggcatcttgaggCTGGGCATCTGCACCTTGGGCAGGTGGCCCTTCAGGCCGGCCCCAGCAGCAGCAGCAGCCTGGGCGGcgggcagctctgcctcgggcagctgtccctcgggcagctTCACGCCCACCTGGCCGGCCTTGAGCTCCAGGTCGGCGGACCGCAGCTGAACGCTCAGGTCAGGGGTCTTCAGGTCGCCCTGCACTTGGGGCGGGGCCACGTCCGCCTCCACCTTGGGCGCACCCACCTCCAGAGAGGCCTCCAGGCTGGGCTTGCCAGGCGCGGACACGCCGAAGGAgggcatcttgaacttgggcatcttgaacttgCTGTCTTTGGCCGCCACGTCCTTGTCGGCCAGGGCCAGCTCCCCCTCCAGCTTGGCACCGGGCGCCTGGATGTCCACCTCCACGCCGGGCAGGGACACCTCCAGGTCGGGGGCGCtcacctcgcccttggcgcccttcacgtccactttggggcccttcaggtccacgtggggccccttgaggtccaccttgggcatcttgaggCTGGGCATCTGCACCTTGGGCAGGTGGCCCTTCAGGCCGGCCCCAGCAGCAGCAGCAGCCTGGGCGGcgggcagctctgcctcgggcagctgtccctcgggcagctTCACGCCCACCTGGCCGGCCTTGAGCTCCAGGTCGGCGGACGGCAGCTGAACGCTCAGGTCAGGGGTCTTCAGGTCGCCCTGCACTTGGGGCGGGACCACGTCTGCCTCCACCTTGGGCGCACCCACCTCCAGAGAGGCCTCCAGGCTGGGCTTGCCAGGCGCGGACACGCCAAAGGAgggcatcttgaacttgggcatcttgaacttgCTGTCTTTGGCCGCCACGTCCTTGTCGGCCAGGGCCAGCTCCCCCTCCAGCTTGGCACCGGGCGCCTGGATGTCCACCTCCACGCCGGGCAGGGACACCTCCAGGTCGGGGGCGCtcacctcgcccttggcgcccttcacgtccactttggggcccttcaggtccacgtggggcccctgaggtccaccttgggcatcttgaggCTGGGCATCTGCACCTTGGGCAGGTGGCCCTTCAGGCCGGCCCCAGCAGCAGCAGCAGCCTGGGCGGcgggcagctctgcctcgggcagctgtccctcgggcagctTCACGCCCACCTGGCCGGCCTTGAGCTCCAGGTCGGCGGACCGCAGCTGAACGCTCAGGTCAGGGGTCTTCAGGTCGCCCTGCACTTGGGGCGGGGCCACGTCCGCCTCCACCTTGGGCGCACCCACCTCCAGAGAGGCCTCCAGGCTGGGCTTGCCAGGCGCGGACACGCCGAAGGAgggcatcttgaacttgggcatcttgaacttgCTGTCTTTGGCCGCCACGTCCTTGTCGGCCAGGGAGAGCTCCCCCTCCAGCTTGGCACCGGGCGCCTGGATGTCCACCTCCACGCCGGGCAGGGACACCTCCAGGTCGGGGGCGCtcacctcgcccttggcgcccttcacgtccactttggggcccttcaggtccacgtggggccccttgaggtccaccttgggcatcttgaggCTGGGCATCTGCACCTTGGGCAGGTGGCCCTTCAGGCCGGCCCCAGCAGCAGCAGCAGCCTGGGCGGcgggcagctctgcctcgggcagctgtccctcgggcagctTCACGCCCACCTGGCCGGCCTTGAGCTCCAGGTCGGCGGACCGCAGCTGAACGCTCAGGTCAGGGGTCTTCAGGTCGCCCTGCACTTGGGGCGGGGCCACGTCCGCCTCCACCTTGGGCGCACCCACCTCCAGAGAGGCCTCCTGGCTGGGCTTGCCAGGCGCGGACACGCCGAAGGAgggcatcttgaacttgggcatcttgaacttgCTGTCTTTGGCCGCCACGTCCTTGTCGGCCAGGGCCAGCTCCCCCTCCAGCTTGGCACCGGGCGCCTGGATGTCCACCTCCACGCCGGGCAGGGACACCTCCAGGTCGGGGGCGCtcacctcgcccttggcgcccttcacgtccactttggggcccttcaggtccacgtggggccccttgaggtccaccttgggcatcttgaggCTGGGCATCTGCACCTTGGGCAGGTGGCCCTTCAGGCCGGCCCCAGCAGCAGCAGCAGCCTTGGCGGcgggcagctctgcctcgggcagctgtccctcgggcagctTCACGCCCACCTGGCCGGCCTTGAGCTCCAGGTCGGCGGACGGCAGCTGAACGCTCAGGTCAGGGGTCTTCAGGTCGCCCTGCACTTGGGGCGGGGCCACGTCCGCCTCCACCTTGGGCGCACCCACCTCCAGAGAGGCCTCCAGGCTGGGCTTGCCAGGCGCGGACACGCCGAAGGAgggcatcttgaacttgggcatcttgaacttgCTGTCTTTGGCAGCCACGTCCTTGTCGGCCAGGGCCAGCTCCCCCTCCAGCTTGGCACCGGGCGCCTGGATGTCCACCTCCACGCCGGGCAGGGACACCTCCAGGTCGGGGGCACtcacctcgcccttggcgcccttcacgtccactttggggcccttcaggtccacgtggggccccttgaggtccaccttgggcatcttgaggCTGGGCATCTGCACCTTGGGCAGGTGGCCCTTCAGGCCGGCCCCAGCAGCAGCAGCAGCCTGGGCGGcgggcagctctgcctcgggcagctgtccctcgggcagctTCACGCCCACCTGGCCGGCCTTGAGCTCCAGGTCGGCGGACGGCAGCTGAACGCTCAGGTCAGGGGTCTTCAGGTCGCCCTGCACTTGGGGCGGGGCCACGTCCGCCTCCACCTTGGGCGCACCCACCTCCAGAGAGGCCTCCAGGCTGGGCTTGCCAGGCGCGGACACGCCGAAGGAgggcatcttgaacttgggcatcttgaacttgCTGTCTTTGGCCGCCACGTCCTTGTCGGCCAGGTGTCCCTCGAGCAGCTTAACGCCCACCTGGCCGACATTGAGCTCCAAGTCGGCGGACGGCAGCTGAACGCTCAGGTCAGGGGTCTTCAGGTCGCCCTGCACTTGGGGCGGGACCACGTCTGCCTCCACATTGGGCGCACCCACCTCCAGAGAGGCCTCCAGGCTGGGCTTGCCAGGCGCGGACACGCCAAAGGAgggcatcttgaacttgggcatcttgaacttgCTGTCTTTGGCCGCCACGTCCTTGTCGGCCAGGGCCAGCTCCCCCTCCAGCTTGGCACCGGGCGCCTGGATGTCCACCTCCACGCCGGGCAGGGACACCTCCAGGTCGGGGGCGCtcacctcgcccttggcgcccttcacgtccactttggggcccttcaggtccacgtggggtcccttgaggtccaccttgggcatcttgaggCTGGGCATCTGCACCTTGGGCAGGTGGCCCTTCAGGCCGGCCCCAGCAGCAGCAGCCTGGGCGGCGggcagctctgcctccggcagctgtccctcgggcagctTCACGCCCACCTGGCGGGCCTTGAGCTCCAGGTCGGCGGACGGCAGCTGAACGCTCAGGTCAGGGGTCTTCAGGTCGCCCTGCACTTGGGGCGGGGCCACGTCCGCCTCCACCTTGGGCGCACCCACCTCCAGAGAGGCCTCCAGGCTGGGCTTGCCAGGCGCGGACACGCCGAAGGAGGGCATCTTGAACTCGGGCATCTTGAACTTGCTGTCTTTGGCCGCCACGTCCTTGTCGGCCAGGGCCAGCTCCCCCTCCAGCTTGGCACCGGGCGCCTGGATGTCCACCTCCACGCCGGGCAGGGACACCTCCAGGTCGGGGGCGCtcacctcgcccttggcgcccttcacgtccactttggggcccttcaggtccacgtggggccccttgaggtccaccttgggcatcttgaggCTGGGCATCTGCACCTTGGGCAGGTGGCCCTTCAGGCCGGCCCCAGCAGCAGCAGCAGCCTGGGCGGcgggcagctctgcctcgggcagctgtccctcgggcagctTCACGCCCACCTGGCCGGCCTTGAGCTCCAGGTCGGCGGACGGCAGCTGAACGCTCAGGTCAGGGGTCTTCAGGTCGCCCTGCACTTGGGGCGGGGCCACGTCCGCCTCCACCTTGGGCGCACCCACCTCCAGAGAGGCCTCCAGGCTGGGCTTGCCAGGCGCGGACACGCCGAAGGAgggcatcttgaacttgggcatcttgaacttgCTGTCTTTGGCCGCCACGTCCTTGTCGGCCAGGGCCAGCTCCCCCTCCAGCTTGGCCCCGGGCGCCTGGATGTCCACCTCCACGCCGGGCAGGGACACCTCCAGGTCGGGGGCGCtcacctcgcccttggcgcccttcacgtccactttggggcccttcaggtccacgtggggccccttgaggtccaccttgggcatcttgaggCTGGGCATCTGCACCTTGGGCAGGTGGCCCTTCAGGCCGGCCCCAGCAGCAGCAGCAGCCTGGGCGGcgggcagctctgcctcgggcagctgtccctcgggcagctTCACGCCCACCTGGCCGGCCTTGAGCTCCAGGTCGGCGGACGGCAGCTGAACGCTCAGGTCAGGGGTCTTCAGGTCGCCCTGCACTTGGGGCGGGACCACGTCTGCCTCCACCTTGGGCGCACCCACCTCCAGAGAGGCCTCCAGGCTGGGCTTGCCAGGCGCGGACACGCCAAAGGAgggcatcttgaacttgggcatcttgaacttgCTGTCTTTGGCCGCCACGTCCTTGTCGGCCAGGGCCAGCTCCCCCTCCAGCTTGGCACCGGGCGCCTGGATGTCCACCTCCACGCCGGGCAGGGACACCTCCAGGTCGGGGGCGCtcacctcgcccttggcgcccttcacgtccactttggggcccttcaggtctacgtggggtcccttgaggtccaTCTTGGGCATCTTGAGGCTGGGCATCTGCACCTTGGGCAGGTGGCCCTTCAGGCCGGCCCCAGCAGCAGCAGCCTGGGCGGCGGGCAGCTCTGCCTCCGGCAGCTGTCCTTCGGGGCAGCTTCACGCCCACCTGGCCGGCCTTGAGCTCCAGGTCGGCGGACGGCAGCTGAACGCTCAGGTCAGGGGTCTTCAGGTCGCCCTGCACTTGGGGCGGGGCCACGTCCGCCTCCACCTTGGGCGCACCCACCTCCAGAGAGGCCTCCAGGCTGGGCTTGCCAGGCGCGGACACGCCGAAGGAgggcatcttgaacttgggcatcttgaacttgCTGTCTTTGGCCGCCACGTCCTTGTCGGCCAGGGCCAGCTCCCCCTCCAGCTTGGCACCGGGCGCCTGGATGTCCACCTCCACGCCGGGCAGGGACACCTCCAGGTCGGGGGCGCtcacctcgcccttggcgcccttcacgtccactttggggcccttcaggtccacgtggggccccttgaggtccaccttgggcatcttgaggCTGGGCATCTGCACCTTGGGCAGGTGGCCCTTCAGGCCGGCCCCAGCAGCAGCAGCAGCCTGGGCGGcgggcagctctgcctcgggcagctgtccctcgggcagctTCACGCCCACCTGGCCGGCCTTGAGCTCCAGGTCGGCGGACGGCAGCTGAACGCTCAGGTCAGGGGTCTTCAGGTCGCCCTGCACTTGGGGCGGGGCCACGTCCGCCTCCACCTTGGGCGCACCCACCTCCAGAGAGGCCTCCAGGCTGGGCTTGCCAGGCGCGGACACGCCGAAGGAgggcatcttgaacttgggcatcttgaacttgCTGTCTTTGGCCGCCACGTCCTTGTCGGCCAGGGCCAGCTCCCCCTCCAGCTTGGCACCGGGCGCCTGGATGTCCACCTCCACGCCGGGCAGGGACACCTCCAGGTCGGGGGCGCtcacctcgcccttggcgcccttcacgtccactttggggcccttcaggtccacgtggggccccttgaggtccaccttgggcatcttgaggCTGGGCATCTGCACCTTGGGCAGGTGGCCCTTCAGGCCGGCCCCAGCAGCAGCAGCAGCCTGGGCGGcgggcagctctgcctcgggcagctgtccctcgggcagctTCACGCCCACCTGGCCGGCCTTGAGGTCCAGGTCGGCGGACGGCAGCTGAACGCTCAGGTCAGGGGTCTTCAGGTCGCCCTGCACTTGGGGCGGGGCCACGTCCGCCTCCACCTTGGGCGCACCCACCTCCAGAGAGGCCTCCTGGCTGGGCTTGCCAGGCGCGGACACGCCGAAGGAgggcatcttgaacttgggcatcttgaacttgCTGTCTTTGGCCGCCACGTCCTTGTCGGCCAGGGCCAGCTCCCCCTCCAGCTTGGCACCGGGCGCCTGGATGTCCACCTCCACGCCGGGCAGGGACACCTCCAGGTCGGGGGCGCtcacctcgcccttggcgcccttcacgtccactttggggcccttcaggtccacgtggggccccttgaggtccaccttgggcatcttgaggCTGGGCATCTGCACCTTGGGCAGGTGGCCCTTCAGGCCGGCCCCAGCAGCAGCCTGGGCAGcgggcagctctgcctcggggagctgtccctcgggcagctTCACGCCCACCTGGCCGGCCTTGAGCTCCAGGTCGGCGGACCGCAGCTGAACGCTCAGGTCAGGGGTCTTCAGGTCGCCCTGCACTTGGGGCGGGGCCACGTCCGCCTCCACCTTGGGCGCACCCACCTCCAGAGAGGCCTCCTGGCTGGGCTTGCCAGGCGCGGACACGCCGAAGGAgggcatcttgaacttgggcatcttgaacttgCTGTCTTTGGCCGCCACGTCCTTGTCGGCCAGGGCCAGCTCCCCCTCCAGCTTGGCACCGGGCGCCTGGATGTCCACCTCCACGCCGGGCAGGGACACCTCCAGGTCGGGGGCGCtcacctcgcccttggcgcccttcacgtccactttggggcccttcaggtccacgtggggccccttgaggtccaccttgggcatcttgaggCTGGGCATCTGCACCTTGGGCAGGTGGCCCTTCAGGCCGGCCCCAGCAGCAGCAGCAGCCTTGGCGGcgggcagctctgcctcgggcagctgtccctcgggcagctTCACGCCCACCTGGCCGGCCTTGAGCTCCAGGTCGGCGGACGGCAGCTGAACGCTCAGGGGCGGGGCCACGTCCGCCTCCACCTTGGGCGCACCCACCTCCAGAGAGGCCTCCAGGCTGGGCTTGCCAGGCGCGGACACGCCGAAGGAgggcatcttgaacttgggcatcttgaacttgCTGTCTTTGGCCGCCACGTCCTTGTCGGCCAGGGCCAGCTCCCCCTCCAGCTTGGCACCGGGCGCCTGGATGTCCACCTCCACGCCGGGCAGGGACACCTCCAGGTCGGGGGCGCtcacctcgcccttggcgcccttcacgtccactttggggcccttcaggtccacgtggggccccttgaggtccaccttgggcatcttgaggCTGGGCATCTGCACCTTGGGCAGGTGGCCCTTCAGGCCGGCCCCAGCAGCAGCAGCAGCCTGGGCGGcgggcagctctgcctcgggcagctgtccctcgggcagctTCACGCCCACCTGGCCGGCCTTGAGCTCCAGGTCGGCGGACGGCAGCTGAACGCTCAGGTCAGGGGTCTTCAGGTCGCCCTGCACTTGGGGCGGGGCCACGTCCGCCTCCACCTTGGGCGCACCCACCTCCAGAGAGGCCTCCAGGCTGGGCTTGCCAGGCGCGGACACGCCGAAGGAgggcatcttgaacttgggcatcttgaacttgCTGTCTTTGGCCGCCACGTCCTTGTCGGCCAGGGCCAGCTCCCCCTCCAGCTTGGCACCGGGCGCCTGGATGTCCACCTCCACGCCGGGCAGGGACACCTCCAGGTCGGGGGCGCtcacctcgcccttggcgcccttcacgtccactttggggcccttcaggtccacgtggggccccttgaggtccaccttgggcatcttgaggCTGGGCATCTGCACCTTGGGCAGGTGGCCCTTCAGGCCGGCCCCAGCAGCAGCAGCAGCCTGGGCGGcgggcagctctgcctcgggcagctgtccctcgggcagctTCACGCCCACCTGGCCGGCCTTGAGCTCCAGGTCGGCGGACGGCAGCTGAACGCTCAGGTCAGGGGTCTTCAGGTCGCCCTGCACTTGGGGCGGGGCCACGTCCGCCTCCACCTTGGGCGCACCCACCTCCAGAGAGGCCTCCAGGCTGGGCTTGCCAGGCGCGGACACGCCGAAGGAgggcatcttgaacttgggcatcttgaacttgCTGTCTTTGGCCACCACGTCCTTGTCGGCCAGGGTCAGCTCCCCCTCCAGCTTGGCACTAGGGACCTGTATATTTACTTCCATGTTTTCTTCTGGTGTGT	8699	1088	13%	1556	18%
12	112776151	112784850	CAGAGAGGCCTCCAGGCTGGGCTTGCCAGGCGCGGACACGCCGAAGGAgggcatcttgaacttgggcatcttgaacttgCTGTCTTTGGCCGCCACGTCCTTGTCGGCCAGGGAGAGCTCCCCCTCCAGCTTGGCACCGGGCGCCTGGATGTCCACCTCCACGCCGGGCAGGGACACCTCCAGGTCGGGGGCGCtcacctcgcccttggcgcccttcacgtccactttggggcccttcaggtccacgtggggccccttgaggtccaccttgggcatcttgaggCTGGGCATCTGCACCTTGGGCAGGTGGCCCTTCAGGCCGGCCCCAGCAGCAGCAGCAGCCTGGGCGGcgggcagctctgcctcgggcagctgtccctcgggcagctTCACGCCCACCTGGCCGGCCTTGAGCTCCAGGTCGGCGGACCGCAGCTGAACGCTCAGGTCAGGGGTCTTCAGGTCGCCCTGCACTTGGGGCGGGGCCACGTCCGCCTCCACCTTGGGCGCACCCACCTCCAGAGAGGCCTCCAGGCTGGGCTTGCCAGGCGCGGACACGCCGAAGGAgggcatcttgaacttgggcatcttgaacttgCTGTCTTTGGCCGCCACGTCCTTGTCGGCCAGGGCCAGCTCCCCCTCCAGCTTGGCACCGGGCGCCTGGATGTCCACCTCCACGCCGGGCAGGGACACCTCCAGGTCGGGGGCGCtcacctcgcccttggcgcccttcacgtccactttggggcccttcaggtccacgtggggccccttgaggtccaccttgggcatcttgaggCTGGGCATCTGCACCTTGGGCAGGTGGCCCTTCAGGCCGGCCCCAGCAGCAGCAGCAGCCTGGGCGGcgggcagctctgcctcgggcagctgtccctcgggcagctTCACGCCCACCTGGCCGGCCTTGAGCTCCAGGTCGGCGGACGGCAGCTGAACGCTCAGGTCAGGGGTCTTCAGGTCGCCCTGCACTTGGGGCGGGACCACGTCTGCCTCCACCTTGGGCGCACCCACCTCCAGAGAGGCCTCCAGGCTGGGCTTGCCAGGCGCGGACACGCCAAAGGAgggcatcttgaacttgggcatcttgaacttgCTGTCTTTGGCCGCCACGTCCTTGTCGGCCAGGGCCAGCTCCCCCTCCAGCTTGGCACCGGGCGCCTGGATGTCCACCTCCACGCCGGGCAGGGACACCTCCAGGTCGGGGGCGCtcacctcgcccttggcgcccttcacgtccactttggggcccttcaggtccacgtggggcccctgaggtccaccttgggcatcttgaggCTGGGCATCTGCACCTTGGGCAGGTGGCCCTTCAGGCCGGCCCCAGCAGCAGCAGCAGCCTGGGCGGcgggcagctctgcctcgggcagctgtccctcgggcagctTCACGCCCACCTGGCCGGCCTTGAGCTCCAGGTCGGCGGACCGCAGCTGAACGCTCAGGTCAGGGGTCTTCAGGTCGCCCTGCACTTGGGGCGGGGCCACGTCCGCCTCCACCTTGGGCGCACCCACCTCCAGAGAGGCCTCCAGGCTGGGCTTGCCAGGCGCGGACACGCCGAAGGAgggcatcttgaacttgggcatcttgaacttgCTGTCTTTGGCCGCCACGTCCTTGTCGGCCAGGGAGAGCTCCCCCTCCAGCTTGGCACCGGGCGCCTGGATGTCCACCTCCACGCCGGGCAGGGACACCTCCAGGTCGGGGGCGCtcacctcgcccttggcgcccttcacgtccactttggggcccttcaggtccacgtggggccccttgaggtccaccttgggcatcttgaggCTGGGCATCTGCACCTTGGGCAGGTGGCCCTTCAGGCCGGCCCCAGCAGCAGCAGCAGCCTGGGCGGcgggcagctctgcctcgggcagctgtccctcgggcagctTCACGCCCACCTGGCCGGCCTTGAGCTCCAGGTCGGCGGACCGCAGCTGAACGCTCAGGTCAGGGGTCTTCAGGTCGCCCTGCACTTGGGGCGGGGCCACGTCCGCCTCCACCTTGGGCGCACCCACCTCCAGAGAGGCCTCCTGGCTGGGCTTGCCAGGCGCGGACACGCCGAAGGAgggcatcttgaacttgggcatcttgaacttgCTGTCTTTGGCCGCCACGTCCTTGTCGGCCAGGGCCAGCTCCCCCTCCAGCTTGGCACCGGGCGCCTGGATGTCCACCTCCACGCCGGGCAGGGACACCTCCAGGTCGGGGGCGCtcacctcgcccttggcgcccttcacgtccactttggggcccttcaggtccacgtggggccccttgaggtccaccttgggcatcttgaggCTGGGCATCTGCACCTTGGGCAGGTGGCCCTTCAGGCCGGCCCCAGCAGCAGCAGCAGCCTTGGCGGcgggcagctctgcctcgggcagctgtccctcgggcagctTCACGCCCACCTGGCCGGCCTTGAGCTCCAGGTCGGCGGACGGCAGCTGAACGCTCAGGTCAGGGGTCTTCAGGTCGCCCTGCACTTGGGGCGGGGCCACGTCCGCCTCCACCTTGGGCGCACCCACCTCCAGAGAGGCCTCCAGGCTGGGCTTGCCAGGCGCGGACACGCCGAAGGAgggcatcttgaacttgggcatcttgaacttgCTGTCTTTGGCAGCCACGTCCTTGTCGGCCAGGGCCAGCTCCCCCTCCAGCTTGGCACCGGGCGCCTGGATGTCCACCTCCACGCCGGGCAGGGACACCTCCAGGTCGGGGGCACtcacctcgcccttggcgcccttcacgtccactttggggcccttcaggtccacgtggggccccttgaggtccaccttgggcatcttgaggCTGGGCATCTGCACCTTGGGCAGGTGGCCCTTCAGGCCGGCCCCAGCAGCAGCAGCAGCCTGGGCGGcgggcagctctgcctcgggcagctgtccctcgggcagctTCACGCCCACCTGGCCGGCCTTGAGCTCCAGGTCGGCGGACGGCAGCTGAACGCTCAGGTCAGGGGTCTTCAGGTCGCCCTGCACTTGGGGCGGGGCCACGTCCGCCTCCACCTTGGGCGCACCCACCTCCAGAGAGGCCTCCAGGCTGGGCTTGCCAGGCGCGGACACGCCGAAGGAgggcatcttgaacttgggcatcttgaacttgCTGTCTTTGGCCGCCACGTCCTTGTCGGCCAGGTGTCCCTCGAGCAGCTTAACGCCCACCTGGCCGACATTGAGCTCCAAGTCGGCGGACGGCAGCTGAACGCTCAGGTCAGGGGTCTTCAGGTCGCCCTGCACTTGGGGCGGGACCACGTCTGCCTCCACATTGGGCGCACCCACCTCCAGAGAGGCCTCCAGGCTGGGCTTGCCAGGCGCGGACACGCCAAAGGAgggcatcttgaacttgggcatcttgaacttgCTGTCTTTGGCCGCCACGTCCTTGTCGGCCAGGGCCAGCTCCCCCTCCAGCTTGGCACCGGGCGCCTGGATGTCCACCTCCACGCCGGGCAGGGACACCTCCAGGTCGGGGGCGCtcacctcgcccttggcgcccttcacgtccactttggggcccttcaggtccacgtggggtcccttgaggtccaccttgggcatcttgaggCTGGGCATCTGCACCTTGGGCAGGTGGCCCTTCAGGCCGGCCCCAGCAGCAGCAGCCTGGGCGGCGggcagctctgcctccggcagctgtccctcgggcagctTCACGCCCACCTGGCGGGCCTTGAGCTCCAGGTCGGCGGACGGCAGCTGAACGCTCAGGTCAGGGGTCTTCAGGTCGCCCTGCACTTGGGGCGGGGCCACGTCCGCCTCCACCTTGGGCGCACCCACCTCCAGAGAGGCCTCCAGGCTGGGCTTGCCAGGCGCGGACACGCCGAAGGAGGGCATCTTGAACTCGGGCATCTTGAACTTGCTGTCTTTGGCCGCCACGTCCTTGTCGGCCAGGGCCAGCTCCCCCTCCAGCTTGGCACCGGGCGCCTGGATGTCCACCTCCACGCCGGGCAGGGACACCTCCAGGTCGGGGGCGCtcacctcgcccttggcgcccttcacgtccactttggggcccttcaggtccacgtggggccccttgaggtccaccttgggcatcttgaggCTGGGCATCTGCACCTTGGGCAGGTGGCCCTTCAGGCCGGCCCCAGCAGCAGCAGCAGCCTGGGCGGcgggcagctctgcctcgggcagctgtccctcgggcagctTCACGCCCACCTGGCCGGCCTTGAGCTCCAGGTCGGCGGACGGCAGCTGAACGCTCAGGTCAGGGGTCTTCAGGTCGCCCTGCACTTGGGGCGGGGCCACGTCCGCCTCCACCTTGGGCGCACCCACCTCCAGAGAGGCCTCCAGGCTGGGCTTGCCAGGCGCGGACACGCCGAAGGAgggcatcttgaacttgggcatcttgaacttgCTGTCTTTGGCCGCCACGTCCTTGTCGGCCAGGGCCAGCTCCCCCTCCAGCTTGGCCCCGGGCGCCTGGATGTCCACCTCCACGCCGGGCAGGGACACCTCCAGGTCGGGGGCGCtcacctcgcccttggcgcccttcacgtccactttggggcccttcaggtccacgtggggccccttgaggtccaccttgggcatcttgaggCTGGGCATCTGCACCTTGGGCAGGTGGCCCTTCAGGCCGGCCCCAGCAGCAGCAGCAGCCTGGGCGGcgggcagctctgcctcgggcagctgtccctcgggcagctTCACGCCCACCTGGCCGGCCTTGAGCTCCAGGTCGGCGGACGGCAGCTGAACGCTCAGGTCAGGGGTCTTCAGGTCGCCCTGCACTTGGGGCGGGACCACGTCTGCCTCCACCTTGGGCGCACCCACCTCCAGAGAGGCCTCCAGGCTGGGCTTGCCAGGCGCGGACACGCCAAAGGAgggcatcttgaacttgggcatcttgaacttgCTGTCTTTGGCCGCCACGTCCTTGTCGGCCAGGGCCAGCTCCCCCTCCAGCTTGGCACCGGGCGCCTGGATGTCCACCTCCACGCCGGGCAGGGACACCTCCAGGTCGGGGGCGCtcacctcgcccttggcgcccttcacgtccactttggggcccttcaggtctacgtggggtcccttgaggtccaTCTTGGGCATCTTGAGGCTGGGCATCTGCACCTTGGGCAGGTGGCCCTTCAGGCCGGCCCCAGCAGCAGCAGCCTGGGCGGCGGGCAGCTCTGCCTCCGGCAGCTGTCCTTCGGGGCAGCTTCACGCCCACCTGGCCGGCCTTGAGCTCCAGGTCGGCGGACGGCAGCTGAACGCTCAGGTCAGGGGTCTTCAGGTCGCCCTGCACTTGGGGCGGGGCCACGTCCGCCTCCACCTTGGGCGCACCCACCTCCAGAGAGGCCTCCAGGCTGGGCTTGCCAGGCGCGGACACGCCGAAGGAgggcatcttgaacttgggcatcttgaacttgCTGTCTTTGGCCGCCACGTCCTTGTCGGCCAGGGCCAGCTCCCCCTCCAGCTTGGCACCGGGCGCCTGGATGTCCACCTCCACGCCGGGCAGGGACACCTCCAGGTCGGGGGCGCtcacctcgcccttggcgcccttcacgtccactttggggcccttcaggtccacgtggggccccttgaggtccaccttgggcatcttgaggCTGGGCATCTGCACCTTGGGCAGGTGGCCCTTCAGGCCGGCCCCAGCAGCAGCAGCAGCCTGGGCGGcgggcagctctgcctcgggcagctgtccctcgggcagctTCACGCCCACCTGGCCGGCCTTGAGCTCCAGGTCGGCGGACGGCAGCTGAACGCTCAGGTCAGGGGTCTTCAGGTCGCCCTGCACTTGGGGCGGGGCCACGTCCGCCTCCACCTTGGGCGCACCCACCTCCAGAGAGGCCTCCAGGCTGGGCTTGCCAGGCGCGGACACGCCGAAGGAgggcatcttgaacttgggcatcttgaacttgCTGTCTTTGGCCGCCACGTCCTTGTCGGCCAGGGCCAGCTCCCCCTCCAGCTTGGCACCGGGCGCCTGGATGTCCACCTCCACGCCGGGCAGGGACACCTCCAGGTCGGGGGCGCtcacctcgcccttggcgcccttcacgtccactttggggcccttcaggtccacgtggggccccttgaggtccaccttgggcatcttgaggCTGGGCATCTGCACCTTGGGCAGGTGGCCCTTCAGGCCGGCCCCAGCAGCAGCAGCAGCCTGGGCGGcgggcagctctgcctcgggcagctgtccctcgggcagctTCACGCCCACCTGGCCGGCCTTGAGGTCCAGGTCGGCGGACGGCAGCTGAACGCTCAGGTCAGGGGTCTTCAGGTCGCCCTGCACTTGGGGCGGGGCCACGTCCGCCTCCACCTTGGGCGCACCCACCTCCAGAGAGGCCTCCTGGCTGGGCTTGCCAGGCGCGGACACGCCGAAGGAgggcatcttgaacttgggcatcttgaacttgCTGTCTTTGGCCGCCACGTCCTTGTCGGCCAGGGCCAGCTCCCCCTCCAGCTTGGCACCGGGCGCCTGGATGTCCACCTCCACGCCGGGCAGGGACACCTCCAGGTCGGGGGCGCtcacctcgcccttggcgcccttcacgtccactttggggcccttcaggtccacgtggggccccttgaggtccaccttgggcatcttgaggCTGGGCATCTGCACCTTGGGCAGGTGGCCCTTCAGGCCGGCCCCAGCAGCAGCCTGGGCAGcgggcagctctgcctcggggagctgtccctcgggcagctTCACGCCCACCTGGCCGGCCTTGAGCTCCAGGTCGGCGGACCGCAGCTGAACGCTCAGGTCAGGGGTCTTCAGGTCGCCCTGCACTTGGGGCGGGGCCACGTCCGCCTCCACCTTGGGCGCACCCACCTCCAGAGAGGCCTCCTGGCTGGGCTTGCCAGGCGCGGACACGCCGAAGGAgggcatcttgaacttgggcatcttgaacttgCTGTCTTTGGCCGCCACGTCCTTGTCGGCCAGGGCCAGCTCCCCCTCCAGCTTGGCACCGGGCGCCTGGATGTCCACCTCCACGCCGGGCAGGGACACCTCCAGGTCGGGGGCGCtcacctcgcccttggcgcccttcacgtccactttggggcccttcaggtccacgtggggccccttgaggtccaccttgggcatcttgaggCTGGGCATCTGCACCTTGGGCAGGTGGCCCTTCAGGCCGGCCCCAGCAGCAGCAGCAGCCTTGGCGGcgggcagctctgcctcgggcagctgtccctcgggcagctTCACGCCCACCTGGCCGGCCTTGAGCTCCAGGTCGGCGGACGGCAGCTGAACGCTCAGGGGCGGGGCCACGTCCGCCTCCACCTTGGGCGCACCCACCTCCAGAGAGGCCTCCAGGCTGGGCTTGCCAGGCGCGGACACGCCGAAGGAgggcatcttgaacttgggcatcttgaacttgCTGTCTTTGGCCGCCACGTCCTTGTCGGCCAGGGCCAGCTCCCCCTCCAGCTTGGCACCGGGCGCCTGGATGTCCACCTCCACGCCGGGCAGGGACACCTCCAGGTCGGGGGCGCtcacctcgcccttggcgcccttcacgtccactttggggcccttcaggtccacgtggggccccttgaggtccaccttgggcatcttgaggCTGGGCATCTGCACCTTGGGCAGGTGGCCCTTCAGGCCGGCCCCAGCAGCAGCAGCAGCCTGGGCGGcgggcagctctgcctcgggcagctgtccctcgggcagctTCACGCCCACCTGGCCGGCCTTGAGCTCCAGGTCGGCGGACGGCAGCTGAACGCTCAGGTCAGGGGTCTTCAGGTCGCCCTGCACTTGGGGCGGGGCCACGTCCGCCTCCACCTTGGGCGCACCCACCTCCAGAGAGGCCTCCAGGCTGGGCTTGCCAGGCGCGGACACGCCGAAGGAgggcatcttgaacttgggcatcttgaacttgCTGTCTTTGGCCGCCACGTCCTTGTCGGCCAGGGCCAGCTCCCCCTCCAGCTTGGCACCGGGCGCCTGGATGTCCACCTCCACGCCGGGCAGGGACACCTCCAGGTCGGGGGCGCtcacctcgcccttggcgcccttcacgtccactttggggcccttcaggtccacgtggggccccttgaggtccaccttgggcatcttgaggCTGGGCATCTGCACCTTGGGCAGGTGGCCCTTCAGGCCGGCCCCAGCAGCAGCAGCAGCCTGGGCGGcgggcagctctgcctcgggcagctgtccctcgggcagctTCACGCCCACCTGGCCGGCCTTGAGCTCCAGGTCGGCGGACGGCAGCTGAACGCTCAGGTCAGGGGTCTTCAGGTCGCCCTGCACTTGGGGCGGGGCCACGTCCGCCTCCACCTTGGGCGCACCCACCTCCAGAGAGGCCTCCAGGCTGGGCTTGCCAGGCGCGGACACGCCGAAGGAgggcatcttgaacttgggcatcttgaacttgCTGTCTTTGGCCACCACGTCCTTGTCGGCCAGGGTCAGCTCCCCCTCCAGCTTGGCACTAGGGACCTGTATATTTACTTCCATGTTTTCTTCTGGTGTGT	8699	1088	13%	1556	18%
12	112776151	112784850	CAGAGAGGCCTCCAGGCTGGGCTTGCCAGGCGCGGACACGCCGAAGGAgggcatcttgaacttgggcatcttgaacttgCTGTCTTTGGCCGCCACGTCCTTGTCGGCCAGGGAGAGCTCCCCCTCCAGCTTGGCACCGGGCGCCTGGATGTCCACCTCCACGCCGGGCAGGGACACCTCCAGGTCGGGGGCGCtcacctcgcccttggcgcccttcacgtccactttggggcccttcaggtccacgtggggccccttgaggtccaccttgggcatcttgaggCTGGGCATCTGCACCTTGGGCAGGTGGCCCTTCAGGCCGGCCCCAGCAGCAGCAGCAGCCTGGGCGGcgggcagctctgcctcgggcagctgtccctcgggcagctTCACGCCCACCTGGCCGGCCTTGAGCTCCAGGTCGGCGGACCGCAGCTGAACGCTCAGGTCAGGGGTCTTCAGGTCGCCCTGCACTTGGGGCGGGGCCACGTCCGCCTCCACCTTGGGCGCACCCACCTCCAGAGAGGCCTCCAGGCTGGGCTTGCCAGGCGCGGACACGCCGAAGGAgggcatcttgaacttgggcatcttgaacttgCTGTCTTTGGCCGCCACGTCCTTGTCGGCCAGGGCCAGCTCCCCCTCCAGCTTGGCACCGGGCGCCTGGATGTCCACCTCCACGCCGGGCAGGGACACCTCCAGGTCGGGGGCGCtcacctcgcccttggcgcccttcacgtccactttggggcccttcaggtccacgtggggccccttgaggtccaccttgggcatcttgaggCTGGGCATCTGCACCTTGGGCAGGTGGCCCTTCAGGCCGGCCCCAGCAGCAGCAGCAGCCTGGGCGGcgggcagctctgcctcgggcagctgtccctcgggcagctTCACGCCCACCTGGCCGGCCTTGAGCTCCAGGTCGGCGGACGGCAGCTGAACGCTCAGGTCAGGGGTCTTCAGGTCGCCCTGCACTTGGGGCGGGACCACGTCTGCCTCCACCTTGGGCGCACCCACCTCCAGAGAGGCCTCCAGGCTGGGCTTGCCAGGCGCGGACACGCCAAAGGAgggcatcttgaacttgggcatcttgaacttgCTGTCTTTGGCCGCCACGTCCTTGTCGGCCAGGGCCAGCTCCCCCTCCAGCTTGGCACCGGGCGCCTGGATGTCCACCTCCACGCCGGGCAGGGACACCTCCAGGTCGGGGGCGCtcacctcgcccttggcgcccttcacgtccactttggggcccttcaggtccacgtggggcccctgaggtccaccttgggcatcttgaggCTGGGCATCTGCACCTTGGGCAGGTGGCCCTTCAGGCCGGCCCCAGCAGCAGCAGCAGCCTGGGCGGcgggcagctctgcctcgggcagctgtccctcgggcagctTCACGCCCACCTGGCCGGCCTTGAGCTCCAGGTCGGCGGACCGCAGCTGAACGCTCAGGTCAGGGGTCTTCAGGTCGCCCTGCACTTGGGGCGGGGCCACGTCCGCCTCCACCTTGGGCGCACCCACCTCCAGAGAGGCCTCCAGGCTGGGCTTGCCAGGCGCGGACACGCCGAAGGAgggcatcttgaacttgggcatcttgaacttgCTGTCTTTGGCCGCCACGTCCTTGTCGGCCAGGGAGAGCTCCCCCTCCAGCTTGGCACCGGGCGCCTGGATGTCCACCTCCACGCCGGGCAGGGACACCTCCAGGTCGGGGGCGCtcacctcgcccttggcgcccttcacgtccactttggggcccttcaggtccacgtggggccccttgaggtccaccttgggcatcttgaggCTGGGCATCTGCACCTTGGGCAGGTGGCCCTTCAGGCCGGCCCCAGCAGCAGCAGCAGCCTGGGCGGcgggcagctctgcctcgggcagctgtccctcgggcagctTCACGCCCACCTGGCCGGCCTTGAGCTCCAGGTCGGCGGACCGCAGCTGAACGCTCAGGTCAGGGGTCTTCAGGTCGCCCTGCACTTGGGGCGGGGCCACGTCCGCCTCCACCTTGGGCGCACCCACCTCCAGAGAGGCCTCCTGGCTGGGCTTGCCAGGCGCGGACACGCCGAAGGAgggcatcttgaacttgggcatcttgaacttgCTGTCTTTGGCCGCCACGTCCTTGTCGGCCAGGGCCAGCTCCCCCTCCAGCTTGGCACCGGGCGCCTGGATGTCCACCTCCACGCCGGGCAGGGACACCTCCAGGTCGGGGGCGCtcacctcgcccttggcgcccttcacgtccactttggggcccttcaggtccacgtggggccccttgaggtccaccttgggcatcttgaggCTGGGCATCTGCACCTTGGGCAGGTGGCCCTTCAGGCCGGCCCCAGCAGCAGCAGCAGCCTTGGCGGcgggcagctctgcctcgggcagctgtccctcgggcagctTCACGCCCACCTGGCCGGCCTTGAGCTCCAGGTCGGCGGACGGCAGCTGAACGCTCAGGTCAGGGGTCTTCAGGTCGCCCTGCACTTGGGGCGGGGCCACGTCCGCCTCCACCTTGGGCGCACCCACCTCCAGAGAGGCCTCCAGGCTGGGCTTGCCAGGCGCGGACACGCCGAAGGAgggcatcttgaacttgggcatcttgaacttgCTGTCTTTGGCAGCCACGTCCTTGTCGGCCAGGGCCAGCTCCCCCTCCAGCTTGGCACCGGGCGCCTGGATGTCCACCTCCACGCCGGGCAGGGACACCTCCAGGTCGGGGGCACtcacctcgcccttggcgcccttcacgtccactttggggcccttcaggtccacgtggggccccttgaggtccaccttgggcatcttgaggCTGGGCATCTGCACCTTGGGCAGGTGGCCCTTCAGGCCGGCCCCAGCAGCAGCAGCAGCCTGGGCGGcgggcagctctgcctcgggcagctgtccctcgggcagctTCACGCCCACCTGGCCGGCCTTGAGCTCCAGGTCGGCGGACGGCAGCTGAACGCTCAGGTCAGGGGTCTTCAGGTCGCCCTGCACTTGGGGCGGGGCCACGTCCGCCTCCACCTTGGGCGCACCCACCTCCAGAGAGGCCTCCAGGCTGGGCTTGCCAGGCGCGGACACGCCGAAGGAgggcatcttgaacttgggcatcttgaacttgCTGTCTTTGGCCGCCACGTCCTTGTCGGCCAGGTGTCCCTCGAGCAGCTTAACGCCCACCTGGCCGACATTGAGCTCCAAGTCGGCGGACGGCAGCTGAACGCTCAGGTCAGGGGTCTTCAGGTCGCCCTGCACTTGGGGCGGGACCACGTCTGCCTCCACATTGGGCGCACCCACCTCCAGAGAGGCCTCCAGGCTGGGCTTGCCAGGCGCGGACACGCCAAAGGAgggcatcttgaacttgggcatcttgaacttgCTGTCTTTGGCCGCCACGTCCTTGTCGGCCAGGGCCAGCTCCCCCTCCAGCTTGGCACCGGGCGCCTGGATGTCCACCTCCACGCCGGGCAGGGACACCTCCAGGTCGGGGGCGCtcacctcgcccttggcgcccttcacgtccactttggggcccttcaggtccacgtggggtcccttgaggtccaccttgggcatcttgaggCTGGGCATCTGCACCTTGGGCAGGTGGCCCTTCAGGCCGGCCCCAGCAGCAGCAGCCTGGGCGGCGggcagctctgcctccggcagctgtccctcgggcagctTCACGCCCACCTGGCGGGCCTTGAGCTCCAGGTCGGCGGACGGCAGCTGAACGCTCAGGTCAGGGGTCTTCAGGTCGCCCTGCACTTGGGGCGGGGCCACGTCCGCCTCCACCTTGGGCGCACCCACCTCCAGAGAGGCCTCCAGGCTGGGCTTGCCAGGCGCGGACACGCCGAAGGAGGGCATCTTGAACTCGGGCATCTTGAACTTGCTGTCTTTGGCCGCCACGTCCTTGTCGGCCAGGGCCAGCTCCCCCTCCAGCTTGGCACCGGGCGCCTGGATGTCCACCTCCACGCCGGGCAGGGACACCTCCAGGTCGGGGGCGCtcacctcgcccttggcgcccttcacgtccactttggggcccttcaggtccacgtggggccccttgaggtccaccttgggcatcttgaggCTGGGCATCTGCACCTTGGGCAGGTGGCCCTTCAGGCCGGCCCCAGCAGCAGCAGCAGCCTGGGCGGcgggcagctctgcctcgggcagctgtccctcgggcagctTCACGCCCACCTGGCCGGCCTTGAGCTCCAGGTCGGCGGACGGCAGCTGAACGCTCAGGTCAGGGGTCTTCAGGTCGCCCTGCACTTGGGGCGGGGCCACGTCCGCCTCCACCTTGGGCGCACCCACCTCCAGAGAGGCCTCCAGGCTGGGCTTGCCAGGCGCGGACACGCCGAAGGAgggcatcttgaacttgggcatcttgaacttgCTGTCTTTGGCCGCCACGTCCTTGTCGGCCAGGGCCAGCTCCCCCTCCAGCTTGGCCCCGGGCGCCTGGATGTCCACCTCCACGCCGGGCAGGGACACCTCCAGGTCGGGGGCGCtcacctcgcccttggcgcccttcacgtccactttggggcccttcaggtccacgtggggccccttgaggtccaccttgggcatcttgaggCTGGGCATCTGCACCTTGGGCAGGTGGCCCTTCAGGCCGGCCCCAGCAGCAGCAGCAGCCTGGGCGGcgggcagctctgcctcgggcagctgtccctcgggcagctTCACGCCCACCTGGCCGGCCTTGAGCTCCAGGTCGGCGGACGGCAGCTGAACGCTCAGGTCAGGGGTCTTCAGGTCGCCCTGCACTTGGGGCGGGACCACGTCTGCCTCCACCTTGGGCGCACCCACCTCCAGAGAGGCCTCCAGGCTGGGCTTGCCAGGCGCGGACACGCCAAAGGAgggcatcttgaacttgggcatcttgaacttgCTGTCTTTGGCCGCCACGTCCTTGTCGGCCAGGGCCAGCTCCCCCTCCAGCTTGGCACCGGGCGCCTGGATGTCCACCTCCACGCCGGGCAGGGACACCTCCAGGTCGGGGGCGCtcacctcgcccttggcgcccttcacgtccactttggggcccttcaggtctacgtggggtcccttgaggtccaTCTTGGGCATCTTGAGGCTGGGCATCTGCACCTTGGGCAGGTGGCCCTTCAGGCCGGCCCCAGCAGCAGCAGCCTGGGCGGCGGGCAGCTCTGCCTCCGGCAGCTGTCCTTCGGGGCAGCTTCACGCCCACCTGGCCGGCCTTGAGCTCCAGGTCGGCGGACGGCAGCTGAACGCTCAGGTCAGGGGTCTTCAGGTCGCCCTGCACTTGGGGCGGGGCCACGTCCGCCTCCACCTTGGGCGCACCCACCTCCAGAGAGGCCTCCAGGCTGGGCTTGCCAGGCGCGGACACGCCGAAGGAgggcatcttgaacttgggcatcttgaacttgCTGTCTTTGGCCGCCACGTCCTTGTCGGCCAGGGCCAGCTCCCCCTCCAGCTTGGCACCGGGCGCCTGGATGTCCACCTCCACGCCGGGCAGGGACACCTCCAGGTCGGGGGCGCtcacctcgcccttggcgcccttcacgtccactttggggcccttcaggtccacgtggggccccttgaggtccaccttgggcatcttgaggCTGGGCATCTGCACCTTGGGCAGGTGGCCCTTCAGGCCGGCCCCAGCAGCAGCAGCAGCCTGGGCGGcgggcagctctgcctcgggcagctgtccctcgggcagctTCACGCCCACCTGGCCGGCCTTGAGCTCCAGGTCGGCGGACGGCAGCTGAACGCTCAGGTCAGGGGTCTTCAGGTCGCCCTGCACTTGGGGCGGGGCCACGTCCGCCTCCACCTTGGGCGCACCCACCTCCAGAGAGGCCTCCAGGCTGGGCTTGCCAGGCGCGGACACGCCGAAGGAgggcatcttgaacttgggcatcttgaacttgCTGTCTTTGGCCGCCACGTCCTTGTCGGCCAGGGCCAGCTCCCCCTCCAGCTTGGCACCGGGCGCCTGGATGTCCACCTCCACGCCGGGCAGGGACACCTCCAGGTCGGGGGCGCtcacctcgcccttggcgcccttcacgtccactttggggcccttcaggtccacgtggggccccttgaggtccaccttgggcatcttgaggCTGGGCATCTGCACCTTGGGCAGGTGGCCCTTCAGGCCGGCCCCAGCAGCAGCAGCAGCCTGGGCGGcgggcagctctgcctcgggcagctgtccctcgggcagctTCACGCCCACCTGGCCGGCCTTGAGGTCCAGGTCGGCGGACGGCAGCTGAACGCTCAGGTCAGGGGTCTTCAGGTCGCCCTGCACTTGGGGCGGGGCCACGTCCGCCTCCACCTTGGGCGCACCCACCTCCAGAGAGGCCTCCTGGCTGGGCTTGCCAGGCGCGGACACGCCGAAGGAgggcatcttgaacttgggcatcttgaacttgCTGTCTTTGGCCGCCACGTCCTTGTCGGCCAGGGCCAGCTCCCCCTCCAGCTTGGCACCGGGCGCCTGGATGTCCACCTCCACGCCGGGCAGGGACACCTCCAGGTCGGGGGCGCtcacctcgcccttggcgcccttcacgtccactttggggcccttcaggtccacgtggggccccttgaggtccaccttgggcatcttgaggCTGGGCATCTGCACCTTGGGCAGGTGGCCCTTCAGGCCGGCCCCAGCAGCAGCCTGGGCAGcgggcagctctgcctcggggagctgtccctcgggcagctTCACGCCCACCTGGCCGGCCTTGAGCTCCAGGTCGGCGGACCGCAGCTGAACGCTCAGGTCAGGGGTCTTCAGGTCGCCCTGCACTTGGGGCGGGGCCACGTCCGCCTCCACCTTGGGCGCACCCACCTCCAGAGAGGCCTCCTGGCTGGGCTTGCCAGGCGCGGACACGCCGAAGGAgggcatcttgaacttgggcatcttgaacttgCTGTCTTTGGCCGCCACGTCCTTGTCGGCCAGGGCCAGCTCCCCCTCCAGCTTGGCACCGGGCGCCTGGATGTCCACCTCCACGCCGGGCAGGGACACCTCCAGGTCGGGGGCGCtcacctcgcccttggcgcccttcacgtccactttggggcccttcaggtccacgtggggccccttgaggtccaccttgggcatcttgaggCTGGGCATCTGCACCTTGGGCAGGTGGCCCTTCAGGCCGGCCCCAGCAGCAGCAGCAGCCTTGGCGGcgggcagctctgcctcgggcagctgtccctcgggcagctTCACGCCCACCTGGCCGGCCTTGAGCTCCAGGTCGGCGGACGGCAGCTGAACGCTCAGGGGCGGGGCCACGTCCGCCTCCACCTTGGGCGCACCCACCTCCAGAGAGGCCTCCAGGCTGGGCTTGCCAGGCGCGGACACGCCGAAGGAgggcatcttgaacttgggcatcttgaacttgCTGTCTTTGGCCGCCACGTCCTTGTCGGCCAGGGCCAGCTCCCCCTCCAGCTTGGCACCGGGCGCCTGGATGTCCACCTCCACGCCGGGCAGGGACACCTCCAGGTCGGGGGCGCtcacctcgcccttggcgcccttcacgtccactttggggcccttcaggtccacgtggggccccttgaggtccaccttgggcatcttgaggCTGGGCATCTGCACCTTGGGCAGGTGGCCCTTCAGGCCGGCCCCAGCAGCAGCAGCAGCCTGGGCGGcgggcagctctgcctcgggcagctgtccctcgggcagctTCACGCCCACCTGGCCGGCCTTGAGCTCCAGGTCGGCGGACGGCAGCTGAACGCTCAGGTCAGGGGTCTTCAGGTCGCCCTGCACTTGGGGCGGGGCCACGTCCGCCTCCACCTTGGGCGCACCCACCTCCAGAGAGGCCTCCAGGCTGGGCTTGCCAGGCGCGGACACGCCGAAGGAgggcatcttgaacttgggcatcttgaacttgCTGTCTTTGGCCGCCACGTCCTTGTCGGCCAGGGCCAGCTCCCCCTCCAGCTTGGCACCGGGCGCCTGGATGTCCACCTCCACGCCGGGCAGGGACACCTCCAGGTCGGGGGCGCtcacctcgcccttggcgcccttcacgtccactttggggcccttcaggtccacgtggggccccttgaggtccaccttgggcatcttgaggCTGGGCATCTGCACCTTGGGCAGGTGGCCCTTCAGGCCGGCCCCAGCAGCAGCAGCAGCCTGGGCGGcgggcagctctgcctcgggcagctgtccctcgggcagctTCACGCCCACCTGGCCGGCCTTGAGCTCCAGGTCGGCGGACGGCAGCTGAACGCTCAGGTCAGGGGTCTTCAGGTCGCCCTGCACTTGGGGCGGGGCCACGTCCGCCTCCACCTTGGGCGCACCCACCTCCAGAGAGGCCTCCAGGCTGGGCTTGCCAGGCGCGGACACGCCGAAGGAgggcatcttgaacttgggcatcttgaacttgCTGTCTTTGGCCACCACGTCCTTGTCGGCCAGGGTCAGCTCCCCCTCCAGCTTGGCACTAGGGACCTGTATATTTACTTCCATGTTTTCTTCTGGTGTGT	8699	1088	13%	1556	18%
12	112776151	112784850	CAGAGAGGCCTCCAGGCTGGGCTTGCCAGGCGCGGACACGCCGAAGGAgggcatcttgaacttgggcatcttgaacttgCTGTCTTTGGCCGCCACGTCCTTGTCGGCCAGGGAGAGCTCCCCCTCCAGCTTGGCACCGGGCGCCTGGATGTCCACCTCCACGCCGGGCAGGGACACCTCCAGGTCGGGGGCGCtcacctcgcccttggcgcccttcacgtccactttggggcccttcaggtccacgtggggccccttgaggtccaccttgggcatcttgaggCTGGGCATCTGCACCTTGGGCAGGTGGCCCTTCAGGCCGGCCCCAGCAGCAGCAGCAGCCTGGGCGGcgggcagctctgcctcgggcagctgtccctcgggcagctTCACGCCCACCTGGCCGGCCTTGAGCTCCAGGTCGGCGGACCGCAGCTGAACGCTCAGGTCAGGGGTCTTCAGGTCGCCCTGCACTTGGGGCGGGGCCACGTCCGCCTCCACCTTGGGCGCACCCACCTCCAGAGAGGCCTCCAGGCTGGGCTTGCCAGGCGCGGACACGCCGAAGGAgggcatcttgaacttgggcatcttgaacttgCTGTCTTTGGCCGCCACGTCCTTGTCGGCCAGGGCCAGCTCCCCCTCCAGCTTGGCACCGGGCGCCTGGATGTCCACCTCCACGCCGGGCAGGGACACCTCCAGGTCGGGGGCGCtcacctcgcccttggcgcccttcacgtccactttggggcccttcaggtccacgtggggccccttgaggtccaccttgggcatcttgaggCTGGGCATCTGCACCTTGGGCAGGTGGCCCTTCAGGCCGGCCCCAGCAGCAGCAGCAGCCTGGGCGGcgggcagctctgcctcgggcagctgtccctcgggcagctTCACGCCCACCTGGCCGGCCTTGAGCTCCAGGTCGGCGGACGGCAGCTGAACGCTCAGGTCAGGGGTCTTCAGGTCGCCCTGCACTTGGGGCGGGACCACGTCTGCCTCCACCTTGGGCGCACCCACCTCCAGAGAGGCCTCCAGGCTGGGCTTGCCAGGCGCGGACACGCCAAAGGAgggcatcttgaacttgggcatcttgaacttgCTGTCTTTGGCCGCCACGTCCTTGTCGGCCAGGGCCAGCTCCCCCTCCAGCTTGGCACCGGGCGCCTGGATGTCCACCTCCACGCCGGGCAGGGACACCTCCAGGTCGGGGGCGCtcacctcgcccttggcgcccttcacgtccactttggggcccttcaggtccacgtggggcccctgaggtccaccttgggcatcttgaggCTGGGCATCTGCACCTTGGGCAGGTGGCCCTTCAGGCCGGCCCCAGCAGCAGCAGCAGCCTGGGCGGcgggcagctctgcctcgggcagctgtccctcgggcagctTCACGCCCACCTGGCCGGCCTTGAGCTCCAGGTCGGCGGACCGCAGCTGAACGCTCAGGTCAGGGGTCTTCAGGTCGCCCTGCACTTGGGGCGGGGCCACGTCCGCCTCCACCTTGGGCGCACCCACCTCCAGAGAGGCCTCCAGGCTGGGCTTGCCAGGCGCGGACACGCCGAAGGAgggcatcttgaacttgggcatcttgaacttgCTGTCTTTGGCCGCCACGTCCTTGTCGGCCAGGGAGAGCTCCCCCTCCAGCTTGGCACCGGGCGCCTGGATGTCCACCTCCACGCCGGGCAGGGACACCTCCAGGTCGGGGGCGCtcacctcgcccttggcgcccttcacgtccactttggggcccttcaggtccacgtggggccccttgaggtccaccttgggcatcttgaggCTGGGCATCTGCACCTTGGGCAGGTGGCCCTTCAGGCCGGCCCCAGCAGCAGCAGCAGCCTGGGCGGcgggcagctctgcctcgggcagctgtccctcgggcagctTCACGCCCACCTGGCCGGCCTTGAGCTCCAGGTCGGCGGACCGCAGCTGAACGCTCAGGTCAGGGGTCTTCAGGTCGCCCTGCACTTGGGGCGGGGCCACGTCCGCCTCCACCTTGGGCGCACCCACCTCCAGAGAGGCCTCCTGGCTGGGCTTGCCAGGCGCGGACACGCCGAAGGAgggcatcttgaacttgggcatcttgaacttgCTGTCTTTGGCCGCCACGTCCTTGTCGGCCAGGGCCAGCTCCCCCTCCAGCTTGGCACCGGGCGCCTGGATGTCCACCTCCACGCCGGGCAGGGACACCTCCAGGTCGGGGGCGCtcacctcgcccttggcgcccttcacgtccactttggggcccttcaggtccacgtggggccccttgaggtccaccttgggcatcttgaggCTGGGCATCTGCACCTTGGGCAGGTGGCCCTTCAGGCCGGCCCCAGCAGCAGCAGCAGCCTTGGCGGcgggcagctctgcctcgggcagctgtccctcgggcagctTCACGCCCACCTGGCCGGCCTTGAGCTCCAGGTCGGCGGACGGCAGCTGAACGCTCAGGTCAGGGGTCTTCAGGTCGCCCTGCACTTGGGGCGGGGCCACGTCCGCCTCCACCTTGGGCGCACCCACCTCCAGAGAGGCCTCCAGGCTGGGCTTGCCAGGCGCGGACACGCCGAAGGAgggcatcttgaacttgggcatcttgaacttgCTGTCTTTGGCAGCCACGTCCTTGTCGGCCAGGGCCAGCTCCCCCTCCAGCTTGGCACCGGGCGCCTGGATGTCCACCTCCACGCCGGGCAGGGACACCTCCAGGTCGGGGGCACtcacctcgcccttggcgcccttcacgtccactttggggcccttcaggtccacgtggggccccttgaggtccaccttgggcatcttgaggCTGGGCATCTGCACCTTGGGCAGGTGGCCCTTCAGGCCGGCCCCAGCAGCAGCAGCAGCCTGGGCGGcgggcagctctgcctcgggcagctgtccctcgggcagctTCACGCCCACCTGGCCGGCCTTGAGCTCCAGGTCGGCGGACGGCAGCTGAACGCTCAGGTCAGGGGTCTTCAGGTCGCCCTGCACTTGGGGCGGGGCCACGTCCGCCTCCACCTTGGGCGCACCCACCTCCAGAGAGGCCTCCAGGCTGGGCTTGCCAGGCGCGGACACGCCGAAGGAgggcatcttgaacttgggcatcttgaacttgCTGTCTTTGGCCGCCACGTCCTTGTCGGCCAGGTGTCCCTCGAGCAGCTTAACGCCCACCTGGCCGACATTGAGCTCCAAGTCGGCGGACGGCAGCTGAACGCTCAGGTCAGGGGTCTTCAGGTCGCCCTGCACTTGGGGCGGGACCACGTCTGCCTCCACATTGGGCGCACCCACCTCCAGAGAGGCCTCCAGGCTGGGCTTGCCAGGCGCGGACACGCCAAAGGAgggcatcttgaacttgggcatcttgaacttgCTGTCTTTGGCCGCCACGTCCTTGTCGGCCAGGGCCAGCTCCCCCTCCAGCTTGGCACCGGGCGCCTGGATGTCCACCTCCACGCCGGGCAGGGACACCTCCAGGTCGGGGGCGCtcacctcgcccttggcgcccttcacgtccactttggggcccttcaggtccacgtggggtcccttgaggtccaccttgggcatcttgaggCTGGGCATCTGCACCTTGGGCAGGTGGCCCTTCAGGCCGGCCCCAGCAGCAGCAGCCTGGGCGGCGggcagctctgcctccggcagctgtccctcgggcagctTCACGCCCACCTGGCGGGCCTTGAGCTCCAGGTCGGCGGACGGCAGCTGAACGCTCAGGTCAGGGGTCTTCAGGTCGCCCTGCACTTGGGGCGGGGCCACGTCCGCCTCCACCTTGGGCGCACCCACCTCCAGAGAGGCCTCCAGGCTGGGCTTGCCAGGCGCGGACACGCCGAAGGAGGGCATCTTGAACTCGGGCATCTTGAACTTGCTGTCTTTGGCCGCCACGTCCTTGTCGGCCAGGGCCAGCTCCCCCTCCAGCTTGGCACCGGGCGCCTGGATGTCCACCTCCACGCCGGGCAGGGACACCTCCAGGTCGGGGGCGCtcacctcgcccttggcgcccttcacgtccactttggggcccttcaggtccacgtggggccccttgaggtccaccttgggcatcttgaggCTGGGCATCTGCACCTTGGGCAGGTGGCCCTTCAGGCCGGCCCCAGCAGCAGCAGCAGCCTGGGCGGcgggcagctctgcctcgggcagctgtccctcgggcagctTCACGCCCACCTGGCCGGCCTTGAGCTCCAGGTCGGCGGACGGCAGCTGAACGCTCAGGTCAGGGGTCTTCAGGTCGCCCTGCACTTGGGGCGGGGCCACGTCCGCCTCCACCTTGGGCGCACCCACCTCCAGAGAGGCCTCCAGGCTGGGCTTGCCAGGCGCGGACACGCCGAAGGAgggcatcttgaacttgggcatcttgaacttgCTGTCTTTGGCCGCCACGTCCTTGTCGGCCAGGGCCAGCTCCCCCTCCAGCTTGGCCCCGGGCGCCTGGATGTCCACCTCCACGCCGGGCAGGGACACCTCCAGGTCGGGGGCGCtcacctcgcccttggcgcccttcacgtccactttggggcccttcaggtccacgtggggccccttgaggtccaccttgggcatcttgaggCTGGGCATCTGCACCTTGGGCAGGTGGCCCTTCAGGCCGGCCCCAGCAGCAGCAGCAGCCTGGGCGGcgggcagctctgcctcgggcagctgtccctcgggcagctTCACGCCCACCTGGCCGGCCTTGAGCTCCAGGTCGGCGGACGGCAGCTGAACGCTCAGGTCAGGGGTCTTCAGGTCGCCCTGCACTTGGGGCGGGACCACGTCTGCCTCCACCTTGGGCGCACCCACCTCCAGAGAGGCCTCCAGGCTGGGCTTGCCAGGCGCGGACACGCCAAAGGAgggcatcttgaacttgggcatcttgaacttgCTGTCTTTGGCCGCCACGTCCTTGTCGGCCAGGGCCAGCTCCCCCTCCAGCTTGGCACCGGGCGCCTGGATGTCCACCTCCACGCCGGGCAGGGACACCTCCAGGTCGGGGGCGCtcacctcgcccttggcgcccttcacgtccactttggggcccttcaggtctacgtggggtcccttgaggtccaTCTTGGGCATCTTGAGGCTGGGCATCTGCACCTTGGGCAGGTGGCCCTTCAGGCCGGCCCCAGCAGCAGCAGCCTGGGCGGCGGGCAGCTCTGCCTCCGGCAGCTGTCCTTCGGGGCAGCTTCACGCCCACCTGGCCGGCCTTGAGCTCCAGGTCGGCGGACGGCAGCTGAACGCTCAGGTCAGGGGTCTTCAGGTCGCCCTGCACTTGGGGCGGGGCCACGTCCGCCTCCACCTTGGGCGCACCCACCTCCAGAGAGGCCTCCAGGCTGGGCTTGCCAGGCGCGGACACGCCGAAGGAgggcatcttgaacttgggcatcttgaacttgCTGTCTTTGGCCGCCACGTCCTTGTCGGCCAGGGCCAGCTCCCCCTCCAGCTTGGCACCGGGCGCCTGGATGTCCACCTCCACGCCGGGCAGGGACACCTCCAGGTCGGGGGCGCtcacctcgcccttggcgcccttcacgtccactttggggcccttcaggtccacgtggggccccttgaggtccaccttgggcatcttgaggCTGGGCATCTGCACCTTGGGCAGGTGGCCCTTCAGGCCGGCCCCAGCAGCAGCAGCAGCCTGGGCGGcgggcagctctgcctcgggcagctgtccctcgggcagctTCACGCCCACCTGGCCGGCCTTGAGCTCCAGGTCGGCGGACGGCAGCTGAACGCTCAGGTCAGGGGTCTTCAGGTCGCCCTGCACTTGGGGCGGGGCCACGTCCGCCTCCACCTTGGGCGCACCCACCTCCAGAGAGGCCTCCAGGCTGGGCTTGCCAGGCGCGGACACGCCGAAGGAgggcatcttgaacttgggcatcttgaacttgCTGTCTTTGGCCGCCACGTCCTTGTCGGCCAGGGCCAGCTCCCCCTCCAGCTTGGCACCGGGCGCCTGGATGTCCACCTCCACGCCGGGCAGGGACACCTCCAGGTCGGGGGCGCtcacctcgcccttggcgcccttcacgtccactttggggcccttcaggtccacgtggggccccttgaggtccaccttgggcatcttgaggCTGGGCATCTGCACCTTGGGCAGGTGGCCCTTCAGGCCGGCCCCAGCAGCAGCAGCAGCCTGGGCGGcgggcagctctgcctcgggcagctgtccctcgggcagctTCACGCCCACCTGGCCGGCCTTGAGGTCCAGGTCGGCGGACGGCAGCTGAACGCTCAGGTCAGGGGTCTTCAGGTCGCCCTGCACTTGGGGCGGGGCCACGTCCGCCTCCACCTTGGGCGCACCCACCTCCAGAGAGGCCTCCTGGCTGGGCTTGCCAGGCGCGGACACGCCGAAGGAgggcatcttgaacttgggcatcttgaacttgCTGTCTTTGGCCGCCACGTCCTTGTCGGCCAGGGCCAGCTCCCCCTCCAGCTTGGCACCGGGCGCCTGGATGTCCACCTCCACGCCGGGCAGGGACACCTCCAGGTCGGGGGCGCtcacctcgcccttggcgcccttcacgtccactttggggcccttcaggtccacgtggggccccttgaggtccaccttgggcatcttgaggCTGGGCATCTGCACCTTGGGCAGGTGGCCCTTCAGGCCGGCCCCAGCAGCAGCCTGGGCAGcgggcagctctgcctcggggagctgtccctcgggcagctTCACGCCCACCTGGCCGGCCTTGAGCTCCAGGTCGGCGGACCGCAGCTGAACGCTCAGGTCAGGGGTCTTCAGGTCGCCCTGCACTTGGGGCGGGGCCACGTCCGCCTCCACCTTGGGCGCACCCACCTCCAGAGAGGCCTCCTGGCTGGGCTTGCCAGGCGCGGACACGCCGAAGGAgggcatcttgaacttgggcatcttgaacttgCTGTCTTTGGCCGCCACGTCCTTGTCGGCCAGGGCCAGCTCCCCCTCCAGCTTGGCACCGGGCGCCTGGATGTCCACCTCCACGCCGGGCAGGGACACCTCCAGGTCGGGGGCGCtcacctcgcccttggcgcccttcacgtccactttggggcccttcaggtccacgtggggccccttgaggtccaccttgggcatcttgaggCTGGGCATCTGCACCTTGGGCAGGTGGCCCTTCAGGCCGGCCCCAGCAGCAGCAGCAGCCTTGGCGGcgggcagctctgcctcgggcagctgtccctcgggcagctTCACGCCCACCTGGCCGGCCTTGAGCTCCAGGTCGGCGGACGGCAGCTGAACGCTCAGGGGCGGGGCCACGTCCGCCTCCACCTTGGGCGCACCCACCTCCAGAGAGGCCTCCAGGCTGGGCTTGCCAGGCGCGGACACGCCGAAGGAgggcatcttgaacttgggcatcttgaacttgCTGTCTTTGGCCGCCACGTCCTTGTCGGCCAGGGCCAGCTCCCCCTCCAGCTTGGCACCGGGCGCCTGGATGTCCACCTCCACGCCGGGCAGGGACACCTCCAGGTCGGGGGCGCtcacctcgcccttggcgcccttcacgtccactttggggcccttcaggtccacgtggggccccttgaggtccaccttgggcatcttgaggCTGGGCATCTGCACCTTGGGCAGGTGGCCCTTCAGGCCGGCCCCAGCAGCAGCAGCAGCCTGGGCGGcgggcagctctgcctcgggcagctgtccctcgggcagctTCACGCCCACCTGGCCGGCCTTGAGCTCCAGGTCGGCGGACGGCAGCTGAACGCTCAGGTCAGGGGTCTTCAGGTCGCCCTGCACTTGGGGCGGGGCCACGTCCGCCTCCACCTTGGGCGCACCCACCTCCAGAGAGGCCTCCAGGCTGGGCTTGCCAGGCGCGGACACGCCGAAGGAgggcatcttgaacttgggcatcttgaacttgCTGTCTTTGGCCGCCACGTCCTTGTCGGCCAGGGCCAGCTCCCCCTCCAGCTTGGCACCGGGCGCCTGGATGTCCACCTCCACGCCGGGCAGGGACACCTCCAGGTCGGGGGCGCtcacctcgcccttggcgcccttcacgtccactttggggcccttcaggtccacgtggggccccttgaggtccaccttgggcatcttgaggCTGGGCATCTGCACCTTGGGCAGGTGGCCCTTCAGGCCGGCCCCAGCAGCAGCAGCAGCCTGGGCGGcgggcagctctgcctcgggcagctgtccctcgggcagctTCACGCCCACCTGGCCGGCCTTGAGCTCCAGGTCGGCGGACGGCAGCTGAACGCTCAGGTCAGGGGTCTTCAGGTCGCCCTGCACTTGGGGCGGGGCCACGTCCGCCTCCACCTTGGGCGCACCCACCTCCAGAGAGGCCTCCAGGCTGGGCTTGCCAGGCGCGGACACGCCGAAGGAgggcatcttgaacttgggcatcttgaacttgCTGTCTTTGGCCACCACGTCCTTGTCGGCCAGGGTCAGCTCCCCCTCCAGCTTGGCACTAGGGACCTGTATATTTACTTCCATGTTTTCTTCTGGTGTGT	8699	1088	13%	1556	18%
12	113949451	113949900	tcttgtacatatcacccatgtgtgtacacatcctctcgtacatatcatccatgtttataggtatcatttcgtacatatcatccatgtgtgtacacatcatctcatacatatcatccatgtgtgtacacatcatcttgtacatattatccatgtgtgtacacatcatctcttacatatcatccatgtgtgtacatatcatctcatacatatcatccatgagtgtacgtaccatcttgtacatatcatccatgtgtgtaggtatcattttgtacatatcatccatgtgtgtacatatcatctcgtacatatcatccatgagtgtacataccatctcgtacatatcatccacgtgtgtatacatcatcttgtatatatcaaccatgtgtgtacacatcatctcgtacatatcatccatatgtttacacatcatcttgttcatatcatccatg	449	14	3%	140	31%
12	114014251	114014850	TGAACATCAATCAGCCTGTAGCTCAGCATTTGtctcatagatatcatccatgtgtgtacacatcatctcgtatatatcatccatgtgtgtacacatcatctcatatatatcatccatgtgtgtaggtatcatttcgtacatatcatccatgtgtgtacacatcatctcatacatatcatccatgtgtgtacatatcatctcatacatatcatccatgagtgtacgtaccatctcgtacatatcatccacatgtgtatacatcatcctgtacatatcatccaagtgtgtacacatcctcttgtacatatcatccatgtgtgtaggtatcatttcgtacatatcatccatgtgtgtacacatcatctcgtatatatcatccatgtgtgtacacatcatctcatacatatcatccatgtgtgtacatatcatctcatacatatcatccatgtgtgtacatatcatctcatacatatcatccatgagtgtacgtacagtcttgtacatatcatccacatgtgtatacatcatctcgtacatatcatccatgtgtgtTAGCCCAGGTCTTGCAGAAGGATGCTTTCACTCCCAACATTCTTCTT	599	16	3%	188	31%
13	3615001	3615600	tgacagctgtgttctaagtagtaaataatctgcacacgtgcaggggcagttttcccgccacatgttctgcctttcccgtgatgacaactcggccgatgggctgcagccaatcagggagtgacacgtcctaggcggaggataattctccttaaaagggacggggttttgccattctttctcttgctttcttgttcttgttctttttcttgctttcttgctctctcttgctcttgctcttgctcttgatcttcctctcttgcactcttgctctcttgcactcttgcgctcttgctctctggctcctgaagatgtaagcaataaagcttttgccgcagaagattccggtttgttgcgtctttcctggccggtcgcgaacgcgtgtaagaGTtggtgctgagacctgggacgagaagacctgggacgagaaatcccgggacgagaaaacccgggacggaatttaccatcaccggcgcaaggaagatccctcattccggaaccagaactgcgggtcatggtaatgaagtgttcccgtaaaacagactgttgagaatgatccagcctggattcagaactcctcagctggggaacggtggtaatga	599	58	10%	54	9%
13	3901501	3902250	tatggacccactctgttagtatctccctgcacgaatgatatccgtgctatggacccactctgttagtatctccctgcacgaatgatatccgtgctatggacccactctgttagtatctccctgcacgaatgatatccgtgctatggacccactctgttagtatctccctgcacgaatgatatccatgctatggacccactctgttagtatctccctgcacgaatgatatccgtgctatggacccactctgttagtatctccctgcacgaatgatatccgtgctatggacccactctgttagtatctccctgcacgaatgatatccgtgctatggacccactctgttagtatctccctgcacgaatgatatccgtgctatggacccactctgttagtatctccctgcacgaatgatatccgtgctatggacccactctgttagtatctccctgcacgaatgatatccgtgctatggacccactctgttagtatctccctgcacgaatgatatccgtgctatggacccactctgttagtatctccctgcacgaatgatatccatgctatggacccactctgttagtatctccctgcacgaatgatatccgtgctatggacccactctgttagtatctccctgcacgaatgatatccgtgctatggacccactctgttagtatctccctgcacgaatgatatccgtgctatggacccactctgttagtatctccctgcacgaatgatatccg	749	60	8%	68	9%
13	4338451	4338900	gccagggTTAAGGtgttgggagccgcgcccacattcgccgttacaagatggcgctgacagctgtgttctaagtggtaaacaaataatctgcgcatgtgccaagggtatcttatgactacttgtgctctgccttccccgtgacgtcaactcggccgatgggctgcagccaatcagggagtgacacgtccgaggcgaaggagaatgctccttaagagggacggggtttcgttttctctctctcttgcttcttgctctcttgcttcttacacgcttgctcctgaagatgtaagaaataaagctttgccgcagaagattctggtctgtggtgttcttcctggccggtcgtgagaacgcgtctaataacaattggtgccgaattccgggacgagaaaaaactcgggactggcgcaaggaagatccctcattccagaaccagaactgcgggtcgc	449	56	12%	40	9%
13	4606051	4606200	aataacactgtgtacagtacctgctcccgtcatcacctgtgctggtaataacactgtgtacagtacctgctcccgtcatcacctgtgctggtaataacactgtgtacagtacctgctcccgtcatcacctgtgctggtaataacactgt	149	6	4%	26	17%
13	5196751	5196900	ttcgttatgcaattggcttatgagaatgctaatgcaatttgccgagctgcgattcaaccgcataagggaacgacagatttggcgggatatgtccgcctttgcgcagacatcgggccttcctgcgagaccttgcagagaacccacgcgca	149	24	16%	20	13%
13	8023951	8024250	tgaatccttctcaacagtctgttttacggaaacacttcattaccatgacccgcagttctggttccggaatgagggatcttccttgcgccggtgatggtaaccgtcccaggttttctcatctcaggatttctcgtcccaggtcttcttgtctcgggtcttctcgtcccaggtcttctcgtcccgggtcttctcgtcccgggtcttctcgtcccgggtttcggcaccaaCtcttacacgcgttctcgcgaccggccaggaagaacgcaacaaaccggaatcttctgcggcaaagctttatt	299	48	16%	36	12%
13	8769751	8770200	tgtgtgcgtctgtgtctgtgtggtgggtggtgggtgggtatgtgtgtgtgcatatgtgtggggtgtgtgtgtacatgtgcatgggtacatgtgtgtgtgcacgtgtgatgtgtctgtgtggtgtgtagtgggtgtgtgtctgtgtggtgcgtggtgtgtggtatgtgtgtgtctgtgtctctgtgtgtgtggtatgtgtgtacgtgtgcatgggtacatgtgtgtgtgcacatctattgtgtctgtgtggtgtgtggtgggtgtgtgtctgtgtggtgtgtggtatgtgtgtgtgtctgtgtctctgtgtgtgtggtgtgtgtgtacgtgtgcatgggtacatgtgcgtgtgcacatgtgatgtgtctgtgtggtgcgtggtgtgtggtatgtgtgtgtctgtgtctgtgtctctgtgtgtgtggtgggtgggtatgtgtgtatgcaca	449	14	3%	30	7%
13	9434551	9434700	ctgctggaatttttgagacgtataagctggtccattatcagtcttaaggagtctgggtttcccccaagcactccatgcctcaagacaatgttgaatcacatgtgaggctttttctccggttaacggagaagcaaacatgatgccagaac	149	6	4%	24	16%
13	9438301	9438750	ccatatatttgcccatactagggagagcggcttttacaaccgtttgccagtcggcaggagttagtgccatgccagcgagcctgtctaactgcaccaaggtaaaattagcattggttccgtatttacgaaccgactcggcaatttccttaatttgtaagtattctaccggagcgtggacacgcccaccctcggctccttcaaagaccggaaatgcctgttgtattttcctttgttcctctctgggaatgaatgagtctgcgcactgcctctctgcgcactgcctctctgcgcattgctgacgcactacgcagggcggggactccgcatagggcggaccttgaagccgactgccctgaggccaatcagcaaactggccttcgccagccgcttttggcttttttcttgaccaattagctggctggtaatgggctgcttcttcctcccagtct	449	48	11%	52	12%
13	10894801	10895250	caaagcgctctccattccatatatttgcccatactagggagagcggcttttacaatcgtttgccagtcggcaggagttagtgccatgccggcaagcctgtctaactgcaccaaggtaaaattagcattggttccgtatttacggaccgactcggcaagttctttaatctgcacgtattctaccggagcgtggacacgcccaccctcggctccttcaaagaccggaaatgcctgttgtattttcctttgttcctctctgggaatgaatgagtctgcgcattgcctctctgcgcattgtctctctgcgcattgtctctctgcgcattgtctctctgcgcagggctgacgcactacgcagggcgggggctccgcatagggcggaccttgaagccgactgcccggaggctgaacagcatgctggctttcgccagccgcttttggcttttttct	449	58	13%	56	12%
13	10963351	10963650	caaaagggctcctaacactagaaaaagttcaaggccaaacataccttgtaaagctattttccactttacttctgatagactgtcttgaatttcgttagaaagttcaagaccagacttaccttgtaaagctgtactcactggtactcctgttccccagctgaaaagttctgaattcatgtagttgaatccttctcaacagtctgttttacgggaacctttattaccgtgacccgcagttctggttccggaatgagggatcttccttgcgccggtgatggttaactcccgtcccgagtttt	299	18	6%	28	9%
13	11129551	11129700	ttttgccattctttctcttgctttcttgttcttgttctttttctctctcttgctctctggctcctgaagatgtaagcaataaagcttttgccgcagaagattccggtttgttgcgtctttcctggccggtcgagaccgcgggtaagaGA	149	14	9%	6	4%
13	12826051	12826350	aagatgcattaaagctatgctgcagaagaacccgtgtgtgtccttgctggcgagactcccttatcacacagacacatctggtgccgagaacccgggaacgccacaacatcgctggcattgagaagttcccctggaaacggggcaggtccagaactgcagtggaaggtaagtccggagagacatgtctggccttgagaaagcatgccagaaactgaacggagcaagataataggagctcatgaaaaaaaaaaaaagacatgtctaaggaaaaagaaggaaaaaggacctacctggacatt	299	18	6%	42	14%
13	12859951	12861300	tcttgctctcttgctcctgaagatgtaagcaataaagctcttgctcttgctctcttgctcttgaagatgtaagcaataaagctttgccgcagaagatttcggtttgttgcgtctttcctggctggttgagaatgcgtgtaagaGttggtgctggaacccgggacgagaaaacccgggacgagaaaacccgggacaagaaaacccgggacggttaccatcaccggcgcaaggaagatccctcattccggaaccagaactgcgggtcacggtcataaaggttcccgtaaaacagactgttgagagggatccagcctggattcagaactcctcagctggggaacggtggtaatgaagtgttcccgcaacacagactgttgagaaggattcaactgcgtgaattcagaactcttcagctggggaacagggtacccgtaagtatagctttacaaggtaagtctggtcttgaactttctaatgaaattcaagacagtctatcagaagtaaagtgggaaatagctttacaaggtatgtctggccttgaactttctaacgaaatttaagacagtctatcagaagtaaagtgggaaatagctttacaaggtatgtttggccttgaactttctctagtgttaggagcctttttgttccttttcacatgttatcaagcggttaaggcagggctaaaaattctggatgaaattcagggcaatctatcagaagtaaagtgggaagagagagtaggagcaaagaggaaatatggtgcacaaaataagtatacaggcctttccacgggtcttgaacccgaggaaaagtttaggtcaggtaagaatacctggggagagattagaaggaaggaaaagaaaaaagaaaagaaaaaagatcaattagcggaggtctctaggagaaggagtctatactcatcactagatgagctcaaggagccagctcttagtagctctgaatcagatgaagaattctcctctgaagaaacagacttggaggaggaagcagctcgttatgagagaaaaaagtaccagccagataaaatgctagctaatcagttaaggaaaaagccaaaagcggctggcgaaggccagcatgctgttcagcctccaggcagtcggcttcaaggtcatagtgcacctccgccctatgcggaggccccgccctgcataagccgtcagctctgcgcagagaggcaatggacagagaggcaatgcgcagactcgttcattcctagagaggaacaaaggaaaatgcaacaggcatttccggtctttgaaggagccgagggtgggcatgtccatgctccggtagaatttgtgcagattaaagagcttgccgagtcg	1349	84	6%	156	12%
13	12859951	12861300	tcttgctctcttgctcctgaagatgtaagcaataaagctcttgctcttgctctcttgctcttgaagatgtaagcaataaagctttgccgcagaagatttcggtttgttgcgtctttcctggctggttgagaatgcgtgtaagaGttggtgctggaacccgggacgagaaaacccgggacgagaaaacccgggacaagaaaacccgggacggttaccatcaccggcgcaaggaagatccctcattccggaaccagaactgcgggtcacggtcataaaggttcccgtaaaacagactgttgagagggatccagcctggattcagaactcctcagctggggaacggtggtaatgaagtgttcccgcaacacagactgttgagaaggattcaactgcgtgaattcagaactcttcagctggggaacagggtacccgtaagtatagctttacaaggtaagtctggtcttgaactttctaatgaaattcaagacagtctatcagaagtaaagtgggaaatagctttacaaggtatgtctggccttgaactttctaacgaaatttaagacagtctatcagaagtaaagtgggaaatagctttacaaggtatgtttggccttgaactttctctagtgttaggagcctttttgttccttttcacatgttatcaagcggttaaggcagggctaaaaattctggatgaaattcagggcaatctatcagaagtaaagtgggaagagagagtaggagcaaagaggaaatatggtgcacaaaataagtatacaggcctttccacgggtcttgaacccgaggaaaagtttaggtcaggtaagaatacctggggagagattagaaggaaggaaaagaaaaaagaaaagaaaaaagatcaattagcggaggtctctaggagaaggagtctatactcatcactagatgagctcaaggagccagctcttagtagctctgaatcagatgaagaattctcctctgaagaaacagacttggaggaggaagcagctcgttatgagagaaaaaagtaccagccagataaaatgctagctaatcagttaaggaaaaagccaaaagcggctggcgaaggccagcatgctgttcagcctccaggcagtcggcttcaaggtcatagtgcacctccgccctatgcggaggccccgccctgcataagccgtcagctctgcgcagagaggcaatggacagagaggcaatgcgcagactcgttcattcctagagaggaacaaaggaaaatgcaacaggcatttccggtctttgaaggagccgagggtgggcatgtccatgctccggtagaatttgtgcagattaaagagcttgccgagtcg	1349	84	6%	156	12%
13	12889651	12889800	ggagagccttgctgcaagcaatcacgtgcgtgcagtgcgcaattgccattattagatggcgctgggttccactgcgcctaactagtaaacaagccttatgcacaagtgcaagagtgaactcacgagtagtcactgcccatctcgcggcg	149	18	12%	28	19%
13	12925651	12926100	tctatcccctccccctacttctataagggtgctacccccacctgtggagagctgcgataacatttgccatcactagatggcgccagcttctgcagtgcctcatgccacctaaacaaagaacaagctgtttgtgcatatgcaagagtaatgcacgccaagtcatagcccaccccggggcgtgtctatgagatcacgggtaagcgaccagtcaggcgtagacacgccacgccagggtgtatataagcagcacctttctgaggctctttgtctaccttatcaatatgcaataaagtttggctgcagaagaatcctgtgttctgtgcgtgttcttgctggcaaggacaatagcgcgggacaTTTAGCGCCgaaacccgggaacacctcaccatcgcccggtgctgagggggcactccgctccatggagagcattcagaactgtaggacaaagg	449	36	8%	76	17%
13	13139701	13139850	tcctgtagcagcgtcgttcttcctggcctgcgtgaacgcgtgtaacaGTtggtgccgaaacccgggacgagaagacctgggacgagaaatcctgggatgagaagacccgggaACGAACcagcaaaagcctacgctaccatggcgaaagt	149	26	17%	10	7%
13	13141051	13141500	acgaccaccagtccttctaacagcagtttattcagttctcatctttcttctttctcttcatcagtaccgttccccagctgaagagttctgaatccacgccggatccttctcaacagtctgttttacgggaacctttattaaccactccttccccgtgatgcagttctgaatcctccctgtagcagggggtcttcgctcatgcctgaagatgtttcttttcccgggtttcagcaccaaCTGttaaacgcgctctcacgcaaccggccaggaagaaagcagcaaaccagaatcttctgcggcaaaaactttattgcttacatcttcaggagcaagagagagagaaaaaaaatggcaaaaccccgtcccttttaaggagaattatcctccgcctaggacttgttactccctgattggctgcagcccatcggcccagttgtcatcacgggaaa	449	34	8%	70	16%
13	13339951	13340400	gttactttgtgcctacttcctggcaactttatgctcacctctactttatccgaggtccttcccaaactcctggggtcgcaagtttcactcaccgtgaacttaccctgccggcaaccactgactgctgaaagttctgaactcggtgggggagtcggttccccgtacgggccaccaattgtcgcgtctgctctcgaccagcaagaacaatgcgaccaccagtccttctaacagcagtttattcagtcttcatctttcttctttctcttcatcaataccgttctccagctgaagagttctgaatccacgccggatccttctcaacagtctgttttacaggaacttttattaaccactccttccccgtgatgcagttctgaatcctccctgtagcaggggttcttcacttgtgcctgaagatgtttcttgtcccgggtttCGGCACCAACTGT	449	36	8%	64	14%
13	15251851	15252150	gtgagagcacgggggtctgccaggcctgagaggtttgtggcacaggcgccggcgggagccttcttggctccgggactccgcggagggcaggctgcacgggtgaccgtgtggaatacagagtgccagccgtttctgggacgggcgagagtcgcagagcttctgggcggcgccatcttcagctccagacagccggccaccttcctggtgagagcacgggggtctgcccggcctgagaggtttgtggcacaggcgccggcgggagccttcttggctccgggactccgcggagggcaggctgc	299	48	16%	36	12%
13	19995301	19995750	GATTTCGGTGTTTGAATCTATCATTGTCGGAATGGCTTCGGCTACGCCGTGGTCTTCCAGTCGGTCTATTTCTAGGACTGTAAGATCTCCTATAGTTATAATCAAAGGAGCGACTCCTATATCTTCTCCTTTCATAACTCCGGCTTCGAGAGCGTCTATATCGGTCATAATCGTCATATCGTGAAGAGCTGTATACATTCCTCCCTTCCTTGGCTTTCATTTGATTTGGTGTCTTCCGATCCCCCTGTGCGAACTGGATTTCAATCTGACGCCCACAAATCCATTTTCTGTCCAAATTATGTAAAGCGTCTTCAGCATCACGAACATCCTCAAATTGAACATATACAAATCCTCTTGGACGCCGAGTGTAGAAATTAAGTGGGACATAAACAACTACTATTGGACCATAACGACCAAATTCCCGACGTATATCTTCAGACCTGGTGTCG	449	48	11%	50	11%
13	20657701	20658300	gcaactcaaagaatcagatggcctctctaaggccggccgattgagaccctctgcacgaggtgggactggaacccacgatcccgtgaccaaacgcgaggcgggactcgaacccatggtctcgcaacaaggcgcgaggtgggactcaaacccacgatctcgcaacaaaacgcgaggtgggactcgaacccacgatctcgcaactgggcacgaggtgggactcaaacccacgatctcgcaaccccaaatggtctcttggccttcaaaggggtccaccaggcgtccctgatcctcccctgttcctcctgggacgtctcccagggtgaacggacggtggacacctggacacgtctatccttatccaccccgcgctccctctcggagcgcggtctcactgagcgtccgcaaaactgaaactgcgatcgcaccaaacttagaaacagaacacagacatcagaccaaaacagaacaaagaatcttacctctaagtgggtctaggacctctgggtggtcgcgctgattcccggccaatgcaccaaatgaaagacccccgaagggagaccctcactcaggcactcaagtcccgggacagccgcggaccc	599	86	14%	94	16%
13	21766951	21767550	gtcagagaaaggggagtgaacacagattgtcccatttttagaaaaacagtagtcacaacaagagcggacacgagactaagacaaaaaagaaaccagaagaatcagatggcctctccaaggccggccgattgagaccctctgcacgaggtgggactcgaacccacgatcccgtgaccagacgcgaggtgggactcgaacccacggtctcgcaacaaggtgcgaggtgggactcaaacccacgatctcgcaacaaaacacgaggtgggactcgaacccacgatctcgcaactgggcacgaggtgggactctaacccacgatctcgcaaccccaaatggtctcttggccttcaaaggggtccaccaggcgtccctgatcctcccctgttcctcctgggacgtctcccagggtgaacggacggtggacacctggacacgtctatccttatccaccccgcactccctctcggagcgcggtctcactgagcgtccgcaaaactgaaactgcgatcgcaccagacttagaaacagaacacagacatcagaacacagacatcagaccaaaacagaacaaagaatcttacctctaagtgggtctagga	599	72	12%	108	18%
13	23644651	23646000	caggagttagtgccatgccggcgagcctgtctaactgcaccaaggtaaaattagcattggttccgtatttacggaccgactcggcgagttctttaatctgcacgtattttaccggagcgtggacacgcccaccctcggctccttcaaagaccagaaatgcctgttgtattttcctttgttcctctctgggaatgaatgagtctgcgcactgcctctctgcgcactgcctctctgcgcactgcctctctgcgcactgcctctctgcgcattgtctctctgcgcattgcctctctgcgcattgcctctctgcgcattgtctctctgcgcattgctgacgcactacgcagggcgggggctccgcatagggcggaccttgaaaccgactgcccggaggttgaacagtacgctggctttcgccagccgcttttggcttttttcttgaccaattagctggctggtaatgggctgcttcttcctcccagtctgtttcctcagaggagaattcttcatctgcttcagagctactaagagctggcttcctgagctcatctagtgacgagtatctcctagagacctccgctaatcgatcttttttcttttcttttttcttttccttccttctaatctctccccaggtattcttacctgacctaaacttttcctcgggttcaagacccgtggaaaggcctgtatacttattttgtgtaccatattttctctttgctcctactctctctccccgctttacttctgatagattgccctgaatttcatccagaattttcagccctatcttaatcacctgataacatgtgaaaaggaacaaaagggctcctaacactagaaaaaattcaaggccaaacattttccactttacttctgatagactgtcttgaatttccttagaaagttcaagaccagacttacctcgtaaagctgtactcactggtactctcgttccccagctgaaaagttctgaattcatgcagttgaatccttctcaacagtctgctttacgggaacctttattaccgcgacccgcagttctggttctggaatgagggatcttccttgcgccggtcccgagttttcttgtattttttcgtcccgggtttcagcaccaattcttaatAgcgttctcacgcccggccaggaagaacacaacagaccagaatcttctgcggcaaaactttattgcttacatcttcaggagctaggagcgcaaacccccagccccaaaagcgaaagccacccctatatcgaaaccgaaaccccttccctatttaggagagttatatttcgcctaggacgcatcactccctgattggctgcagcccatggccgagctg	1349	118	9%	146	11%
13	25007701	25008300	cgggacggggataagctcgggatacttggtgccgaaacccgggaaaaaacgccttaacaacgccggcacctagaggagaccctccgaccaaccggagcagatttcagaaccacggtggatttggaattccgagagcatgctgaatccttgtaagtaactctgatccttcttaatccctccccttaactggaaggtggcactaaaagccttttgttctcatgctggctgtgttaaccctatttctcccggtttgatcctgcactcaccagaagtggcgctgaaagaaaaagttttgaatgctgtgaagcacgatcagacggacgtatataagccgcagtgctcgtctcatatttaagcctctcgtagataagggagcagtatgggaaattcacattctgtaactacagctctacactctgttttaaaacagcgagagataaaagtttctacaagaaccttagaaacgttcattaaggaaatagaacgtatatcaccttggtacgcgtgttcagggttgttaactctttcctcttgggagaaattaagggaagacttagctaaggaacaacagaatgggaaattaaaggcagggaccatgc	599	50	8%	60	10%
13	26367001	26368500	atatatatatatatatgtgcgtgtgtgtgtctgtgtgtgagtgtgtATGAATCTATACATATTTGTTTTTGTTTATGTGCTTATGAGTGTGCATGTGTGTATAGATGAATGTGTGTtgttgggagctgcgcccacattcgccgttacaagatggcgctgacagctgtgttctaagtggtaaacaaataatctgcgcatgtgccgagggtggttctccactccatgtgctctgccttccccgtgacgtcaactcggccgatgggctgcagccaatcagggagtgacacgtcctaggcgaaggataattctccttaatagggacggggtttcgttttctctctctcttgcttcttacactcttgctcctgaagatgtaagcaataaagttttgccgcagaagattctggtctgtggtgttcttcctggccgggcgtgagaacgcgtctaataacaattggtgccgaattccgggacgagaaaaaactcgggactggcgcaaggaagatccctcattccagaaccagaactgcgggtcgcggtaataaaggttcccgtaaagcagactgttaagaaggattcaactgcatgaattcagaacttttcagctggggaacgagagtaccagtgagtatagctttacgaggtaagcctggccttgaactttctaaggaaattcaagacagtctatcagaagtaaagtggaatatgtttggccttgaattttttctggtgttaggagcccttttgttccttttcacatgttatcaagtgattaagatagggctgaaaattctagaggaaattcaggacaagctatcagaagtaaagcggggagagagagtaggagcaaagagaaaatatggtacacaaaataagtatacaggcctttccaagggtcttgaacccgaggaaaagtttaggtcaggtaagaatacctggggagagattagaaggaaggaaaagaaaaaagaaaagaaaaaagatcgattagcggaggtctctaggagatactcgtcactagatgggctcggggagccagctcttggtagctctgaatcagatgatgaattctcctctgaagaaacagactgggaggaaaaagcagctcattatgagaaaaaagggtaccagccaggtaaagtgctagctaatcagttaaggaagccaaaagcggctggcgaaggccagtttgctgattggcctcagggcagtcggcttcaaggtccgccctatgcggagtccccgccctgcgtagtgcgtcagcaatgcgcagagaggcaatgcgcagagagatgcgcagagaggcaatgcgcagagagatgcgcagagaggcagtgcgcagagaggcagtgcgcagagaggcagtgcgcagactcattcattcccagagaggaacaaaggaaaatacaacaggcatttccagtctttgaaggagccgagggtgggcgtgtccacgctccggtagaatacttacaaattaaagaacttgccgagtcggt	1499	118	8%	166	11%
13	28131151	28131450	attgttattagacgcgttctcacgaccggccaggaagaacaccacagaccagaatcttctgcggcaaagctttattcttacatcttcaggaaaagagagcaagaagcaagagagagagaaaacgaaaaccccgtccctcttaaggagcattctccttcgcctcggacgtgtcactccttgattggctgcagcccatcggccgagttgacgtcacggggaaggcagagcacaagtagtcataagatacccttggcacatgcgcagattatttgtttaccacttagaacacaggatgtcag	299	30	10%	54	18%
13	29885251	29886750	ggcttttacaaccgtttgccagtcagcaggagttagtgccatgccggcgagcctgtctaactgcaccaaggtaaaattagcattggttccatatttacggaccgactcggcgagttctttaatttgtaagtattctaccggagcgtggacacgcccaccctcggctccttcaaagaccggaaatgcctgttgtattttcctttgttcctctctgggaatgaatgagtctgcgcactgcctctctgcgcattgtctctctgcgcactgcctctctgcgcatctctctgcgcattgcctctctgcgcatctctctgcgcattgcctctctgcgcatctctctgcgcattgcctctctgcgcattgctgacgcactacgcagggcgggggctccgcatagggcggaccttgaaaccgactgccctgaggccaatcagcaaactggccttcgccagccgcttttggcttccttaactgattagctagcactttacctggctggtacccttttttctcataatgagctgcttcttcctcccagtctgtttcctcagaggagaattctttatctgcttcagagctactaagagctggcttcctgagctcatctagtgacgagtatctcctagagacctccgctaatcgatcttttttcttttcttttttcttttccttccttctaatctctccccaggtattcttacctgacctaaacttttcctcgggttcaagacccttggaaaggcctgtatacttattttgtgtaccatattttctctttgctcctactctctctccccgctttacttctgatagattgtcctgaatttcatctagaatcctccctgccttaaccacttgataacatgtgaaaaggaacaaaagggctcctaacaccagaaaaaattcaaggccaaacatattccactttacttctgatagactgtcttgaatttccttagaaagttcaaggccaggcttacctcgtaaagctgtactcactggtactctcgttccccagctgaaaagttctgaattcatacagttgaatccttcttaacagtctgctttacgggaacctttattaccgcgacccgcagttctggttctggaatgagggatcttccttgcgccagtcccgagttttttctcgtcccggaattcggcaccaattgttattagacgcgttctcacgaccggccaggaaagacgcaacaaaccagaatcttctgcggcaaagctttattgcttacatcttcaggagccagagtgcaagaagcaagagaaagagaaaacgaaacccccgtcccttttttaggagagttatatttcgcctaggacgtgtcactccctgattggctgcagcccatcggccgagttgacgtcacggggaaggcagagcacatggagtggagaaccaccctcggcatatgcgcagattatttgtttaccacttagaacacagctgtcagcgccatcttgtaacggcgaatgtgggcgcg	1499	134	9%	170	11%
13	31594501	31594650	cagactgttgagaagggtccggcgtggattcagaactcttcagctggggaacggtactgatgaagagaaagaagaaagatgaggactgaataaactgctgttagaaggactggtggtcgcgtcgttcttgctggttgagagtgggcgcg	149	16	11%	6	4%
13	32941951	32942250	attagcattggttccatatttacgaaccgactcggcaatttctttaatttgtaagtattctaccggagcgtggacacgcccaccctcggctccttcaaagaccggaaatgcctgttgtattttcctttgttcctctctgggaatgaatgagtctgcgcactgcctctctgcgcactgcctctctgcgcattgctgacgcactacgcagggcggggactccgcatagggcggaccttgaagccgactgccctgaggccaatcagcaaactggccttcgccagccgcttttggcttttttc	299	38	13%	32	11%
13	32943001	32943150	aatcttctgcggcaaagctttattcttacatcttcaggagccagggtgcaggaagcaagagagcaagaagcaagagagagcgagaagcaagagagagagaaaacgaaaccccgtccctcttaaggagcattctccttcgcctcggacgt	149	14	9%	20	13%
13	33776701	33777150	acacttcattaccaccgttccccagctgaggagttctgaatccaggctggatccttctcaacagtctgttttacgggaacacttcattaccatgacccgcagttctggttccggaatgagggatcttccttgcgccggtgatggtaaccgtcccgggttttctcatcccaggatttctcgtcccgggttttctcgtctcggtttcagcaccaaCCcttacacgcgttcacgaccggccaggaagaacgcagcaaaccggaatcttctgtggcaaaactttattgcttacatcttcaggagcaagagtgcaagagagcaagagctctattgcttacatctttaggagccagagcgcaagagcgcaagagcaaaagcaagagtgcaaaaagggagaatggcgaaaccccgtccctttttaaagagaattattctccgcctaggacgtatta	449	48	11%	68	15%
13	33862201	33863400	cacgtccgaggcgaaggagaatgctccttaagagggacggggtttcgttttctctctctcttgcttcttgctctcttgcttcttacacgcttgctcctgaagatgtaagaaataaagctttgccgcagaagattctggtctgtggtgttcttcctggccggtcgtgagaacgcgtctaataacaattggtgccgaattccgggacgagaaaaaactcgggactggcgcaaggaagatccctcattccagaaccagaactgcgggtcgcggtaataaaggttcccgtaaagcagactgttaagaaggattcaactgtatgaattcagaacttttcagctggggaacgagagtaccagtgagtacagctttacgaggtaagtccgatcttgaactttctaacgaaattcaagacagtctatcagaagtaaagtggaatatgtttggccttgaattttttctggtgttaggagcccttttgttccttttcacatgttatcaagtgattaagatagggctgaaaattctagaggaaattcaggacaagctatcagaagtaaagcggggagagagagtaggagcaaagaggaaatatggtacacaaaataagtatacaggcctttccaagggtcttgaacccgaggaaaagttaaggttaggtaggaatacctggagagagattagaagaaaaagaggaaaaagggaaaagaagaaagatcaattagcggaggtctctaggagatactcgtcactagatgagctcaggaagccagctcttagtagttctgaagcaggtgaagaatcctcctctgaggaaacagactgggaggaagaagcagcccattaccagccagctaattggtcaagaaaaaagccaaaagcggctggcgaaggccagtttgctgattggcctcagggcagtcggcttcaaggtccgccctatgcggagtccccgccctgcgtagtgcgtcagcaatgcgcagagagatgcgcagagaggcagtgcgcagagaggcagtgcgcagactcattcattcccagagaggaacaaaggaaaatacaacaggcatttccggtctttgaaggagccgagggtgggcgtgtccacgctccggtagaatacttacaaattaaagaaattgccgagtcggttcgtaaatacggaaccaatgctaattttaccttggtgcagttagacaggc	1199	98	8%	128	11%
13	33862201	33863400	cacgtccgaggcgaaggagaatgctccttaagagggacggggtttcgttttctctctctcttgcttcttgctctcttgcttcttacacgcttgctcctgaagatgtaagaaataaagctttgccgcagaagattctggtctgtggtgttcttcctggccggtcgtgagaacgcgtctaataacaattggtgccgaattccgggacgagaaaaaactcgggactggcgcaaggaagatccctcattccagaaccagaactgcgggtcgcggtaataaaggttcccgtaaagcagactgttaagaaggattcaactgtatgaattcagaacttttcagctggggaacgagagtaccagtgagtacagctttacgaggtaagtccgatcttgaactttctaacgaaattcaagacagtctatcagaagtaaagtggaatatgtttggccttgaattttttctggtgttaggagcccttttgttccttttcacatgttatcaagtgattaagatagggctgaaaattctagaggaaattcaggacaagctatcagaagtaaagcggggagagagagtaggagcaaagaggaaatatggtacacaaaataagtatacaggcctttccaagggtcttgaacccgaggaaaagttaaggttaggtaggaatacctggagagagattagaagaaaaagaggaaaaagggaaaagaagaaagatcaattagcggaggtctctaggagatactcgtcactagatgagctcaggaagccagctcttagtagttctgaagcaggtgaagaatcctcctctgaggaaacagactgggaggaagaagcagcccattaccagccagctaattggtcaagaaaaaagccaaaagcggctggcgaaggccagtttgctgattggcctcagggcagtcggcttcaaggtccgccctatgcggagtccccgccctgcgtagtgcgtcagcaatgcgcagagagatgcgcagagaggcagtgcgcagagaggcagtgcgcagactcattcattcccagagaggaacaaaggaaaatacaacaggcatttccggtctttgaaggagccgagggtgggcgtgtccacgctccggtagaatacttacaaattaaagaaattgccgagtcggttcgtaaatacggaaccaatgctaattttaccttggtgcagttagacaggc	1199	98	8%	128	11%
13	33868801	33869100	atggcgctgacagctgtgttctaagtggtaaacaaataatctgcgcatgtgccaagggtatcttatgactacttgtgctctgccttccccgtgacgtcaactcggccgatgggctgcagccaatcagggagtgacacgtccgaggcgaaggagaatgctccttaagagggacggggtttcgttttctctctctcttgcttcttgctctcttgcttcttacacgcttgctcctgaagatgtaagaaataaagctttgccgcagaagattctggtctgtggtgttcttcctggccggtcgt	299	30	10%	22	7%
13	36853051	36853200	tggagctgaagatggcgccgccccagaatctctgcgactctctcgcccgtcccagaaacggctggcactctgtattccacacggtcacccgtgcagcctgccctccgcggagtctcggagccaagaaggctcccgccggcgcctgtgcc	149	28	19%	16	11%
13	38642551	38643300	ccgtgagtaaacaactcacctgttacaccgtgagtaaacaactcacctgttacaccgtgagtaaacaactcacctataacaccgtgagtaaacaactcacctgttacaccgtgagtaaacaactcacctgttacaccgtgagtaaacaactcacctgttacaccgtgagtaaacaactcacctgttacaccgtgagtaaacaactcacctgttacaccgtgagtaaacaactcacctgttacaccgtgagtaaacaactcacctgttacaccgtgagtaaacaactcacctgttacaccgtgagtaaacaactcacctgttacaccgtgagtaaacaactcacctgttacaccgtgagtaaacaactcacctataacaccgtgagtaaacaactcacctgttacaccgtgagtaaacaactcacctgttacaccgtgagtaaacaactcacctgttacaccgtgagtaaacaactcacctataacaccgtgagtaaacaactcacctgttacaccgtgagtaaacaactcacctgttacaccgtgagtaaacaactcacctataacaccgtgagtaaacaactcacctgttacaccgtgagtaaacaactcacctgttacaccgtgagtaaacaactcacctgttacaccgtgagtaaacaactcacctgttacaccgtgagtaaacaactcacctgttacaccgtgagtaaacaactcacctgttacaccgtgagtaaacaactcacc	749	56	7%	166	22%
13	43662601	43662900	actgcacgtgctggatactgcacgtgctggacactgcatggagcacacactgcacatactgcacactgcacatgttacacacgctgtacactctatacacactgcacacactgcacatgctgcaaatactgcacatgctggacactacatgtggcacacactgcacatgctgcacattgcacatgttacacacgctgtatacactgtacatactgtacacactgtacactgtacatgctgcatatgatgcacactgcacatgctggacactgcacgtgctggacactgcatggagcaca	299	10	3%	112	37%
13	44271151	44271450	tacaagatggcgctgacagctgtgttctaagtggtaaacaaataatctgcgcatgtgccgagggtggttcttcactccatgtgctctgccttccccgtgacgtcaactcggccgatgggctgcagccaatcagggagtgacacgtcctaggcgaaggagaattctctttaatagggacggggtttcgttttctcgctctctcttgcttcttgcactctggctcctgaagatgtaagcaataaagctttgccgcagaagattctggtctgtggtgttcttcctggccggtcgtgagaacg	299	32	11%	28	9%
13	45011401	45012600	cctgcaccctggctcctgaagatgtaagaaataaagctttgccgcagaagattctggtctgtggtgttcttcctggccggtcgtgagaacgcgtctaataacaattggtgccgaattccgggacgagaaaaaactcgggactggcgcaaggaagatccctcattccagaaccagaactgcgggtcgcggtaataaaggttcccgtaaagcagactgttaagaaggattcaactgtatgaattcagaacttttcagctggggaacgagagtaccagtgagtacagctttacgaggtaagtccgatcttgaactttctaacgaaattcaagacagtctatcagaagtaaagtggaatatgtttggccttgaattttttctggtgttaggagcccttttgttccttttcacatgttatcaagtggttaagatagggaaaattctagaggaaattcaggacaagctatcagaagtaaagcggggagagagagtaggagcaaagagaaaatatggtacacaaaataagtatacaggcctttccaagggtcttgaacccgaggaaaagttaaggttaggtaggaatacctggagagagattagaagaaaaagaggaaaaagggaaaagaagaaagatcaattagcggaggtctctaggaaaaggagcctgtgctcatcgctggatgggctcggggagccagctcttagtagctctgaagcaggtgaagaatcctcctctgaggaaacagactgggaggaagaagcagcccattaccagccagctaattggtcaagaaaaaagccaaaagcggctggcgaaggccagtttgctgattggcctcagggcagtcggcttcaaggtccgccctatgcggagtccccgccctgcgtagtgcgtcagcaatgcgcagagaggcagtgcgcagagaggcagtgcgcagactcattcattcccagagaggaacaaaggaaaatacaacaggcatttccggtctttgaaggagccgagggtgggcgtgtccacgctccggtagaatacttacaaattaaggaaattgccgagtcggttcgtaaatacggaaccaatgctaattttaccttggtgcagttagacaggctcgctggcatggcactaactcctgccgactggcaaacggttgtaaaagccgctctccctagtatgggcaaatatatggaatggagag	1199	94	8%	130	11%
13	45011401	45012600	cctgcaccctggctcctgaagatgtaagaaataaagctttgccgcagaagattctggtctgtggtgttcttcctggccggtcgtgagaacgcgtctaataacaattggtgccgaattccgggacgagaaaaaactcgggactggcgcaaggaagatccctcattccagaaccagaactgcgggtcgcggtaataaaggttcccgtaaagcagactgttaagaaggattcaactgtatgaattcagaacttttcagctggggaacgagagtaccagtgagtacagctttacgaggtaagtccgatcttgaactttctaacgaaattcaagacagtctatcagaagtaaagtggaatatgtttggccttgaattttttctggtgttaggagcccttttgttccttttcacatgttatcaagtggttaagatagggaaaattctagaggaaattcaggacaagctatcagaagtaaagcggggagagagagtaggagcaaagagaaaatatggtacacaaaataagtatacaggcctttccaagggtcttgaacccgaggaaaagttaaggttaggtaggaatacctggagagagattagaagaaaaagaggaaaaagggaaaagaagaaagatcaattagcggaggtctctaggaaaaggagcctgtgctcatcgctggatgggctcggggagccagctcttagtagctctgaagcaggtgaagaatcctcctctgaggaaacagactgggaggaagaagcagcccattaccagccagctaattggtcaagaaaaaagccaaaagcggctggcgaaggccagtttgctgattggcctcagggcagtcggcttcaaggtccgccctatgcggagtccccgccctgcgtagtgcgtcagcaatgcgcagagaggcagtgcgcagagaggcagtgcgcagactcattcattcccagagaggaacaaaggaaaatacaacaggcatttccggtctttgaaggagccgagggtgggcgtgtccacgctccggtagaatacttacaaattaaggaaattgccgagtcggttcgtaaatacggaaccaatgctaattttaccttggtgcagttagacaggctcgctggcatggcactaactcctgccgactggcaaacggttgtaaaagccgctctccctagtatgggcaaatatatggaatggagag	1199	94	8%	130	11%
13	49799851	49800300	agatataaaaacaagggagatataaacaagaagaaacaggactgaataaacgtgtgcagaaggatcctgttgcagcatcgttcttgctggcgagttgggggcgcgcTCGAGAGttggtgccgaaacccgggaaaagaaacatcttcaggcacaagcgaagaccccctgctacagggaggattcagaactgcatcacggggaaaggtggtaataaagtgttcccgtaaaacagactgttgagaaggatccggcgtggattcagaactcttcagctggggaacggtactgatgaagagaaagaagaaagatgaagactgaataaactgctgttagaaggactggtggtcgcatcgttcttgctggtcgagagcgggcgtgacaattggtggcccgtacggggaaccgactcccccaccgagttcagaactttcagcagtcagtggttgccg	449	48	11%	48	11%
13	50021251	50021850	gtgttgggcaagactctgctggcaaggtagcccggggctcgagtcttgagtcgagcggaagggacttgtgccccagatcaggcccgggtagcctgcttccctatgtaccgcagtctcgagttccgcgcgattggattggggcaggcactgtgatccactcaccagaggtcttagggtcccgtggggagtcctgtgtggacccttgcgggtgttgggcaagactctgctggcaaggtagcccggggctcgagtcacgagtcgagcggaagggacttgtgccccagatcacgcccgggtagcctgcttccctatgtacctcagtctcaagttccgcgcgattggattggggcaggcactgtgatccactcaccagaggtcttagggtcccgtggggagtcccgtgtggacccttgcgggtgttgggcaagactctgctggcaaggtagcccggggctcgagtctcctgttttatctttttttattccttttcctatttatgagatgttcctgatagcctaggctaagatcttaagaaagaataatgggtatgaaaccatccttgagatggagtcactaataaccataacctcatcaccagg	599	54	9%	60	10%
13	50504701	50505300	gctatacttacgggtaccctgttccccagctgaagagttctgaattcacgcagttgaatccttctcaacagtctgtgatgcgggaacactttattaccaccgttccccgcagttctggttccggaatgagggatcttccttgcgccggtgatggtagtttccgtcccgggttttctcttcccgggttctcggcaccaaCtcttacacgcgttctcacgaccggccaggaagaacacaacaaaccagaatcttctgcggcaaaactttattgcttacatcttcaggtgccagagtgcaagccccaagcccccagccccctgcttacatctttaggagccagagcgccagagcgccagagcgccagagcgcagagcaagagctctattgtttacatctttaggagcaagcgtgcaaacctcaaacccaaaaacgaaagtgaaaccccgtccctatttaggagagttatccttcgcctaggacgtatcactccctgattggctgcagcccatggccgagttgttgccacggggaaggcagagtacatggggtggagaaatacccttggcacatgcgcagattatttgtttaccacttagaac	599	58	10%	92	15%
13	50719351	50719500	ccacggtctcgcaacaaggcgtgaggtgggattcgaacccacgatctcgcaaccccagatggtctcttggcctccaaaggggtccaccaggcgtccctggtcctcccctgttcctcctgggacgtctcccagggcgaacggacggtgga	149	22	15%	20	13%
13	51269551	51270600	atttgccagtcggcaggagttagtgccatgctggcaagcctgtctaactgcaccaaggtaaaattagcattgattccgtatttacgaaccgactcggcaatttctttaatttgtaagtattctaccggagcgtggacacgcccaccctcggctccttcaaagactggaaatgcctgttctattttcctttgttcctctcggggaatgaatgagtctgcgcactgcctctctgcgcactgcctctctgcgcattgctgacgcactacgcagggcggggactccgcatagggcgggagtgcacctggtagccgattgccctgaggccaatcagcaaactggccttcgccagccgcttttggcttttttcttaaatgactagttagcactttacttggcggctggtatccttttctttcataatgagccgcttttttctcccagtctgtttcttcagagcacaggctccttctcctagagacctccgctaattgatcttttttcttttcttttttcttttccttctttctaatctctccccaggtattcctacctgaccttaacttttcctcgggttcaagacccttggaaaggcctgtatacttattttgtgtaccatatttcctttttgttcctactctctctccccgctttacttctgatagcttgtcctgaatttcctctagaattttcagccctatcttaatcacttgataacatgtgaaaaggaacaaaagggctcctaacaccagaaaaaattcaaggccaaacatattccactttacttctgatagactgtcttgaatttcgttagaaagttcaaggccaggcttacctcgtaaagctgtactcactggtactctcgttccccagctgaaaagttctgaattcatacagttgaatccttcttaacagtctgctttacgggaacctttattaccgcgacccgcagttctggttctggaatgagggatcttccttgcgccagtcccgagtttttttctcgtcccgggtttcggcaccaattgttattagacgcgttctcacgaccg	1049	84	8%	106	10%
13	51269551	51270600	atttgccagtcggcaggagttagtgccatgctggcaagcctgtctaactgcaccaaggtaaaattagcattgattccgtatttacgaaccgactcggcaatttctttaatttgtaagtattctaccggagcgtggacacgcccaccctcggctccttcaaagactggaaatgcctgttctattttcctttgttcctctcggggaatgaatgagtctgcgcactgcctctctgcgcactgcctctctgcgcattgctgacgcactacgcagggcggggactccgcatagggcgggagtgcacctggtagccgattgccctgaggccaatcagcaaactggccttcgccagccgcttttggcttttttcttaaatgactagttagcactttacttggcggctggtatccttttctttcataatgagccgcttttttctcccagtctgtttcttcagagcacaggctccttctcctagagacctccgctaattgatcttttttcttttcttttttcttttccttctttctaatctctccccaggtattcctacctgaccttaacttttcctcgggttcaagacccttggaaaggcctgtatacttattttgtgtaccatatttcctttttgttcctactctctctccccgctttacttctgatagcttgtcctgaatttcctctagaattttcagccctatcttaatcacttgataacatgtgaaaaggaacaaaagggctcctaacaccagaaaaaattcaaggccaaacatattccactttacttctgatagactgtcttgaatttcgttagaaagttcaaggccaggcttacctcgtaaagctgtactcactggtactctcgttccccagctgaaaagttctgaattcatacagttgaatccttcttaacagtctgctttacgggaacctttattaccgcgacccgcagttctggttctggaatgagggatcttccttgcgccagtcccgagtttttttctcgtcccgggtttcggcaccaattgttattagacgcgttctcacgaccg	1049	84	8%	106	10%
13	51637801	51638700	aacgtaaacaaacaaaattaccaagcgacagaaccagagtcagagaaaggggagtggacacagattgtcccatttctagaaaaacagtagtcacaacaagagcggacacgagactaagacaaaaaagaaaccagaagaatcagatggcctctctaaggccggccaattgagaccctctgcacgaggtgggactcgaacccacgatcttgcaacaaaacacgaggtgggactcgaacccacgatcccgtgaccagacgcgaggtgggactcgaacccacgatctcgcaacaaaacacgaggtgggactcgaacccacgatctcgcaacaaaacacgaggtgggactcgaacccacgatctcgcaactgggcacgaggtgggactctaacccacgatctcgcaaccccaaatggtctcttggccttcaaaggggtccaccaggcgtccctgatcctcccctgttcttcttgggacgtctcccagggcgaacggacggtggacacctggacacgtctatccttatccaccccgcactccctctcggagcgcggtctcactgagcatccgcaaaactgaaactgcgatcgcaccagacttagaaacagaacacagacattagaacacagacatcagaacacagacatcagaccaaagcagaacaaagaatcttacctctaagtgggtctaggacctctgggtggtcgcgctgtttcccggccaatgcaccaaatgaaagattctcgaattcccggcccatgtaccaaatgaaagaccctcgagggaagaccctcactcagacacttaagtcccgggacagccgcgtacccaagaagacactgagaccatacataaaatgtagaaggtaagatttaataaagcagcgacatgaaagcacacaga	899	102	11%	170	19%
13	51637801	51638700	aacgtaaacaaacaaaattaccaagcgacagaaccagagtcagagaaaggggagtggacacagattgtcccatttctagaaaaacagtagtcacaacaagagcggacacgagactaagacaaaaaagaaaccagaagaatcagatggcctctctaaggccggccaattgagaccctctgcacgaggtgggactcgaacccacgatcttgcaacaaaacacgaggtgggactcgaacccacgatcccgtgaccagacgcgaggtgggactcgaacccacgatctcgcaacaaaacacgaggtgggactcgaacccacgatctcgcaacaaaacacgaggtgggactcgaacccacgatctcgcaactgggcacgaggtgggactctaacccacgatctcgcaaccccaaatggtctcttggccttcaaaggggtccaccaggcgtccctgatcctcccctgttcttcttgggacgtctcccagggcgaacggacggtggacacctggacacgtctatccttatccaccccgcactccctctcggagcgcggtctcactgagcatccgcaaaactgaaactgcgatcgcaccagacttagaaacagaacacagacattagaacacagacatcagaacacagacatcagaccaaagcagaacaaagaatcttacctctaagtgggtctaggacctctgggtggtcgcgctgtttcccggccaatgcaccaaatgaaagattctcgaattcccggcccatgtaccaaatgaaagaccctcgagggaagaccctcactcagacacttaagtcccgggacagccgcgtacccaagaagacactgagaccatacataaaatgtagaaggtaagatttaataaagcagcgacatgaaagcacacaga	899	102	11%	170	19%
13	51985651	51986850	acgtccgaggcgaaggagaatgctccttaagagggacggggttttcgttttctctctctcttgcttcttgctctcttgcttcttgctctcttgcttcttgctctcttgcttcttgctctcttttcctgaagatgtaagaataaagctttgccgcagaagattctggtctgtggtgttcttcctggccggtcgtgagaacgcgtcgaataacaattggtgccgaattccgggacgagaaaatccgggacgagaaaaaactccggactggcgcaggagggatacttcattccagaaccagaactgcgaatcaaggttataaggttcccgtaacacagactgttgagaaggattcaactgccgaattcagaactcatcagctggggaacgacggtgataaaggttcccgtaaagcagactgttaagaaggattcaactgtatgaattcagaacttttcagctggggaacgagagtaccagtgagtatgtttggccttgaattttttctggtgttaggagcccttttgttctttttcacatgctatcaagtgattaagatagggctgaaaattctagaggaaattcaggacaagctatcagaagtaaagcgggaagaaagagtaggaacaaagagaaaatatggttcacaaaataagtatacaggcctttccaagggtcttgaacccgaggaaaagttaaggttaggtaggaatacctggagagagattagaagaaaaagaggaaaaagggagaagaaaaaagatcgattagcggaggtctctaggagatactcgtcactagatgagctcaggaagccagctcttagtagctctgaagcagatgaagaatcctcctctgaggaaacagactgggaggaagaagcagcccattaccagccagctaatcggtcaagaaaaaagccaaaagcggctggcgaaggccagtttgctaattggcctcagggcaatcggctaccaggtgcactcccgccctatgcggagtccccgccctgcgtagtgcgtcagcccgtagtgcgtcagcaatgcgcagagaggcagtgcgcagactcattcattccccgagaggaacaaaggaaaatagaacaggcatttccagtctttgaaggagccgagggtgggcgtgtccacgctccggtagaatacgtacagattaaggaaattgccgagtcggttcgtaaatac	1199	104	9%	118	10%
13	53872801	53873250	GTTGCAGAGGGACAGGCACTCCCAGCAAGGGATAGAATGATCTCTACACAGAGAtattgcatcccactcgaccggcaagaaagacgcaacaaaccggaatcttccgcggcaaaagctttattgcttacttcttcaggaagaccccgaaccgggaaaatggcgccgcttttatagcccgcagcgtgacgtttcagcacctgatatggcgtgacagctcctgattagttgctcacccatcaccccactattacacccggagaatgggagtgactaggagtgagttcactctcgcacctgcgtacaaggcttgtttactagttgggcacagcggaggcccgcgccatcttataatggcgattgcttgcggcacacacagctctcctcagagattactggcggcacgcacgcaattgctcgcagcacgtacTCTGAAAACTGGGATAAGGCCT	449	54	12%	78	17%
13	54771151	54771600	taagtagtaaacaaataatctgcgcatgtgccaagggtattttacgactacttgtactctgcctttcccgtgaacgtcagctcggccatgggctgcagccaatcagggagtgatgcgtcctaggcgaaagataactctcctaaatagggaaggggtttcggtttcgttattggggtggctttcgcttttggggctgggggtttgcgctcctggctcctgaagatgtaagcaataaagttttgccgcagaagattctggtttgttgtgttctttcctggccgggcgtgtgagaacgcgtataagaattggtgccgaaacccgggacgagaaattccgggacgagaaaaccccgggaagtgaaaacctgggacgaaaattaccatcaccggcgcaaggaagatccctcattccagaaccagaactgcgggtcgcggtaataaaggttcccg	449	58	13%	32	7%
13	55779001	55779600	TTAAATCCCTGTAGCTCTTGTTTTTAAAACATGTCTTTGCTGACACTCTGGTTTCCGTGTTtgttgggagccgcgcccacattcgccgttacaagatggcgctgacagctgtgttctaagtggtaaacaaataatctgcgcatgtgccgagggtggttcttcactccatgtgctctgccttccccgtgacgtcaactcggccgatgggctgcagccaatcagggagtgacacgtcctaggcgaaggagaattctccttaatagggacggggtttcgttttcgctctctcttgcttcttgcactctggctcctgaagatgtaagcaataaagctttgccgcagaagattctggtttgttgcgtctttcctggccggtcgtgagaacgcgtctaataacaattggtgccgaattccgggacgagaaaaaactcgggactggcgcaaggaagatccctcattccagaaccagaactgcgggtcgcggtaataaaggttcccgtaaagcagactgttaagaaggattcaactgtatgaattcagaacttttcagctggggaacgagagtaccagtgagtacagctttacgaggtaagtctgat	599	68	11%	58	10%
13	55783351	55783650	tctccactctcattaatatgggtggcctatttgctcttattaaaaggaaagggggagatgttgggagccgcgcccacattcgccgttacaagatggcgctgacagctgtgttctaagtggtaaacaaataatctgcgcatgtgccgagggtggttcttcactccatgtgctctgccttccccgtgacgtcaactcggccgatgggctgcagccaatcagggagtgacacgtcctaggcgaaggagaattctccttaatagggacggggtttcgttttcgctctctcttgcttcttgcac	299	32	11%	32	11%
13	56718451	56718900	tctggagtcaaagcagctgcgtttgctcgggcctgcgcctgtgcagcttcgtgccaaagcgctttccattccatatatttgcccatactagggagagcggcttttacaaccgtttgccagtcagcaggagttagtgccatgccagcgagcctgtctaactgcaccaaggtaaaattagcattggttccgtatttacgaaccgactcggcaatttccttaatctgtacgtattctaccggagcgtggacacgcccaccctcggctccttcaaagactggaaatgcctgttctattttcctttgttcctctcggggaatgaatgagtctgcgcactgcctctctgcgcattgctgacgcactacgggctgacgcactacgcagggcggggactccgcatagggcgggagtgcacctggtagccgattgccctgaggccaattagcaaactg	449	56	12%	58	13%
13	58092901	58093200	TTTAATTTGAGatgtgtgtgtgtgtgtatgtatatgtgtatatgagtgcatatgtatgtgtgagtgtgcgtgagtgtgtgtatgtgtgcatatgagtgttcatgtatatatgtgtgtgagtgtgtgtgaatgtatatgagtgtgtatgtgtgtaagtgtgtattgttgtatatgagtgtatatgtatacgtatgtaagtatgcatgaatgtgtgtgtgagtgtatgtgttgtatgtgtgtatatgtatgcatgtaagtatgtgtgAATACATCTgtatatgtgtgagtgtatatgatat	299	4	1%	12	4%
13	58625251	58625550	acacacatgcatatacaaacatacacatacacacattgaaacacatacacacatacgtatacacacatacatatacacacatacacacttatacacacatacacatatacatacatatacacacatgcaaacacaaatatacatacatatacacacatacaaacacacatatccacacatccacacacatacatacacacatacaaacacatacacacttacacacacatacaaacacacacacttacacatacatgtatacgaacacacatatacacacatacacatacatacatatg	299	4	1%	170	57%
13	60950401	60950550	gaatgaacgagtctgtgcattgcctctctgtccattgcctctctgcgcagggctgatgcactacgcagggcgggggctcagcatagggtggaggtgcactatgaccttgaagccgactgccaagaggccaagcagcaagctggcctttg	149	10	7%	24	16%
13	65309851	65310450	tgtatgaggcgtgttttgaggcatgtgtgaggcatgtgaggtgtgtgtgtgaggtgtgtggtgtgtgtgtgtgaggctagtgtgaggcatgtgggacatgtgtgaggcgtgtgtgtgaggcatgtgtggtgtgtgtgtgtgtgaggctagtgtgaggcatgtgggacatgtgtgtggcgtttgtgaagagcgtgtgaggtgtgtgtgaggcgtgtgtgaggtgcatgtgtgAGGCTAACGTGAGGCGTTTGAGACATGTGTAAGGcgtgtgcgaagcatgtgtgaggcgtgtgaggtgtgtgtgaggcatgtgtgtgaagcacgtgtgaggcacgtgtgtggcattgtaaggcgtgtgtgtgaagcatgtgtgaggctcgtgtgaggagcatgtgaggcttgtgtgtgaaaagcacacagaagaaagcagagcgcgcagccttgagctgtgagaaagagagtgaggagtgcagagagtgagagagaaactctaagccttgaaaaaccgcctgtcagcttgcacccaaaaaagcagtctatgtctgtttattacgtgcctcccagatagccccacttccaggtgagaactccgatcccga	599	40	7%	58	10%
13	65378701	65379150	AAGAATGCATGCGGAAtgtgtgtgtgtgtgtgtgtgtgtgtgtgtgtggtgcgtatgaggcatgtgttgaggcatgtgttgaggcatgtgtgaggcgtgtgtggtgtgtgtgtgtgtgtgaggctagtgtgaggcatgtaagacatgtgtgaggcgtgtgtatgaggcctgtgaggtatgtgtgtgaggcatgtgtggtgtgtgtgtgaagctagtgtgaggcatgtgagagatgtgtgagaggcatgtgtgaggcgttggaggtatgtgtgtgtgtgtgtgtgtgtgtgtgtgtgtgtgtgtgAGGCTAGTGTGAGGCATGTGAAACATATGTGAGACGTGTTTGTGAGGCTCGTGTGAGGAGCATGTGAGGCGTGTGTGTGAAAAGCACACAGGAGAAAGCAGAGCGCGCAGCCTTGAGCTGTGAGCAAGCGAGCGAGGAGTGCAGA	449	24	5%	38	8%
13	65450851	65451150	gtggtgtgtgcgtgtgtgtgtgtgaggctagtgtgaggcatgtaagacatgtgtgaggcgtgtgtgtgaggcctgtgaggtatgtgtgtgaggcgtgtgtggtgtgtctgtgaagctagtgtgaggcatgtgagagatgtgtgagaggcatgtgtgaggcgttggaggtatgtgtgtgtgtgtgaggctagtgtgaggcatgtgaaacatgtgtgaGACGTGTTTGTGAGGCTCGTGCGAGGAGCATGTGAGGCGTGTGTGTGAAAAGCACACAGGAGAAAGCAGAGAGCGCAGCCTTG	299	18	6%	24	8%
13	65654401	65654550	aaacaccagaagagggcatcagatctcattacgggtggttgtgagccaccatgtggttgctgggatttgaactttggaccttcggaagagcagtcgggtgctcttacccgctgagccatctcaccagccccgggaaaaatcttaaatgt	149	10	7%	22	15%
13	65681101	65681250	gaatcacagaaaagacctttgggattttggagcaaagctctaccatcatctgcagacaactattctccctttgaaaaacagctcttggcctgctattgggccttagtggaaactgaacgtttgacgataggacaccaagttactatgcg	149	6	4%	20	13%
13	65682451	65683200	gcagctggtctgatagaaagatggaatggccttttaaagacgcagttacagcgccaattaggtggtaacagcttggaaggctggggtagagttcttcagaaggcagtatatgctttgaatcagcgctcgatatatggtacagtttctcccatagccaggattcatgggtccaggaatcaaggggtggaaaagggaatagttccacttactatcactcctagtgaccctctaggaaaatttttgcttcctgtccccataactctaggttctgctggcctagaagttttggctccagagaggggagtgctcctaccaggagctacaacaaacattccattgaactggaagctcagacttccccctggtcattttgggcttctaatgcccttaaaccaacaggctaaaaaaggaataacagtgttaggaggggtgatagatccagattaccatggggaaattggattacctcttcacaatggtggtaagcaagattatgtctggagtgtaggagatcccttagggcgtctcttagtactaccatgtcctgtgattaaagtcaatgggaaactacaacagcctaatccaagcaggatgacaaaggacacagacccatcaggaatgaaggtatgggtcaatcctccaagaaaagagccaagacctgctgaggtgctggctgaaggtgaaggaaatacagaatgggtagtagaggaaggtagttataaatgccaattaaggccacgtaaccagtt	749	12	2%	102	14%
13	65682451	65683200	gcagctggtctgatagaaagatggaatggccttttaaagacgcagttacagcgccaattaggtggtaacagcttggaaggctggggtagagttcttcagaaggcagtatatgctttgaatcagcgctcgatatatggtacagtttctcccatagccaggattcatgggtccaggaatcaaggggtggaaaagggaatagttccacttactatcactcctagtgaccctctaggaaaatttttgcttcctgtccccataactctaggttctgctggcctagaagttttggctccagagaggggagtgctcctaccaggagctacaacaaacattccattgaactggaagctcagacttccccctggtcattttgggcttctaatgcccttaaaccaacaggctaaaaaaggaataacagtgttaggaggggtgatagatccagattaccatggggaaattggattacctcttcacaatggtggtaagcaagattatgtctggagtgtaggagatcccttagggcgtctcttagtactaccatgtcctgtgattaaagtcaatgggaaactacaacagcctaatccaagcaggatgacaaaggacacagacccatcaggaatgaaggtatgggtcaatcctccaagaaaagagccaagacctgctgaggtgctggctgaaggtgaaggaaatacagaatgggtagtagaggaaggtagttataaatgccaattaaggccacgtaaccagtt	749	12	2%	102	14%
13	65782501	65783100	CTTCTGTGTGCTtttcacacacacgcctcacatgctcctcacacgagcctcacaaacacgtctcacacatgtttcacatgcctcacacacacacctccaacacctcacacatgactctcacacatgtctcacatgcctcacactagcttcacacacacatcacacacacctcacacacatacctcacaggcctcacacacacacctcacacatatctcacataccacacacacacacaccacacacctcacacacacacctcttatgcctcacacacgcctcacacacatacctcacaggcctcacacacacctcacacatgtctcacatgcctcacactagcctcatacacacacgcacaaacaccatacacgcctcacacacacaacctctcatgcctcacacatgcctcacacataggcctcacactagcctcacacacacaccacacatgcctcacacatgcctcaacatatgcctcatacgcaccacacacacacacacacacacacacacacacacacacTCCGCATGCATTCTTCCTTCACTCACTCGCTCTCCACCGGCTCTTCTCAGGCTCTCTCGCCTTCTTCTTGCCC	599	22	4%	310	52%
13	66012451	66012600	caatcagggagtgacacgtccgaggcgaaggataattctccttaagagggacagggtttcgttttctctctctcttgcttcttgcactcctgctcctaaagatgtaagcaataaagctttgccgcagaagattctggtctgttgcgtct	149	12	8%	14	9%
13	66230401	66230700	gcagagaggcagtgcgcagagaggcagtgcgcagactcattcattcccagagaggaacaaaggaaaatacaacaggcatttccggtctttgaaggagccgagggtgggcgtgtccacgctccggtagaatacttacaaattaaagaaattgccgagtcggtccgtaaatacggaaccaatgctaattttaccttggtgcagttagacaggctcgccggcatggcactaactcctgccgactggcaaacggttgtaaaagccgctctccctagtatgggcaaatatatggaatggagagc	299	32	11%	42	14%
13	66639751	66640200	tgtgaggctagtgtgaggcctgtgtgtgaggcatgtgtgaggcatgAGAGgtgtgtgtgtgtgtgtgtgtgtgtgtgtgtgtgtgtgtgtgtggcatgtgagatatgtgtgaggcgtgtgtgtgaggcctgtgaggtatgtgtgtgaggcgtgtgtggtgtgtgtgtgAACCTACtgtgagacatttgagacatgtgtgagaggcatgtgggaggcgtgggaggtgtgtgtgtgtgtgtgaggcttgtgtgaggcatgtgagacatgtgtgaagcatgtttgtgaggtatgtgtgtggtgttgtgaggcgtgtgtgtgAAAAGCACACAGGAGAAAGCAGAGCTCGCAGCCTTGAGCTGTGAGCAAGCTAGCGTGGAGTGCAGAGTGAGAAAGAAACTCAATGCCTTGAAAAACCGCCTGTCACCTTGCACCCAAAAAAGCAGTCTGTG	449	14	3%	42	9%
13	66714301	66714600	tgaggcctgtgaggtatgtgtgtgaggcgtgtgtggtttgtgtgtgaagctagtgtgaggcatgtgagagatgtgtgagaggcatgtgtgaggcgttggaggtgtgtgtgtgtgtgtgtgtgtgtgtgtgtgtgtgtgtgtgtgtgtgtgtgtgaggctagtgtgaggcatgtgaaacatgtgtgagacgtgtttgtgaggctcgtgtgaggagcatgtgaggcgtgtgtgtaaagcaCACAGGAGAAAACAGAGTGCGCAGCCTTGAGCTGTGAGCAAGTGAGCGAGCAGTGCAGAGA	299	14	5%	26	9%
13	67996201	67996350	tcctggtgattggcagacggtagtaaaagctgtagcccccagtatgggaatgtatcttgagtggaaagccttgtggcaggactcctgccagacgcaggcaagggccaatgccaccatgaaaggggatcagagaacgtggacttttgaat	149	6	4%	20	13%
13	68073001	68073150	ctgtccaggcctgactgcgactgagaatcagtcagcagtgtggaagcaaaacgaaaccgaaagggaaggaataatcgccgtgaaaacaatcaaaagggcgtctaactctggagaaatttcaagactgtacgtaccttgcagagccttat	149	14	9%	18	12%
13	68444701	68444850	accgtggctcaaggctgccggttcgatgccgcctgaccaagactttgtctccaacttggaacccgtggggtactgcggtggtccctggggtataggctgctttcagttggtcccaaatctgggtcctaatcacttctagggcctttaaa	149	12	8%	12	8%
13	70005601	70006050	TTAATATATTTCTAAATGACTTGCATGTGCCgagtgtggctatatgcatgtgtgcaggtgcccgtgtctgagtgtggatatatgcatgtgtgcaggtgcccgtgtctgagtgtggctatatgcatgtgtgcaggtgtccgtgtctgagtgtggatatatgcatgtgtgcaggtgcccgtgtctgagtgtggatatatgcatgtgtgcaggtgtccgtgtctgagtgtggctatatgcatgtgtgcaggtgcccgtgtccgagtgtggctatatgcatgtgtgcaggtgtccgtgtctgagtgtggctatatgcatgtgtgcaagtgtccgtggaagctggaggttttggatgtcctgggagctggagttgcaggtggttgtgagctgtctcacctagatgttgggagcctttgggtgctattgagagcagagcataagggatttaacct	449	18	4%	42	9%
13	73144501	73145700	ggcaggagttagtgccatgccggcaagcctgtctgcaccaaggtaaaattagcattggttccatatttacggaccgactcggcaagctctttaatctgcacatattctaccggagcgtggacacgcccaccctcggctccttcaaagaccggaaatgcctgttgtattttcctttgttcctcctttggaatgaacaagtctgcgcattacctctctgtccattgcctctctgcgcagggctgacaccttacgcagggcgggggctccacatagggcggaagtgcactatgaccttgaagccgactgcccggaggctgagcagcatgctggccttcgccagccgcttttggctttttccttaactgattagctagcattttatctggctggtacccttttctctcataatgagctgcttcctcctccaagtctgtttattcagaggagaattcttcatctgattcagagctactaagagctggctccttgagctcatctagtgatgagtataggctccttctcctagagacctccgctaattgatcttttttcttttcttttttcttttccttccttctaatctctccccaggtattcttacctgacctaaacttttcctcgggttcaagacccgtggaaaggcctgtatacttattttgtgtaccatatttcctctttgctcctactctctctccccgctttacttctgatagattgccctgaatttcatccagaattttcatccctgccttaaccgcttgataacatgtgaaaaggaacaaaaaggctcctaacactagagaaagttcaaggccaaacataccttgtaaagctatttcccactttacttctgatagactgtcttgaatttcattagaaagttcaaggccagacgtaccttgtaaagctatttcccactttacttctgatagactgtcttgaatttcattagaaagttcaagaccagacttaccttgtaaagctatacttacgggtaccctgttccccagctgaagagttctgaattcacgcagttgaatccttctcaacagtctgttttacgggaacacttcattaccaccattccccagctgaagagttctgaatccaggctggatcattctcaacagtctgttttacgggaacacttcattaccatgacccgcagttctggttccggaatgagggatcttccttgc	1199	60	5%	140	12%
13	73144501	73145700	ggcaggagttagtgccatgccggcaagcctgtctgcaccaaggtaaaattagcattggttccatatttacggaccgactcggcaagctctttaatctgcacatattctaccggagcgtggacacgcccaccctcggctccttcaaagaccggaaatgcctgttgtattttcctttgttcctcctttggaatgaacaagtctgcgcattacctctctgtccattgcctctctgcgcagggctgacaccttacgcagggcgggggctccacatagggcggaagtgcactatgaccttgaagccgactgcccggaggctgagcagcatgctggccttcgccagccgcttttggctttttccttaactgattagctagcattttatctggctggtacccttttctctcataatgagctgcttcctcctccaagtctgtttattcagaggagaattcttcatctgattcagagctactaagagctggctccttgagctcatctagtgatgagtataggctccttctcctagagacctccgctaattgatcttttttcttttcttttttcttttccttccttctaatctctccccaggtattcttacctgacctaaacttttcctcgggttcaagacccgtggaaaggcctgtatacttattttgtgtaccatatttcctctttgctcctactctctctccccgctttacttctgatagattgccctgaatttcatccagaattttcatccctgccttaaccgcttgataacatgtgaaaaggaacaaaaaggctcctaacactagagaaagttcaaggccaaacataccttgtaaagctatttcccactttacttctgatagactgtcttgaatttcattagaaagttcaaggccagacgtaccttgtaaagctatttcccactttacttctgatagactgtcttgaatttcattagaaagttcaagaccagacttaccttgtaaagctatacttacgggtaccctgttccccagctgaagagttctgaattcacgcagttgaatccttctcaacagtctgttttacgggaacacttcattaccaccattccccagctgaagagttctgaatccaggctggatcattctcaacagtctgttttacgggaacacttcattaccatgacccgcagttctggttccggaatgagggatcttccttgc	1199	60	5%	140	12%
13	73877251	73878000	aaaaccatcccttaggctcatcacccagagaggtcttggccagctcccgtgtcgtttttcctgggggaagggaactaggacactgaaccttcatgcaatcagacgtgccttccacaggatgccaacagcaagctatcctctgtgcagtgcttagcctcgcaccccacggcataacgcagcataatttcttttagagcggcaaaccgaatctgaggagattgtcccgcctccactgcagcaaaagcctatgctaccatggcgaaagtgcgggccgcacactctgcacctaacacatgtgccaaacacacaacgcacacgcactataacaagcatacatcccagggctctcatccccgctcatcttccctgaagcaagggatagatggccagcagggctatctctttaaggggaattcagggatcaaaaagcgtggaaaaatttgaatgtcatgtcgagctggtatcggcttctggaatagcgaaaggatctctcatctcggctccatcctttgtgcttgtgggatcatccaccacatccacaggggcaactggatcaggacgctcattcttgcagcgtctcaccaatctctccggcacccaaagaggttccgtctggtcctgtggaaacacacaaacagaccctctcgcccacgtcaacacctgatcctgtcgatccccAGGGGAGATGGACACAATACCTCGTGGTAATGAGACCATAACCTCAATCACCTGTGTGACCATCTGGGGAG	749	56	7%	156	21%
13	74417551	74418000	CCTGTGGTCCTCCTAGCACGTCTGCCAACCACAGTCCTCCAGTCCTTACGGCCCAAAAGGACAGCTGCAAAATATAGACGCGTGCATTTCAGAAAACCCCATCACCCCATCGTCTACAAACACCGTCGTCCACTTCTACCTAGACGACCAAAACCAGAGaagcacacttgttcctcactctgccaggtgtaaaaccaaggcacgaggtgggactcaaacccacgatctcgtaaccctgaaaccaagacacaaattcaataaactcagatggatccaaactcagacttcgccgtgcttcagaaacataggacaagacacaaacaacccaacACAACAAGCACATGTTCCAATGTTCGTTTcagaaaacagacactcaaaacagagacaccggccagcacacacacaagaggggatccccatacctccaagtcggttctcgggtgtgaggg	449	34	8%	118	26%
13	75862351	75862800	gctcgacaGttggtgccgaaacccgggaaaagaaacatcttcaggcacgagcgaagacccctgctacagggaggattcagaactgcatcacggggaaggagtggttaataaaagttcctgtaaaacagactgttgagaaggatccggtgtggattcagaactcttcagctggggaacggtactgatgaagagaaagaagaaagatgaagactgaataaactgctgttagaaggactggtggtcgcatcgttcttgctggtcgagagcagacgcgacaattggtggcccgtacggggaaccgactcccccaccgagttcagaactttcagcagtcagtggttgccggcagggtaagttcacggtgagtgaaacttgcaaccccaggagtttgggaaggacctcggataaaatagaggtgagcataaagttgccaggaagtaggcacaaag	449	40	9%	54	12%
13	77643001	77643600	acctccaccgactggttgtgggctctgacctgcacctccttccaatgctccagagttaaagaaaggggagtggacacagattgtcccatttccagaataatagtagacacaacaagagcgaacacgagactaagacaaaaaagaaaccaaaagcagcggcgacttcgcgtcgaccacaagcaactcaaagaatcagatggcctttccaaggctggccgattgagaccctctgcacgaggtgggactcgaacccacgatcccgtaacaaaacacgaggtgggactcgaacccacggtctcgcaacaaggcgcgaggtgggactcgaacccacgatctcgcaaccccagatggtctcttggcctccaaaggggtccaccaggcgtccctggtcctcccctgttcctcctgggacgtctcccagggcgaacggacggtgaacacctggacacgtctatccttatccaccccgcgttccctctcggagcgcggtctcactgagcgtccgcaaaaccgaaactgcgatcgcaccaaacttagaaacagaacacagacaccagaccaagacaggtcaaagaatcttaccttaaagtgggtctagg	599	76	13%	100	17%
13	78138901	78139050	ggctatctggagctgaagatggcgccgcccagaagctctgcgactctcgcccgtcccagaaacggctggcactctgtattccacacggtcacccgtgcagcctgccctccgcggagtcccggagccaagaaggctcccgccggcgcctg	149	28	19%	16	11%
13	81085801	81086250	caacagtctgttttacgggaacacttcattaccaccgttccccagctgaagagttctgaattcacgcagttgaatccttctcaacagtctgttttacgggaacacttcattaccaccgttccccagctgaagagttctgaattcacgaagttgaatccttctcaacagtctgttttacgggaacacttcattaccaccgttccccagctgaggagttctgaatccaggccggatccttctcaacagtctgttttacgggaacacttcattaccatgacccgcagttctggttccggaatgagggatcttccttgcgccggtgatggtaaccgtcccaggttttcttgtcccgggttttctcggcccgggttttctcttcccgggtttcggcaccaaCtcttacccgcgttcacgcgaccggccaggaagaacgcaacaaaccggaatct	449	54	12%	70	16%
13	81892051	81892200	tactgttcaacctcagggcagtcggcttcaaggtccgccctatgcggagtccccgccctgcgtagtgcgtcagcaatgcgcagagaggcagtgcgcagagaggcagtgcgcagactcattcattcccagagaggaacaaaggaaaatac	149	18	12%	30	20%
13	83135401	83136000	ggtctgatccccagtgtgcaagcataggggccctacacaaaaccatcccttaggctcatcacccagagaggtcttggccagctcccgtgtcgtttttcctgggggaagggaactaggacactgaaccttcatgcaatcagacatgccttccacaggatgccaacagcaagctatcctctgtgcagtgcttagcctcgcaccccacggcataacgcagcataatttcttttagagcggcaaaccgaatctgaggagattgtcccgcctccactgcagcaaaagcctacgctaccatggcaaaagtgcgggcctgcacacgctgcacctaacacatgtgccaaacacacaacgcacacgcactataacaagcatacatcccagggctctcatccccgctcatcttccctgaagcaagggatagatggccagagagactatctctttaaggggaattcagggatcaaaaagcgtggaaaaacttgaatgtcatgtcgagctggtatcggcttctggaacaccgaaaggatctctcatctcggctccatcctttatgcttgtgggatcatccaccacatccacaggggcaactggatcaggag	599	38	6%	132	22%
13	83419201	83419350	tccttaaaaagggacggggtttcgttttctctctctcttgcttttctctctctcttgcttcttgctctcttgcttcctgcaccctggctcctgaagatgtaagaaataaagctttgccgcagaagattctggtctgtggtgttcttcct	149	6	4%	4	3%
13	85600051	85600200	tagtgcgtcagccctgcgcagagagacaatgcgcagagaggcaatgcgcagactcattcattcccagagaggaacaaaggaaaatacaacaggcatttccggtctttgaaggagccgagggtgggcgtgtccacgctccagtagaatac	149	16	11%	30	20%
13	86712901	86714250	atctgcgcatgtgccgagggtggttcttcactccatgtgctctgccttccccgtgacgtcaactcggccgatgggctgcagccaatcagggagtgacacgtcctaggcgaaggagaattctctttaatagggacggggtttcgttttctctctctcttgcttctcgctctctcttgcttcttgcactctggctcctgaagatgtaagcaataaagctttgccgcagaagattctggtctgtggtgttcttcctggccggtcgtgagaacgcgtctaataacaattggtgccgaattccgggacgagaaaaaaaactcgggactggcgcaaggaagatccctcattccagaaccagaactgcgggtcgcggtaataaaggttcccgtaaagcagactgttaagaaggattcaactgtatgaattcagaacttttcagctggggaacgagagtaccagtgagtacagctttacgaggtaagtctgatcttgaactttctaaggaaattcaagacagtctatcagaagtaaagtggaatatgtttggccttgaattttttctggtgttaggagcccttttgttccttttcacatgttatcaagtggttaagatagggctgaaaattctagaggaaattcaggacaagctatcagaagtaaagcggggagagagagtaggagcaaagagaaaatatggtacacaaaataagtatacaggcctttccaagggtcttgaacccgaggaaaagttaaggttaggtaggaatacctggagagagattagaagaaaaagaggaaaaagggaaaagaagaaagatcaattagcggaggtctctaggagatactcgtcactagatgagctcaggaagccagctcttagtagttctgaagcagatgaagaattctcctctgaggaaacagactgggaggaagaagcagcccattaccagccagctaattggtcaagaaaaaagccaaaagcggctggcgaaggccagtttgctgattggcctcagggcagtcggcttcaaggtccgccctatgcggagtccccgccctgcgtagtgcgtcagcaatgcgcagagaggcagtgcgcagagaggcagtgcgcagactcattcattcccagagaggaacaaaggaaaatacaacaggcatttccggtctttgaaggagccgagggtgggcgtgtccacgctccggtagaatacttacaaattaaagaaattgccgagtcggtccgtaaatacggaaccaatgctaattttaccttggtgcagttagacaggctcgccggcatggcactaactcctgctgactggcaaacggttgtaaaagccgctctccctagt	1349	110	8%	148	11%
13	86773801	86774100	gaagcagcccattaccagccagctaattggtcaaggaaaaagccaaaagcggctggcgaaggccagtttgctaattggcctcagggcaatcggctaccaggtgcactcccgccctatgcggagtccccgccctgcgtagtgcgtcagcccgtagtgcgtcagcaatgcgcagagaggcaatgcgcagagaggcaatgcgcagactcattcattccccgagaggaacaaaggaaaatagaacaggcatttccagtctttgaaggagccgagggtgggcgtgtccacgctccggtagaata	299	36	12%	52	17%
13	87069601	87070050	ctgtctaactgcaccaaggtaaaattagcattggttccgtatttacggaccgactcggcaagttctttaatttgtaagtattctaccggagcgtggacacgcccaccctcggctccttcaaagaccggaaatgcctgttgtattttcctttgttcctctctgggaatgaatgagtctgcgcactgcctctctgcgcactgcctctctgcgcactgcctctctgcgcactgcctctctgcgcactgcctctctgcgcattgcctctctgcgcattgcctctctgcgcattgctgatgcactacgcagggcgggggctccgcatagggcggaccttgaaaccgactgcccggaggttgaacagtacgctggctttcgccagccgcttttggcttttttcttgaccaattagctggctggtaatgggctgcttcttcctcccagtctgtttc	449	52	12%	44	10%
13	92624851	92625150	gatccttctcagcagtctgttttacgggaacctctattaaccgctccttccccgcgatgcagttctgaatcctccctgtagtagggggtcttcgctcgtgcctgaagatgtttcttgtcccgggttttcggcaccacttcttgcgcgcaccggactcgaccagcaagaacgacgctgcaacaggatccttctgcacacgtttattgggagagcttgattgcagaggcgaaaagactttttgcccagagctggtgctgcttttataggcctaggagaggcatgtctcataccctgattgg	299	32	11%	32	11%
13	93534451	93535050	ccccgtgacgacaactcggccatggactgcagccaatcagggagtgatacgtcctagacaaaggataactctccttaagagggaaggggtttcgctttcgtttttgggcttggggcttactctcttgctcctgaagatgtaagcaataaagttttgccgcagaagattctggtttgttgtgttcttcctggccggtcgtgagaacgcgtgtaagaGttggtgccgaaacccgggacgagaaaatccgggaagaaaaaacccgggacaagaaaactcgggacgggagttaaccatcaccggcgcaaggaagattcctcattccagaaccagaactgcgggtcacggtcataaaggttcccgtaaaacagactgttgagaaggattcaactgtgtgaattcagaactcttcagctggggaacggtggtaatgaagtgttcccgtaaaacagactgttgagaaggatttaactgcgtgaattcagaactcttcagctggggaacagggtacccgtaagtatagctttacaaggtaagtctggccttgaactttctaacgaaattcaagacagtctatcagaagtgggaaatagctttacaag	599	56	9%	60	10%
13	94736551	94736850	gcgaaggccagtttgctgattggcctcagggcagtcggtttcaaggtccgccctatgcggagcccccgccctgcgtagtgcgtcagcaatgcgcagagagatgcgcagagaggcaatgcgcagagagatgcgcagagaggcaatgcgcagagagatgcgcagagaggcagtgcgcagagaggcagtacgcagagaggcagtgcgcagactcattcattcccagagaggaacaaaggaaaatacaacaggcatttccagtctttgaaggagccgagggtgggcgtgtccacgctccggta	299	40	13%	58	19%
13	98425651	98425800	gccaaagactaagttctgtgtgtgtgtgtgtgtgcatatgtacgtatgtgtgcatgtgtgtgaatgtatgtgtgtctgtgtatatgtatgtgtgtgtgtctgtgtatatgtatgtgtgtgtgtatgtgtgtctgtgtatatgtatgtgt	149	2	1%	6	4%
13	101962351	101962500	gcagagaggcaatggacagagaggcaatgcacagactcgttcattccaaaggaggaacaaaggaaaatacaacaggcatttccggtctttgaaggagccgagggtgggcgtgtccacgctccggtagaatacttacaaattaaagaaat	149	12	8%	28	19%
13	104995351	104995650	ggttccgtatttacggaccgactcggcaagttctttaatctgcacgtattctaccggagcgtggacacgcccaccctcggctcctttaaagaccggaaatgcctgttgtattttcctttgttcctctctgggaatgaatgagtctgcgcattgcctctctgcgcattgtctctctgcgctttgtctctctgcgcattgtctctctgcgcagggctgacgcactacgcagggcgggggctccgcatagggcggaccttgaagccgactgcccggaggctgaacagcatgctggctttcgc	299	46	15%	26	9%
13	106785301	106786050	GGGATGAAATAATTAAAAAGTATATATATATAtgtggggagccgccctcacattcgccgttgcaagatggcgctgacatcctgtgttctaagtggtaaacaaataatctgcgcatgtgccaagggtagttttccactacatgtgctctgccttccccgtgacgacaactcggccgatgggctgcagccaatcagggagtaatacgtcctaggcggagaataattctccttaaaggggacggggtttcgccatattcgctctcttgctctggctcttgcttcttgctcctgaagaggtaagcaataaaactcttgcgctcttgcgttcttgcttcttgctcctgaagatgtaagcaataaagctcttgcgctcttgctctcttgcactcttgctcctgaagatgtaagcaataaagttttgccgcagaagattccggtttgttgcgttcttcctggccggtcgcgtgaacgcgtgtaagaGttggtgctgaaacccgggacgagaaaacccgggacgagaaatcctgggatgagaaaacccaggacggttaccatcaccggcgcaaggaagatccctcattccggaaccagaactgcgggtcatggtaatgaagtgttcccgtaaaacagactgttgagaaggattcaactgcgtgaattcagaactcttcagctggggaatggtggtaatgaagtgttcccgtaaaacagactgttgagaaggattcaactgcgtgaattcagaactct	749	76	10%	66	9%
13	108002401	108002700	gaacctttatcaccgtcgttccccagctgatgagttctgaattcggcagttgaatccttctcaacagtctgctttacgggaacctttatcaccgtcgttccccagctgatgagttctgaattcggcagttgaatccttctcaacagtctgtgttacgggaacctttataaacgtgatccgcagttctggttccggaatgagggatcctccttgcgccagtcccgagtttttttctcgtcccggaattcggcaccaattgttattagacgcgttctcacgaccggccaggaagaacacca	299	40	13%	36	12%
13	109674751	109675050	ctcctggggtcgcaaatttcactcaccgtgaacttaccctgccggcaaccactgactgctgaaagttctgaactcggtgggggagtcggttccccgtacgggccaccaattgtcgcgcccgctctcgaccagcaagaacgatgcgaccaccagtccttctaacagcagtttattcagtcttcatctttcttctttctcttcatcagtaccgttccccagctgaagagttctgaatccacgccagatccttctcaacagtctgttttacgggaacttttattaaccactccttccccgtt	299	34	11%	46	15%
13	111499951	111500400	tgcactcttgctcctgaaaatgtaagcaataaagctttgccgcagaagattctggtctgtggtgttcttcctggccggtcgtgagaacgcgtctaataacaattggtgccgaattccgggacgagaaaaaaactcgggactggcgcaaggaggattcctcattccggaaccagaactgcggatcacgtttataaaggttcccgtaacacagactgttgagaaggattcaactgccgaattcagaactcatcagctggggaacgacggtgataaaggttcccgtaaagcagactgttgagaaggattcaactgccgaattcagaactcatcagctggggaacgacggtgataaaggttcccgtaaagcagactgttaagaaggattcaactgtatgaattcagaacttttcagctggggaacgagagtaccagtgagtacagctttacga	449	48	11%	50	11%
13	111700201	111700650	ctgatagactgtcttgaatttcgttagaaagttcaaggccaggcgtacctcgtaaagctatacttactggtatccaccgttccccagctgaaaagttctgaattcatgtagttgaatccttctcaacagtctgttttatgggaacctttattaccgtgacccgcagttctggttctggaatgagggatcttccttgcgccagtcccgagttttttctcgtcccggattttctcgtcccggaattcggcaccaattgttattagacgcgttctcacgaccggccaggaagaacaccacagaccagaatcttctgcggcaaagctttatttcttacatcttcaggagccagggtgcaggaagcaagagagcaagaagcaagagagagagaagcaagagagagagaaaacgaaaccccgtccctcttaaggagcattctccttcgcctcgga	449	44	10%	54	12%
13	111729151	111730200	agcgcgaccacccagaggtcctagacccacttaaaggtaagattctttgttctgtcttggtctggtgtctgtgttctgtttctaagtttggtgcgatcgcagtttcggttttgcggacgctcagtgagaccgcgctccgagagggaacgcggggtggataaggatagacgtgtccaggtgtccaccgtccgttcgccctgggagacgtcccaggaggaacaggggaggaccagggacgcctggtggacccctttggaggccaagagaccatctggggttgcgagatcgtgggttcgagtcccacctcgtgccttgttgcgagatcgtgggttcgagtcccacctcgtgttttatcgcgagatcgtgggttcgagtcccacctcgcgccttgttgcgagaccgtgggttcgagtcccacctcgtgttttgttatgggatcgtgggttcgagtcccacctcgtgcagagggtctcaatcggccggccttggaaaggccatctgattctttgagttgcttgtggtcgacgcaaagtagccgccgtttttggtttcttttttgtcttagtctcgtgttcgctcttgttgtgtctactattattctagaaatgggacaatctgtgtccactcccctttctctaactctggagcattggaaggaggtgcaggtcagaacccacaaccagtcggtggaggtcagaaagggtccgtggcagaccttttgcgcctccgagtggccgacgtttggagtgggctggccaccagaaggtgcttttgacttgtcactaatcgccgccatcaggcgaattgtttttcaggaggaagggggtcaccctgatcagatcccctacattgtgacctggcagaatctcgtccaattcccacctccgtgggtcaagccttggaccccaaattcttcgaaactgacggtcgcggttgcccagtctgatgcagccggaaagtccggcccgtcagcaccccccaagatttatccagagattgacgacctcctctggatggactcccaacctcccccttacccctgccccagc	1049	132	13%	106	10%
13	112793101	112793400	gtgtgtgtgtatctgtgtgtgtccgtgtgtgtgtctgtgtgtgtatgtgtctgtgtgtatctgtgtttgtgtgtgtgagtgtgtgtgtgtgtgagtgtgtgtgtgtctgtgtgtgtgagtgtctgtgtgtgagtgtgtgtgtgtctgtgtgtgtgtctgtgtgtgtgtgtgtctgtgtgtgtgtatgtgtctgtgtgtgtatgtgtgagtgtgtgtgtctgtgtttgtgtgagtgtgtctctgtgtgtgtgtgtgtttgtgtgtgaatgtttcgttagcatgtacaatatgcatgttgg	299	4	1%	6	2%
13	114542101	114542400	ctccattccatatatttgcccatactagggagagcggcttttacaaccgtttgccaatcaccaggagtcatagcgtgattcgcaagcctttccacttgtgctatagtgaaattagcactgactccatagttacggaccgactcggcaagctctttaatctgtatatacgctaccggagcgtggacacgcccaccctcggctccttcaaagaccggaaatgcctgttgtattttcctttgttcctcctttggaatgaacgagtctgtgcattgcctctctgtccattgcctctctgcgca	299	30	10%	38	13%
13	117295951	117296400	agtgacacgtccgaggcgaaggagaatgctccttaagagggacggggtttcgttttctctctctcttgcttttctctctctcttgcttcttgctctcttgcttcttgcactctgttcctgaagatgtaagaataaagctttgccgcagaagattctggtctgtggtgttcttcctggccggtcgtgagaacgcgtctaataacaattggtgccgaattccgggacgagaaaaaaactcgggactggcgcaaggaagatccttcatttcagaaccagaactgcggatcacgtttataaaggttcccgtaacacagactgttgagaaggattcaactgccgaattcagaactcatcagctggggaacgacggtgataaaggttcccgtaaagcagactgttaagaaggattcaactgtatgaattcagaacttttcagctggggaacgaga	449	46	10%	38	8%
13	118073851	118074450	tgacctctatctccactctcattaatatgggtggcctattgctcttattaaaaggaaagggggagatgttgggagccgcccccacattcgccgtcacaagatggcgctgacatcctgtgttctaagtggtaaacaaataatctgcgcatgtgccaagagtaattttccactacatgtactctgcctttcccgtgacgtgcaactcggccatgggctgcagccaatcagggagtgatgcgtcctaggcggagaataactctcctaaaaaggggacggggtttccgccattctctctcttgcttgcgcttttgcgctctgcgctctggcgctctggcgctctggcgcgctggcgctctggctcctaaagatgtaaggggggacctttcgtttttggggcttggggcttgcgctcctggctcctgaagatgtaagcaataaagttttgccgcagaagattctggtttgttgtgttcttcctggccggtcgtgagaacgcgtataagaTTTAAGTAAAATGTGTGGTAAGTTTCTAGTTAAGAAAAACAATACTTTTTATTTGGATATGTTTAGAGAAAGagaaaatgattgagggagaaaga	599	54	9%	42	7%
13	119133901	119134350	cgtttgctcgggcctgcgcttgtgcagcttcatgccaaagagctctccattccatatatttgcccatactagggagagcggcttttacaaccgtttgccagtcggcaggagttagtgccatgccggcgagcctgtctaactgcaccaaggtaaaattagcattggttccgtatttacggaccgactcggcaagttctttaatctgtacgtattctaccggagcgtggacacgcccaccctcggctccttcaaagactggaaatgcctgttgtattttcctttgttcctctctgggaatgaatgagtctgcgcattgcctctctgcgcattgtctctctgcgcagggctgacgcactacgcagggcggggactccgcatagggcggaccttgaagccgactgccctgaggccaatcagcaaactggccttcgccagccgcttttggcttc	449	56	12%	54	12%
13	119662051	119662650	atccttgtaagtaactctgatccttcttaatccctccccttaactggaaggtggcactaaaagccttttgttctcatgctggctgtgttaaccctatttctcccggtttgatcctgcactcaccagaagtggcgctgaaagaaaaagttttgaatgctgtgaagcacgatcagacggacgtatataagccgcagtgctcgtctcatatttaagcctctcgtagataagggagcagtatgggaaattcacattctgtaactacagctctacactctgttttaaaacagcgagagataaaagtttctacaagaaccttagaaacgttcattaaggaaatagaacgtatatcaccttggtacgcgtgttcagggtcgttaactctttcctcttgggagaaattaagggaagacttagctaaggaacaacagaatgggaaattaaaggcagggaccatgccattatggaaactggtgagatcgtgcctggaggatgagagatgccgtccagcaataataacagggcaggcaatattagaagaagcacaggacagcatggcagaaacggaatggtgtgaaaggttaggagctccaaaaaaggaa	599	34	6%	70	12%
14	3870751	3871200	tgccattagcaatcgccattataagatggcgccggcttccactgagcctaattagtaaacaagccttatgcgcaagtgcaagagtaaattcacgcccagtcactgcccatctcggggcgtagtaatggggtgatgggcgagcaactaatcaggtgctgtcacgccacatcaggtgctgaaccgtcacgctgcgggctatataagcagcaccattttccgggttcggggtcttccttatgttgaagcaataaaagctttgccgtagaaggatccggttgtccgagtgaattcttgccggcgagatactagctcgggtgagaGtcctggggttaaagcactccctggaggcaagctctcctctgggagggaaggtgctcggaggactgagggtcagctccacctcctggctgcagatgtaggcctgtaggaccctgtcccagaagctctgt	449	42	9%	56	12%
14	4821901	4822200	GCAGATATTGTCACTTAATTGTAGGTCAATTTGTGTCAGTATGGAACATGTTCAGGGAAGTGGAAATAAGTTCGGGTCACGGCAACAGAGCCAGTTGGAGTGTAAGATCAAGTAGGACCCGGCACCTCCTCCTAAAGGCAAGAAGAAGATTCTCCCTGACCCCTGGGTTCAGAAGgtgtgtgtgtgtgtgtgtgtgtgtgtgtgtgtgtgtgtgtgtatgtgtgtgcgtgcgtgtgtgtatgtgggcgtgtgtgtgtgcatgtgtgtgtatgtgtgtgtgtgcgtgtgtgtgtgtgtgt	299	14	5%	30	10%
14	4917001	4917450	aagacagtaaccacagcagatggacatgactgcagaggcctagaccagcctcaaattttaataaaataaaaagggggaaatgtggagagccgtgccattagcaatcgccattataagatggcgccggcttccactgagcctaactagtaaacaagccttatgcgcaagtgcaagagtaaattcacgcccagtcactgcccatctcggggcgtagtaatggggtgatgggcgagcaactaatcaggtgctgtcacgccacatcaggtgctgaaccgtcacgctgcgggctatataagcagcaccattttccgggttcggggtcttccttatgtggaagcaataaaagctttgccatagaaggatccggttgtccgagtgaattcttgccggtgagatactagctcgggagagaGtcctggggttaaagcactccctggaggcaagctctc	449	38	8%	66	15%
14	6323401	6324000	agaggaatggatacagaaaatgtggtacatttacacaatggagtactacacagctattaaaaagaatgaatttatgaaattcctagccaaacggatggacctggaggacatcatactgagtgaggtaacccaatcacaaaagaattcacacaaGgagaggtttgtgtcacaggcgccggcgggacccttcttggctccgggactccgtggagggcaggctgcacgggagaccgtgtggaatacagaggccagccgtttctgggacgggtgagagtcgcagagcttctgggacggcgccatcttcgtctccagacaaccggccaccttcctggcgagatgcacagagcttctgaggcggcgccatcttcagctccagacagccgaccaccttcctggtgagagcacgggggtctgcccggcctgagaggtttgtgtcacaggcgccggtgggagccttcttggctccaggactccgtggagggcaggctgcacgggagaccgtgtggaatacagaggccagccgtttctgggacgggcgagagtcgcagagcttctggggcggtgccatcttcgtatccagacaaccggccaccttcctg	599	66	11%	92	15%
14	7356301	7356450	gttagtgccatgccggcaagcctgtctaactgcaccaaggtaaaattagcattgattccatatttacgaaccgactcggcaatttccttaatttgtaagtattctaccggagcgtggacacgcccaccctcggctccttcaaagaccgg	149	18	12%	20	13%
14	9130951	9131250	tacttctgatagactgtcttgaatttccttagaaagttcaagatcagacttacctcgtaaagctgtactcactggtactctcgttccccagctgaaaagttctgaattcatacagttgaatccttcttaacagtctgctttacgggaacctttattaccgcgacccgcagttctggttctggaatgagggatcttccttgcgccagtcccgagttttttctcgtcccgggtttcggcaccaattgttattagacgcgttctcacgaccggccaggaaagacgcaacaaaccagaatctt	299	32	11%	32	11%
14	14153101	14153550	cttacgggtaccctgttccccagctgaagagttctgaattcacgcagttaaatccttctcaacagtctgtgttgcgggaacacttcattaccaccgttccccagctgaggagttctgaatccaggctggatccttctcaacagtctgttttacgggaacctttatgaccttgacccgcagttctggttctggaatgagggatcttccttgcgctggtgatggtaaattccgtcccgggttttctcgtcccgggatttctcgtcccaggtcttctcgtcccgggtctcagcaccaaCtcttacacgcgttcgcgaccggccaggaaagacgcaacaaaccggaatcttctgcggcaaaagctttattgcttacatcttcaggagccagagagcaagagtacaagagtgcaagagagcaagagagcaagagagcaagagagcaagagagca	449	44	10%	66	15%
14	18145501	18145650	ttctaccggagcgtggacacgcccaccctcggctccttcaaagaccggaaatgcctgttgtattttcctttgttcctctctgggaatgaatgagtctgcgcactgcctctctgcgcattgtctctctgcgcagggctgacgcactacgc	149	20	13%	14	9%
14	19415551	19419750	tttccatatcctaaagaaagagatgcccatgcacataccagaagcttacagaactccatatagactggaccagaaaagaaattcctcccgacacataataattagaacaacaaatgcactaaataaagacagaattcactgagaaaagtgaaaaacaagaaatgcacaatgtaggacctggaatatggcgagaaaactgaaaatcacggaaaatgagaaatacacactttaggacgtgaaatatgtcgaggaaaatggaaaaaggaggaaaatttagaaatgtccactgtaggacatggaatatggcaagaaaactgaaaatcatggaaaatgagaaacatccacttgacgacttgaaaaatgacgaaatcactgaaaaacatgaaaaataagaaatgcaaactgtaggccttggaatatggcgagaaaactgaaaatcacggaaaatgagaaatacacactttaggacattaaatatggcgaagaaaactgaagaagtttgaaaatttagaaatttccactgtaggacatggaatatgtcgagaaaactgaaaatcatggaaaattagatacatccacttgacgacttgaaaaatgacaaaatcactgaaaaacgtgaaaattgagaaatgcacactgtaggacctggaatatggcaagaaaactgaaaatcacagaaaatgagaataacactcgttaggtagtgaaatatgactagaaatattgaaaaacatgaaaaatgagaaatgcatactgtagtacctggaatatggccaagaaactgaaaatcacgaaacatgagaaatacacactttagggcgtgaaatatggtgaggaaaacttaaaaaggtggaaaataaaaaaaatgtccactgtaggacatggaatatggcaagaaaactgaaaatcatggaaaatgagaatcatccacttgaggacttgaaaaatgacgaaatcactgaaaaaagtgaaaaataagaaatgcacactataggaccagtatatggcgagaaaactgaaaatcacggaaaatgagaaatacacactttaggacgtgaaatatgacgagaaaactgaaaaaggtggaaaatttagaattgtctagtgtaggacatggaatatggcaagaaaactgataattatggaaaataagaaacatccacttgacgacttgaaaaatgacgaaatcactgaaacacatgaaaaatgagaaatgaacactataggacctggaatatggcgagaaaactgaaaatctcgggaaaatgagaaatacaaactttaggacaagaaatatggcaaggaaaactgaaaatgatggaaaatttagaaatttccactgtaggacatggaatatagcgagaaaactgaaaatcatggaaaatgagaaacatccacttgacgacttgaaaaatgacgaaatcactgaaaaacgtgaaaaatgagaaatgcatactgtaggacctggaatatggcgagaaaactgaaaatcacggaaaatgagaataacaattgttaggtagtgaaatataacaagaaatattgaaaatcgtgaaaaatgagaaatgcatactgtaggacctggaatatggcgagaaaactgaaaatcacggaaaatgagaaatagacactttattacatgaaatatggcaaggaaaactgaaaaaggtcgaaaatgtagaaatgtccactgtaggacatggaatatggcaagaaaactgaaaatcatggaaaatgagaaacatccacttgacgacttgaaaaatgacgaaatcactgaaaaacgtgaaaaatgagaaatgcacactgtaggacctggaatatggcgagaaaaatgaaaatcacagaaaatgagaataacagttgttaggtattgaaataggacgagaaatattgaaaatcgtgaaaaatgagaaatgcacactgtaggacctggaatatggcaagaaaacttaaaatcacggaaaatgagaaatacacactttattatgtgaaatatggcaaggaaaactgaaaaagttggaaaatttagaaatgtccactgtaggacatggaatatggcaagaaaactgaaaatcatggaaaatgagaaacatccactcgaggacttgaaaaaagactaaatcactgaaaaacgtgaaaaatgagaaatgcaaactgtaggacctcgaacatggcgagaaaactgaaaatcacggaaaatgagaaatacacactaaggacgggaaatatggcgaggaaaatagaaaaaggtggaaaatttagaaatgtccactgtaggacttggaatatggcaagaaaactgaaaattatggaaaatgagaaacatccacttgacgacttgaaaaatgacgaaatcactcaaaaacgtgaaaaatgagaaatgcacactgtagacctggaatatggcgagaaatctgaacttcttggaaaatgagaaatacacactttaggacatgaaataaagcgaggaaaactgaaaaaggtggaaattttagaaatttccactgtaggacatggaatatggcaagaaaactgaaaatcatggaaaatgagaacatccacttgaggacttgaaaaatgacgaaatcactgaaaaaagtgaaaaataagaaatgcacactgtaggacctggaatatggcaagaaatctgaaaatcacggaaaatgagaaatacacactttaggacgtgaactatggcgaggaaaactgaaaaaggtggaaaatttagaaatgtccactgtaggacatggaatatgactagaaaactgctaatcatggaaaatgacaaatatccacttgacgacttgaaaaatgacggaatcactgaaaaacgtgaaaaatgagaaatgcacaatgtagtacctgtaatatggaaagaaaactgaaaatcacgaaaataagaaatacacactttaggacgtgatatatggtgaggaaaactgaaaaaggtggaatatttagaaatgtgcactgtagaacatggaatatagcaagaaaactgaaaatcatgggaaattagaaacatccacttgacgacttgaaaaatgacgaaatcactgaaaaacgtgaaaaatgagaaatgcacactgtaggacctggaatatggagagaaaacggaaaatcacggaaaatgagaataacacacgttaggtagtgtaatatgatgagaaatattgaaaaacatgaaaaatgagaaatgaacactgtaggacctggaatatggcgagaaaactgaaaatcacggaaaatgagaaatacacacttaaggacgtgaaatatggcgaggaaaactgaaaaaggtggaaaatttagaaatgtccactgtaggacatggaatatggcaagaaaactgataatcatggaaaatcagaaacatccacttgacgacttgagaaatgacgaaatcactgaaaaacgtgaaaaatgagaaattcacactgtagtacctggaatatggcgaaaaaagtgaaaatcaaggaaaatgagaaatacacactgtagggtgtgaaatatggtgaggaaaactgaaaaaggtggaaaataaagaaatgtccactgtaggacatggaatatgttaagaaaactgaaaatcatgtaaaatgagaaacttccacttgaagacttgaaaaaagacgaaatcactgaaaaacgtgaaaaatgagaaatgcacactgtaggacctggaatctggcgagaaaactgaaaatcacggaaaatgagaaatacacacttaaaaacgtgaaatatggcgaggaaaactgaaagaggtggaaaatttagaaatgtccactgtaggacatggaatatggcaagaaaactgataatcatggaaaatgagaaacatccacttgacgacttgaaaaatgaaaaaaccactgaaaaacgtgaaaaatgcgaaatgcacactgtaggacctggactatggcaagaaaactgaaaatcacagaaaatgataataacactcgttaggtagtgaaatattactagaaatattgaaaaacgtgaaaaatgagaaatgcatactgtaggacctggaatatggccaagaaactgaaaatcacgaaaaatgagaaatacacactttaggacatgaaatatggcaaggaaaactgaaacaggtggaaaatttagaaatatccactgtaggaAAnnnnnnnnnnnnnnnnnnnnnnnnnnnnnnnnnnnnnnnnnnnnnn	4199	178	4%	442	11%
14	19415551	19419750	tttccatatcctaaagaaagagatgcccatgcacataccagaagcttacagaactccatatagactggaccagaaaagaaattcctcccgacacataataattagaacaacaaatgcactaaataaagacagaattcactgagaaaagtgaaaaacaagaaatgcacaatgtaggacctggaatatggcgagaaaactgaaaatcacggaaaatgagaaatacacactttaggacgtgaaatatgtcgaggaaaatggaaaaaggaggaaaatttagaaatgtccactgtaggacatggaatatggcaagaaaactgaaaatcatggaaaatgagaaacatccacttgacgacttgaaaaatgacgaaatcactgaaaaacatgaaaaataagaaatgcaaactgtaggccttggaatatggcgagaaaactgaaaatcacggaaaatgagaaatacacactttaggacattaaatatggcgaagaaaactgaagaagtttgaaaatttagaaatttccactgtaggacatggaatatgtcgagaaaactgaaaatcatggaaaattagatacatccacttgacgacttgaaaaatgacaaaatcactgaaaaacgtgaaaattgagaaatgcacactgtaggacctggaatatggcaagaaaactgaaaatcacagaaaatgagaataacactcgttaggtagtgaaatatgactagaaatattgaaaaacatgaaaaatgagaaatgcatactgtagtacctggaatatggccaagaaactgaaaatcacgaaacatgagaaatacacactttagggcgtgaaatatggtgaggaaaacttaaaaaggtggaaaataaaaaaaatgtccactgtaggacatggaatatggcaagaaaactgaaaatcatggaaaatgagaatcatccacttgaggacttgaaaaatgacgaaatcactgaaaaaagtgaaaaataagaaatgcacactataggaccagtatatggcgagaaaactgaaaatcacggaaaatgagaaatacacactttaggacgtgaaatatgacgagaaaactgaaaaaggtggaaaatttagaattgtctagtgtaggacatggaatatggcaagaaaactgataattatggaaaataagaaacatccacttgacgacttgaaaaatgacgaaatcactgaaacacatgaaaaatgagaaatgaacactataggacctggaatatggcgagaaaactgaaaatctcgggaaaatgagaaatacaaactttaggacaagaaatatggcaaggaaaactgaaaatgatggaaaatttagaaatttccactgtaggacatggaatatagcgagaaaactgaaaatcatggaaaatgagaaacatccacttgacgacttgaaaaatgacgaaatcactgaaaaacgtgaaaaatgagaaatgcatactgtaggacctggaatatggcgagaaaactgaaaatcacggaaaatgagaataacaattgttaggtagtgaaatataacaagaaatattgaaaatcgtgaaaaatgagaaatgcatactgtaggacctggaatatggcgagaaaactgaaaatcacggaaaatgagaaatagacactttattacatgaaatatggcaaggaaaactgaaaaaggtcgaaaatgtagaaatgtccactgtaggacatggaatatggcaagaaaactgaaaatcatggaaaatgagaaacatccacttgacgacttgaaaaatgacgaaatcactgaaaaacgtgaaaaatgagaaatgcacactgtaggacctggaatatggcgagaaaaatgaaaatcacagaaaatgagaataacagttgttaggtattgaaataggacgagaaatattgaaaatcgtgaaaaatgagaaatgcacactgtaggacctggaatatggcaagaaaacttaaaatcacggaaaatgagaaatacacactttattatgtgaaatatggcaaggaaaactgaaaaagttggaaaatttagaaatgtccactgtaggacatggaatatggcaagaaaactgaaaatcatggaaaatgagaaacatccactcgaggacttgaaaaaagactaaatcactgaaaaacgtgaaaaatgagaaatgcaaactgtaggacctcgaacatggcgagaaaactgaaaatcacggaaaatgagaaatacacactaaggacgggaaatatggcgaggaaaatagaaaaaggtggaaaatttagaaatgtccactgtaggacttggaatatggcaagaaaactgaaaattatggaaaatgagaaacatccacttgacgacttgaaaaatgacgaaatcactcaaaaacgtgaaaaatgagaaatgcacactgtagacctggaatatggcgagaaatctgaacttcttggaaaatgagaaatacacactttaggacatgaaataaagcgaggaaaactgaaaaaggtggaaattttagaaatttccactgtaggacatggaatatggcaagaaaactgaaaatcatggaaaatgagaacatccacttgaggacttgaaaaatgacgaaatcactgaaaaaagtgaaaaataagaaatgcacactgtaggacctggaatatggcaagaaatctgaaaatcacggaaaatgagaaatacacactttaggacgtgaactatggcgaggaaaactgaaaaaggtggaaaatttagaaatgtccactgtaggacatggaatatgactagaaaactgctaatcatggaaaatgacaaatatccacttgacgacttgaaaaatgacggaatcactgaaaaacgtgaaaaatgagaaatgcacaatgtagtacctgtaatatggaaagaaaactgaaaatcacgaaaataagaaatacacactttaggacgtgatatatggtgaggaaaactgaaaaaggtggaatatttagaaatgtgcactgtagaacatggaatatagcaagaaaactgaaaatcatgggaaattagaaacatccacttgacgacttgaaaaatgacgaaatcactgaaaaacgtgaaaaatgagaaatgcacactgtaggacctggaatatggagagaaaacggaaaatcacggaaaatgagaataacacacgttaggtagtgtaatatgatgagaaatattgaaaaacatgaaaaatgagaaatgaacactgtaggacctggaatatggcgagaaaactgaaaatcacggaaaatgagaaatacacacttaaggacgtgaaatatggcgaggaaaactgaaaaaggtggaaaatttagaaatgtccactgtaggacatggaatatggcaagaaaactgataatcatggaaaatcagaaacatccacttgacgacttgagaaatgacgaaatcactgaaaaacgtgaaaaatgagaaattcacactgtagtacctggaatatggcgaaaaaagtgaaaatcaaggaaaatgagaaatacacactgtagggtgtgaaatatggtgaggaaaactgaaaaaggtggaaaataaagaaatgtccactgtaggacatggaatatgttaagaaaactgaaaatcatgtaaaatgagaaacttccacttgaagacttgaaaaaagacgaaatcactgaaaaacgtgaaaaatgagaaatgcacactgtaggacctggaatctggcgagaaaactgaaaatcacggaaaatgagaaatacacacttaaaaacgtgaaatatggcgaggaaaactgaaagaggtggaaaatttagaaatgtccactgtaggacatggaatatggcaagaaaactgataatcatggaaaatgagaaacatccacttgacgacttgaaaaatgaaaaaaccactgaaaaacgtgaaaaatgcgaaatgcacactgtaggacctggactatggcaagaaaactgaaaatcacagaaaatgataataacactcgttaggtagtgaaatattactagaaatattgaaaaacgtgaaaaatgagaaatgcatactgtaggacctggaatatggccaagaaactgaaaatcacgaaaaatgagaaatacacactttaggacatgaaatatggcaaggaaaactgaaacaggtggaaaatttagaaatatccactgtaggaAAnnnnnnnnnnnnnnnnnnnnnnnnnnnnnnnnnnnnnnnnnnnnnn	4199	178	4%	442	11%
14	19415551	19419750	tttccatatcctaaagaaagagatgcccatgcacataccagaagcttacagaactccatatagactggaccagaaaagaaattcctcccgacacataataattagaacaacaaatgcactaaataaagacagaattcactgagaaaagtgaaaaacaagaaatgcacaatgtaggacctggaatatggcgagaaaactgaaaatcacggaaaatgagaaatacacactttaggacgtgaaatatgtcgaggaaaatggaaaaaggaggaaaatttagaaatgtccactgtaggacatggaatatggcaagaaaactgaaaatcatggaaaatgagaaacatccacttgacgacttgaaaaatgacgaaatcactgaaaaacatgaaaaataagaaatgcaaactgtaggccttggaatatggcgagaaaactgaaaatcacggaaaatgagaaatacacactttaggacattaaatatggcgaagaaaactgaagaagtttgaaaatttagaaatttccactgtaggacatggaatatgtcgagaaaactgaaaatcatggaaaattagatacatccacttgacgacttgaaaaatgacaaaatcactgaaaaacgtgaaaattgagaaatgcacactgtaggacctggaatatggcaagaaaactgaaaatcacagaaaatgagaataacactcgttaggtagtgaaatatgactagaaatattgaaaaacatgaaaaatgagaaatgcatactgtagtacctggaatatggccaagaaactgaaaatcacgaaacatgagaaatacacactttagggcgtgaaatatggtgaggaaaacttaaaaaggtggaaaataaaaaaaatgtccactgtaggacatggaatatggcaagaaaactgaaaatcatggaaaatgagaatcatccacttgaggacttgaaaaatgacgaaatcactgaaaaaagtgaaaaataagaaatgcacactataggaccagtatatggcgagaaaactgaaaatcacggaaaatgagaaatacacactttaggacgtgaaatatgacgagaaaactgaaaaaggtggaaaatttagaattgtctagtgtaggacatggaatatggcaagaaaactgataattatggaaaataagaaacatccacttgacgacttgaaaaatgacgaaatcactgaaacacatgaaaaatgagaaatgaacactataggacctggaatatggcgagaaaactgaaaatctcgggaaaatgagaaatacaaactttaggacaagaaatatggcaaggaaaactgaaaatgatggaaaatttagaaatttccactgtaggacatggaatatagcgagaaaactgaaaatcatggaaaatgagaaacatccacttgacgacttgaaaaatgacgaaatcactgaaaaacgtgaaaaatgagaaatgcatactgtaggacctggaatatggcgagaaaactgaaaatcacggaaaatgagaataacaattgttaggtagtgaaatataacaagaaatattgaaaatcgtgaaaaatgagaaatgcatactgtaggacctggaatatggcgagaaaactgaaaatcacggaaaatgagaaatagacactttattacatgaaatatggcaaggaaaactgaaaaaggtcgaaaatgtagaaatgtccactgtaggacatggaatatggcaagaaaactgaaaatcatggaaaatgagaaacatccacttgacgacttgaaaaatgacgaaatcactgaaaaacgtgaaaaatgagaaatgcacactgtaggacctggaatatggcgagaaaaatgaaaatcacagaaaatgagaataacagttgttaggtattgaaataggacgagaaatattgaaaatcgtgaaaaatgagaaatgcacactgtaggacctggaatatggcaagaaaacttaaaatcacggaaaatgagaaatacacactttattatgtgaaatatggcaaggaaaactgaaaaagttggaaaatttagaaatgtccactgtaggacatggaatatggcaagaaaactgaaaatcatggaaaatgagaaacatccactcgaggacttgaaaaaagactaaatcactgaaaaacgtgaaaaatgagaaatgcaaactgtaggacctcgaacatggcgagaaaactgaaaatcacggaaaatgagaaatacacactaaggacgggaaatatggcgaggaaaatagaaaaaggtggaaaatttagaaatgtccactgtaggacttggaatatggcaagaaaactgaaaattatggaaaatgagaaacatccacttgacgacttgaaaaatgacgaaatcactcaaaaacgtgaaaaatgagaaatgcacactgtagacctggaatatggcgagaaatctgaacttcttggaaaatgagaaatacacactttaggacatgaaataaagcgaggaaaactgaaaaaggtggaaattttagaaatttccactgtaggacatggaatatggcaagaaaactgaaaatcatggaaaatgagaacatccacttgaggacttgaaaaatgacgaaatcactgaaaaaagtgaaaaataagaaatgcacactgtaggacctggaatatggcaagaaatctgaaaatcacggaaaatgagaaatacacactttaggacgtgaactatggcgaggaaaactgaaaaaggtggaaaatttagaaatgtccactgtaggacatggaatatgactagaaaactgctaatcatggaaaatgacaaatatccacttgacgacttgaaaaatgacggaatcactgaaaaacgtgaaaaatgagaaatgcacaatgtagtacctgtaatatggaaagaaaactgaaaatcacgaaaataagaaatacacactttaggacgtgatatatggtgaggaaaactgaaaaaggtggaatatttagaaatgtgcactgtagaacatggaatatagcaagaaaactgaaaatcatgggaaattagaaacatccacttgacgacttgaaaaatgacgaaatcactgaaaaacgtgaaaaatgagaaatgcacactgtaggacctggaatatggagagaaaacggaaaatcacggaaaatgagaataacacacgttaggtagtgtaatatgatgagaaatattgaaaaacatgaaaaatgagaaatgaacactgtaggacctggaatatggcgagaaaactgaaaatcacggaaaatgagaaatacacacttaaggacgtgaaatatggcgaggaaaactgaaaaaggtggaaaatttagaaatgtccactgtaggacatggaatatggcaagaaaactgataatcatggaaaatcagaaacatccacttgacgacttgagaaatgacgaaatcactgaaaaacgtgaaaaatgagaaattcacactgtagtacctggaatatggcgaaaaaagtgaaaatcaaggaaaatgagaaatacacactgtagggtgtgaaatatggtgaggaaaactgaaaaaggtggaaaataaagaaatgtccactgtaggacatggaatatgttaagaaaactgaaaatcatgtaaaatgagaaacttccacttgaagacttgaaaaaagacgaaatcactgaaaaacgtgaaaaatgagaaatgcacactgtaggacctggaatctggcgagaaaactgaaaatcacggaaaatgagaaatacacacttaaaaacgtgaaatatggcgaggaaaactgaaagaggtggaaaatttagaaatgtccactgtaggacatggaatatggcaagaaaactgataatcatggaaaatgagaaacatccacttgacgacttgaaaaatgaaaaaaccactgaaaaacgtgaaaaatgcgaaatgcacactgtaggacctggactatggcaagaaaactgaaaatcacagaaaatgataataacactcgttaggtagtgaaatattactagaaatattgaaaaacgtgaaaaatgagaaatgcatactgtaggacctggaatatggccaagaaactgaaaatcacgaaaaatgagaaatacacactttaggacatgaaatatggcaaggaaaactgaaacaggtggaaaatttagaaatatccactgtaggaAAnnnnnnnnnnnnnnnnnnnnnnnnnnnnnnnnnnnnnnnnnnnnnn	4199	178	4%	442	11%
14	19470001	19470150	gtgtcacaggcgccggcgggacccttcttggctccgggactccgtggagggcaggctgcacgggagaccgtgtggaatacagaggccagccgtttctgggacgggtgagagtcgcagagcttctgggacggcgccatcttcgtctccag	149	26	17%	18	12%
14	19517851	19518300	cctcagtcctccgagcaccttccctcccagaggagagcttgcctccagggagtgctttaaccccaggaCtctctcccgagctagtatctcaccggcaagaattcactcggacaaccggatccttctacggcaaagcttttattgcttccacataaggaagaccccgaacccggaaaatggtgctgcttatatagcccgcagcgtgacggttcagcacctgatgtggcgtgacagcacctgattagttgctcgcccatcaccccattactacgccccgagatgggcagtgactgggcgtgaatttactcttgcacttgcgcataaggcttgtttactagttaggctcagtggaagccggcgccatcttataatggcgattgctaatggcacggctctccacatttccccctttttattttattaaaatttgaggctggtctaggcctctg	449	42	9%	56	12%
14	20280901	20281350	cagactgggaggaagaagcagctcattatgagaaaaaagggtaccagccaggtaaagtgctagctaatcagttaaggaagccaaaagcggctggcgaaggccagtttgctgattggcctcagggcagtcggtttcaaggtccgccctatgcggagcccccgccctgcgtagtgcgtcagcaatgcgcagagagatgcgcagagaggcaatgcgcagagagatgcgcagagaggcagtgcgcagagaggcagtgcgcagagaggcagtgcgcagactcattcattcccagagaggaacaaaggaaaatacaacaggcatttccggtctttgaaggagccgagggtgggcgtgtccacgctccggtagaatacttacaaattaaagaaattgccgagtcggtccgtaaatacggaaccaatgctaattttaccttggtgcagttagacagg	449	48	11%	72	16%
14	21360451	21360900	ctgcgcatgtgccgagggtggttcttcactccatgtgctctgccttcctcgtgacgtcaactcggccgatgggctgcagccaatcagggagtgacacgtcctaggcgaaggagaattctccttaatagggacggggtttcgttttctctctctcttgcttcttgcgctcttgcttcttgcactctggctcctgaagatgtaagcaataaagctttgccgcagaagattctggtttgttgcgtctttcctggccggtcgtgagaacgcgtctaataacaATtggtgctgagacccgggacgggacgagaagacctgggacgagaaattccgggacgagaaattccgggacgagaaattccgggacgagaaattccgggacgagaaaaaatccgggaagaaaaaacccgggaggaaactcgggacgggagtttcaccggcgcaaggaagat	449	70	16%	28	6%
14	24416401	24417000	ccttataaagctattttccactttacttctgatagactgtcttgaatttccttagaaagttcaaggccaggcttacctcgtaaagctatacttacgggttaccgccgttccccagctgaaaagttctgaattcatgtagttgaatcttttttaacagtctgctttacgggaacctttattaccgcgacccgcagttctggttctggaatgagggatcttccttgcgccggtgaaactctcgtcccgagtttcctcccgggttttttcttttcggattttttctcgtcccggaatttttcgtcccgggtttcggcaccaattcttaatcgcgttctcacgcccggccaggaaagacgcaacagaccagaatcttctgcggcaaaactttattgcttacatctttgggagccaggagggcaagcgcccagcgcccagccccaaaaacgaaaagccccttctattacatctttaggagccagagctccggcgcgcgcgctctattgtttacatctttaggcagcgagcgagcgcagggcgcgcagagccagagagatgccagcgagagagaaatggcggaaacccgtccccttttttaggag	599	82	14%	58	10%
14	25706701	25707150	ttaaaagggacggggttttgccattctttttctctctcttgttcttgctttttctctctcttgctttcttgttctttttctctctcttgctttcttgttcttgttctttttctctctcttgctttcttgttcttgttccttttctctctcttgctctctggctctctggctcctgaaaatgtaagcaataaagctttgccgcagaagattccggtttgttgcgttcttcctggccggtcgcgagaacgcgtgtaagaGTtggtgctgagacccgggacgggacgagaagacccgggacgagaagacctgggacgagaagacctgggacaagaagacctgggacaagaaaacctgggacgGTTACCATCACTCATGTTTAGTGCAGTCAGCCCAGTGTGTGCGAGCGTCTTTTCCTGTCACAGAAGATTTTGCGCCCTCAGTCTATAGCT	449	38	8%	28	6%
14	26325751	26326050	agactattttattatcctgagcttttgttcctgccggcaagaacacactcagtgacaaccggaatcttctgcggcaaaaagctttattgcttacttatcaggagggaagaccccaaaccgggaaaatggcgctgcttatatagcccgcagcatgacgtttcagcacctgatgtggcgtgacagctcctgattcgttgctcgcccatcaccccattactacgctgtgagatgggcagtgactaggcgtgagttcactcttgcacttgcgcataaggcttgtttactagttaggcgcagtg	299	28	9%	42	14%
14	31171201	31171350	TTCAGAAAAGGACGTGGGGGTTATCAGGTCCACAGCGCCACGCTAACAACAGCATCAATCACAGACAAAACAATGCTGGCGCGTCTGACCATGCCACTTCAGAGGCAGGCGACACAAGGGACGCTAACAGCACAAGGACGCTCTGGTGG	149	16	11%	44	30%
14	34387501	34389000	gatctccatttcacatatttgcccatactagggagagcggcttttgcaatcatttgccagtcggcaggagttagtgccatgccggcaagcctgtctaactgcaccaaggtaaaattagcattggttccgtatttacggaccgactcagcaatttctttaatttgtaagtattctaccggagcgtggacacgcccaccctcggctccttcaaagaccggaaatgcctgttgtattttcctttgttcctctctgggaatgaatgagtctgcgcactgcctctctgcgcactgcctctctgcgcattgctgacgcactacgcagggcggggactccgcatagggcggaccttgaagccgactgccctgaggccaatcagcaaactggccttcgccagccgcttttggcttttttcttgaccaattagctggctggtaatgggctgcttcttcctcccagtctgtttcctcagaggagaatttttcacctgcttcagagctactaagagctggctccccgagcccatccagcgatgagcacaggctcctttttctagagacctccgctaattgatttttcttcttttccctttttcctctttttcttctaatctctctccaggtattcttacctaaccttaacttttcctcgggttcaagacccttggaaaggcctgtatacttattttgtgtaccatatttcctctttgttcctactctctctccccgctttacttctgatagcttgtcctgaatttcctctagaattttcagccctatcttaatcacttgataacatgtgaaaaggaacaaaagggctcctaacaccagaaaaaattcaaggccaaacatattccactttacttctgatagactgtcttgaatttcgttagaaagttcaaggccaggcttacctcgtaaagctgtactcactggtactctcgttccccagctgaaaagttctgaattcatacagttgaatccttcttaacagtctgctttacgggaacctttatcaccgtcgttccccagctgatgagttctgaattcggcagttgaatccttctcaacagtctgctttacgggaacctttatcaccgtcgttccccagctgatgagttctgaattcggcagttgaatccttctcaacagtctgtgttacgggaacctttataaacgtgatccgcagttctggttccggaatgagggatcctccttgcgccagtcccgagtttttttctcgtcccgggtttcggcaccaattgttattagacgcgttctcacgaccggccaggaagaacaccacagaccagaatcttctgcggcaaagctttattcttacatcttcaggagcagagtgcaagaagcaagagagcaagaagcaagagagtaagaagcaagagagagagaaaagcaagagagagagaaaacgaaaccccgtccctttttaaggagaattctccttcgcctcggacgtgtcactccctgattggctgcagccca	1499	114	8%	180	12%
14	34387501	34389000	gatctccatttcacatatttgcccatactagggagagcggcttttgcaatcatttgccagtcggcaggagttagtgccatgccggcaagcctgtctaactgcaccaaggtaaaattagcattggttccgtatttacggaccgactcagcaatttctttaatttgtaagtattctaccggagcgtggacacgcccaccctcggctccttcaaagaccggaaatgcctgttgtattttcctttgttcctctctgggaatgaatgagtctgcgcactgcctctctgcgcactgcctctctgcgcattgctgacgcactacgcagggcggggactccgcatagggcggaccttgaagccgactgccctgaggccaatcagcaaactggccttcgccagccgcttttggcttttttcttgaccaattagctggctggtaatgggctgcttcttcctcccagtctgtttcctcagaggagaatttttcacctgcttcagagctactaagagctggctccccgagcccatccagcgatgagcacaggctcctttttctagagacctccgctaattgatttttcttcttttccctttttcctctttttcttctaatctctctccaggtattcttacctaaccttaacttttcctcgggttcaagacccttggaaaggcctgtatacttattttgtgtaccatatttcctctttgttcctactctctctccccgctttacttctgatagcttgtcctgaatttcctctagaattttcagccctatcttaatcacttgataacatgtgaaaaggaacaaaagggctcctaacaccagaaaaaattcaaggccaaacatattccactttacttctgatagactgtcttgaatttcgttagaaagttcaaggccaggcttacctcgtaaagctgtactcactggtactctcgttccccagctgaaaagttctgaattcatacagttgaatccttcttaacagtctgctttacgggaacctttatcaccgtcgttccccagctgatgagttctgaattcggcagttgaatccttctcaacagtctgctttacgggaacctttatcaccgtcgttccccagctgatgagttctgaattcggcagttgaatccttctcaacagtctgtgttacgggaacctttataaacgtgatccgcagttctggttccggaatgagggatcctccttgcgccagtcccgagtttttttctcgtcccgggtttcggcaccaattgttattagacgcgttctcacgaccggccaggaagaacaccacagaccagaatcttctgcggcaaagctttattcttacatcttcaggagcagagtgcaagaagcaagagagcaagaagcaagagagtaagaagcaagagagagagaaaagcaagagagagagaaaacgaaaccccgtccctttttaaggagaattctccttcgcctcggacgtgtcactccctgattggctgcagccca	1499	114	8%	180	12%
14	37234801	37235250	cttcgtgccaaagcgctttccattccatatatttgcccatactagggagagcggcttttacaaccgtctgccaatcggcaggagttagtgccatgccagcgagcctgtctaactgcgccaaggtaaaattagcattggttccgtatttacgaaccgactcggcaatttccttaatctgtacgtattctaccggagcgtggacacgcccaccctcggctccttcaaagactggaaatgcctgttctattttcctttgttcctctcggggaatgaatgagtctgcgcactgcctctctgcgcattgctgacgcactacgggctgacgcactacgcagggcggggactccgcatagggcgggagtgcacctggtagccgattgccctgaggccaattagcaaactggccttcgccagccgcttttggcttttttcttgaccgattagctggc	449	60	13%	50	11%
14	37625251	37626300	tgtctaactgcaccaaggtaaaattagcattggttccatatttacggaccgactcggcaatttctttaatttgtaagtattctaccggagcgtggacacgcccaccctcggctccttcaaagaccggaaatgcctgttgtattttcctttgttcctctctgggaatgaatgagtctgcgcactgcctctctgcgcactgcctctctgcgcattgctgacgcactacgcagggcggggactccgcatagggcggaccttgaagccgactgccctgaggccaatcagcaaactggccttcgccagccgcttttggcttttttcttgaccaattagctggctggtaatgggctgcttcttcctcccagtctgtttcctcagaggagaattcttcatctgcttcagaactactaagagctggcttcctgagctcatctagtgacgagtatctcctagagacctccgctaattgatctttcttcttttccctttttcctctttttcttctaatctctctccaggtattcctacctaaccttaacttttcctcgggttcaagacccttggaaaggcctgtatacttattttgtgtaccatattttctctttgctcctactctctctccccgctttacttctgatagcttgtcctgaatttcatctagaatcctccctatcttaaccacttgataacatgtgaaaaggaacaaaagggctcctaacaccagaaaaaattcaaggccaaacatattccactttacttctgatagactgtcttgaatttccttagaaagttcaagatcagacttacctcgtaaagctgtactcactggtactctcgttccccagctgaaaagttctgaattcatacagttgaatccttcttaacagtctgctttacgggaacctttattaccgcgacccgcagttctggttctggaatgagggatcttccttgcaccagtcccgagttttttctcgtcccggaattcggcaccaattgttattagacgcgttctcacgaccggccaggaagaacaccacagaccagaa	1049	74	7%	110	10%
14	37625251	37626300	tgtctaactgcaccaaggtaaaattagcattggttccatatttacggaccgactcggcaatttctttaatttgtaagtattctaccggagcgtggacacgcccaccctcggctccttcaaagaccggaaatgcctgttgtattttcctttgttcctctctgggaatgaatgagtctgcgcactgcctctctgcgcactgcctctctgcgcattgctgacgcactacgcagggcggggactccgcatagggcggaccttgaagccgactgccctgaggccaatcagcaaactggccttcgccagccgcttttggcttttttcttgaccaattagctggctggtaatgggctgcttcttcctcccagtctgtttcctcagaggagaattcttcatctgcttcagaactactaagagctggcttcctgagctcatctagtgacgagtatctcctagagacctccgctaattgatctttcttcttttccctttttcctctttttcttctaatctctctccaggtattcctacctaaccttaacttttcctcgggttcaagacccttggaaaggcctgtatacttattttgtgtaccatattttctctttgctcctactctctctccccgctttacttctgatagcttgtcctgaatttcatctagaatcctccctatcttaaccacttgataacatgtgaaaaggaacaaaagggctcctaacaccagaaaaaattcaaggccaaacatattccactttacttctgatagactgtcttgaatttccttagaaagttcaagatcagacttacctcgtaaagctgtactcactggtactctcgttccccagctgaaaagttctgaattcatacagttgaatccttcttaacagtctgctttacgggaacctttattaccgcgacccgcagttctggttctggaatgagggatcttccttgcaccagtcccgagttttttctcgtcccggaattcggcaccaattgttattagacgcgttctcacgaccggccaggaagaacaccacagaccagaa	1049	74	7%	110	10%
14	38109151	38109900	agtgcttgagtgagggtctcccttcgggggtctttcatttggtgcattggccgggaatcagcgcgactacccagaggtcctagacccacttagaggtaagattctttgttctgttttggtctgatgtctgtgttctgtttctaagtttggtgcgatcgcagtttcggttttgcggacgctcagtgagaccgcgctctgagagggaacgcggggtggataaggatagacgtgtccaggtgtccaccgtccgttcaccctgggagacgtcccagggggaacaggggaggaccagggacgcctggtggacccctttggaggccaagagaccatttggggttgcgagatcgtgggtttgagtcccacctcgtgcccagttgcgagatcgtgggttcgagtcccgcctcgtgttttgttgcgagatcgtgggtttgagtcccacctcgcgccttgttgcgagaccgtgggttcgagtcccacctcgcgtttggtcacgggatcgtgggttcgagtcccacctcatgcagagggtctcaatcggccagccttagagaggccatctgattctttgagttgcttgtggtcgacgcggagtcgccgccgtttctggtttcttttttgtcttagtctcgtgtccgctcttgttgtgactactgtttttctagaaatgggacaatctgtgtccactcccctttctctgactctggagcattggaaggaggtgcgggtcagagcccacaaccagtcggtgg	749	98	13%	66	9%
14	38109151	38109900	agtgcttgagtgagggtctcccttcgggggtctttcatttggtgcattggccgggaatcagcgcgactacccagaggtcctagacccacttagaggtaagattctttgttctgttttggtctgatgtctgtgttctgtttctaagtttggtgcgatcgcagtttcggttttgcggacgctcagtgagaccgcgctctgagagggaacgcggggtggataaggatagacgtgtccaggtgtccaccgtccgttcaccctgggagacgtcccagggggaacaggggaggaccagggacgcctggtggacccctttggaggccaagagaccatttggggttgcgagatcgtgggtttgagtcccacctcgtgcccagttgcgagatcgtgggttcgagtcccgcctcgtgttttgttgcgagatcgtgggtttgagtcccacctcgcgccttgttgcgagaccgtgggttcgagtcccacctcgcgtttggtcacgggatcgtgggttcgagtcccacctcatgcagagggtctcaatcggccagccttagagaggccatctgattctttgagttgcttgtggtcgacgcggagtcgccgccgtttctggtttcttttttgtcttagtctcgtgtccgctcttgttgtgactactgtttttctagaaatgggacaatctgtgtccactcccctttctctgactctggagcattggaaggaggtgcgggtcagagcccacaaccagtcggtgg	749	98	13%	66	9%
14	41459551	41459700	ggtttcccccaagcactccatgcctcaagacaatgttgaatcacatgtgaggctttttctccggttaacggagaggcaaacatgatgccagaacatgtgtcaatggacacatggagatattgaagttttccaaaggaagaaacatgtgt	149	4	3%	32	21%
14	41723851	41724300	accttcctggtgagagcacgggggtctgccaggcctgagaggtttgtggcacaggcgccggcgggagccgtcttggctccgggactccgcggagggcaggctgcacgggtgaccgtgtggaatacagagtgccagccgtttctgggacgggcgagagtcgcagagcttctgggcggcgccatcttcagctccagatagccggccaccttcctggtgagagcacgggggtctgcccggcctgagaggtttgtggcacaggcgccggcgggagccttcttggctccgggactccgcggagggcaggctgcacgggtgaccgtgtggaatacagagtgccagccgtttctgggacgggcgagagtcgcagagcttctgggcggcgccatcttcagctccagatagccggccaccttcctggtgagagcacgggggtctgcccggcctgagag	449	72	16%	52	12%
14	42319801	42321450	taactgcaccaaggtaaaattagcattggttccgtatttacggaccgactccgcgagttctttaatctgcacgtattctaccggagcgtggacacgcccaccctcggctccttcaaagactggaaatgcctgttgtattttcctttgttcctctctgggaatgaatgagtctgcgcactgcctctctgcgcactgtctctctgcgcactgcctctctgcgcactgcctctctgcgcactgcctctctgcgcattgctgacgcactacgcagggcgggggctccgcatagggcggaccttgaaaccgactgcccggaggttgaacagtacgctggctttcgccagccacttttggcttttttcttgaccaattagctggctggtaatgggctgcttcttcctcccagtctgtttcctcagaggagaattcttcatctgcttcagagctactaagagctggcttcctgagctcatctagtgacgagtatctcctagagacctccgctaatcgatcttttttcttttcttttttcttttccttccttctaatctctccccaggtattcttacctgacctaaacttttcctcgggttcaagacccttggaaaggcctgtatacttattttgtgtaccatattttctctttgtcctactctctctccccgctttacttctgatagattgtcctgaatttcatctagaatccgccctgccttaaccacttgataacatgtgaaaaggaacaaaagggcttctaacactagaaaaaattcaaggccaaacataccttgtaaagccatttcccactttacttctgatagactgtcttgactttccttagaaagttcaagaccagacttaccttgtaaagctattttccactttacttctgatagactgtcttgaatctcgttagaaagttcaaggccagacttaccttgtaaagctatacttacgggttaccgccgttccccagctgaaaagttctgaattcacgcagttgaatccttctcaacagtctgctttacgggaacctttattaccgtgacccgcagttctggttctggaatgagggatcttccttgcgccggtgaaactcccgtcccgagtttcctcccgggttttttcttcccggattttctcgtcccggaatttctcgtcccggattttctcgtcccggatttcggcaccaattcttatacgcgttctcacgaccggccaggaaagaacacaacaaaccagaatcttctgcggcaaaactttattgcttacatcttcaggagccaggagcgcaaacccccagccccaaaagcgaaagccaccccttcttacatctttaggagccagagctccggcgcgccaaagcgcagagcgcgctctattgtttacatctttaggcagcgagagagcgcagggcgcgcagagccagagagatgccagcgagagagaatggcggaaaccccgtcccctttaaggaggagttatccttcgcttaggacgcatcactccctgattggctgcagcccatggccgagctgacgttcacgggaaaggcagagtacaagtagtcgtaaaatacccttggcacatgcgcagattatttgtttaccacttagaacacaggatgtcagcgccatcttgtgacggcg	1649	164	10%	180	11%
14	43308001	43308450	atgtaggggcttgaacaataaatgaaacagatgtacatcttggtcttcatgtgggtgactaacaattggagtgggtgctgcctcggatttagactctgttactgaaagaacctagtggggaaacccccactcaatttccgttaggtgcgcacccaagaatcacgaacagacgactatcatgatgtaaatgcatgaggtagtttaatgatggagctccgggccgacacgtatgtcccgcaggagacagaggtttcgaccacatggtggagccataatggcggagctccggttcgaaacgtatctcacacaggacacagtgttttccaccccgaggcttggaagctagggacttttatagaaaaggggtggggctgggggaggaattggcgtggttttacatgattggtccatttaaacatcaacagactgtctgaagggcgggagatagg	449	34	8%	60	13%
14	44676751	44677200	caatcgcatgtgtgccgccagtaatctctgaggagagccgtgtgtgccgcgagcaatcgccattataagatggcgcgggcctccgctgtgcctaactagtaaacaagccttgtacgcaggtgcaagagtgaattcactcctagtcactcccattctcggggtgtaatagtggggtgatgggcaagcaacgaatcgggagctgtcacgccatatcaggagctgaaacgtcatgctgcgggttataaaagcagcgccattttcctggtttggagtcttcctgagaagcaagcaataaagcttttgccgcggaagattctggtttgttgcgtctttcttgccggtcgagcgggacgcaataTCCACACAttcattttctctttccatcttgtttctttatacttgctcattgcttctaagactcaggtattatgttgaataaggtagagaga	449	48	11%	58	13%
14	46211701	46211850	tgatctggggcacaagtcccttccgctcgactcgagactcgagccccgggctaccttgccagcagagtcttgcccaacacccgcaagggcccacacgggactccccacgggaccctaagacctctggtgagtggaccacagtgcctgcc	149	16	11%	24	16%
14	53568001	53568450	accccgcctccttactacctgaggctgacgaggcccctgcacataagtgtaaagaaatactggcagaagagactagaatccggccagacctcacagaccaaccttggccaggggcgatgacttggttcacggacggaagcagctttgtggtagaaggtaagcggaaggctggggcggcagtagtggatggaaaggctgtcatatgggccagcagtctgccggagggtacatcagctcaaaaagcggaactaatcgcattaattcaagccttaaggctggcagaaggaagggctcttaatgtctataccgacagccggtacgcttttgccacggctcatgttcacggagcaatataccgacaccgtggactgctgacgtctgccggcaaagatatcaaaaataaagaagaaattctcagcttattagaagctgttcatttgccccgtagg	449	42	9%	60	13%
14	55979401	55979550	gctgtgggaagacgacggtctatttccccacaggctgcacccttggaagacattccgagggagaccctggagtgcccggggtacggaacagtcaggaggacctggctgttgcctggcagagtgaagaagagtgagtgctcttcctgcca	149	10	7%	16	11%
14	58052701	58053000	tctgccttccccgtgacgtcaactcggccgatgggctgcagccaatcagggagtgacacgtcctaggcgaaggagaattctctttaatagggacggggtttcgttttctctctctcttgcttcttgctctcttgcttcttgcactctggctcctgaagatgtaagcaataaagctttgccgcagaagattctggtctgtggtgtctttcctggccggtcgtgagaacgcgtctaataacaattggtgccgaaacccgggacgagaaaaaaactcgggactggcgcaaggaagatccctc	299	36	12%	20	7%
14	65178301	65178750	ACTctccacatcctcccaactccccggtgttggagtgtccaggaatgagttctgaactcttcttcctctttatAAGATGTCACAGGGTATCAAGTATCATCTGTGCGTGCTgctgggcgtgatggcgcacacctttaatcccagcactcgggaggcagaggcaggcggatttctgagttcgaggccagtctggtttataaagttcttattcgcgttctcacgaccggccaggaaagaacacaacaaaccagaatcttctgcggcaaaactttattgcttacatcttcaggagcaggagcgcaaaaacccaagccccaaaaacgaaagcccccttctaacatctttaggagccagagcgcgccagagcgccagagcaagagctctattgtttacatctttaggagcaagcgagcaggcgccagagccagagagagaatggcggaaacccc	449	40	9%	76	17%
14	65182801	65183550	ttctgatagactgtcttgaatttcgttagaaagttcaaggccagacttaccttgtaaagctattttccactttacttctgatagactgtcttgaatctcgttagaaagttcaaggccagacttaccttgtaaagctatacttacgggttaccgccgttccccagctgaaaagttctgaattcacgcagttgaatccttctcaacagtctgttttacgagaacacttcattaccgtgacccgcagttctggttccggaatgagggatcttccttgcgccggtgatggtaaactctcgtcccgagtttttcttcccgggtttcctcttcccggattttctcgtcccggaatttctcgtcccggaattcggcaccaattcttattcgcgttctcacgaccggccaggaaagaacacaacaaaccagaatcttctgcggcaaaactttattgcttacatcttcaggagcaggagcgcaaaaacccaagccccaaaaacgaaagcccccttctaacatctttaggagccagagcgcgccagagcgccagagcaagagctctattgtttacatctttaggagcaagcgagcaggcgccagagccagagagagaatggcggaaaccccgtcccctttaaggaggagttatccttcgcttaggacgcatcactccctgattggctgcagcccatggccgagctgacgtcacgggaaaggcagagtacaagtagtggtaaaatacccttggcacatgc	749	80	11%	94	13%
14	66463801	66464100	caacctcagggcagtcggcttcaaggtccgccctatgcggagtccccgccctgcgtagtgcgtcagcaatgcgcagagaggcagtgcgcagagaggcagtgcgcagactcattcattcccagagaggaacaaaggaaaatacaacaggcatttccggtctttgaaggagccgagggtgggcgtgtccacgctccggtagaatacttacaaattaaagaaattgccgagtcggtccgtaaatacggaaccaatgctaattttaccttggtgcagttagacaggctcgccggcatggcact	299	40	13%	50	17%
14	68012551	68012850	gccggcgagcctgtctaactgcaccaaggtaaaattagcattggttccgtatttacggaccgactcggcaatttctttaatttgtaagtattctaccggagcgtggacacgcccaccctcggctccttcaaagaccggaaatgcctgttgtattttcctttgttcctctctgggaatgaatgagtctgcgcactgcctctctgcgcactgcctctctgcgcatctctctgcgcattgctgacgcactacgcagggcgggggctccgcatagggcggaccttgaaaccgactgccctgag	299	42	14%	28	9%
14	68013451	68013900	ccagctgaaaagttctgaattcatacagttgaatccttcttaacagtctgctttacgggaacctttattaccgcgacccgcagttctggttctggaatgagggatcttccttgcgccagtcccgagttttttctcgtcccggaattcggcaccaattgttattagacgcgttctcacgaccggccaggaagaacaccacagaccagaatcttctgcggcaaagctttattgcttacatcttcaggagccagagtgcaagaagcaagagagcaagaagcaagagagagagaaaacgaaaccccgtccctattaaagagaattctccttcgcctaggacgtgtcactccctgattggctgcagcccatcggccgagttgacgtcacggggaaggcagagcacatggagtgaagaaccaccctcggcacatgcgcagattatttgtttacca	449	48	11%	68	15%
14	75710701	75711150	tatactgtgcaccatgtatactgtgcaccatgtatactgtacacaatgtatactgtacacgatgtatactgtacacagtgtatactgtacaccatgtatacggcacaccgtgtatactgtacacaatgtatactgtacagcatgtatactgtacaccatgtaaactgtacacaatgtatacggtacactgtgtatactgtacacaatgtatactgtacaccatgtatactgtacaccatgtaaactgtacacgatgtatactgtacacaatgtatactgtacaccatgtatacggcacacgatgtatactgtacacgatgtatactgtacaccatgtatacggtacactgtgtatactgtacacgatgtatactgtacccgatgtatactgtatgcgatgtatactgtacacaatgtatactgtacacaatgtatactgtacacaatgt	449	24	5%	92	20%
14	79189951	79190400	AGCTACATGCCGagacagccggccaccttcctggtgagagcacgggggtctgcccggcctgagaggtttgtggcacaggcgccggcaggagccttcttggctccgggactccgcggagggcaggctgcacgggtgaccgtgtggaatacagagtgccagccgtttctgggacgggcgagagtcgcagagcttctgggcggcgccatcttcagctccagatagccggccaccttcctggtgagagcacgggggtctgcccagcctgagaggtttgtggcacaggcgccggcgggagccttcttggctccgggactccgcggagggcaggctgcacgggtgaccgtgtggaatacagagtgccagccgtttctgggacgggcgagagtcgcagagcttctgggcggcgccatcttcagctccagacaaccagccaccttcccggcaagagc	449	68	15%	64	14%
14	85524001	85525350	tggagtcaaagcagctgcgtttgctcgggcctgcgcttgtgcagcttcgtgccaaagcgctctccattccatatatttgcccatactagggagagcggcttttacaaccgtttgccagtcggcaggagttagtgccatgccggcaagcctgtctaactgcaccaaggtaaaattagcattggttccatatttacggaccgactcggcaatttctttaatttgtaagtattctaccggagcgtggacacgcccaccctcggctccttcaaagaccggaaatgcctgttgtattttcctttgttcctctctgggaatgaatgagtctgcgcactgcctctctgcgcagggctgacgcactacgcagggcggggactccgcatagggcggaccttgaagccgactgccctgaggccaatcagcaaactggccttcgccagccgcttttggcttccttaactgattagctagcactttacctggctggtacccttttttctcataatgagctgcttcttcctcccagtctgtttcttcagaggagaattcttcatctgcttcagagctactaagagctggctccccgagcccatccagcgatgagcacaggctccttttcctagagacctccgctaattgatctttcttcttttccctttttcctctttttcttctaatctctctccaggtattcctacctaaccttaacttttcctcgggttcaagacccttggaaaggcctgtatacttattttgtgtaccatattttctctttgctcctactctctctccccgctttacttctgatagcttgtcctgaatttcctctagaattttcagccctatcttaatcacttgataacatgtgaaaaggaacaaaagggctcctaacaccagaaaaaattcaaggccaaacatattccactttacttctgatagactgtcttgaatttccttagaaagttcaagatcagacttacctcgtaaagctgtactcactggtactctcgttccccagctgaaaagttctgaattcatacagttgaatccttcttaacagtctgctttacgggaacctttattaccgcgacccgcagttctggttctggaatgagggatcttccttgcgccagtcccgagttttttctcgtcccgggtttcggcaccaattgttattagacgcgttctcacgaccggccaggaaagacgcaacagaccagaatcttctgcggcaaaactttattgcttacatcttcaggagcaggagtgcaagaagcaagagagcaagaagcaagagagagagaaaacgaaaccccgtccctattaaggagaattttccttcgcctaggacg	1349	106	8%	152	11%
14	86590651	86592000	gtcaactcggccgatgggctgcagccaatcagggagtgacacgtccgaggcgaaggataattctccttaatagggacggggtttcgttttctcgctctcttgcttcttgcactctggctcctgaagatgtaagcaataaagctttgccacagaagattctggtttgttgcgtctttcctggccggtcgtgagaacgtgtctaataacaattggtgccgaattccgggacgagaaaaaactcgggactggcgcaaggaagatccctcattccagaaccagaactgcgggtcgcggtaataaaggttcccgtaaagcagactgttaagaaggattcaactgtatgaattcagaacttttcagctggggaacgagagtaccagtgagtacagctttacgaggtaagtctggtcttgaactttctaaggaaattcaagacagtctatcagaagtaaagtggaatatgtttggccttgaattttttctggtgttaggagcccttttgttccttttcacatgttatcaagtgattaagatagggctgaaaattctagaggaaattcaggacaagctatcagaagtaaagcggggagagagagtaggaacaaagaggaaatatggtacacaaaataagtatacaggcctttccaagggtcttgaacccgaggaaaagttaaggttaggtaggaatacctggagagagattagaagaaaaagaggaaaaagggaaaagaagaaagatcaattagcggaggtctctaggaaaaggagcctgtgctcatcgctggatgggctcggggagccagctcttggtagctctgaatcagatgatgaattctcctctgaagaaacagactgggaggaagaagcagctcattatgagaaaaaagggtaccagccaggtaaagtgctagctaatcagttaaggaagccaaaagcggctggcgaaggccagtttgctgattggcctcagggcagtcggcttcaaggtccgccctatgcggagtccccgccctgcgtagtgcgtcagccctgcgcagagagacaatgcgcagagaggcaatgcgcagactcattcattcccagagaggaacaaaggaaaatacaacaggcatttccagtctttgaaggagccgagggtgggcgtgtccacgctccggtagaatacgtacagattaaagaacttgccgagtcggtccgtaaatacggaaccaatgctaattttaccttggtgcagttagacaggctcgccggcatggcactaactcctgccgactggcaaacggttgtaaaagccgctctccctagtatgggcaaatatatggaatggagagctctttggcatgaagctg	1349	106	8%	146	11%
14	86913901	86914200	cacgaccaccagtccttctaacagcagcttattcagtcttcatctttcttctttctcttcatcagtaccgttccccagctgaagagttctgaatccacgccggatccttctcaacagtctgttttacgggaacactttattaaccactccttccccgtgatgcagttctgaatcctccctgtagcagggggtcttcgcttgtgcctgaagatgtttcttgtcccgggtttCGGCACCACTTCttgcgcgcccccaactcgccagcaagaacgacgctgctacaggatccttctgcacac	299	28	9%	50	17%
14	87607801	87608400	gaaagttcaagaccagacttaccttgtaaagctatacttacgggtaccctgttccccagctgaagagttctgaattcacgcagttgaatccttctcaacagtctgtgatgcgggaacactttattaccaccgttccccagctgaagagttctgaattcacgcagttgaatccttctcaacagtctgttttacaggaaccttcattaccataacccgcagttctggttccggaatgagggatcttccttgcgccggtgatggttaactcccgtcccgagttttcttgtcccgggtttttttcttcccggattttctcgtcccggattttctcgtctcggatttcctcgtcccggatttcggcaccaaCtcttgcacgctttctcacgaccggccaggaagaacacaacaaaccagaatcttctgcggcaaaactttattgcttacatcttcaggggcaagcgtgcaagccccaaaacccccagccccctgcttacatctttaggagccagagcgccagagcgccagagcgccagagcgccagagcgccagagcgccagagcaagagctctattgtttacatctttaggagccagaagcaa	599	62	10%	92	15%
14	88033651	88034100	ttttcttgtacctgttgagacttgctatgtgtttgagtatacgatcaattttggagacaattccatgagattctgagaagaggtgttattagacgcgttctcacgaccggccaggaaagacgcaacaaaccagaatcttctgcggcaaagctttattgcttacatcttcaggagccagagtgcaagaagcaagagagagagaaaacgaaaccccgtccctattaaggagaattatccttcgcctaggacgtgtcactccctgattggctgcagcccatcggccgagttgacgtcacggggaaggcagagcacatggagtggagaaccaccctcggcacatgcgcagattatttgtttaccacttagaacacagctgtcagcgccatcttgtaacggcgaatgtgggcgcggctcccaacatctccccctttccttttaataagagcaaa	449	44	10%	66	15%
14	88039351	88039650	tccattccatatatttgcccatactagggagagcggcttttacaaccgtttgccagtcggcaggagttagtgccatgccggcgagcctgtctaactgcaccaaggtaaaattagcattggttccgtatttacggaccgactcggcaagttctttaatctgtacgtattctaccggagcgtggacacgcccaccctcggctccttcaaagactggaaatgcctgttgtattttcctttgttcctctctgggaatgaatgagtctgcgcattgcctctctgcgcattgtctctctgcgcag	299	34	11%	34	11%
14	88040251	88040850	ccaggcgtacctcgtaaagctgtactcactggtactctcgttccccagctgaaaagttctgaattcatacagttgaatccttcttaacagtctgctttacgggaacctttattaccgcgacccgcagttctggttctggaatgagggatcttccttgcgccagtcccgagttttttctcgtcccgggtttcggcaccaattgttattagacgcgttctcacgaccggccaggaaagacgcaacaaaccagaatcttctgcggcaaagctttattgcttacatcttcaggagccagagtgcaagaagcaagagagagagaaaacgaaaccccgtccctattaaggagaattatccttcgcctaggacgtgtcactccctgattggctgcagcccatcggccgagttgacgtcacggggaaggcagagcacatggagtggagaaccaccctcggcacatgcgcagattatttgtttaccacttagaacacagctgtcagcgccatcttgtaacggcgaatgtgggcgcggctcccaacaAAGaggtatatacttttttttgaggaggcaaaaatgttctgtaaatatctcatacattcatt	599	66	11%	86	14%
14	88123201	88123500	ACTGGCAAGCCTTTTCTATGTCTTTCCCAATGCTGTCTGGAATCAGTTTATTAACTACTTCCTTCAAGTCATTGGTCTGCACCTCTCGGGTCATGATTTCCATCATCTTCTTCCGGATCTGGCGGACTTGCTGGTGCTGCGCATAGGATGTCTTTCTTATCTGGTTGTTGCGTTTCTTAGTGAAGCCAACACAGAAAAGTCGGAGCAAATACCCATCGGTCGTCTTGACATCAACGTGAGCTTCGATCATGGTCTGCCACTTCTTGACCATGGAGCACATTTTGTCCCGGGTAAGATCC	299	22	7%	44	15%
14	88854751	88855050	gtaaaacagactgttgagaaggatccggtgtggattcagaactcttcagctggggaacggtactgatgaagagaaagaagaaagatgaagactgaataagctgctgttagaaggactggtggtcgcatcattcttgctggtcgagagcagacgcgacaattggtggcccgtacggggaaccgactcccccaccgagttcagaactttcagcagtcagtggttgctggcagggtaagttcacggtgagtgaaacttgtgaccccaggagtttgggaaggacctcggataaaatagaggtg	299	24	8%	30	10%
14	91961101	91961400	aactttattgcttacatcttcaggagctaggagcgcaaacccccagccccaaaagcgaaagccccttcaatattacatctttaggagccagagctccggcgccgccaaagcgcagagcgcgctctattgtttacatctttaggcagcgagagagcgcagggcgcgcagagccagagagatgccagcgagagagaatggcggaaaacccgtcccctttttaggagagttatatttcgcctaggacgcatcactccctgattggctgcagcccatggccgagctgacgttcacgggaaaag	299	40	13%	42	14%
14	91963651	91964250	cagccacttctaaaagatttactgcattaaccacataacaggaatctgacacaatattaaggggtccCGGGTTTCGGCACCAATtcttatttgcgttctcacgcccggccaggaagaacacaacagaccagaatcttctgcggcaaaactttattgcttacatcttcaggagctaggagcgcaaacccccagccccaaaagcgaaagccccttcaatattacatctttaggagccagagctccggcgccgccaaagcgcagagcgcgctctattgtttacatctttaggcagcgagagagcgcagggcgcgcagagccagagagatgccagcgagagagaatggcggaaaacccgtcccctttttaggagagttatatttcgcctaggacgcatcactccctgattggctgcagcccatggccgagctgacgttcacgggaaaagcagagtacaagtagtcgtaaaatacccttggcacatgcgcagattatttgtttaccacttagaacacaggatgtcagcgccatcttgtgacggcgaatgtgggggcggctcccaacaGATGTCCAATAAAAAAGATAAAACAAATATACAGAAA	599	64	11%	106	18%
14	91992451	91993050	tgtgcagaaggatcctgctgtggcgtcgttcttgctggtgcgttgggggcgcgcTCGAGAAGttggtgccgaaacccgggacaagaaacatcttcaggcacgagcgaagaccccctgctacagggaggattcagaactgcatcacggggaaggagtggttaataaaagttcccgtaaaacagactgttgagaaggatccggcgtggattcagaactcttcagctggggaacggtactgatgaagagaaagaagaaagatgaggactgaataaactgctgttagaaggactggtggtcgtgtcgttcttgctggtcgagagcagacgcgacaattggtggcccgtacggggaaccgactcccccaccgagttcagaactttcagcagtcagtggttgccggcagggtaagttcacggtgagtgaaacttgcgaccccaggagtttgggaaggacctcggataaaatagaggtgagcataaagttgccaggaagtaggcacaaagtaacccaggagtttgggaaggacctcggataaaatagaggggaatataaagttgccaggaagtaggctttggtacaagttaaggttcatggtttag	599	58	10%	60	10%
14	94810501	94810650	gggcgcgcTCGACAGTTGGTGCTGaaacccgggacaagaaacaacttcaggcaagagtgaagaccccctgctacagggaggattcagaactgcatcacggggaaggagtggttaataaaagttcctgtaaaacagactgttgagaagga	149	10	7%	20	13%
14	96284101	96284400	ggcgaaggataattctccttaatagggacggggtttcgttttctctctctcttgcttcttgcactctggctcctgaagatgtaagcaataaagctttgccgcagaagattctggtttgttgcatctttcctggccggtcgtgagaacgcgtctaataacaattggtgccgaattccgggacgagaaaaaactcgggactggcgcaaggaagatccctcattccagaaccagaactgcgggtcgcggtaataaaggttcccgtaaagcagactgttaagaaggattcaactgtatgaatt	299	34	11%	22	7%
14	100249501	100250100	gtcactagatgagctcaggaagccagctcttagtagctctgaagcaagtgaagaatcctcctctgaggaaacagactgggaggaagaagcagcccattaccagccagctaattggtcaagaaaaaagccaaaagcggctggcgaaagtcagcgtactgttcaacctcccggcagtcggtttcaaggtccgccctatgcggagcccccgccctgcgtagtgcgtcagcaatgcgcagagagatgcgcagagaggcaatgcgcagagagatgcgcagagaggcagtgcgcagagaggcagtgcgcagagaggcagtgcgcagactcattcattccccgagaggaacaaaagaaaatacaacaggcatttccagtctttgaaggagccgagggtgggcgtgtccacgctccggtagaatacgtacagattaaggaaattgccgagtcggttcgtaaatacggaaccaatgctaattttaccttggtgcagttagacaggctcgctggcatggcactaactcctgccgactggcaaacggttgtaaaagccgctctccctagtatgggcaaatatatggaatggaaagcgctttggcacgaag	599	66	11%	90	15%
14	103635751	103635900	ctgttgagaaggattcaactgcgtgaattcagaactcttcagctggggaacagggtacccgtaagtatagctttacaaggtaagtctggccttgaactttctaacgaaattcaagacagtctatcagaagtaaagtgggaaatagcttt	149	6	4%	16	11%
14	104110501	104111850	gcttttacaaccgtttgccagtcagcaggagttagtgccatgccggcgagcctgtctaactgcaccaaggtaaaattagcattggttccgtatttacggaccgactcggcaagttctttaatttgtaagtattctaccggagcgtggacacgcccaccctcggctccttcaaagactggaaatgcctgttgtattttcctttgttcctctctgggaatgaatgagtctgcgcactgcctctctgcgcactgcctctctgcgcactgcctctctgcgcactgcctctctgcgcatctctctgcgcattgctgacgcactacgcagggcggggactccgcatagggcggaccttgaagccgactgccctgaggccaatcagcaaactggccttcgccagccgcttttggcttccttaactgattagctagcactttacctggctggtacccttttttctcataatgagctgcttcttcctcccagtctgtttcttcagaggagaattcttcatctgcttcagagctactaagagctggcttcctgagctcatctagtgacgagtatctcctagagacctccgctaatcgatcttttttcttttcttttttcttttccttccttctaatctctccccaggtattcttacctgacctaaacttttcctcgggttcaagacccttggaaaggcctgtatacttattttgtgtaccatattttctctttgctcctactctctctccccgctttacttctgatagcttgtcctgaatttcctctagaatcctccctgccttaaccacttgataacatgtgaaaaggaacaaaagggcttctaacactagaaaaaattcaaggccaaacatattccactttacttctgatagactgtcttgaatttccttagaaagttcaagatcagacttacctcgtaaagctgtactcactggtactctcgttccccagctgaaaagttctgaattcatacagttgaatccttcttaacagtctgctttacgggaacctttattaccgcgacccgcagttctggttctggaatgagggatcttccttgcgccagtcccgagttttttctcgtcccggaattcggcaccaattgttattagacgcgttctcacgaccggccaggaaagacgcaacaaaccagaatcttctgcggcaaagctttattgcttacatcttcaggagccagagtgcaagaagcaagagagcaagaagcaagagagagagaaaacgaaaccccgtccctattaaggagaattttccttcgcctaggacgtgtcactccctgattggctgcagcccatcggccgagttgactcacgaggaag	1349	108	8%	142	11%
14	104110501	104111850	gcttttacaaccgtttgccagtcagcaggagttagtgccatgccggcgagcctgtctaactgcaccaaggtaaaattagcattggttccgtatttacggaccgactcggcaagttctttaatttgtaagtattctaccggagcgtggacacgcccaccctcggctccttcaaagactggaaatgcctgttgtattttcctttgttcctctctgggaatgaatgagtctgcgcactgcctctctgcgcactgcctctctgcgcactgcctctctgcgcactgcctctctgcgcatctctctgcgcattgctgacgcactacgcagggcggggactccgcatagggcggaccttgaagccgactgccctgaggccaatcagcaaactggccttcgccagccgcttttggcttccttaactgattagctagcactttacctggctggtacccttttttctcataatgagctgcttcttcctcccagtctgtttcttcagaggagaattcttcatctgcttcagagctactaagagctggcttcctgagctcatctagtgacgagtatctcctagagacctccgctaatcgatcttttttcttttcttttttcttttccttccttctaatctctccccaggtattcttacctgacctaaacttttcctcgggttcaagacccttggaaaggcctgtatacttattttgtgtaccatattttctctttgctcctactctctctccccgctttacttctgatagcttgtcctgaatttcctctagaatcctccctgccttaaccacttgataacatgtgaaaaggaacaaaagggcttctaacactagaaaaaattcaaggccaaacatattccactttacttctgatagactgtcttgaatttccttagaaagttcaagatcagacttacctcgtaaagctgtactcactggtactctcgttccccagctgaaaagttctgaattcatacagttgaatccttcttaacagtctgctttacgggaacctttattaccgcgacccgcagttctggttctggaatgagggatcttccttgcgccagtcccgagttttttctcgtcccggaattcggcaccaattgttattagacgcgttctcacgaccggccaggaaagacgcaacaaaccagaatcttctgcggcaaagctttattgcttacatcttcaggagccagagtgcaagaagcaagagagcaagaagcaagagagagagaaaacgaaaccccgtccctattaaggagaattttccttcgcctaggacgtgtcactccctgattggctgcagcccatcggccgagttgactcacgaggaag	1349	108	8%	142	11%
14	105213751	105214200	atccttcttaacagtctgctttacgggaacctttattaccgcgacccgcagttctggttctggaatgagggatcttccttgcgccagtgaaactcccgtcccgagtttcctcccgggttttttcttcccggattttttctcgtcccggaatttctcgtcccggatttcagcaccaattcttattaaacgcgttctcacgcccggccaggaagaacacggcaaaccagaatcttctgcggcaaaactttattgcttacatcttcaggagcaagagtgtaagaagcaagagcgagagaaaacgaaaccccgtccctattaaggagaattatccttcgcctaggacgtgtcactccctgattggctgcagcccatcggccgagttgacgtcacggggaaggcagagcacatggagtggagaaccaccctcggcacatgcgcagattatttgt	449	60	13%	54	12%
14	106005001	106005150	ctgaaagttctgaactcggcgggggagttggttccccgtacgggccaccaattgtcgcgcctgctctcgaccagcaagaacgacgcgaccaccagtccttctaacagcagtttattcagtcctcatctttcttctttctcttcatcaat	149	20	13%	24	16%
14	108340051	108340500	gccagcaaccactgactgctgaaagttctgaactcggtgggggagtcgggcccccgtacgggccaccaattgtcgcgcccgctctcgaccagcaagaacgacgcgaccaccagtccttctaacagcagtttattcagtcttcatctttcttctttctcttcatcagtaccgttccccagctgaagagttctgaatccacgctggatccttctcaacagtctgttttatgagaacctttattaaccactccttccccgtgatgcagttctgaatcctccctgtagcagggggtcttcgctcatgcctgaagatgtttcttttcccgggtttCGGCACCACTtgttgcgcgcgctcaactggccaggaagaacgacgctgctacaggatccttctgcacacgtttattcagtcctgattcttcttgtttatatctctcttgtttatatctc	449	46	10%	62	14%
14	109054951	109055250	tcttgcttcttgcgctctcttgcttcttgctctcttgcttcttacacgcttgctcctgaagatgtaagaaataaagctttgccgcagaagattctggtctgtggtgttcttcctggccggtcgtgagaacgcgtctaataacaattggtgccgaattccgggacgagaaaatccgggacgagaaaaaactcgggactggcgcaaggaagatccctcattccagaaccagaactgcgggtcgcggtaataaaggttcccgtaaagcagactgttaagaaggattcaactacatgaattca	299	36	12%	22	7%
14	112633351	112633800	ctgcgcttgtgcagcttcgtgccaaagcgctctccattccatatatttgcccatactagggagagcggcttttacaaccgtttgccagtcggcaggagttagtgccatgccggcaagcctgtctaactgcaccaaggtaaaattagcattggttccgtatttacggaccgactcggcaatttctttaatttgtaagtattctaccggagcgtggacacgcccaccctcggctccttcaaagactggaaatgcctgttgtattttcctttgttcctctctgggaatgaatgagtctgcgcactgcctctctgcgcagggctgacgcactacgcagggcggggactccgcatagggcggaccttgaagccgactgccctgaggccaatcagcaaactggccttcgccagccgcttttggcttccttaactgattagctagcactttacctg	449	50	11%	54	12%
14	114102151	114102450	tctgaggaacagaaagtcatccatggctttttcttcacttttactgacaaattttgtcctctagccctaacgtccgtccaatggtccttagtcaaagataaaggagtagacacggtctgtcccatagtgaagaataagagtaaacacaacacaatgacagagacggaaaacactaagacatccaagcacactcgtctgcgtctggacttacacaaccagccaaacgctacctctgatggagtgggattccgctccactcctctggcaggaagagcactcactcttcttcactctgccag	299	16	5%	58	19%
14	114209251	114210900	ctctccattccatatatttgcccatactagggagagcggcttttacaaccgtttgccagtcggcaggagttagtgccatgccggcaagcctgtctaactgcaccaaggtaaaattagcattggttccgtatttacggaccgactcggcaatttctttaatttgtaagtattctaccggagcgtggacacgcccaccctcggctccttcaaagaccggaaatgcctgttgtattttcctttgttcctctctgggaatgaatgagtctgcgcactgcctctctgcgcattgtctctctgcgcactgcctctctgcacatctctctgcgcattgcctctctgcgcattgcctctctgcgcattgtctctctgcgcattgctgacgcactacgcagggcgggggctccgcatagggcggaccttgaaaccgactgccctgaggccaatcagcaaactggccttcgccagccgcttttggcttccttaactgattagctagcactttacctggctggtacccttttttctcataatgagctgcttcttcctcccagtctgtttcctcagaggagaattcttcatctgcttcagaactactaagagctggctttctgagctcatctagtgacgagtatctcctagagacctccgctaatcgatcttttttcttttcttttttcttttccttccttctaatctctccccaggtattcttacctgaccttaacttttcctcgggttcaagacccttggaaaggcctgtatacttattttgtgtaccatatttcctctttgttcctactctctctccccactttacttctgatagcttgtcctgaatttcatctagaatccgccctgccttaaccacttgataacatgtgaaaaggaacaaaagggcttctaacactagaaaaaattcaaggccaaacataacttgtaaagccattttccactttacttctgatagactgtcttgaatttccttagaaagttcaagatcagacttacctcgtaaagctgtactcactggtactctcgttccccagctgaaaagttctgaattcatacagttgaatccttcttaacagtctgctttacgggaacctttattaccgcgacccgcagttctggttctggaatgagggatcttccttgcgccagtcccgagttttttctcgtcccggaattcggcaccaattgttattagacgcgttctcacgcccggccaggaagaacaccacagaccagaatcttctgcggcaaaactttattgcttacatcttcaggagcaagagtgtaagaagcaagagagagagaaaacgaaaccccgtcccttttttaggagagttatatttcgcctaggacgtgtcactccctgattggctgcagcccatcggccgagttgacgtcacggggaaggcagagcacatggagtggagaaccaccctcggcatatgcgcagattatttgtttaccacttagaacacagctgtcagcgccatcttgtaacggcgaatgtgggcgcggctcccaacaCTGCAgagtgtgcaagcaagttggtctctgtttcttgtcccttctcatgctcttttccttttggtttttgtttgtttgtttatttataatgttttgtttttatcttcgtatat	1649	130	8%	190	12%
14	114209251	114210900	ctctccattccatatatttgcccatactagggagagcggcttttacaaccgtttgccagtcggcaggagttagtgccatgccggcaagcctgtctaactgcaccaaggtaaaattagcattggttccgtatttacggaccgactcggcaatttctttaatttgtaagtattctaccggagcgtggacacgcccaccctcggctccttcaaagaccggaaatgcctgttgtattttcctttgttcctctctgggaatgaatgagtctgcgcactgcctctctgcgcattgtctctctgcgcactgcctctctgcacatctctctgcgcattgcctctctgcgcattgcctctctgcgcattgtctctctgcgcattgctgacgcactacgcagggcgggggctccgcatagggcggaccttgaaaccgactgccctgaggccaatcagcaaactggccttcgccagccgcttttggcttccttaactgattagctagcactttacctggctggtacccttttttctcataatgagctgcttcttcctcccagtctgtttcctcagaggagaattcttcatctgcttcagaactactaagagctggctttctgagctcatctagtgacgagtatctcctagagacctccgctaatcgatcttttttcttttcttttttcttttccttccttctaatctctccccaggtattcttacctgaccttaacttttcctcgggttcaagacccttggaaaggcctgtatacttattttgtgtaccatatttcctctttgttcctactctctctccccactttacttctgatagcttgtcctgaatttcatctagaatccgccctgccttaaccacttgataacatgtgaaaaggaacaaaagggcttctaacactagaaaaaattcaaggccaaacataacttgtaaagccattttccactttacttctgatagactgtcttgaatttccttagaaagttcaagatcagacttacctcgtaaagctgtactcactggtactctcgttccccagctgaaaagttctgaattcatacagttgaatccttcttaacagtctgctttacgggaacctttattaccgcgacccgcagttctggttctggaatgagggatcttccttgcgccagtcccgagttttttctcgtcccggaattcggcaccaattgttattagacgcgttctcacgcccggccaggaagaacaccacagaccagaatcttctgcggcaaaactttattgcttacatcttcaggagcaagagtgtaagaagcaagagagagagaaaacgaaaccccgtcccttttttaggagagttatatttcgcctaggacgtgtcactccctgattggctgcagcccatcggccgagttgacgtcacggggaaggcagagcacatggagtggagaaccaccctcggcatatgcgcagattatttgtttaccacttagaacacagctgtcagcgccatcttgtaacggcgaatgtgggcgcggctcccaacaCTGCAgagtgtgcaagcaagttggtctctgtttcttgtcccttctcatgctcttttccttttggtttttgtttgtttgtttatttataatgttttgtttttatcttcgtatat	1649	130	8%	190	12%
14	114505951	114507150	actcggccgatgggctgcagccaatcagggagtgacacgtcctaggcgaaatataactctcctaaaaaagggacggggtttcattttctctctctcttgcttcttgcactctggctcctgaagatgtaagcaataaagctttgccgcagaagattctggtttgttgcgtctttcctggccggtcgtgagaacgcgtctaataacaattggtgctgaaacccgggacgagaaaaaactcgggactggcgcaaggaagatccctcattccagaaccagaactgcgggtcgcggtaataaaggttcccgtaaagcagactgttaagaaggattcaactgtatgaattcagaacttttcagctggggaacgagagtaccagtgagtacagctttacgaggtaagtctgatcttgaactttctaaggaaattcaagacagtctatcagaagtaaagtggaatatgtttggccttgaattttttctggtgttaggagcccttttgttccttttcacatgttatcaagtgattaagatagggctgaaaattctagaggaaattcaggacaagctatcagaagtaaagtggggagagagagtaggaacaaagaggaaatatggtacacaaaataagtatacaggcctttccaagggtcttgaacccgaggaaaagttaaggttaggtaggaatacctggagagagattagaagaaaaagaggaaaaagggaaaagaagaaagatcaattagcggaggtctctaggaaaaggagcctgtgctcatcgctggatgggctcggggagccagctcttggtagctctgaatcagatgatgaattctcctctgaagaaacagactgggaggaagaagcagctcattatgagaaaaaagggtaccagccaggtaaagtgctagctaatcagttaaggaagccaaaagcggctggcgaaggccagtttgctgattggcctcagggcagtcggcttcaaggtccgccctatgcggagtccccgccctgcgtagtgcgtcagcaatgcgcagagaggcaatgcgcagagagatgcgcagagaggcaatgcgcagagagatgcgcagagaggcagtgcgcagagaggcagtgcgcagagaggcagtgcgcagactcattcattcccagagaggaacaaaggaaaatacaacaggcatttccagtctttgaaggagccg	1199	84	7%	142	12%
14	116233651	116233800	cagaaacggctggcactctgtattccacacggtcacccgtgcagcctgccctccgcggagtcccggagccaagaaggctcccgccggcgcctgtgccacaaacctctcaggccaggcagacccccgtgctctcaccaggaaggtggccg	149	22	15%	28	19%
14	117081901	117082350	ggtagtttgtttgatcagcagaataagctccctgacccgttaacaagtcaaaagtccaatctctctgctctggagtcaaagcagctgcgtttgctcgggcctgcgcttgtgcagcttcgtgccaaagcgctctccattccatatatttgcccatactagggagagcggcttttacaaccgtttgccagtcagcaggagtcatagcgtgattcgcaagcctttccacttgtgctatagtgaaattagcactgactccatagttacggaccgactcggcaagctctttaatctgtatatacgctaccggagcgtggacacgcccaccctcggctccttcaaagaccggaaatgcctgttgtattttcctttgttcctcctttggaatgaatgagtctgcgcactgcctctctgcgcagggctgacgcactacgcagggcggggactccgca	449	50	11%	60	13%
14	117180001	117180300	ttatgagaaaaaagggtaccagccaggtaaagtgctagctaatcagttaaggaagccaaaagcggctggcgaaggccagtttgctgattggcctcagggcagtcggcttcaaggtccgccctatgcggagtccccgccctgcgtagtgcgtcagccctgcgcagagaggcaatgcgcagagaggcagtgcgcagactcattcattcccagagaggaacaaaggaaaatacaacaggcatttccagtctttgaaggagccgagggtgggcgtgtccacgctccggtagaatacttacaaa	299	30	10%	48	16%
14	118155901	118156050	gggtacggcactccatcactgtacagtgagcatggggtacggcactccatcactgtacagtgagcacggggtacgacactccatcactgtacagtgagcacggggtacggcactccatcactgtacagtgagcacggggtacggcactc	149	16	11%	42	28%
14	118802251	118802400	gtggatgcacacactgtatgtggacgcacacactgtatgtggacgcacacactgtatgtggatgcacacactgtatgtggatgcacacactgtatgtggatgcacacactgtatgtggacgcacacactgtatgtggatgcacacactg	149	6	4%	48	32%
14	119482051	119483550	gagctctccattccatatatttgcccatactagggagagcggcttttacaaccgtttgccagtcggcaggagttagtgccatgccggcaagcctgtctaactgcaccaaggtaaaattagcattggttccatatttacggaccgactcggcaagctctttaatctgtaagtattctaccggagcgtggacacgcccaccctcggctccttcaaagaccggaaatgcctgttgtattttcctttgttcctctctgggaatgaatgagtctgcgcactgcctctctgcgcactgcctctctgcgcatctctctgcgcattgcctctctgcgcattgctgacgcactacgcagggcgggggctccgcatagggcggaccttgaagccgactgccctgaggccaatcagcaaactggccttcgccagccgcttttggcttccttaactgattagctagcactttacctggctggtacccttttttctcataatgagctgcttcttcctcccagtctgtttcttcagaggagaattcttcatctgcttcagagctactaagagctggctccccgagcccatccagcgatgagcacaggctccttttcctagagacctccgctaattgatctttcttcttttccctttttcctctttttcttctaatctctctccaggtattcctacctaaccttaacttttcctcgggttcaagacccttggaaaggcctgtatacttattttgtgtaccatatttcctctttgttcctgctctctctccccactttacttctgatagcttgtcctgaatttcctctagaattttcagccctatcttaatcacttgataacatgtgaaaaggaacaaaagggctcctaacaccagaaaaaattcaaggccaaacatattccactttacttctgatagactgtcttgaatttccttagaaagttcaagatcagacttacctcgtaaagctgtactcactggtactctcgttccccagctgaaaagttctgaattcatacagttgaatccttcttaacagtctgctttacgggaacctttattaccgcgacccgcagttctggttctggaatgagggatcttccttgcgccagtcccgagttttttctcgtcccggaattcggcaccaattgttattagacgcgttctcacgaccggccaggaaagacgcaacaaaccagaatcttctgcggcaaagctttattgcttacatcttcaggagccagagtgcaagaagcaagagagagagaaaacgaaaccccgtccctattaaggagaattttccttcgcctaggacgtgtcactccctgattggctgcagcccatcggccgagttgacgtcacgaggaaggcagagcacatggagtgaagaaccaccctcggcacatgcgcagattatttgtttaccacttagaacacagctgtcagcgccatcttgtaacggcgaatgtgggcgcggctcccaacaCTGGAAGTT	1499	122	8%	184	12%
14	120951601	120951750	gtgacgacaactcggccgatgggctgcagccaatcagggagtgacacgtcctaggtggaggataattctccttaaaagggacggggtttcgccattctctctctcttgctctcttgctcctgaagatgtaagcaataaagctcttgctc	149	12	8%	14	9%
14	121006951	121007400	GGTTTGCTGAAATGGGAGAAAGAGAACTGTTTCCAGACTTAAGCTTGCTGgtgtgtgtgtatgtgtatgcacgtgtgtgtgtgtgCAGGTTTCCATGTGCATGCTCATCTGTGTACATGTACATGGGAGGGAGCCAGAGCTCTCttatacgcgttctcacgaccggccaggaaagaacacaacaaaccaaaatcttctgcggcaaaactttattgcttacatcttcaggagccaggagcgcaaacccccagccccaaaagcgaaagccaccccaataacgaaaccgaaaccccttccctatttaggagagttatctttcgcctaggacgcatcactccctgattggctgcagcccatggccgagctgacgttcacgggaaaggcagagtacaagtagtcgtaaaatacccttggcacatgcgcagattatttgtttaccacttagaaca	449	34	8%	72	16%
14	121068601	121069050	ctgcttcctggcaactttatattcccctctattttatccgaggtccttcccaaactcctggggtcgcaagtttcactcaccatgaacttaccctgccggcaaccactgactgctgaaagttctgaactcggtgggggagtcggttccccgtacgggccaccaattgtcgcgcccgctctcgaccagcaagaacgacgtgaccaccagtccttctaacagcagtttattcagtcttcatctttcttctttctcttcatcagtaccgttccccagctgaagagttctgaatccacgccggatccttctcaacagtctgtttcacgggaacactttattaaccgctccttccccgtgatgcagttctgaatcctccctgtagcagggggtcttcgctcatgcctgaagatgtttcttttcccgggtttcagcaccacttcttgcgcgcgctc	449	48	11%	64	14%
14	121519051	121519200	cttcaggagccagagagcaagagagcaagagtgcaagagagagcaagaaagcaagaaaaagaacaagagcaagagaaagaacaagaaagcaagagaaagaatggcaaaaccccgtcccttttaaggagaattatcctccgcctaggacg	149	6	4%	24	16%
14	123724651	123725850	ctcctaaaatagggacggggtttcgttttctctctctcttgcttcttgcactctggctcctgaagatgtaagcaataaagctttgccgcagaagattctggtctgttgcgtctttcctggccggtcgtgagaacgcgtctaataacaattggtgccgaattccgggacgagaaaaaactcgggactggcgcaaggaagatccctcattccagaaccagaactgcgggtcgcggtaataaaggttcccgtaaagcagactgttaagaaggattcaactgtatgaattcagaacttttcagctggggaacgagagtaccagtgagtacagctttacgaggtaagtctgatcttgaactttctaaggaaattcaagacagtctatcagaagtaaagtggaatatgtttggccttgaattttttctggtgttaggagcccttttgttccttttcacatgttatcaagtggttaaggcagggcggattctagatgaaattcagggcaatctatcagaagtaaagcggggagagagagtaggagcaaagagaaaatatggtacacaaaataagtatacaggcctttccaagggtcttgaacccgaggaaaagttaaggttaggtaggaatacctggagagagattagaagaaaaagaggaaaaagggaaaagaagaaagatcaattagcggaggtctctaggaaaaggagcctgtgctcatcgctggatgggctccgggagccagctcttagtagctctgaagcagatgaagaattctcctctgaagaaacagactgggaggaagaagcagctcattatgagaaaaaagggtaccagccaggtaaagtgctagctaatcagttaaggaagccaaaagcggctggcgaaggccagtttgctgattggcctcagggcagtcggcttcaaggtccgccctatgcggagcccccgccctgcgtagtgcgtcagcaatgcgcagagaggcaatgcgcagagagatgcgcagagaggcagtgcgcagagaggcagtgcgcagactcattcattcccagagaggaacaaaggaaaatacaacaggcatttccggtctttgaaggagccgagggtgggcgtgtccacgctccggtagaatacttacaaattaaagaaattgccgagtcggtccgtaaatacggaaccaatgctaattttaccttggtgcagtt	1199	94	8%	130	11%
14	123999301	123999450	caaacgatggagccgagatgggagatcctttcggtattccagaagccgctaccagctcgacatgacattcaaatttttccacgctttttgatccctgaattccccctaaagagatagccccgctggccatctatcccttgcttcaggga	149	14	9%	18	12%
14	124780051	124780200	cgttccgcgggggccaccttgattctgggactccgcagcgggcagtctgcaggccaaagcaacacagcttctgggaaaaatcctgttttgggccttcatcttcggccaggaggaggtccaaacaccagataactgtgcacctccctgaa	149	12	8%	28	19%
15	3360901	3361200	cgggggagatataaacaagggcgatatataaacaagggagatataaacaagggagatataaacaagaagaaacaggactgaataaacgtgtgcagaaagatcctgttgcagcgtcgttcttcctggccagttgagcgcgtgcaacaAGTGGTGCCGaaacccgggacaagaaacatcttcaggcacgagcgaagaccccctgctacagggaggattcagaactgcatctcggggaaggagtggttaataaagtgttcccgtaaaacagactgttgagaaggatccggcgtggattcaga	299	30	10%	38	13%
15	4126801	4126950	cgcagagcgcaaaagcgcaagagcgcaagtaagagagcgcaagtaagagagagaatggcggaaaccccgtccccttttaaggagaattattctttgcctaggacgcatcactccctgattggctgcagcccatggccgagttgacgtca	149	20	13%	20	13%
15	5379301	5379750	gcagcccattaccagccagctaattggtcaagaaaaaagccaaaagcggctggcgaaagccagcgtactgttcaacctccgggcagtcggtttcaaggtccgccctatgcggagcccccgccctgcgtagtgtgtcagcaatgcgcagagagacaatgcgcagagaggcaatgcgcagagaggcaatgcgcagagaggcagtgcgcagagaggcagtgcgcagagaggcagtgcgcagagaggcagtgcgcagagaggcagtgcgcagagaggcagtgcgcagactcattcattcccagagaggaacaaaggaaaatacaacaggcatttccggtctttgaaggagccgagggtgggcgtgtccacgctccggtagaatacttacaaattaaaaaacttgccgagtcggtccgtaaatatggaaccaatgctaattttaccttggtgca	449	54	12%	84	19%
15	6680251	6680400	ctgaggcctgagcgaggggctcctcttggagtctttcatttgggggctcatcccgggattagcgtgaccacctacgtctccgaagacccacttggaggtgaaattttttgtccaaaaatatttctgtaagctggctaggttctgtgctg	149	10	7%	10	7%
15	7911901	7912350	caggtaaagtgctagctaatcagttaaggaagccaaaagcggctggcgaaggccagtttgctgattggcctcagggcagtcggcttcaaggtccgccctatgcggagtccccgccctgcgtagtgcgtcagcaatgcgcagagaggcaatgcgcagagaggcaatgcgcagagaggcaatgcgcagagaggcaatgcgcagagaggcagtgcgcagactcattcattcccagagaggaacaaaggaaaatacaacaggcatttccggtctttgaaggagccgagggtgggcgtgtccacgctccggtagaatacttacaaattaaagaaattgccgagtcggtccgtaaatacggaaccaatgctaattttaccttggtgcagttagacaggcttgccggcatggcactaactcctgccgactggcaaacggttgtaaaagccgctctc	449	54	12%	70	16%
15	8291701	8291850	ACATTCCATTGCCGGCAATGAGACGCACCGTGACCGCCAGCGCCAAGGGGTTAACGTATACTTGTAAAACCATATAGCTTTTAATTTGTACCCGTGTCTTTACTCTTGATATATAAAATTATTATATGTACATATAAACCATAAAGCTA	149	14	9%	18	12%
15	8548051	8548500	ctcacgcccggccaggaagaacacaacagaccagaatcttctgcggcaaaactttattgcttacatcttcaggagctaggagcgcaaacccccagccccaaaagcgaaagccaccccttcttacatctttaggagccagagctccggcgcgccaaagcgcagagcgcgctctattgtttacatctttaggcagcgagagagcgcagggcgcgcagagccagagagatgccagcgagagagaatggcggaaaacccgtcccctttaaggaggagtgatccttcgcttaggacgcatcactccctgattggctgcagcccatggccgagctgacgttcacgggaaaggcagagtacaagtagtcgtaaaatacccttggcacatgcgcagattatttgtttaccacttagaacacaggatgtcagcgccatcttgtgacggcgaatgtggg	449	56	12%	76	17%
15	8552251	8552850	ctgatagactgtcttgaatttccttagaaagttcaaggccaggcttacctcgtaaagctatactcactggtactctcgttccccagctgaaaagttctgaattcatgcagttgaatctttcttaacagtctgctttacgggaacctttattaccgcgacccgcagttctggttctggaatgagggatcttccttgcgccggtgaaactcccgtcccgagtttcctcccgggttttttcttcccggattttttctcgtcccggaatttctcgtcccggatttcagcaccaattcttaatcgcgttctcacgcctggccaggaagaacacaacagaccagaatcttctgcggcaaaactttattgcttacatcttcaggagctaggagcgcaaacccccagccccaaaagcgaaagccaccccttcttacatctttaggagccagagctccggcgcgccaaagcgcagagcgcgctctattgtttacatctttaggcagcgagagagcgcagggcgcgcagagccagagagatgccagcgagagagaatggcggaaaacccgtcccctttaaggaggagtgatccttcgcttaggacgcat	599	74	12%	70	12%
15	8918101	8918400	tcagctcctgattcgttgctcgcccatcaccccattactatgccccgagatgggcagtgattaggcgtgagttcactctcgcacctgtgtacaaggcttgtttactagttaggcacaatggaggccagcgccatcttataatggcgattgcttacggcacggctctccacatctccccctttttgttttattaaaatgaggctggactaggtctgtgtaattatgcccatccgctgtggctcctgtcttaggtcgttcctctaatgtcacagcctttcccgtcatagggtaaccctatc	299	24	8%	38	13%
15	9015601	9016350	agaggggagcaccaatgacttcctcctctggcctctccatgcctgcactcccctgctgcgcactcacaagtgcacatatactacaaatgcatgatacacacacatgtacacacgcactcccctgctgcacactcacaagtgcacatatactacaaatgcatgatacacactcatgtacacacgcactcccctgctgcacactcacaagtgcacatatactacaaatgcatgatacacacgcatgtacacacgcactcccctgctgcacactcacaagtgcacatatactacaaatgcatgatacacacgcatgtacacacgcactcccctgctgcacactcacaagtgcacatatactacaaatgcatgatacacacgcatgtacacacgcactcccctgctgcacactcacaagtgcacatatactacaaatgcatgatacacacgcatgtagacacgcactcccctgctgcacactcacaagtgcacatatactacaaatgcatgatacacacgcatgtagacacgcactcccctgctgcacactcacaagtgcacatatactacaaatgcatgatacacacgcatgtacacacgcactcccctgctgcacactcacaagtgcacatatactacaaatgcatgatacacacgcatgtacacacgcactcccctgctgcacactcacaagtgcacatatactacaaatgcatgatacacacgcatgtacacacgcactcccctgctgc	749	38	5%	284	38%
15	9244951	9245100	tgctctcttgcgctcttgcgctctggctcctaaagatgtaagcaatagagctcttgctctcttgctcctgaagatgtaagcaataaagctcttgcgctcttgccctcgctctctctcttgctctcttgcactcttgctcctgaagatgt	149	8	5%	6	4%
15	21101851	21102150	caagcatgtgtgtgttaacggccatggtgtcttcaagcatgtgtgtgttaacggccatggtgtcttcaagcatgtgtgtgttaacggccatggtgtcttcaagcatgtgtgtgttaacggccatggtgtcttcaagcatgtgtgtgttaacggccatggtgtcttcaagcatgtgtgtgttaacggccatggtgtcttcaagcatgtgtgtgttaacggccatggtgtcttcaagcatgtgtgtgttaacggccatggtgtcttcaagcatgtgtgtgttaacggccatggtgtcttca	299	18	6%	56	19%
15	26908501	26909850	cgagcctgtctaactgcaccaaggtaaaattagcattggttccatatttacggaccgactcggcaagctctttaatctgtaagtattctaccggagcgtggacacgcccaccctcggctccttcaaagaccggaaatgcctgttgtattttcctttgttcctctctgggaatgaatgagtctgcgcactgcctctctgcgcactgcctctctgcgcatctctctgcgcattgctgacgcactacgcagggcgggggctccgcatagggcggaccttgaagccgactgccctgaggccaatcagcaaactggccttcgccagccgcttttggcttccttaactgattagctagcactttacctggctggtacccttttttctcataatgagctgcttcttcctcccagtctgtttcttcagaggagaattcttcatctgcttcagagctactaagagctggctccccgagcccatccagcgatgagcacaggctccttttcctagagacctccgctaattgatcttttttcttttccctttttcctctttttcttctaatctctctccaggtattcctacctaaccttaacttttcctcgggttcaagacccttggaaaggcctgtatacttattttgtgtaccatattttctctttgctcctactctctctccccgctttacttctgatagattgtcctgaatttcatctagaatccgccctgccttaaccacttgataacatgtgaaaaggaacaaaagggcttctaacactagaaaaaattcaaggccaaacattttccactttacttctgatagactgtcttgaatttccttagaaagttcaagatcagacttacctcgtaaagctgtactcactggtactctcgttccccagctgaaaagttctgaattcatacagttgaatccttcttaacagtctgctttacgggaacctttattaccgcgacccgcagttctggttctggaatgagggatcttccttgcaccagtcccgagttttttctcgtcccggaattcggcaccaattgttattagacgcgttctcacgcccggccaggaagaacaccacagaccagaatcttctgcggcaaagctttattgcttacatcttcaggagccagagtgcaagaagcaagagagagcgaaaacgaaaccccgtccctattaaggagaattctccttcgcctaggacgtgtcactccctgattggctgcagcccatcggccgagttgacgtcacggggaaggcagagcacatggagtagagaaccaccctcggcatatgcgcagattatttgtttaccacttagaacacagctgtcagcgcc	1349	108	8%	158	12%
15	27291901	27292350	attagcattggttccgtatttacggaccgactcggcgagttctttaatctgcacgtattctaccggagcgtggacacgcccaccctcggctccttcaaagactggaaatgcctgttgtattttcctttgttcctctctgggaatgaatgagtctgcgcactgcctctctgcgcactgtctctctgcgcactgcctctctgcgcactgcctctctgcgcattgcctctctgcgcactgcctctctgcgcattgctgacgcactacgcagggcgggggctccgcatagggcggaccttgaaaccgactgcccggaggttgaacagtacgctggctttcgccagccgcttttggcttttttcttgaccaattagctggctggtaatgggctgcttcttcctcccagtctgtttcctcagaggagaattcttcatctgcttcagagctactaa	449	54	12%	44	10%
15	27388801	27389100	tttgtaagtattctaccggagcgtggacacgcccaccctcggctccttcaaagactggaaatgcctgttgtattttcctttgttcctctctgggaatgaatgagtctgcgcactgcctctctgcgcactgcctctctgcgcactgcctctctgcgcatctctctgcgcattgcctctctgcgcatctctctgcgcattgcctctctgcgcatctctctgcgcagggctgacgcactacgcagggcggggactccgcatagggcggaccttgaagccgactgccctgaggccaatcagca	299	38	13%	36	12%
15	29286751	29286900	ctacacatttaccacactgtaggacaatatctcgggcttctgttcgtgtgagcttaaatttttgtcgtaatgtagaagcagggacatgataaagctgatgaaaattcttagcactttctatagaactttgtgataggaaaatcatgtct	149	6	4%	18	12%
15	33831451	33831750	gtcttgttacaacttcagaacggtttccgtgtcgttattcgtacaagaccctcgtctctctctaccccccatttggttattaggaggaggtcccctcgagatcctcgaataactggacctgctggacgggtcaagtggcgcccgacgtggagcacgaggtacgactgccctccggacaacggattaaggattaaagaggtaccgcgcagactgagaaacagtgggacagtccaccgacacttcactcgagtgtcgagtacggacgtcgggaggtaagcctaggcattcaattgttgtcc	299	46	15%	30	10%
15	38381251	38381400	tatacatacacacatacacacattcacacacacagacacacatacatatacaccctcacacaccctcacagacacacatgtacagacatacatatacacgttcacacatactcacacagacacacactcacagacatacatacatgcac	149	2	1%	88	59%
15	38478901	38479350	tgctctgccttccccgtgacgtcaactcggccgatgggctgcagccaatcagggagtgacacgtcctaggcgagggataactctcctaaaatagggacggggtttcgttttctctctctcttgcttcttgctctcttgcttcttacactcttgctcctgaagatgtaagcaataaagttttgccgcagaagattctggtctgtggtgttcttcctggccgggcgtgagaacgcgtctaataacaattggtgccgaattccgggacgagaaaaaactcgggactggcgcaaggaagatccctcattccagaaccagaactgcgggtcgcggtaataaaggttcccgtaaagcagactgttaagaaggattcaactgtatgaattcagaacttttcagctggggaacgagagtaccagtgagtacagctttacgaggtaagtctgatcttg	449	48	11%	38	8%
15	39339301	39339750	ttagaaagttcaaggccaggcttacctcgtaaagctatactcactggtactctcgttccccagctgaaaagttctgaattcatacagttgaatccttcttaacagtctgctttacgggaacctttattaccgcgacccgcagttctggttctggaatgagggatcttccttgcgccagtcccgagtttttttctcgtcccgggtttcggcaccaattgttattagacgcgttctcacgaccggccaggaaagacgcaacaaaccagaatcttctgcggcaaagctttattgcttacatcttcaggagccagagtgcaagagagcaagcaagcaaatggcgaaaccccatccctttttaaggagaattatcctccacctaggacgtattactccctgattagctgcagcccatcggcccagttgtcatcacgggaaaggcagaacacatg	449	42	9%	68	15%
15	46502551	46502850	taagcaataaagctttgccgcagaagattctggtttgttgcgtctttcctggccggtcgtgagaacgcgtctaataacaattggtgctgaaacccgggacgagaaaaaaactcgggactggcgcaaggaagatccctcattccagaaccagaactgcgggtcgcggtaataaaggttcccgtaaagcagactgttaagaaggattcaactgtatgaattcagaacttttcagctggggaacgagagtatccgtaagtatagctttacgaggtaagcctggccttgaactttctaaggaa	299	34	11%	22	7%
15	49171351	49171650	attgaagcatgagggttaagattccctaggtctagagtggcgcctgcgacgcagacgaagcttaagaggattgtcagtggctgccactgtccaattgtcgtcgtggttttcttcatcttggctggcggtcctcttgacgtgggaggcgtggatccaggaggcgattccgtcaacttttaccgcagtaggggttgtcagtaacaccaaatagggtcccttccaccgtggctcaaggctgccggttcgatgccgcctgaccaagactttgtctccaactcggaacccgtggggtactgcgg	299	38	13%	32	11%
15	49176451	49177050	agagaaaggggagtggacacagattgccccatttctagaaaaacagtagtcacaacaagagcggacacgagactaagacaaaaaagaaaccagaaacggcggcgactccgtgtcgaccacaagcaactcaaagaatcagatggcctctctaaggccggccgattgagaccctctgcacgaggtggactcgaacccacgatcccgtgaccaaacgcgaggcgggactcgaacccacggtctcgcaacaaaacgcgaggtgggactcgaacccacgatctcgcaactgggcacgaggtgggactcaaacccacgatctcgcaaccccaaatggtctcttggccttcaaaggggtccaccaggcgtccctgatcctcccctgttcctcctgggacgtctcccagggtgaacggacggtggacacctggacacgtctatccttatccaccccgcgctccctctcggagcgcggtctcactgagcgtccgcaaaactgaaactgcgatcgcaccaaacttagaaacagaacacagacatcagaccaaaacagaacaaagaatcttacctctaagtgggtctaggacctctgggtggtcgcgctg	599	86	14%	94	16%
15	49323751	49323900	ggcgaaggccagtttgctgattggcctcagggcagtcggcttcaaggtccgccctatgcggagtccccgccctgcgtagtgcgtcagtcctgcgcagagaggcactgcgcagagaggcagtgcgcagactcattcattcccagagagga	149	20	13%	26	17%
15	50625151	50625600	ctgaggaatctgacctaagtACtgttgggagccgcccccacattcgccgtcacaagatggcgctgacatcctgtgttctaagtggtaaacaaataatctgcgcatgtgccaagggtattttacgactacttgtactctgcctttcccgtgaacgtcagctcggccatgggctgcagccaatcagggagtgatgcgtcctaggcgaaatataactctcctaaataggaaaggggtttcggtttcaatatagaaggggctttcgcttttggggctgggggtttgcgctcctagctcctgaagatgtaagcaataaagttttgccgcagaagattctggtctgttgtgttcttcctggccgggcgtgagaacgcTattaagaattggtgccgaaacccgggacgagaaattccgggacgagaaaaaatccgggacgaaaaaatacaagaaaa	449	50	11%	34	8%
15	56459251	56459550	cgcgaacgcgtgtaagaGttggtgctgagacccgggacgagaagacctggaacgagaaatcctgggacgagaaaacccaggacggttaccatcaccggcgcaaggaagatccctcattctggaaccagaactgcgggtcatggtaataaaggttcccgtaaaacagactgttgagaaggatccagcctggattcagaactcctcagctggggaacggtggtaatgaagtgttcccacaacacagactgttgagaaggattcaactgtgtgaattcagaactcttcagctggggaatggt	299	28	9%	36	12%
15	56874451	56874600	cccctgctacagggaggattcagaactgcataacggggaagaaggggttaataaagtgttcccgtaaaacagactgttgagaaggatccggcgtggattcagaactcttcagctggggaacggtactgatgaagagaaagaagaaagat	149	10	7%	12	8%
15	57900151	57900750	gggctgcagccaatcagggagtaatacgtcctaggcggaggataattctccttaaaagggacggggttttgccattctttctcttgctttcttgttctctctctcttgctttcttgttcttgttctttttcttgctttcttgctcttgctcttgctctctggctcctgaagatgtaagcaataaagcttttgccgcagaagattccggtttgttgcgtctttcctggccggtcgcgaatgcgtgtaagaGttggtgctgaaacccgggacgagaaaacccgggacgagaaatcctgggatgagaaaacctgggacggttaccatcaccggcgcaaggaagatccctcattccggaaccagaactgcgggtcatggtaatgaagtgttcccgtaaaacagactgttgagaaggatccagcctggattcagaactcctcagctggggaacggtggtaatgaagtgttcccgtaaaacagactgttgagaaggattcaactgcgtgaattcagaactcttcagctggggaacggtggtaataaagtgttcccacaacacagactgttgagaaggattcaactgcgtgaattcagaactcttc	599	50	8%	52	9%
15	59347501	59348100	tacgataggtaggctcactgaggtgtaacttacgattgataggctcactgaggtgcaccttacgataggtaggctcactgaggtgtaacttacgataggtaggctcactgaggtgtaacttacgataggtaggctcactgaagtgtaacttacgataggtaggctcactgaggtgtaacttacgatagataggctcactgaggtgtaacttacgataggtaggctcactgaggtgcaacttacgatagataggctcactgaggtgtaacttacgattgataggctcactgaggtgcaccttacgataggtaggctcactgaggtgtaacttacgataggtaggctcactgaggtgtaacttacgataggtaggttcactgaggtgtaacttacgataggtaggctcactgaggtgtaacttacgatagataggctcactgaggtgtaacttacaataggtaggctcactgaggtgtaacttacgataggtaggctcactgaggtgtaacttacgataggtaggctcactgaggtgtaacttatgataggtaggctcactgagctgtaactGTAGCTTGAGTACCGCACGTACAAAGGAG	599	38	6%	50	8%
15	65666701	65668200	acaagatggcgctgacagctgtgttctaagtggtaaacaaataatctgcgcatgtgccgagggtggttcttcactccatgtgctctgccttccccgtgacgtcaactcggccgatgggctgcagccaatcagggagtgacacgtcctaggcgaaggagaattctctttaatagggacggggtttcgttttctctttctcttgcttcttgctctcttgcttcttgcactctgctcctgaagatgtaagcaataaagctttgccgcagaagattctggtctgtggtgttcttcctggccggtcgtgagaacgcgtctaataacaattggtgccgaaacccgggacgagaaaaaaactcgggactggcgcaaggaagatccctcattccagaaccagaactgcgggtcgcggtaataaaggttcccgtaaagcagactgttaagaaggattcaactgtatgaattcagaacttttcagctggggaacgagagtaccagtgagtacagctttacgaggtaagcctggccttgaactttctaaggaaattcaagacagtctatcagaagtaaagtggaatatgtttggccttgaattttttctagtgttagaagcccttttgttccttttcacatgttatcaagtggttaagatagggcggattctagatgaaattcaggacaagctatcagaagtaaagcggggagagagagtaggagcaaagagaaaatatggtacacaaaataagtatacaggcctttccaagggtcttgaacccgaggaaaagtttaggtcaggtaagaatacctggggagagattagaaggaaggaaaagaaaaaagaaaagaaaaaagatcgattagcggaggtctctaggagatactcgtcactagatgagctcaggaagccagctcttagtagttctgaagcagatgaagaattctcctctgaggaaacagactgggaggaagaagcagcccattaccagccagctaattggtcaagaaaaaagccaaaagcggctggcgaaggccagtttgctgattggcctcagggcagtcggcttcaaggtccgccctatgcggagtccccgccctgcgtagtgcgtcagcaatgcgcagagaggcagtgcgcagagaggcagtgcgcagactcattcattcccagagaggaacaaaggaaaatacaacaggcatttccggtctttgaaggagccgagggtgggcgtgtccacgctccggtagaatacttacaaattaaagaaattgccgagtcggtccgtaaatacggaaccaatgctaattttaccttggtgcagttagacaggctcgccggcatggcactaactcctgctgactggcaaacggttgtaaaagccgctctccctagtatgggcaaatatatgaaatggagagcgctttggcacgaagctgcacaagcgcaggcccgagcaaacgcagctgctttgactccagagcagagagattggacttttgacttgtta	1499	124	8%	172	11%
15	65666701	65668200	acaagatggcgctgacagctgtgttctaagtggtaaacaaataatctgcgcatgtgccgagggtggttcttcactccatgtgctctgccttccccgtgacgtcaactcggccgatgggctgcagccaatcagggagtgacacgtcctaggcgaaggagaattctctttaatagggacggggtttcgttttctctttctcttgcttcttgctctcttgcttcttgcactctgctcctgaagatgtaagcaataaagctttgccgcagaagattctggtctgtggtgttcttcctggccggtcgtgagaacgcgtctaataacaattggtgccgaaacccgggacgagaaaaaaactcgggactggcgcaaggaagatccctcattccagaaccagaactgcgggtcgcggtaataaaggttcccgtaaagcagactgttaagaaggattcaactgtatgaattcagaacttttcagctggggaacgagagtaccagtgagtacagctttacgaggtaagcctggccttgaactttctaaggaaattcaagacagtctatcagaagtaaagtggaatatgtttggccttgaattttttctagtgttagaagcccttttgttccttttcacatgttatcaagtggttaagatagggcggattctagatgaaattcaggacaagctatcagaagtaaagcggggagagagagtaggagcaaagagaaaatatggtacacaaaataagtatacaggcctttccaagggtcttgaacccgaggaaaagtttaggtcaggtaagaatacctggggagagattagaaggaaggaaaagaaaaaagaaaagaaaaaagatcgattagcggaggtctctaggagatactcgtcactagatgagctcaggaagccagctcttagtagttctgaagcagatgaagaattctcctctgaggaaacagactgggaggaagaagcagcccattaccagccagctaattggtcaagaaaaaagccaaaagcggctggcgaaggccagtttgctgattggcctcagggcagtcggcttcaaggtccgccctatgcggagtccccgccctgcgtagtgcgtcagcaatgcgcagagaggcagtgcgcagagaggcagtgcgcagactcattcattcccagagaggaacaaaggaaaatacaacaggcatttccggtctttgaaggagccgagggtgggcgtgtccacgctccggtagaatacttacaaattaaagaaattgccgagtcggtccgtaaatacggaaccaatgctaattttaccttggtgcagttagacaggctcgccggcatggcactaactcctgctgactggcaaacggttgtaaaagccgctctccctagtatgggcaaatatatgaaatggagagcgctttggcacgaagctgcacaagcgcaggcccgagcaaacgcagctgctttgactccagagcagagagattggacttttgacttgtta	1499	124	8%	172	11%
15	67005751	67005900	agtggagcggaaggggtttgtgccccagatcaagcccgggtagcctgcttccctatgtaccgcagtctcaggttccgcgcgattggattggggcaggcgctatgttccactcaccagaggtcttaggatcccgtggggagtcccgtgtg	149	18	12%	16	11%
15	71598001	71598450	taaacaaataatctgcgcatgtgccaagggtatttttctactacatgtactctgcctttcccatgacgtcaactcggccatgggctgcagccaatcagggagtgatgcgtcctaggcgaaggataactctcctaaatagggacggggtttcgctttcgttttgggggctttcgtttttggggcttggggcttgcgctcctggctcctgaagatgtaagcaataaagttttgccgcagaagattctggtttgttgtgttcttcctggccggtcgtgagaacgcgtttaagagttggtgccgaaacccgggacgagaaaatccgggaagaaaaaaacccgggacgagaaaatacaagaaaactcgggacgggagttaaccatcaccggcgcaaggaagatccctcattccggaaccagaactgcgggtcatggtaacgaaggttcccgtaa	449	58	13%	38	8%
15	73377451	73378050	ttagaaagttcaaggccaggcgtacctcgtaaagctatacttacgggttaccgccgttccccagctgaaaagttctgaattcatgcagttgaatctttcttaacagtctgctttacgggaacctttattaccgcgacccgcagttctggttctggaatgagggatcttccttgcgccggtgaaactcccgtcccgagtttcctcccgggttttttcttcccggattttttctcgtcccggaatttctcgtcccgggtttCGGCACCAATtcttaatagcgttctcacgcccggccaggaagaacacaacagaccagaatcttctgcggcaaaactttattgcttacatcttcaggagcaggagtgcaaaaacccccagccccaaaagcgaaaagccccttctattacatctttaggagccagagctccggcgcgcgcgctctattgtttacatctttaggcagcgagcgagcgcagggcgcgcagagccagagagatgccagcgagagagaaatggcggaaaacccgtccccttttttaggagcgttatatttcgcctaggacgcatcactccctgattggctgcagcccatggccgag	599	84	14%	68	11%
15	73878901	73879200	aaaattagcattggttccgtatttacgaaccgactcagcaatttctttaatttgtaagtattctaccggagcgtggacacgcccaccctcggctccttcaaagaccggaaatgcctgttgtattttcctttgttcctctctgggaatgaatgagtctgcgcactgcctctctgcgcactgcctctctgcgcattgctgacgcactacgcagggcggggactccgcatagggcggaccttgaagccgactgccctgaggccaatcagcaaactggccttcgccagccgcttttggctttt	299	38	13%	32	11%
15	75339001	75339150	gtgttgggcaagactctgctgtcaaggtagcccggggctcgagtctcgagtcgagcggaagggacttgtgccccagatcaggcccgggtagcctgcttccctatgtaccgcagtctcaagttctgcgcgattggattggggcaggcact	149	18	12%	16	11%
15	76102801	76104450	CTCAGGACTCCCTTCCACATGGCCTGATAGATGCTCATCTTCTCCTGGCGCCCAGGCTCTCCCTGGACGGGCACCAGGACGCCCGCTATGCAGCTGGAGCCCCCCAGGTAGCGCTTGACGGAGTCCATCTCTGTCACCTCATGAATGGTCTTGGTGCCCTGTGCCAGTTCTCGCATGGTGTCCCGGTCCAGGATGCCAGAGGTACACAACTCAGATGCGGACACCTGTCGCCTCAGGCCGGGGAAAGACACCTTGCTGAGCCGTTCTTCTGTCTCCTCGATGATTTGGGTGAGGAGGGAAACGAGTTCCATTACCCCCAGCTTGCCAGCCAAGTGCTGGGCAAGGAGCTCCTCCCGGCGGGTCTCACTCAGGTAGGAGGAGAACAGGACTTTCCACACAGAAACTTGCTGGTCCCGGAACTGCCCACGGTGTACCTGCATGGTGGTGGCACGCAGAGTCTGCTCCTGTTGCTGCCTGGCACTCTCGGAGCTGTCCTGAGCATCTCCCTCGTCTGGGGAGGTCCCTGAGCCTCTGGCCCCAGTGTCCTGTTGCTTAAGAGAGGCGTCTCTCGGCTTTGGCTTGGACTCCTGTGTCTCCTCAGCCTCCTCAATAATGGTGGTCAGTCTCCTCTTCAGCATGGGCAGAGTCAGCGACCCAGAGCTGAACTGGGCCAGCAGCTCCTTCCGGGTGTCCCTGCTCACATAGTTGGATGTCAGAATGTCCCACACTGGGACCTCGTGGCCCCGGAGATGACCCCGTTTTACTTCCATGGTGGCCTTGCCCAGGGCTCCTTGTGGATCCTCACGTGGGCTCCCATCCTTGGCTCGGGCCAGCAGTGAGGTGAGTGTGGTGGTCACGTCATGAACGGTGAGCCCACCTGCCTGGTAGCGACGCAGCAGGTCCTGGCGCAGACTCTCAGGCACCTCTCGGTAGAAGAGAAGCTCCCAGACAGAGATGCTCTGGCCCTGGAAGTCGCCCGTGCCTGGGGTCACACGGGCTTCACGCAGGGCCCGTCTCAGCTCCTCGCTCAGGTGGTGCACACTGGAGCCCTTTCCAGCCAGCTGCAGCATGTAGAAGCCAGTCTCTGGGTCGCGCACACAGCGGCGCAGCAGCTGTAGGTAAGTGAGGTTCTCGTGAGTGTTGGGGTCAAAGAAGCCCTTGGTGTCGTCACCAGGGTCCGCCAAAATGCTGTTCATGTCTTCATCAAAGTAGCCACGCTGGTAGGCCACGTCCACGGGCACACGGTGGCTGTGCACAGGGTCGATGACGCCACCCGTGGCAATCTGGGCTTCCAACAAACGAATGCCATGGTCTCTCACAATGAGGTCCCTCTGCATGGCCTGGAAGAGGGAGATCTGGTCCCCGGTGTAGGGGTCCGTGTACCCGGTGACCGCACGCTCAGCAGACAGCAGCTTCTCTTGGATCTCGCCTCCCACCACGCCTGCAGCCACGGCCTCCTCCACAGACAGTCTGCGGTTGTTCACTGGGTCGATGATGAAGCCTGTGGCTGCCTGAGCCTCCAGCAGCACCAGGGCTGTGCCTGGCCTCAGGACTCCCTTCCACATGGCCTGATAGATGCTCATCTTCTCCTGGCGCCCAGGCTCTCCCTGGACGGGCACCAGGACGCCCGCTATGCAGCTGGAGCCCCC	1649	142	9%	272	16%
15	76105051	76105800	TTGGATGTCAGAATGTCCCACACTGGGACCTCGTGGCCCCGGAGATGACCCCGTTTTACTTCCATGGTGGCCTTGCCCAGGGCTCCTTGTGGATCCCCACGTGGGCTCCCATCCTTGGCTCGGGCCAGCAGTGAGGTGAGTGTGGTGGTCACGTCATGAACGGTGAGCCCACCTGCCTGGTAGCAACGCAGCAGGTCCTGGCGCAGACTCTCAGGCACCTCTCGGTAGAAGAGAAGCTCCCAGACAGAGATGCTCTGGCCCTGGAAGTCGCCCGTGCCTGGGGTCACACGGGCTTCACGCAGGGCCCGTCTCAGCTCCTCGCTCAGGTGGTGCACACTGGAGCCCTTTCCAGCCAGCTGCAGCATGTAGAAGCCAGTCTCTGGGTCGCGCACACAGCGGCGCAGCAGCTGTAGGTAAGTGAGGTTCTCGTGAGTGTTGGGGTCAAAGAAGCCCTTGGTGTCGTCACCAGGGTCCGCCAAAATGCTGTTCATGTCTTCATCAAAGTAGCCACGCTGGTAGGCCACGTCCACGGGCACACGGTGGCTGTGCACAGGATCGATGACGCCACCCGTGGCAATCTGGGCTTCCAACAAACGAATGCCATGGTCTCTCACAATGAGGTCCCTCTGCATGGCCTGGAAGAGGGAGATCTGGTCCCCGGTGTAGGGGTCCGTGTACCCGGTGACCGCACGCTCAGCAGACAGCAGCTTCTCTTGGATCTCGCCTCCCACCACGCCTGCAGCCACGGC	749	78	10%	138	18%
15	76105051	76105800	TTGGATGTCAGAATGTCCCACACTGGGACCTCGTGGCCCCGGAGATGACCCCGTTTTACTTCCATGGTGGCCTTGCCCAGGGCTCCTTGTGGATCCCCACGTGGGCTCCCATCCTTGGCTCGGGCCAGCAGTGAGGTGAGTGTGGTGGTCACGTCATGAACGGTGAGCCCACCTGCCTGGTAGCAACGCAGCAGGTCCTGGCGCAGACTCTCAGGCACCTCTCGGTAGAAGAGAAGCTCCCAGACAGAGATGCTCTGGCCCTGGAAGTCGCCCGTGCCTGGGGTCACACGGGCTTCACGCAGGGCCCGTCTCAGCTCCTCGCTCAGGTGGTGCACACTGGAGCCCTTTCCAGCCAGCTGCAGCATGTAGAAGCCAGTCTCTGGGTCGCGCACACAGCGGCGCAGCAGCTGTAGGTAAGTGAGGTTCTCGTGAGTGTTGGGGTCAAAGAAGCCCTTGGTGTCGTCACCAGGGTCCGCCAAAATGCTGTTCATGTCTTCATCAAAGTAGCCACGCTGGTAGGCCACGTCCACGGGCACACGGTGGCTGTGCACAGGATCGATGACGCCACCCGTGGCAATCTGGGCTTCCAACAAACGAATGCCATGGTCTCTCACAATGAGGTCCCTCTGCATGGCCTGGAAGAGGGAGATCTGGTCCCCGGTGTAGGGGTCCGTGTACCCGGTGACCGCACGCTCAGCAGACAGCAGCTTCTCTTGGATCTCGCCTCCCACCACGCCTGCAGCCACGGC	749	78	10%	138	18%
15	76990951	76991250	GTAACCACCGCTTACGTTATCAGTGCTATGCAATGTAGTAATGACACACAAGTAATTACCTGCAGAGTTGTTAGTCATTGGCAGACTGAAAGAACATGGGACAGTCTtgtaggtggtgtgtgtgtatgtgtatgcctgtatgtgtgtgcatcatgtgtatatatgtgtgtatgtatgtatgccacgtgtatgtgtgtacaccatgtatatgtgtgtgcgcatcatgtgtatgtgtgtgccatgtgtataccatgtatgtgtgtatcatgtacatgtgtgtgccatgtgtatgtgtgtgc	299	8	3%	46	15%
15	77030401	77030700	gtgcatgtctgtatgagcatgcatgtgtatgtgtgtgtgtgtgtctatgtgtatgttcctgagtgtgtctatgtgtctttgtgtgtatgtctgtgtgcctgtgtgttcatgtctttgtgtatgcatgtgtctacgtgtctatgtgtgtatgtatctgtgtgtgtatatatgtgtgtatgtctgtgtgtacctgtatagatgtctgtgtgggcatgtttgcgtgtgtatgtcttgtgtctgtgtgtgcctatctgtgtgtctgtgtgagtgtatgtgcctgtctgcaagcgtgcatgtga	299	6	2%	16	5%
15	79485001	79485900	ATGATGGGTGACACCAAGAAGATGCGGTCCAGGCCGATGTCATAGCCCACGTTGAGGTCCCGCTGGTCCAGTGGCAGGTACTCACCCTCCTGTGTCATGTAGGGTTTGATGAGCTGGGCCCGGACGTGGGCCTCCACAATGTGACTCTTGCGCAGGTTACCCACGCGCCACATCAGGCAGAGCTTGCCGTCTCGAACGGAGATGACAGCATGGTGGCTGAACAGCAGGGTCTGTGCCCGCTTCTTGGGCCGTGCCATCTTGGCCATGATCGTGCCAATCATGAAGGAGTCAATGACACAGCCCACAATGGACTGGACAACCACCGCAATGACCGCCAACGGGCACTCCTCTGTCACACACCGGAACCCGTAGCCAATGGTCGTCTGGGTCTCCACTGAGAAGAGGAAGGCCCCCAAAAAGCCGTTTACGTGCATGATACAGGGTTTGGGGGCATTCGGGCTTGCCCCGCCATTGCCCCCCGGGCCTCCTGCCGCGGGCACAGAGGGACTGGCCTCCAGGTCACCATGGAAGAAGGCAATGCACCAGAAGAGGAGGCCGAAGAAGAGCCAGGAAACGAGGAAGGCCGCGGAGAAGATCATGAGCATATAGCGCCAGCGCGTGTCCACGCAGGTGGTGAAGATGTCTGCCATGTAGCGCTGGGACTTGTTGCTCAGGTTGGCGAAGTAGACGTTACACTGGCCGTTCTTCTTGACAAAGCGGTTGCGGCGTTTCCGCCTGGGCACGTGGGCCTGCCCGTTTCGGTTGTGTCCGTGCATGACCTGAGGACGTCGTCGTGGTCACCTGGGGAGATGCAGGGCCTGTGGGGGACAAGGGACAGGTGAGTTGCTGGAGAGCGAGGGGGGTGTGGTGGTAAAGAAACAACCTGCCAGACTCTCAGG	899	104	12%	144	16%
15	79978801	79979100	tagcacatgcctgtagttatagcacatgtatgtagtcctagcacatgcctgtatagcacatgtctgtagtcgtagcacatgcctgtagtcgtagtcggagcacatgtctatagtcagagcacatgtttgtagtcggagcacatgctgtagtcggagcacatgttgtagtcatagcacatgtctgtagtcatagcacatgcttttagtagcacatgcctgtagtcggagcacatgcctgtaattatagtacacatttgtagtcatagcacatactgtagtcatagcacatgtctgtagtc	299	12	4%	74	25%
15	81041251	81041400	agacacacacacattcacatcacagacacacacacacaccacacacattcatatcacagacacacacacacacacacgaaacatatacatacacattcacatcacacacacacaccacacacacacattcacatcacagacacacacac	149	2	1%	112	75%
15	81494851	81495000	ttcttgtcccgggtttctcgtcccaggtcttctcgtcccgtcccgggtttcagcaccactTCttgcgcgcgctcaacaggccaggaagaacgacgctgctacaggatccttctgcacacgtttattcagtcctgtttcttcttgtttat	149	22	15%	22	15%
15	82363351	82363650	tccgagagggagtgcggggtggataaggatagacgtgtccaggtgtccaccgtccgttcaccctgggagacgtcccaggaggaacaggggaggatcagggacgcctggtggacccctttgaaggccaagagaccatttggggttgcgagatcgtgggttagagtcccacctcgtgcccagttgcgagatcgtgggttcgagtcccacctcgtgttttgttgcgagatcgtgggtttgagtcccacctcgcaccttgttgcgagaccgtgggttcgagtcccacctcgcgtctggtcacg	299	46	15%	30	10%
15	83217151	83217450	acacccctcacacacacatgcactcagacacacatatacatacacacatatacacacactcaaatattcatacacactcacacaatgccacacatactcccacacattcactcatacgcagtcacatacacatacagtctcacatacacaatcacacgcacactcaaatacacactcactaacacacaaaactcacacaaatatacacgcatgcactcacacacacataaacacatgcactcacacacattcacaccctcacacacatgtactcacagacacgcacacacacgttcaca	299	10	3%	174	58%
15	84148651	84149250	gacgtaccttgtaaagctatttcccactttacttctgatagactgtcttgaatttcgttagaaagttcaagaccagacttaccttgtaaagctatacttacgggtaccctgttccccagctgaagagttctgaattcacgcagttgaatccttctcaacagtctgtgttgcgggaacacttcattaccaccgttccccagctgaggagttctgaatccaggctggatccttctcaacagtctgttttacgggaacacttcattaccatgacccgcagttctggttccggaatgagggatcttccttgcaccggtgatggtaaccgtcccgggttttcttgtcccgggttttctcgtcccaggtcttctcgtcccgggtctcagcaccaaCtcttacacgcgttcgcgaccggccaggaagaacgcaacaaactggaatcttctgcggcaaagctttattgcttacatcttcaggagccagagagcaagagcaagagctctattgcttacatctttaggagccagagcgcaagagcgcaagagctttattgcttacttcttcaggagcaagaagcaagagccagagcgagagagagaatg	599	52	9%	84	14%
15	87293851	87295350	CATGAGAGTTTGTTGTTTCTAGATTTTTCTCTTGTGTTTGTGAAGGTTGCCACTACGAACCTTTGGGACATGGTTTATAGAATGTGCTCCTGTTTCTGATAAGTGGGTTTGtgttgggagccgcgcccacattcgccgttacaagatggcgctgacagctgtgttctaagtggtaaacaaataatctgcgcatgtgctgagggtggttctccactccatgtgctctgccttccccgtgacgtcaactcggccgatgggctgcagccaatcagggagtgacacgtcctaggcgaaggataattctccttaatagggacggggtttcgttttctctctcttgcttcttacactcttgctcctgaagatgtaagcaataaagttttgccgcagaagattctggtctgtggtgttcttcctggccgggcgtgagaacgcgtctaataacaattggtgccgaattccgggacgagaaaaaactcgggactggcgcaaggaagatccctcattccagaaccagaactgcgggtcgcggtaataaaggttcccgtaaagcagactgttaagaaggattcaactgtatgaattcagaacttttcagctggggaacgagagtaccagtgagtatagctttatgaggtaagcctggccttgaactttctaaggaaattcaagacagtctatcagaagtaaagtggaaaatgtttggccttgaattttttctagtgttagaagcccttttgttccttttcacatgttatcaagtggttaaggcagggaggattctggatgaaattcagggcaatctatcagaagtaaagcggggagagagagtaggagcaaagagaaaatatggtacacaaaataagtatacaggcctttccaagggtcttgaacccgaggaaaagtttaggtcaggtaagaatacctggggagagattagaaggaaggaaaagaaaaaagaaaagaaaaaagatcgattagcggaggtctctaggagatactcgtcactagatgagctcaggaagccagctcttagtagctctgaagcagatgaagaattctcctctgaggaaacagactgggaggaagaagcagctcattatgagaaaaaagggtaccagccaggtaaagtgctagctaatcagttaaggaagccaaaagcggctggcgaaggccagtttgctgattggcctcagggcagtcggcttcaaggtccgccctatgcggagcccccgccctgcgtagtgcgtcagcaatgcgcagagaggcaatgcgcagagagatgcgcagagaggcagtgcgcagagaggcagtgcgcagagaggcagtgcgcagactcattcattcccagagaggaacaaaggaaaatacaacaggcatttccggtctttgaaggagccgagggtgggcgtgtccacgctccggtagaatacttacaaattaaagagcttgccgagtcggtccgtaaatatggaaccaatgctaattttaccttggtg	1499	114	8%	164	11%
15	87293851	87295350	CATGAGAGTTTGTTGTTTCTAGATTTTTCTCTTGTGTTTGTGAAGGTTGCCACTACGAACCTTTGGGACATGGTTTATAGAATGTGCTCCTGTTTCTGATAAGTGGGTTTGtgttgggagccgcgcccacattcgccgttacaagatggcgctgacagctgtgttctaagtggtaaacaaataatctgcgcatgtgctgagggtggttctccactccatgtgctctgccttccccgtgacgtcaactcggccgatgggctgcagccaatcagggagtgacacgtcctaggcgaaggataattctccttaatagggacggggtttcgttttctctctcttgcttcttacactcttgctcctgaagatgtaagcaataaagttttgccgcagaagattctggtctgtggtgttcttcctggccgggcgtgagaacgcgtctaataacaattggtgccgaattccgggacgagaaaaaactcgggactggcgcaaggaagatccctcattccagaaccagaactgcgggtcgcggtaataaaggttcccgtaaagcagactgttaagaaggattcaactgtatgaattcagaacttttcagctggggaacgagagtaccagtgagtatagctttatgaggtaagcctggccttgaactttctaaggaaattcaagacagtctatcagaagtaaagtggaaaatgtttggccttgaattttttctagtgttagaagcccttttgttccttttcacatgttatcaagtggttaaggcagggaggattctggatgaaattcagggcaatctatcagaagtaaagcggggagagagagtaggagcaaagagaaaatatggtacacaaaataagtatacaggcctttccaagggtcttgaacccgaggaaaagtttaggtcaggtaagaatacctggggagagattagaaggaaggaaaagaaaaaagaaaagaaaaaagatcgattagcggaggtctctaggagatactcgtcactagatgagctcaggaagccagctcttagtagctctgaagcagatgaagaattctcctctgaggaaacagactgggaggaagaagcagctcattatgagaaaaaagggtaccagccaggtaaagtgctagctaatcagttaaggaagccaaaagcggctggcgaaggccagtttgctgattggcctcagggcagtcggcttcaaggtccgccctatgcggagcccccgccctgcgtagtgcgtcagcaatgcgcagagaggcaatgcgcagagagatgcgcagagaggcagtgcgcagagaggcagtgcgcagagaggcagtgcgcagactcattcattcccagagaggaacaaaggaaaatacaacaggcatttccggtctttgaaggagccgagggtgggcgtgtccacgctccggtagaatacttacaaattaaagagcttgccgagtcggtccgtaaatatggaaccaatgctaattttaccttggtg	1499	114	8%	164	11%
15	87300901	87301050	cctaggcgaaggataattctccttaatagggacggggtttcgttttctctctcttgcttcttacactcttgctcctgaagatgtaagcaataaagttttgccgcagaagattctggtctgtggtgttcttcctggccgggcgtgagaac	149	12	8%	6	4%
15	88592701	88593300	taagacacggggcccggtggcgatagggttaccctatgacaggaaaggctgtgacattggaggaacgacctaagacaggagccacagcggatgggcataattacacaggcctagaccagcctcaaattttaataaaataaaaagggggaTAtgtggagagccgttacgtgctgcgagcaattgcatgcgtgctgccagtaatctctgaggagagccgtgtgtgccgcgagcaatcgccattataagatggcgcgggcctccgctgtgcctaactagtaaacaagtcctgtacgcaggtgcaagagtgaattcactcctagtcactcccattcttggggtgtaatagtggggtgatgggcaagcaacgaaccaggagctgtcacgccatatcaggtgctgaaacgtcacactgcgggttataaaagcagcgccattttcccggtttgggatcttcctgagaagcaagcaataaagcttttgccacggaagattctggtttgttgcgtctttcttgccggtcgagcgggacgcaataGGAGAGACTGTAGAAATAAATCACATGGTTAATAAGGTCGATTAATAAATACATAGGTGCAGAA	599	60	10%	80	13%
15	88975051	88976250	cgttgtcaatctacaataatcggaaccacacaggcacagcatcgttgtcaatctacaataatcggaaccacacaggcacagcatcgttgtcaatctacaataatcggaaccacacaggcacagcatcgttgtcaatctacaataatcgggaccacacaggcacagcatcgttgtcaatctacaataatcgggaccacacaggcacatcatcgttgtcaatctacaataatcgggaccacacaggcacagcatcgttgtcaatctacaataatcggaaccacacaggcacagcatcgttgtcaatctacaataatcgggaccacacaggcacagcatcgttgtcaatctacaataatcgggaccacacaggcacatcatcgttgtcaatctacaataatcgggaccacacaggcacagcatcgttgtcaatctacaataatcggaaccacacaggcacagcatcgttgtcaatctacaataatcgggaccacacaggcacagcatcgttgtcaatctacaataatcgggaccacacaggcacagcatcgttgtcaatctacaataatcgggaccacacaggcacagcatcgttgtcaatctacaataatcgggaccacacaggcacagcatcgttgtcaatctacaataatcgggaccacacaggcacagcatcgttgtcaatctacaataatcgggaccacacaggcacagcatcgttgtcaatctacaataatcgggaccacacaggcacagcatcgttgtcaatctacaataatcggaaccacacaggcacatcatcgttgtcaatctacaataatcgggaccacacaggcacagcatcgttgtcaatctacaataatcgggaccacacaggcacatcatcgttgtcaatctacaataatcggaaccacacaggcacagcatcgttgtcaatctacaataatcggaaccacacaggcacagcatcgttgtcaatctacaataatcgggaccacacaggcacagcatcgttgtcaatctacaataatcggaaccacacaggcacagcatcgttgtcaatctacaataatcgggaccacacaggcacatcatcgttgtcaatctacaataatcgggaccacacaggcacagcatcgttgtcaatctacaataatcggaaccacacaggcacatcatcgttgtcaatctacaataatcgg	1199	116	10%	452	38%
15	89039551	89040000	cttaccttgtaaagctgtactcactggtactcctgttccccagctgaagagttctgaattcatgcagttgaatccttctcaacagtctgttttacgggaaccttcgttaccatgacccgcagttctggttccggaatgagggatcttccttgcgccggtgatggttaactcccgtcccgagttttcttgtattttctcgtcccgggtttCAGCACCAACtcttaaacgcgttctcacgaccggccaggaagaacacaacaaaccagaatcttctgcggcaaaactttattgcttacatcttcaggagcaggagcgcaagccccaagccccaaaaacgaaaggcccctgcttacatctttaggagccagagcgccagcgcgccagagcgccagagcgcagagcaagagctctattgtttacatctttaggagcaagcgagcaagagccag	449	46	10%	70	16%
15	89338201	89338650	tgtgttctaagtggtaaacaaataatctgcgcatgtgccaagggtagttttccaccccatgtgctctgccttccccgtgacgacaactcggccgatgggctgcagccaatcggagtgacacgtcctaggcagaggatgattctccttaaaagggacggggtttcaccattctctctcttgctctggcgcttgctctcttgctcctgaagatgtaagcaataaagtttttgcgttcttgcgctctggctcctaaagatgtaagcaatagagctcttactctcttgctctctggctcctgaagatgtaagcaataaagttttgccgcagaagattccggtttgttgcgttcttcctggccggtcgcgtgaacgcgtgtaagaTCCCTGCTCTTAGGGGATTTTCTTCAGCACGGCCTTTCTGGTTGCTTCTCCCCTCTCACATTTGCCTGC	449	40	9%	40	9%
15	89943451	89943900	cgggacaagaaacatcttcaggcacgagcgaagaccccctactacagggaggattcagaactgcatcgcggggaaggagcggttaatagaggttcccgtaaaacagactgctgagaaggatccggcgtggattcagaactcttcagctggggagcggtgttaataaaggttcctgcaaaacagactgctgagaaggattcaacagcatggattcagaactcttcagctgaggaacggcggtaccggtaagtgtaaagaaattaatgtaaatctctgagaggcatgctctcctacgaagtagatccattaattgtcgctgggattgtgctgcttgcttgctttcttgccttaattttatgctattgccttaattgtcatcgccctgggcacgagtgtatctgctgggaataatttcacgtagataacgctttagtccaggacgatcatgg	449	40	9%	48	11%
15	89948251	89948400	gtgtagaatttgttaatgcaccttccgtgggtgttaatcctcgcggattgcgacccctagatgtttggcaaatggacgtaacgcatatcccatcttttgggaaattacaatatgtacatgtatccatcgataccagttctggtgtccta	149	14	9%	16	11%
15	90764251	90764850	TCTGCAACTTTATTTGACACGAGCAGGTTAGTTCTCATCCACGTTGACCGTCTGTAGATTTTTGAATGTGGTAACAGGCACGTAAGTTACCAGCGTGTAGAGCTTGTTTGGGGAATCCTCATCCTCATTACGTTTTCTGGACAAGCGTACTCGGATGCGATATGGAACGTTCCTTATTCCCTTGGCCCAGACGGCTTTATTGAGCCTGGTGTCAATGCGCACATCTGGTGTCCCCATTTCCTTCATGGCAAACTTCCGAATTTCTTTGAGTGCCCGAGGAGCACGCTTCTTGAAGCCCACTCCATGGATGCGCTTGTGAATGTTGATGGTGTATTCTCGGGTCACCACCTCGTTGATGGCAGAACGGCCCTTCTTCTTCTCGCCACCCTTCTTTGCGGGAGCCATTCTGCCGGGCCCAAGTAGGAAAGGAAGGGCGCGAGGGTTTGTGGGAGGGAAAGTCGCGTAGCCGTACAACTTCCGGGTCACGGGGAGGCccatagttccaattttaatctattttataatccaccttctccctaggccattgtagattcctgtatatgggagtaactcagctgttattctaagtatttactcta	599	58	10%	68	11%
15	92474551	92475000	gctgaaaagttctgaattcatacagttgaatccttcttaacagtctgctttacgggaacctttattaccgcgacccgcagttctggttctggaatgagggatcttccttgcaccggtgatggtaaactctcgtcccgagttttttctcgtcccggaattcggcaccaattgttattagacgcgttctcacgaccggccaggaaagacgcaacaaaccagaatcttctgcggcaaagctttattgcttacatcttcaggagccagagtgcaagaagcaagagagcgagaaaacgaaaccctgtccctattaaagagaattctccttcgcctaggacgtgtcactccctgattggctgcagcccatcggccgagttgacgtcacggggaaggcagagcacatggagtgaagaaccaccctcggcacatgcgcagattatttgtttaccact	449	52	12%	60	13%
15	92729551	92730300	gacccgcagttctggttctggaatgagggatcttccttgcgccggtgatggtaattttcgtcccaggttttctcttcccggggttttctcgtcccggaatttctcgtcccggattttctcgtcccgggtttcagcaccaattcttatacgcgttctcacgcccggccaggaaagaacacaacaaaccaaaatcttctgcggcaaaactttattgcttacatcttcaggagccaggagcgcaaacccccagccccaaaagcgaaagccaccccaattacatctttaggagccagagctccggcgcgccaaagcgcagagcgcgctctattgtttacatcttttggagccagaagccagcgcgcgccagagccagagagagaaagagagagagtggcagaaaaccccgtcccctttaaggaggagttatccttcgcttaggacgcatcactccctgattggctgcagcccatggccgagctgacgttcacgggaaaggcagagtacaagtagtcgtaaaatacccttggcacatgcgcagattatttgtttaccacttagaacacaggatgtcagcgccatcttgtgacggcgaatgtgggggcggctcccaacatctgaggaaccaccagactgacttccagagtggttgtacaagtttgcaatccaaccagcaatggaagagtgttcctctttctccacatccttcccagcatctgctgtcacctgaagttttgatcttagccattctg	749	78	10%	122	16%
15	93333901	93334050	gtgcacatacacgtatgtaagtacacagtacatgtgtgcacatacacATAAAGAAGAAAAGGCTTCAGACATCTAGAATAGCTTAGGCTTGCCTTCGTGATTGGCAGCTAGAACAGATTCAGTTCAGAGGTTGTTCTGACCCAAGGGAT	149	4	3%	32	21%
15	93468901	93469050	caggtccgtgcagatgagatgcagtgttaagacaaatacaatgtaaccaggtaccgggtgcttgtacaggtccgtgcagatgagatgcagtgttaagacaaatacaatgtaaccaggtaccgggtgcttgtacaggtccgtgcagatga	149	10	7%	28	19%
15	96148951	96149700	TGTCACACGTCATCATGGTCACTTGAAATCTCATCTTACCACACAATACATTAATGTCTGTAATGGCATCTGAAAGTGAAATGAGTAGAAgtgtgtgtgtgtgtgtgtacgtgagtgtgtcagtgtgtgagtgtgtgtgcatgtgagtgtgtcagtgtgtgagtgtgtgtacatgagagtatgtgagtgtgtgtgcatgtgagtgtgtcagtgtgtgagtgtgtgtatgtgagagtatgtgagtgtgtgtgcatgtgagtgtgtcagtgtgtgagtgtgtgtatgtgagagtatgtgagtgtgtgtgcatgtgagtgtgtcagtgtgtgagtgtgtgtacatgagagtatgtgagtgtgtgtgcatgtgagtgtgtcagtgtgtcagtgtgtgtgtgagaccatgtgagtgtgtgtgcatgtgagtgtatgtgtcagtgtgtgagtgtgtgtatgtgagagtatgtgagtgtgtgtgcatgtgagtgtgtcagtgtgtgagtgtgtgtacatgagagtatgtgagtgtgtgtgcatgtgagtgtgtcagtgtgtgagtgtgtgtacatgagagtatgtgtgtgtgtgtgcatgtgagtgtgtcagtgtgtcagtgtgtgtacgtgagagtatgtgagtgtgtgtgcatgtgagtgtgtcagtgtgtgagtgtgtgtatgtgagagtatgtgagtgtgtgtgcatgtgagtgtgtcagtgtgtcagtgtgtgtgtgagaccatgtgagtg	749	6	1%	86	11%
15	96480451	96480900	gtgtgtgtgtgtgtgtgtgtgtatatgtgtgtatgtgtatatgtgtacgagtgtgtatatgtgtgtgtatgtgtatgagtgtgtgtatatgtgtgtatgtatatgtgcatgagtgtgtgtatgtatgtgtgtatatgtgtgtgtatgtatgtgtgtatgtgtatgagtatgtgtatatctgtgtgtatgtgtgtatgggtgtgtatgtgtgagtgtgtatgtgtgtgtatggatgtgtatgtgtgtgtttgtgtgtgtatgtgtgtgtgtatgtgtgtgtgtatgtgtgtgtatgtgtgtttgtgtgtgcgttgtgtgtgtatgtgtgtgtttgcgtgtgtatgtgtgtatgggtgtgtatgtgtgtgtatatgtgtgtgtgtAGGCTTCTATAGTAGAAGATTTCCATTAAGTTCTTTCTCCCCTTCTCCCTCCCGTTCTTCCTCCCT	449	8	2%	4	1%
15	96978151	96978600	gcatgtgccaagggtatcttatgactacttgtgctctgccttccccgtgacgtcaactcggccgatgggctgcagccaatcagggagtgacacgtccgaggcgaaggagaatgctccttaagagggacggggtttcgttttctctctctcttgcttcttgctctcttgcttcttgcactctggctcctgaagatgtaagcaataaagctttgccgcagaagattctggtctgttgcgtctttcctggccggtcgtgagaacgcgtctaataacaattggtgccgaattccgggacgagaaaaaactcgggactggcgcaaggaagatccctcattccagaaccagaactgcgggtcgcggtaataaaggttcccgtaaagcagactgttaagaaggattcaactgtatgaattcagaacttttcagctggggaacgagagtaccagtga	449	50	11%	40	9%
15	96979201	96979500	aggtccgccctatgcggagcccccgccctgcgtagtgcgtcagcaatgcgcagagagatgcgcagagaggcaatgcgcagagagatgcgcagagaggcagtgcgcagagaggcagtgcgcagactcattcattcccagagaggaacaaaggaaaatacaacaggcatttccagtctttgaaggagccgagggtgggcgtgtccacgctccggtagaatacttacaaattaaagaacttgccgagtcggtccgtaaatacggaaccaatgctaattttaccttggtgcagttagacaggc	299	38	13%	48	16%
15	97555801	97556400	tggagtcaaagcagctgcgtttgttcgggcctgcgcttgtgcagcttcgtgccaaagagctctccattccatatatttgcccatactagggagagcggcttttacaatcgtttgccagtcagcaggagttagtgccatgccggcgagcctgtctaactgcaccaaggtaaaattagcattggttccgtatttacggaccgactcggcgagttctttaatctgcacgtattctaccggagcgtggacacgcccaccctcggctccttcaaagactggaaatgcctgttgtattttcctttgttcctctctgggaatgaatgagtctgcgcactgcctctctgcgcactgtctctctgcgcactgcctctctgcgcactgcctctctgcgcattgcctctctgcgcactgcctctctgcgcattgctgacgcactacgcagggcgggggctccgcatagggcggaccttgaaaccgactgcccggaggttgaacagtacgctggctttcgccagccgcttttggcttttttcttgaccaattagctggctggtaatgggctgcttcttcctcccagtctgtttcctcagaggagaattctt	599	70	12%	68	11%
15	97662301	97662750	cacagacatacatacacacatacatacacacatacatacacacacatacatgcatgcatacacatacatacatgcatgcatgcatgcacacatacatgcatacatacacacatacatatacacgcatacacacatatatacatacatacatacacacatgcatacatacatgcatacacacatacatatacacgcatacacacatatatacatacatgcatacacacatgcatacatacatgcatacacacatacatatacacgcatacacacatacatacacacacatgcatgcatgcatacacacatacatatacacgcacacacacatatatacatacatgcatacacacatacatacatgcatacacacatacatatacacgcatacacacatatatacatacatgcatacacacatgcatacatacatgcatacacacatacat	449	10	2%	258	57%
15	97736401	97736700	gctctgccttccccgtgacgacaactcggccgatgggctgcagccaatcagggagtaatacgtcctaggcggagaataattctccttaaaaagggacggggtttcgccattctctctcttgcttttgctcttgcactcttgctctggctcttgcactctagcgctcttgcgctctggctcctaaagatgtaagcaatagagctcttgctctcttgcactcttgctcctgaagatgtaagcaataaagttttgccgcagaagattctggtttgctgcgtctttcctggccggtcgagaac	299	28	9%	22	7%
15	98612401	98613150	acacatgtacaatacacacatgcacacatatacacaggcataatacacacatgcacatatatacacacccacaatacacacacccacacatacacacacgcacccatacacacatgcacatatacacatatgcatacacacacgcacatgtacacacatgcacacgtgcacacatacacacatacacacatacacacatgcacatgtacacacatgcacacatacacacatgcatacacacatgcacacatatacacatgcacccatacacacatgcacattaaaaacatgtacacatacacacatgcacccatacacacatacacacatgaacacatacacacatgaacacatacacacatacacagatttactcatacacacatgtacccatatacatacccacacatacacacatgcacacatacacacacatgcacacagactcacttatacacacattaacactcatgcacatgcacacagactcatacacatacacacacagactccctcgtacacttatacacactcacacacagacacactcacacacagattcatttacacacGCATAAACATAATACAGAGAGACTCAGATTTTTTTCTcacacacagatacagaaacacacacagagacactcatacacacacacTATAAGATACGTAAAGTGTGGTagttaggcctggtgatactcccatcaccccagctactcaggaggctggggtgggcaaggttacacatttgc	749	10	1%	394	53%
15	98937901	98938200	cacacacacacactcacacacacactcacacacacacacacccacgcacacacacactcacacacacacacactcacacacacccacacacactcacacccacacacactcacacacacacacacactcacacacacacacacactcacacacacacacacgcacacactcacacacacacacacacacactcactcacacacacacacacacacacacacacacacaTGCGCCCCCGCAAACTCTGTAAATAAGTGTTTAGAATATATAAAGTAAAATACAGCCCCCGTGAAGCAAAG	299	10	3%	202	68%
15	99552301	99552600	agcagtagacatgtacactgtggatgagcagttcacatgtacacgtgtggatgaacagttcacatgtacacgtgtggatgagcagttcacatgtacactgtggatgagcagtagacatgtacactgtggatgagcagttcacatgtacactgtggatgagcagttcacatgtacatggtggatgagcagttcacatgtacacgtgtggatgaacagttcacatgtacactgtggatgagcagttcacatgtacactgtggatgagcagttcacatgtacatggtggatgagcagttcac	299	6	2%	88	29%
15	99871201	99871500	acatactctctctcacacacacatacacatacccacacatatacacacgcacactcacatatatacacacatatacacatgcatacacacactcacatatgcatatagacatacatatacacacatacaaacatacacacatacactcatatacacacactcacacacatactcacatacactcacatacatatacacacacactcacatatatacacacatatacacatacatacacacacactcacagacgcatacagacatacatatacacacatacaaacatacacgcatacact	299	6	2%	168	56%
15	100165201	100166100	atatagtgcagacttgtcctccagtctccatgagtgtgttgtggtgtgtacgtgtgctctccccatgtcataatacaaataataatatagtgcagacttgtcctccagtcttccatgagtgtgttgtggtgtgtacgtgtgctctccccgtgtcataatacaaataataatatagtgcagacttgtcctccagtctccatgagtgtgttgtggtgtgtacgtgtgctctccccgtgtcataatacaaataataatatagtgcagacttgtcctccagtctccatgagtgtgttgtggtgtgtacgtgtgctctccccgtgtcataatacaaataataatatagtgcagacttgtcctccagtctccatgagtgtgttgtggtgtgtacgtgtgctctccccgtgtcataatacaaataataatatagtgcagacttgtcctccagtctccatgagtgtgttgtggtgtgtacgtgtgctctccccaagtcataatacaaataataatatagtgcagacttgtcctccagtctccatgagtgtgttgtggtgtgtacgtgtgctctccccatgtcataatacaaataataatatagtgcagacttgtcctccagtctccatgagtgtgttgtggtgtgtacgtgtgctctccccgtgtcataatacaaataataatatagtgcagacttgtcctccagtctccatgagtgtgttgtggtgtgtacgtgtgctctccccgtgtcataatacaaataataatatagtgcagacttgtcctccagtctccatgagtgtgttgtggtgtgtacgtgtgctctccccatgtcataatacaaataataatatagtgcagacttgtcctccagtctccatgagtgtgttgtggtgtgtacgtgtgct	899	34	4%	114	13%
15	100849051	100849800	agcagatgttcatgcatatcttccatggaaGGAAGATacagaacacgtgtacaacagatgatttacacagaacacatgtgcaacagatgatatacacagaacatgtgtataacagatgatttacacagaacatgtgtacaacagatgatgtacacatgacacatgtgcaacagatgatatacacagaacacatgtgcaacagatgacttacacagaacacgtgcacaacagatgacttacacagaacacgtgtacaacagatgatttacacagaacacgtgtacaacagatgatgtacacaggacacgtgtgcaacagatgatatacacagaacacgtgtacaacagatgatttacacagaacacgtgtacaacagatgatttacacagaacacgtgtacaacggattatgtacacagaacacatgtgcaacagatgacttacacagaacacgtgtacaacagatgatttacacagaacacgtgtacaacagatgatgtacacaggacacgtgtgcaacagatgatatacacagaacacgtgtacaacagatgatatacacagaacacgtgtacaacagatgatttacacagaacacgtgtacaacagatgatttacacagaacacaggtacaacagatgatatacacagaacacatgtagaacagatgatgtacacaggacacatgtgcaaaagatgatgtacacagaacatatgagcaacagaagatgtatatagaacatatgtgcg	749	32	4%	256	34%
15	102020701	102020850	cacacatacagacacgcacactcactcatgtacagacacgcatgtatacacatacacatgtacacacacgtacacacagacacacaggtttgcacgagagagagacagcaaaagagagagtaagagagagagagagacaatataaaaaa	149	8	5%	58	39%
15	102153601	102153900	catgcacacacacatatgcacttttgctcgtgcacatgcatacacacacatgcacacatgcacacacatgcagaaacacacacaaatgcacatacccacacatgcgtgtatgcctacacaagcacacagattcacgggtatgcacatgcatgcacatgtgcacatgtatgtgctcacatgcatgcacacacacacacacacacacacacacacacacacactcctccatcttcCAGGCCTCATTCAGCCATCTACCTTCCTCGGCTAGCTTTACTGCTTCTTATTACCTTCCACACGGC	299	10	3%	144	48%
15	102367501	102367650	atgtgtgagtgtgcatttgtgtgtacgtgtatgcgtgtatatgtgtatgtgtgtgcatatatgtgaatgtatgtatatgtatgtgtgttcgtgtatgtgtgtgtgcctgtgtatatatgtgtatgtgtgtgcctatgtatatatgtatg	149	6	4%	4	3%
15	103606951	103607250	gcgctcgctcgctgcctaaagatgtaaacaatagagcgcgctctgcgccccggcgcgccggagctctggctcctaaagatgtaagaagggggctttcgtttttggggtttggggtttttgcactcctgctcctgaagatgtaagcaataaagttttgccgcagaagattctggtctgttgcgtctttcctggccgggcgtgagaacgcgattaagaATtggtgctgaaatccgggacgagaaattccgggacgagaaaaaatccgggaagaaaaaacccgggaggaaactcgggacggg	299	50	17%	8	3%
15	103781251	103781400	taaggaaaaagccaaaagtggctggcgaaggccagtttgctgcttggcctccgggcagtcggcttcaaggtgcacttccgccctatgcggagcccccgccctgcgtagtgcgtcagccctgcgcagagagacaatgcgcagagaggcaa	149	20	13%	20	13%
16	3042301	3042450	ctcattcattcccagagaggaacaaaggaaaatacaacaggcatttccagtctttgaaggagccgagggtgggcgtgtccacgctccggtagaatacttacaaattaaagaacttgccgagtcggtccgtaaatacggaaccaatgcta	149	16	11%	22	15%
16	3106201	3106950	tgccacggaccctttctgacctccaccgactggttgtgggctctgacctgcacctccttccaatgctctagagttagagaaaggggagtggacacagattgtcccatttccagaataatagtagacacaacaagagcgaacacgagactaagacaaaaaagaaaccaaaagcggcggcgacttcgcgtcgaccacaagcaactcaaagaatcagatggcctttctaaggccggctgattgagaccctctgcacgaggtgggactcgaacccacgatcccgtaacaaaacacgaggtgggactcgaacccacagtctcgcaacaaggcgagaggcgggactcgaacccacgatctcgcaacaaaacgcgaggtgggactcgaacccacgatctcgcaacaaggcacgaggtgggactcgaacccacgatctcgcaaccccagatggtctcttggcctccaaaggggtccaccaggcgtccctggtcctcccctgttcctcctgggacgtctcccagggcgaacggacggtggacacctggacacgtctatccttatccaccccacgttccctctcggagcgcggtctcactgagcatccgcaaaaccgaaactgcgatcgcaccaaacttagaaacagaacacagacaccagaccaagtcaaagaatcttacgttaaagtgggtctagggtctctgggtggtcgcgctgatcccggacgagcccccaaatgaaagacccccgaagggaga	749	104	14%	116	15%
16	3359701	3361200	acctgtcttggtctggtgtctgtgttctgtttctaagtttggtgcgatcgcagtttcggttttgcggatgctcagtgagaccgcgcttcgagagggaacgtggggtggataaggatagacgtgtccaggtgtccaccgtccgttcgccctgggagacgtcccaggaggaacaggggaggaccagggacgcctggtggacccctttggaggccaagagaccatctggggttgcgagatcgtgggttcgagtcgcacctcgtgccttgttgcgagatcgtgggttcgagtcccacctcgcgttttgttgcgagatcgtgagttcgagtcccgcctcgcgccttgttgcgagaccgtgggttcgagtcccacctcgtgttttgttacgggatcgtgggttcgagtcccacctcgtgcagagggtctcaatcggccggccttagaaaggccatctgattctttgagttgcttgtggtcgacgcgaagtcgccgccgcttttggtttcttttttgtcttagtctcgtgttcgctcttgttgtgtctactattattctggaaatgggacaatctgtgtccactcccctttctctaactctagagcattggaaggaggtgcaggtcagagcccacaaccagtcggtggaggtcagaaagggtccgtggcagaccttttgcgcctccgagtggccgacgtttggagtgggctggccaccagaaggtgcttttgacttgtcactaatcgccgccgtcaggcgaattgtttttcaggaggaagggggtcaccctgatcagatcccctacattgtgacctggcagaatctcgtccaattcccacctccgtgggtcaagccttggaccccaaattcttcgaaactgacggtcgcggttgcccagtctgatgcagccggaaagtccggcccatcagcaccccccaagatttatccagaaattgacgacctcctctgatggactcccaacctcccccttaccccctgccccagcagccacctgcagccgccccaccacagggaccaatagcgagaggggctcagggacctgcgggggggactcggagccgccgaggccgaagccccggggaggaaggggggtcggattcaacagttgccttgccacttagagcacatgtgggagggccagcgccaggacctaatgatctcattcctttacaatactggcctttttcctcttctgatttatataattggaaaactaaccacactcccttctcagagaacccctctgggcttactgggctccttgagtcacttatgttctcccatcaacccacttgggatgattgtcagcagcttttgcaggttctttttaccacagaagaaagagaaagaatcctgatggaggtgagaaaaaatgttctgggagaggacggcacacccactgccctccctaacctcgtggacgaggctttccccttgaaccaccccaactgggactacaacaccgcggaaggtaggggacgcct	1499	166	11%	168	11%
16	4749151	4749450	atatttacggaccgactcggcgagctctttaatctgtaagtattctaccggagcgtggacacgcccaccctcggctccttcaaagactggaaatgcctgttgtattttcctttgttcctctctgggaatgaatgagtctgcgcactgcctctctgcgcattgtctctctgcgcagggctgacgcactacgcagggcgggggctccgcatagggcggaccttgaagccgactgccctgaggccaatcagcaaactggccttcgccagccgcttttggcttccttaactgattagctagca	299	38	13%	28	9%
16	4750051	4750200	acctttattaccgcgacccgcagttctggttctggaatgagggatcttccttgcgccagtcccgagttttttctcgtcccggaattcggcaccaattgttattaaacgcgttctcacgcccggccaggaagaacacagcaaaccagaat	149	24	16%	20	13%
16	8039701	8040150	ttgccagtcagcaggagttagtgccatgccggcgagcctgtctaactgcaccaaggtaaaattagcattggttccgtatttacggaccgactcggcgagttctttaatctgcacgtattctaccggagcgtggacacgcccaccctcggctccttcaaagactggaaatgcctgttgtattttcctttgttcctctctgggaatgaatgagtctgcgcactgcctctctgcgcagtgtctctctgcgcactgcctctctgcgcactgcctctctgcgcattgcctctctgcgcactgcctctctgcgcattgctgacgcactacgcagggcgggggctccgcatagggcggaccttgaaaccgactgcccggaggttgaacagtacgctggctttcgccagccgcttttggcttttttcttgaccaattagctggctggtaatgggctg	449	58	13%	48	11%
16	9038101	9038250	ctcacacacttactgacacatacacacacactcacacacatgcacacacttgcacactcactcacagacacacacaatcacactcacacatatgctcacattcacactTAAACTCAAACTCCCCAAACTTACACAACTCACACGcatac	149	2	1%	82	55%
16	11680201	11680500	aatgctccttaagagggacggggttttcgttctctctctctcttgcttcgctctctggcttctctctcttgcttctctctcttgcttctctctctcttgcttcttgctctcttttcctgaagatgtaagaataaagctttgccgcagaagattctggtctgtggtgttcttcctggccggtcgtgagaacgcgtcgaataacaattggtgccgaaacccgggacgagaaaatccgggacgagaaaaaactccggactggcgcaggagggatacttcattccagaaccagaactgcgaat	299	34	11%	12	4%
16	11681251	11681400	tgctaattggcctcagggcaatcggctaccaggtgcactcccgccctatgcggagtccccgccctgcgtagtgcgtcagcccgtagtgcgtcagcaatgcgcagagaggcagtgcgcagaaaggcagtgcgcagactcattcattcccc	149	22	15%	28	19%
16	12339751	12341100	ttacaagatggcgctgacagctgtgttctaagtggtaaacaaataatctgcgcatgtgccgagggtggttcttcactccatgtgctctgccttcctcgtgacgtcaactcggccgatgggctgcagccaatcagggagtgacacgtcctaggcgaaggaaaattctccttaatagggacggggtttcgttttctctctctcttgcttcttgcactctggctcctgaagatgtaagcaataaagctttgccgcagaagattctggtctgttgcgtctttcctggccggtcgtgagaacgcgtctaataacaattggtgccgaattccgggacgagaaaaaactcgggactggcgcaaggaagatccctcattccagaaccagaactgcgggtcgcggtaataaaggttcccgtaaagcagactgttaagaaggattcaactgtatgaattcagaacttttcagctggggaacgagagtaccagtgagtatagctttacgaggtaagtctgatcttgaactttctaaggaaattcaagacagtctatcagaagtaaagtggaaaatgtttggccttgaattttttctagtgttagaagcccttttgttccttttcacatgttatcaagtggttaaggcagggcgaattctagacgaaattaaagtcaatctatcagaagtaaagtggggagagagagtaggagcaaagagaaaatatggtacacaaaataagcgtacaggcctttccacgggtcttgaacctgaggaaaagttaaggttaggtaggaatacctggagagagattagaagaaaaagaggaaaaagggaaaagaagaaagatcaattagcggaggtctctaggaaaaggagcctgtgctcatcgctggatgggctcggggagccagctcttagtagctctgaagcagatgaagaattctcctctgaagaaacagactgggaggaagaagcagctcattatgagaaaaaagggtaccagccaggtaaagtgctagctaatcagttaaggaagccaaaagcggctggcgaaggccagtttgctgattggcctcagggcagtcggcttcaaggtccgccctatgcggagtccccgccctgcgtagtgcgtcagccctgcgcagagaggcagtgcgcagactcattcattcccagagaggaacaaaggaaaatacaacaggcatttccggtctttgaaggagccgagggtgggcgtgtccacgctccggtagaatactacaaattaaagaaattgccgagtcggtccgtaaatacggaaccaatgctaattttaccttggtgcagttagacaggcttgccggcatggcactaactcc	1349	110	8%	142	11%
16	12977401	12977850	ccattaccagccagctaatcggtcaagaaaaaagccaaaagcggctggcgaaggccagtttgctaattggcctcagggcaatcggctaccaggtgcactcccgccctatgcggagtccccgccctgcgtagtgcgtcagcccgtagtgcgtcagcaatgcgcagagaggcagtgcgcagactcattcattccccgagaggaacaaaggaaaatacaacaggcatttccagtctttgaaggagccgagggtgggcgtgtccacgctccggtagaatatgtgcagattaaatatggaatcaatgctaattttaccttggtgcagttagacaggcttgccagcatggcactaactcctgccgactggcaaatgattgcaaaagccgctctccctagtatggccaaatatttggaatggagatctctgtggcgagaggctgcacaggcgcagg	449	44	10%	74	16%
16	13099801	13100100	acaacacccagaatcttctacggcaaagctttattgcttacatcttatggggccagagtgtaagaagcaagagagagagaaaacgaaacccctttcctctttaaagagaacaacaattgcctcggacgcatcactccctgattggctgcagcccatggccgagctgacgttcacgggaaaaacagagtacaagtagtcgtaaatacccttggctcatgcgcagattatttgtttaccaacttagaacacaggatgtcagcgccatcttgtgacggcgaatgtgggggcggcttcccaca	299	26	9%	50	17%
16	13105501	13105650	tggttccgtatttacgaaccgactcggcaatttccttaatctgtacgtattctaccggagcgtggacacgcccaccctcggctccttcaaagactggaaatgcctgttgtattttcttttgttcctctcggggaatgaatgagtctgcg	149	22	15%	8	5%
16	13270651	13270800	tgcactctggctcctgaagatgtaagcgataaagctcttgcgctcttgcgctcttgctctggctcttgctctcttgcgctctggctcctaaagatgtaagcaatagagctcttgctctcttgctctctggctcctgaagatgtaagcaa	149	8	5%	6	4%
16	14685451	14685600	gtggatgatgacagacagacacacacgcaggagagtttgtgtggaatctgaatgtaattttacaactcgagcatcagactttttatgcagaggacaataaggaagttgggtgacatattcgcaaggtacaattgaggtaactggaatct	149	6	4%	28	19%
16	15502801	15504150	ggaagtgaaatgttgggagccgcgcccacattcgccgttacaagatggcgctgacagctgtgttctaagtggtaaacaaataatctgcgcatgtgccgagggtggttctccactccatgtgctctgccttccccgtgacgtcaactcggccgatgggctgcagccaatcagggagtgacacatcctaggcgaaggataattctccttaatagggacggggtttcgttttctcgctctcttgcttcttacactcttgctcctgaagatgtaagcaataaagttttgccgcagaagattctggtctgtggtgttcttcctggccgggcgtgagaacgcgtctaataacaattggtgccgaattccgggacgagaaaaaactcgggactggcgcaaggaagatccctcattccagaaccagaactgcgggtcgcggtaataaaggttcccgtaaagcagactgttaagaaggattcaactgtatgaattcagaacttttcagctggggaacgagagtaccagtgagtacagctttacgaggtaagtctggtcttgaactttctaaggaaattcaagacagtctatcagaagtaaagtggaatatgtttggccttgaattttttctagtgttagaagcccttttgttccttttcacatgttatcaagtggttaaggcagggaaaattctagaggaaattcaggacaagctatcagaagtaaagtggggagagagagtaggaacaaagaggaaatatggtacacaaaataagtatacaggcctttccaagggtcttgaacccgaggaaaagttaaggttaggtaggaatacctggagagagattagaagaaaaagaggaaaaagggaaaagaagaaagatcaattagcggaggtctctaggaaaaggagcctgtgctcatcgctggatgggctcggggagccagctcttggtagctctgaatcagatgatgaattctcctctgaagaaacagactgggaggaagaagcagctcattatgagaaaaaagggtaccagccaggtaaagtgctagctaatcagttaaggaagccaaaagcggctggcgaaggccagtttgctgattggcctcagggcagtcggcttcaaggtccgccctatgcggagtccccgccctgcgtagtgcgtcagccctgcgcagagaggcaatgcgcagagaggcagtgcgcagactcattcattcccagagaggaacaaaggaaaatacaacaggcatttccggtctttgaaggagccgagggtgagcgtgtccacgctccggtagaatacttacaaattaaagaacttgccgagtcggtccgtaaatacggaaccaat	1349	110	8%	148	11%
16	15745801	15745950	atgcgaccaccagtccttctaacagcagtttattcagtcttcatctttcttctttctcttcatcagtaccgttccccagctgaagagttctgaatccacgccagatccttctcaacagtctgtttcacgggaacctttattaactgctc	149	8	5%	28	19%
16	15843901	15844200	ctaaaatagcatttgttttacgaaattgagtacactaagttttgtgcatatatgttcttgattcagtcttaaacgcgttctcacgaccggccaggaagaacacaacaaaccagaatcttctgcggcaaaactttattgcttacatctttaggagccaggagcgcaagccccaagccccaaaaacgaaaggccccccgcttacatctttaggagccagagcgccagcgcgccagagcgccagagcgcagagcgcaaaagcgcaagcaagagagagaatggcggaaaccccgtcccctttt	299	36	12%	50	17%
16	16026901	16027200	cgacccgcagttctggttctggaatgagggatcttccttgcgccagtcccgagtttttttctcgtcccggaATTCGGCACCAATtgttattaaacgcgttctcacgcccggccaggaagaacaccacagaccagaatcttctgcggcaaaactttattgcttacatcttcaggagcaagagtgtaagaagcaagagagagagaaaacgaaaccccgtcccttttttaggagagttatatttcgcctaggacgtgtcactccctgattggctgcagcccatcggccgagttgacgtcacg	299	40	13%	38	13%
16	16819651	16820100	aggtactattgaaatatatgtactaattattgtcaatatgttgttgattttttttttttttGGCAGTTCTGCAACTTTATTTGACATGAGCAGGTTAGTTCTCATCCACATTGACCGTCTGTAGATTTTTGAATGTGGTAACAGGCACGTAAGTTACCAGCGTGTAGAGCTTGTTTGGGGAATCCTCATCCTCATTACGTTTTCTGGACAAGCGTACTCGGATGCGATATGGAACGTTCCTTATTCCCTTGGCCCAGACGGCTTTATTGAGCCTGGTGTCAATGCGCACATCTGGTGTCCCCATTTCCTTCATGGCAAACTTCCGAATTTCTTTGAGTGCCCGAGGAGCATGCTTCTTGAAACCCACTCCATGGATGCGCTTGTGAATGTTGATGGTGTATTCTCGGGTCACCACCTTGTTGATGGCAGAACGGCCCTTCTTCTTCTCG	449	32	7%	54	12%
16	16934701	16935300	aaacaaataatctgcgcatgtgccaagggtattttaccactacatgtactctgcctttcccgtgacgtcaactcggccatgggctgcagccaatcagggagtgatgcgtcctaggcaaagaataattctccttaaaaggggacggggtttccgccattctctctcttgctggcgctctggcgcgctggcgctctggctcctaaagatgtaagcggggggctttcgtttttggggctgggggcttgcgctcctgctcctgaagatgtaagcaataaagttttgccgcagaagattctggtttgttgtgttcttcctggccggtcgtgagaacgcgtttaagaGttggtgccgaaatccgggacgagaaaatccgggacgagaaaatacaagaaaactcgggacgggagttaaccatcaccggcgcaaggaagatccctcattccggaaccagaactgcgggttatggtaatgaaggttcccgtaaaacagactgttgagaaggattcaactgcgtgaattcagaactcttcagctgggaaacggcggtaataaagtgttcccgcatcacagactgttgagaaggattcaactgcgtgaat	599	72	12%	56	9%
16	17952451	17952900	atatagatatatatgcatatatagacatatatatgtatatatctaatatatatgtgtgtgtatatatatgtatattAGGAGGAAACCtcttaaacgcgttctcacgaccggccaggaagaacacaacaaaccagaatcttctgcggcaaaactttattgcttacatcttcaggagcaggagcgcaagccccaagccccaaaaacgaaaaagccccccacttacatctttaggagccagagcgccagcgcgccagagcgcagagcaagagctctattgtttacatctttaggagcaagcgagcaagagccagagccagagagcaaaagcgcaagagcgcaagcaagagagagaatggcggaaaccccgtcccctttaaggagaattatccttcgcctaggacgtatcactccctgattggctgcagcccatggccgagttgttgccacgg	449	40	9%	70	16%
16	17955901	17956050	tctCAGCACCAACtcttaaacgcgttctcacgaccggccaggaagaacacaacaaaccagaatcttctgcggcaaaactttattgcttacatcttcaggagcaggagcgcaagccccaagccccaaaaacgaaaaagccccccacttac	149	14	9%	34	23%
16	19593151	19593600	ttgaatttccttagaaagttcaaggccaggcttacctcgtaaagctatactcactggtactctcgttccccagctgaaaagttctgaattcatacagttgaatccttcttaacagtctgctttacgggaacctttattaccgcgacccgcagttctggttctggaatgagggatcttccttgcgccagtcccgagttttttctcgtcccgggtttcggcaccaattgttattagacgcgttctcacgaccggccaggaaagacgcaacaaaccagaatcttctgcggcaaagctttattgcttacatcttcaggagccagagtgcaagagagcaagccagcaaatggcgaaaccccatccctttttaaggagaattatcctccacctaggatgtattactccctgattggctgcagcccatcggcccagttgtcatcacgggaaaggca	449	40	9%	64	14%
16	19601401	19602000	tgaaaaacaattcgcctaacggcagcaattagtgacaagtcaaaagcaccttctggtggccagcccactccaaacgtcggccactcggaggcacaaaaggtctgccacggaccctttctgacctccaccgactggttgtgggctctgacccgcacctccttccaatgctccagagtcagagaaaggggagtggacaccgattgtcccatttctagaaaaacagtagacactacaagagcggacacgagactaagacaaaaaagaaaccagaaacggcggcgactctgcgtcgaccacaagcaactcaaagaatcagatggcctttccaaggccggccgattgagaccctctgcacgaggtgggactcgaacccacgatcccgtgaccaaacgcgaggtgggactcaaacccacggtctcgcaacaaggcgcgaggtgggactcaaacccacgatctcgcaacaaaacgcgaggtgggactcgaacccacgatctcgcaactgggcacgaggtgggactcaaacccacgatctcgcaaccccaaatggtctcttggcctccaaaggggtccaccaggcgtccctggtcctcccctgttcc	599	78	13%	106	18%
16	19928551	19928700	acaactggccaccttccaggcgagagccacagagcttctgaggcggcgccatcttcagctccagacagccggccaccttcctggtgagagcacgggggtctgcccagcctgagaggtttgtgtcacaggtgccggcgggagccttcttg	149	14	9%	28	19%
16	20042401	20043600	accctcggctccttcaaagactggaaatgcctgttgtattttcctttgttcctctctgggaatgaatgagtctgcgcactgcctctctgcgcactgcctctctgcgcactgcctctctgcgcatctctctgcgcattgcctctctgcgcatctctctgcgcattgcctctctgcgcattgctgacgcactacgcagggcgggggctccgcatagggcggaccttgaagccgactgccctgaggccaatcagcaaactggccttcgccagccgcttttggcttccttaactgattagctagcactttacctggctggtacccttttttctcataatgagctgcttcttcctcccagtctgtttcttcagaggagaattcatcatctgattcagagctaccaagagctggctccccgagcccatccagcgatgagcacaggctccttttcctagagacctccgctaattgatctttcttcttttccctttttcctctttttcttctaatctctctccaggtattcctacctaaccttaacttttcctcgggttcaagacccttggaaaggcctgtatacttattttgtgtaccatatttcctctttgttcctactctctctccccactttacttctgatagcttgtcctgaatttcctctagaattttcagccctatcttaatcacttgataacatgtgaaaaggaacaaaagggctcctaacaccagaaaaaattcaaggccaaacatattccactttacttctgatagactgtcttgaatttccttagaaagttcaagaccagacttacctcgtaaagctgtactcactggtactctcgttccccagctgaaaagttctgaattcatacagttgaatccttcttaacagtctgctttacgggaacctttattaccgcgacccgcagttctggttctggaatgagggatcttccttgcgccagtcccgagttttttctcgtcccagaattcggcaccaattcttaatcgcgttctcacgcccggccaggaagaacacagcaaaccagaatcttctgcggcaaaactttattgcttacatcttcaggagcaagagtgtaagaagcaagagagagagaaaacgaaaccccgtccctattaaggagaattatccttcgcctaggacgtgtcactccctgattggctgcagcccatcggccgag	1199	84	7%	136	11%
16	20042401	20043600	accctcggctccttcaaagactggaaatgcctgttgtattttcctttgttcctctctgggaatgaatgagtctgcgcactgcctctctgcgcactgcctctctgcgcactgcctctctgcgcatctctctgcgcattgcctctctgcgcatctctctgcgcattgcctctctgcgcattgctgacgcactacgcagggcgggggctccgcatagggcggaccttgaagccgactgccctgaggccaatcagcaaactggccttcgccagccgcttttggcttccttaactgattagctagcactttacctggctggtacccttttttctcataatgagctgcttcttcctcccagtctgtttcttcagaggagaattcatcatctgattcagagctaccaagagctggctccccgagcccatccagcgatgagcacaggctccttttcctagagacctccgctaattgatctttcttcttttccctttttcctctttttcttctaatctctctccaggtattcctacctaaccttaacttttcctcgggttcaagacccttggaaaggcctgtatacttattttgtgtaccatatttcctctttgttcctactctctctccccactttacttctgatagcttgtcctgaatttcctctagaattttcagccctatcttaatcacttgataacatgtgaaaaggaacaaaagggctcctaacaccagaaaaaattcaaggccaaacatattccactttacttctgatagactgtcttgaatttccttagaaagttcaagaccagacttacctcgtaaagctgtactcactggtactctcgttccccagctgaaaagttctgaattcatacagttgaatccttcttaacagtctgctttacgggaacctttattaccgcgacccgcagttctggttctggaatgagggatcttccttgcgccagtcccgagttttttctcgtcccagaattcggcaccaattcttaatcgcgttctcacgcccggccaggaagaacacagcaaaccagaatcttctgcggcaaaactttattgcttacatcttcaggagcaagagtgtaagaagcaagagagagagaaaacgaaaccccgtccctattaaggagaattatccttcgcctaggacgtgtcactccctgattggctgcagcccatcggccgag	1199	84	7%	136	11%
16	20578651	20578950	gttctttaatctgcacgtattctaccggagcgtggacacgcccaccctcggctccttcaaagactggaaatgcctgttgtattttcctttgttcctctctgggaatgaatgagtctgcgcactgcctctctgcgcactgtctctctgcgcactgcctctctgcgcactgcctctctgcgcattgcctctctgcgcactgcctctctgcgcattgctgacgcactacgcagggcgggggctccgcatagggcggaccttgaaaccgactgcccggaggttgaacagtacgctggctttcg	299	42	14%	30	10%
16	21106201	21106650	gagagaaaagtgccagccagataaaatgcgagctaattggtcaagaaaaaagccaaaagcggctggcgaaggccagtttgctgcttggcctccgggcagtcggcttcaaggtgcacttccgccctatgcggagcccccgccctgcgtagtgcgtcagccctgcgcagagagacaatgcgcagagaggcaatgcgcagactcattcattcccagagaggaacaaaggaaaatacaacaggcatttccggtctttgaaggagccgagggtgggcgtgtccacgctccggtagaatatgtgcagattaaagagcttgccgagtcggtccgtaaatatggaaccaatgctaattttaccttggtgcagttagacaggcttgccggcatggcactaactcctgccgactggcaaacgattgtaaaagccgctctccctagtatgggcaaatata	449	50	11%	60	13%
16	22035151	22035750	cttgtaaagctatttcccactttacttctgatagactgtcttgaatttcgttagaaagttcaaggccagacgtaccttgtaaagctatttcccactttacttctgatagactgtcttgaatttcgttagaaagttcaagaccagacgtaccttgtaaagctatacttacgggtaccctgttccccagctgaagagttctgaattcacgcagttgaatccttctcaacagtctgttttgcgggaacacttcattaccatgacccgcagttctggttccggaatgagggatcttccttgcgccggtgatggtaaccgtcccaggttttctcgtcccaggtcttctcatcctgggtcttctcgtcccgggttttctcgtcccaggtcttctcgtcccgggtctcagcaccaACtcttacacgcattcacgaccggccaggaagaacacagcaaaccagaatcttctgcggcaaaactttattgcttacatcttcaggagtaagagagcaagagagcaagagtgcaagagtgcaagagagagagagagcaagagagagaaaaagaacaagaaagcaagagaaagaatggcaaaaccccgtccc	599	46	8%	82	14%
16	27424051	27424950	tcttcagctccagacagccggccaccttcctggtgagagcacgggggtctgcctggcctgagaggtttgtggcacaggcgccggcgggagccttcttggctccgggactccgcggagggcaggctgcacgggtgaccgtgtggaatacagagtgccagccgtttctgggacgggcgagagagtcgcagagcttctgggcggcgccatcttcagctccagacagccggccaccttcctggtgagagcacgggggtctgcctggcctgagaggtttgtggcacaggcgccggcgggagccttcttggctccgggactccgcggagggcaggctgcacgggtgaccgtgtggaatacagagtgccagccgtttctgggacgggcgagagagtcgcagagcttctgggcggcgccatctttagctccagacagccggccaccttcctggtgagagcacgggggtctgcctggcctgagaggtttgtggcacaggcgccggcgggagccttcttggctccgggactccgcggagggcaggctgcacgggtgaccgtgtggaatacagagtgccagccgtttctgggacgggcgagagagtcgcagagcttctgggcggcgccatcttcagctccagacagccggccaccttcctggtgagagcacgggggtctgcctggcctgagaggtttgtggcacaggcgccggcgggagccttcttggctccgggactccgcggagggcaggctgcacgggtgaccgtgtggaatacagagtgccagccgtttctgggacgggcgagagagtcgcagagcttctgggcggcgccatcttcagctccagacagccggccaccttcctggtgagagcacgggggtctgcctggcctgagaggtttgtggcac	899	132	15%	114	13%
16	29515951	29516400	cactccagacacgagctcaagtcagtcacagataggctgacagatccggatcacgaggaatagtccagcctggcaggcagcctacgcatgcagttctactgtgcatgttccggcaaggcagtaaacatgtggggtcagggcgctgtcttggcccatgcggccgcacccgcttcccgcaGTAAATAAATTATTTTTTAAAAGAAAGAGAGAGcccttccgctcgactcgagactcgagccccgggctaccttgccagcagagtcttgcccaacacccgcaagggtccacacgggactccccacgggaccctaagacctctggtgagtggaccacagtgcctgccccaatccaatcgcgtggaacttgagactgcggtacatagggaagcaggctacccgggcctgatctggggcacaagtcccttccgctcaactcgagactcgagcccc	449	50	11%	78	17%
16	30192301	30192600	atgtatatgggaatatgtgtgtgagagtgtatatgactgtgtgtgtggtatatgtgtgtttgtggtatatgtgtttgcaagtgagtgtgtatgtgtatgttgtgtgtgctgtgtgtttgtgacgtgtgagtgtatatgtatgtgtatagtatgagtatgtgaatatgtgtgtgaatgtgaatgaagtgagtgtgtaaatgtgtgtgagtgcatacgtgtgtgtgtgtgtgtgtggtgtgtgtgtgtggtatgcgtggtttatgtgtgtgtgtttggtgtacgtaagagtgtgtttgagt	299	8	3%	4	1%
16	31162501	31163250	gccacagccgtgcagatagccgcagccgtgcagacagccgcagccgtgcagacagacacagcagtgcagacagccacagccgtgcagacagacacagccgtgcagacagacacagccgtgcagacagccgcagccgtgcagacagccgcagccgtgcagacagccgcagccgtgcagacagccgcagccgtgcagacagccgcagccgtgcagacagccgcagccgtgcagacagccgcagccgtgcagacagccgcagcggtgcagacagccacagccgtgcagacagacacagcagtgcagacagctgcagcaatgcagacagccacagcagtgcagacagccgcagcagtgcagacagccacagcagtgcagacagccacagccgtgcagacagccgcagcagtgcagacagccacagccgtgcagacagccgcagccgtgcagacagccgcagcagtgcagacagccgcagcagtgcagacagccgcagcagtgcagacagccgcagccgtgcagacagccacagccgtgcagacagccacagccgtacagacagccacagccgtgcagacagccgcagccgtgcagacagccacagccgtgcagacagccacagccgtgcagacagacacagccgtgcagacagccgcagccgtgcagacagccgcagccgtgcagacagacacagcagtgcagacagacacagcagtgcagacagacacagcagtgcagacagacactcatgg	749	96	13%	314	42%
16	31193401	31194000	tctgaggacagttcacactcacacatgctaccacgcatcttagcaagatcagcatgagcgtctgaggacagttcacactcacacgtgctaccacgcatcttagcaagatcagcatgagcgtctgaggacagttcacactcacacgtgctaccacgcatcttagcaagatcagcatgagcgtctgaggacagttcacactcacacgtgctaccacgaatcttagcaagctcagcatgagcgtctgaggacagttcacactcacacatgctaccacgaatcttagcaagctcagcatgagcgtctggggacagttcacactcacacatgctaccacgcatcttagcaagatcagcatgagcgtctgaggacagttcacactcacacatgctaccacgaatcttagcaagctcagcatgagcgtctgaggacagttcacactcacacatgctaccacgaatcttagcaagctcagcatgagcgtctggggacagttcacactcacacatgctaccacgaatcttagcaagctcagcatgagcgtctggggacagttcacactcacacatgctaccacgcagcttggcaagctcagcatgaga	599	44	7%	204	34%
16	32195551	32195850	cccacattcgccgttacaagatggcgctgacagctgtgttctaagtggtaaacaaataatctgcgcatgtgccaagggtatcttatgactacttgtgctctgccttccccgtgacgtcaactcggccgatgggctgcagccaatcagggagtgacacgtccgaggcgaaggagaatgctccttaagagggacggggtttcgttttctctctctcttgcttcttgctctcttgcttcctgcaccctggctcctgaagatgtaagaataaagctttgccgcagaagattctggtctgtggt	299	28	9%	28	9%
16	32579401	32579850	cgtcctaggcgaaggagaattctctttaatagggacggggtttcgttttctcgctctctcttgcttcttgctctcttgcttcttgcactctggctcctgaagatgtaaggaataaagctttgccgcagaagattctggtctgtggtgtctttcctggccggtcgtgagaacgcgtctaataacaattggtgccgaattccgggacgagaaaaaactcgggacgagagtttaccatcaccggcacaaggaagatccctcattccagaaccagaactgcgggtcgcggtaataaaggttcccgtaaagcagactgttaagaaggattcaactgtatgaattcagaacttttcagctggggaacgagagtaccagtgagtacagctttacgaggtaagtctgatcttgaactttctaaggaaattcaagacagtctatcagaagtaaagtgg	449	44	10%	38	8%
16	35508001	35508150	CAACCCATAGGGTCCACACTAACCCCCAAAGTCAATGACATTGAACTGTTATAGACACCCAGTTGGAAATGTAAAAGACAAGAGCCCTCTGGTGTGGGAATGCTCTTGgtgtgtatgtgcatgaatgcgtgcgtgcgagcgtgtgtgca	149	8	5%	24	16%
16	36298651	36299100	gcttgtgcagtttcatgccaaagagctctccattccatatatttgcccatactagggagagcggcttttacaaccgtttgccagtcagcaggagttagtgccatgccggcgagcctgtctaactgcaccaaggtaaaattagcattggttccgtatttacggaccgactcggcaatttctttaatttgtaagtattctaccggagcgtggacacgcccaccctcggctccttcaaagactggaaatgcctgttgtattttcctttgttcctctctgggaatgaatgagtctgcgcactgcctctctgcgcagggctgacgcactacgcagggcggggactccgcatagggcggaccttgaagccgactgccctgaggccaatcagcaaactggccttcgccagccgcttttggcttccttaactgattagctagcactttacctggctg	449	44	10%	56	12%
16	37798951	37799250	tccccgtacgggccaccaattgtcacgcccactctcgaccagcaagaacgacgcgaccaccagtccttctaacagcagtttattccgtcttcatctttcttctttctcttcatcagtaccgttccccagctgaagagttctgaatccacgccggatccttctcaacagtctgttttacgggaacttttattaaccactccttccccgtgatgcagttctgaatcctccctgtagcagggggtcttcactcatgcctgaagatgtttcttttcccgggtttcggcaccactTCttgcgcg	299	34	11%	48	16%
16	41490901	41492400	gttgggagccgcgcccacattcgccgttacaagatggcgctgacagctgtgttctaagtggtaaacaaataatctgcgcatatgccgagggtggttctctactccatgtgctctgccttccccgtgacgtcaactcggccgatgggctgcagccaatcagggagtgacacgtcctaggcgaaggagaattctccttaatagggacggggtttcgttttctctctctcttgcttcttgcactctggctcctgaagatgtaagcaataaagctttgccgcagaagattctggtttgttgcgtctttcctggccggtcgtgagaacgcgtctaataacaattggtgccgaattccgggacgagaaaaaactcgggactggcgcaaggaagatccctcattccagaaccagaactgcgggtcgcggtaataaaggttcccgtaaagcagactgttaagaaggattcaactgtatgaattcagaacttttcagctggggaacgagagtaccagtgagtatagctttacgaggtaagcctggccttgaactttctaaggaaattcaagacagtctatcagaagtaaagtggaaaatggctttacaagttatgtttggccttgaattttttctagtattagaagcccttttgttccttttcacatgttatcaagtggttaaggcagggcggattctggatgaaattcagggcaatctatcagaagtaaagtggggagagagagtaggagcaaagagaaaatatggtacacaaaataagtatacaggcctttccaagggtcttgaacccgaggaaaagttaaggttaggtaggaatacctggagagagattagaagaaaaagaggaaaaagggaaaagaagaaagatcaattagcggaggtctctaggaaaaggagcctgtgctcatcgctggatgggctcggggagccagctcttagtagctctgaagcagatgaagaattctcctctgaagaaacagactgggaggaagaagcagctcattatgagaaaaaagggtaccagccaggtaaagtgctagctaatcagttaaggaagccaaaagcggctggcgaaggccagtttgctgattggcctcagggcagtcggcttcaaggtccgccctatgcggagtccccgccctgcgtagtgcgtcagccctgcgcagagaggcagtgcgcagactcattcattcccagagaggaacaaaggaaaatacaacaggcatttccggtctttgaaggagccgagggtgggcgtgtccacgctccggtagaatacttacaaattaaagaaattgccgagtcggtccgtaaatacggaaccaatgctaattttaccttggtgcagttagacaggcttgccggcatggcactaactcctgccgactggcaaacggttgtaaaagccgctctccctagtatgggcaaatatatggaatggagagcgctttggcacgaagctgcacaagcgcaggcccgagcaaacgc	1499	130	9%	162	11%
16	41490901	41492400	gttgggagccgcgcccacattcgccgttacaagatggcgctgacagctgtgttctaagtggtaaacaaataatctgcgcatatgccgagggtggttctctactccatgtgctctgccttccccgtgacgtcaactcggccgatgggctgcagccaatcagggagtgacacgtcctaggcgaaggagaattctccttaatagggacggggtttcgttttctctctctcttgcttcttgcactctggctcctgaagatgtaagcaataaagctttgccgcagaagattctggtttgttgcgtctttcctggccggtcgtgagaacgcgtctaataacaattggtgccgaattccgggacgagaaaaaactcgggactggcgcaaggaagatccctcattccagaaccagaactgcgggtcgcggtaataaaggttcccgtaaagcagactgttaagaaggattcaactgtatgaattcagaacttttcagctggggaacgagagtaccagtgagtatagctttacgaggtaagcctggccttgaactttctaaggaaattcaagacagtctatcagaagtaaagtggaaaatggctttacaagttatgtttggccttgaattttttctagtattagaagcccttttgttccttttcacatgttatcaagtggttaaggcagggcggattctggatgaaattcagggcaatctatcagaagtaaagtggggagagagagtaggagcaaagagaaaatatggtacacaaaataagtatacaggcctttccaagggtcttgaacccgaggaaaagttaaggttaggtaggaatacctggagagagattagaagaaaaagaggaaaaagggaaaagaagaaagatcaattagcggaggtctctaggaaaaggagcctgtgctcatcgctggatgggctcggggagccagctcttagtagctctgaagcagatgaagaattctcctctgaagaaacagactgggaggaagaagcagctcattatgagaaaaaagggtaccagccaggtaaagtgctagctaatcagttaaggaagccaaaagcggctggcgaaggccagtttgctgattggcctcagggcagtcggcttcaaggtccgccctatgcggagtccccgccctgcgtagtgcgtcagccctgcgcagagaggcagtgcgcagactcattcattcccagagaggaacaaaggaaaatacaacaggcatttccggtctttgaaggagccgagggtgggcgtgtccacgctccggtagaatacttacaaattaaagaaattgccgagtcggtccgtaaatacggaaccaatgctaattttaccttggtgcagttagacaggcttgccggcatggcactaactcctgccgactggcaaacggttgtaaaagccgctctccctagtatgggcaaatatatggaatggagagcgctttggcacgaagctgcacaagcgcaggcccgagcaaacgc	1499	130	9%	162	11%
16	44045701	44046150	agacttacctcgtaaagctgtactcactggtactctcgttccccagctgaaaagttctgaattcatacagttgaatccttcttaacagtctgctttacgggaacctttattaccgcgacccgcagttctggttctggaatgagggatcttccttgcgccagtcccgagttttttctcgtcccggaattcggcaccaattgttattagacgcgttctcacgaccggccaggaaagacgcaacagaccagaatcttctgcggcaaagctttattgcttacatcttcaggagccagagtgcaagaagcaagagagagagaaaacgaaaccccgtccctattaaggagaattttccttcgcctaggacgtgtcactccctgattggctgcagcccatcggccgagttgacgtcacgaggaaggcagagcacatggagtgaagaaccaccctcg	449	52	12%	56	12%
16	48101401	48102000	tcctaggcggaggataattctccttaaaagggacggggttttgccattctttttctctctcttgttcttgctttttctctctcttgctcttgctttcttgttctttttcttgctctcttgctctcttgcgctcttgctctcttgcttctgaagatgtaagcaataaagttttgccgcagaagattccggtttgttgcgttctttcctggccggtcgtgaacgcgtgtaagaGttggtgctgagacccgggacgggacgagaagacctgggacgagaaatcccgggacgagaaaacctgggacggttaccatcaccggcgcaaggaagatccctcattccggaaccagaactacgggtcatggtaatgaagtgttcccgtaaaacagactgttgagaaggattcaactgcgtgaattcaaaactctttagctggggaatggtggtaatgaagtgttcccgtaaaacagactgttgagaaggattcaactgcgtgaattcagaactcttcagctggggaacagggtacccgtaagtatagcattacaaggtaagtctggccttgaactttctaacgaaattcaagacagtctatcagaagt	599	54	9%	44	7%
16	48540451	48540600	cctggccagttgagcgcgcgcaaGAGTTGGTGCTGaaacccgggaaaagaaacatcttcaggcaagagcgaagaccccctgctacagggaggattcagaactgcatcacggggaaggagtggttaataaaagttcccgtaaaacagact	149	14	9%	20	13%
16	50994301	50995200	ttaactggtatctttggtatcttccaacaacgccctccccacttccttgagtttcggtttcttcctttaaatacccccttacccagctactcggggcgccacggtcctctacccctgcgtggtgtatgaccatgggcccgagagcgctcttgaataaaaatcctcttgcaatttgcagcaagacccgtttcttgtgggtgattttggggtgtcgcctctcctgagtcagaacgtgggggagtcctcacgttgtgggtctttcaTTTGGTGCATGGGCCGGGAAACGCGACCACCCCTCACACCCGAGAACCGACTTGGAGGTATGGGGATCCCCTCTTGTGTGCGTGCCGGCCGGTGTCTCTGTTCTGAGTGTCTGTTTTCTGAAACGAACATTGGAACATGTGCTTGTTGTGTTGGGTTGTTTGTATCTTGTCCTATGTTTCTGAAACACGGCAAAGTCTGAGTTTAGATCCAtctgagtttattgaatttgtgtcttggtttcagggttacgagatcgtgggttcgagtcccaccttgtgccttggttttacatctggcagagtgaggaacaagtgtgcttCTCTGGTTTTGGTCGTCTAGGTAGAAGTGGACGACGGTGTTTGTAGACGATGGGGTGATGGGGTTTTCTGAAATGCGCGCGTCTGTATTTGCAGCTGTCCTTTTGGGCCGTAAGGACCGGAGGACTGTGGTCGGCAGACGTGCTAAGAGGACCACAGGCTGTGGCCCTGGGGGACGCCCTGGGAGGTAGGGAGAGTCAGGGACGCCTGGCTGTCTCCGGAGATCGGTTAAAGCGGAAGCTTCTCCCTCCAACATCGTCTAATTCTTTTGCCTGCTTGTGGAGGACAAGAAAGGGTCGAGTGTGTCTGGATCTGTTG	899	86	10%	68	8%
16	51087451	51088500	agcaataaagttttgccgcagaagattctggtctgtggtgttcttcctggccggtcgtgagaacgcgtctaataacaattggtgccgaattccgggacgagaaaaaactcgggactggcgcaaggaagatccctcattccagaaccagaactgcgggtcgcggtaataaaggttcccgtaaagcagactgttaagaaggattcaactgtatgaattcagaacttttcagctggggaacgagagtaccagtgagtacagctttacgaggtaagtctgatcttgaactttctaacgaaattcaagacagtctatcagaagtaaagtggaatatgtttggccttgaattttttctggtgttaggagcccttttgttccttttcacatgttatcaagtggttaagatagggaggattctagatgaaattcaggacaagctatcagaagtaaagcggggagagagagtaggagcaaagagaaaatatggtacacaaaataagtatacaggcctttccaagggtcttgaacccgaggaaaagttaaggttaggtaggaatacctggagagagattagaagaaaaagaggaaaaagggaaaagaagaaagatcaattagcggaggtctctaggagatactcgtcactagatgagctcaggaagccagctcttagtagttctgaagcagatgaagaattctcctctgaggaaacagactgggaggaagaagcagcccattaccagccagctaattggtcaagaaaaaagccaaaagcggctggcgaaagccagcgtactgttcaacctcagggcagtcggcttcaaggtccgccctatgcggagtccccgccctgcgtagtgcgtcagcaatgcgcagagaggcagtgcgcagagaggcagtgcgcagactcattcattcccagagaggaacaaaggaaaatacaacaggcatttccggtctttgaaggagccgagggtgggcgtgtccacgctccggtagaatacttacaaattaaagaaattgccgagtcggtccgtaaatacggaaccaatgct	1049	84	8%	122	12%
16	51945901	51946200	ttgtcctattgacaatgtcctttgctgttattagacgcgttctcacgcccggccaggaagaacaccacagaccagaatcttctgcggcaaaactttattgcttacatcttcaggagcaagagtgtaagaagcaagagagagagaaaacgaaaccccgtccctattaaggagaattctccttcgcctaggacgtgtcactccctgattggctgcagcccatcggccgagttgacgtcacggggaaggcagagcacatggagtgaagaaccaccctcggcacatgcgcagattatttgttt	299	30	10%	46	15%
16	51952351	51953100	cttaaccacttgataacatgtgaaaaggaacaaaagggcttctaacattagaaaaaattcaaggccaaacattttccactttacttctgatagactgtcttgaatttccttagaaagttcaaggccaggcttacctcgtaaagctatactcactggtactctcgttccccagctgaaaagttctgaattcatacagttgaatccttcttaacagtctgctttacgggaacctttattaccgcgacccgcagttctggttctggaatgagggatcttccttgcgccagtcccgagttttttctcgtcccggaattcggcaccaattgttattagacgcgttctcacgaccggccaggaaagacgcaacaaaccagaatcttctgcggcaaaactttattgcttacatcttcaggagcaagagtgtaagaagcaagagagagagaaaacgaaaccccgtccctattaaggagaattctccttcgcctaggacgtgtcactccctgattggctgcagcccatcggccgagttgacgtcacggggaaggcagagcacatggagtgaagaaccaccctcggcacatgcgcagattatttgtttaccacttagaacacagctgtcagcgccatcttgtaacggcgaatgtgggcgcggctcccaacactttgccttacagaagctttgtaattttatgatgtcacatttgttgagtcttaatcttagagcataagccattggtgttctgttcagg	749	64	9%	106	14%
16	51976201	51976350	ccggtcgtgagaacgcgtctaataacaattggtgccgaaacccgggacgaaaaaaaaaaactcgggactggcgcaaggaagatccctcattccagaaccagaactgcgggtcgcggtaataaaggttcccgtaaagcagactgttaaga	149	26	17%	12	8%
16	53016451	53017800	tcgggcctgcgcttgtgcagcttcgtgccaaagcgctctccattccatatatttgcccatactagggagagcggcttttacaaccgtttgccagtcggcaggagttagtgccatgccggcaagcctgtctaactgcaccaaggtaaaattagcattggttccgtatttacggaccgactcggcaatttctttaatttgtaagtattctaccggagcgtggacacgcccaccctcggctccttcaaagactggaaatgcctgttgtattttcctttgttcctctctgggaatgaatgagtctgcgcactgcctctctgcgcattgcctctctgcgcattgctgacgcactacgcagggcggggactccgcatagggcggaccttgaagccgactgccctgaggccaatcagcaaactggccttcgccagccgcttttggcttccttaactgattagctagcactttacctggctggtacccttttttctcataatgagctgcttcttcctcccagtctgtttcctcagaggagaattcttcatctgcttcagagctactaagagctggcttcctgagctcatctagtgacgagtatctcctagagacctccgctaatcgatcttttttcttttcttttttcttttccttccttctaatctctccccaggtattcttacctgacctaaacttttcctcgggttcaagacccttggaaaggcctgtatacttattttgtgtaccatattttctctttgctcctactctctctccccgctttacttctgatagcttgtcctgaatttcatctagaatccgccctgccttaaccacttgataacatgtgaaaaggaacaaaagggcttctaacactagaaaaaattcaaggccaaacattttccactttacttctgatagactgtcttgaatttccttagaaagttcaagaccaggcttacctcgtaaagctatactcactggtactctcgttccccagctgaaaagttctgaattcatacagttgaatccttcttaacagtctgctttacgggaacctttattaccgcgacccgcagttctggttctggaatgagggatcttccttgcgccagtcccgagttttttctcgtcccggaatttctcgtcccggaattcggcaccaattgttattagacgcgttctcacgaccggccaggaaagacgcaacagaccagaatcttctgcggcaaagctttattgcttacatcttcaggagccagagtgcaagaagcaagagagagagaaaacgaaaccccgtccctattttaggagagttatccctcgcctaggacgtgtcactccctgattggctg	1349	112	8%	138	10%
16	53571451	53572800	ttaaaaagaaaaaaaTGGCCTAATAATAACtgttgggagccgcccccacattcgccgttacaagatggcgctgacatcctgtgttctaagtggtaaacaaataatctgcgcatgtgccaagggtatcttatgactacttgtgctctgccttccccgtgacgtcaactcggccgatgggctgcagccaatcaaggagtgacacgtccgaggcgaaggagaatgctccttaagagggacggggttttcgttttctctctctcttgcttttctctctctcttgcttcttgctctcttttcctgaagatgtaagaataaagctttgccgcagaagattctggtctgtggtgttcttcctggccggtcgtgagaacgcgtctaataacaattggtgccgaattccgggacgagaaaatccgggacgagaaaaaactccggactggcgcaggagggatacctcattccagaaccagaactgcgaatcaaggttataaggttcccgtaacacagactgttgagaaggattcaactgccgaattcagaactcatcagctggggaacgacggtgataaaggttcccgtaaagcagactgttgagaaggattcaactgccgaattcagaactcatcagctggggaacggaagtgagaaatggctttaccaggtatgtttggccttgaactttttctagtgttaggagcccttttgttccttttcacatgttatatagtgcttaaggcagggctaaaaattctagaggaagttcaggacagtctatcagaagtaaagcggagagagagagtaggaacaaggagaaacggtaagtatacaggcctttccaagggtcttgaacccgaggaaaagttaaggttaggtaggaatacctggagagagattagaagaaaaagaggaaaaagggagaagaaaaaagatcgattagcggaggtctctaggagatactcgtcactagatgagctcaggaagccagctcttagtagttctgaagcagatgaagaatcctcctctgaggaaacagactgggaggaagaagcagcccattaccagccagctaatcggtcaagaaaaaagccaaaagcggctggcgaaggccagtttgctaattggcctcagggcaatcggctaccaggtgcactcccgccctatgcggagtccccgccctgcgtagtgcgtcagcccgtagtgcgtcagcaatgcgcagagaggcagtgcgcagactcattcattccccgagaggaacaaaggaaaatacaacaggcatttccagtctttgaaggagccgagggtgggcgtgtccacgctccggtagaatatgtgcagattaaatatggaat	1349	116	9%	142	11%
16	53571451	53572800	ttaaaaagaaaaaaaTGGCCTAATAATAACtgttgggagccgcccccacattcgccgttacaagatggcgctgacatcctgtgttctaagtggtaaacaaataatctgcgcatgtgccaagggtatcttatgactacttgtgctctgccttccccgtgacgtcaactcggccgatgggctgcagccaatcaaggagtgacacgtccgaggcgaaggagaatgctccttaagagggacggggttttcgttttctctctctcttgcttttctctctctcttgcttcttgctctcttttcctgaagatgtaagaataaagctttgccgcagaagattctggtctgtggtgttcttcctggccggtcgtgagaacgcgtctaataacaattggtgccgaattccgggacgagaaaatccgggacgagaaaaaactccggactggcgcaggagggatacctcattccagaaccagaactgcgaatcaaggttataaggttcccgtaacacagactgttgagaaggattcaactgccgaattcagaactcatcagctggggaacgacggtgataaaggttcccgtaaagcagactgttgagaaggattcaactgccgaattcagaactcatcagctggggaacggaagtgagaaatggctttaccaggtatgtttggccttgaactttttctagtgttaggagcccttttgttccttttcacatgttatatagtgcttaaggcagggctaaaaattctagaggaagttcaggacagtctatcagaagtaaagcggagagagagagtaggaacaaggagaaacggtaagtatacaggcctttccaagggtcttgaacccgaggaaaagttaaggttaggtaggaatacctggagagagattagaagaaaaagaggaaaaagggagaagaaaaaagatcgattagcggaggtctctaggagatactcgtcactagatgagctcaggaagccagctcttagtagttctgaagcagatgaagaatcctcctctgaggaaacagactgggaggaagaagcagcccattaccagccagctaatcggtcaagaaaaaagccaaaagcggctggcgaaggccagtttgctaattggcctcagggcaatcggctaccaggtgcactcccgccctatgcggagtccccgccctgcgtagtgcgtcagcccgtagtgcgtcagcaatgcgcagagaggcagtgcgcagactcattcattccccgagaggaacaaaggaaaatacaacaggcatttccagtctttgaaggagccgagggtgggcgtgtccacgctccggtagaatatgtgcagattaaatatggaat	1349	116	9%	142	11%
16	56038951	56039100	accacccacgtctccgaagacccacttggaggtgagatttttttgtccaaaaatatttctgtaagccggctaggttctgtgctgaaatttgcagccgcgacgtttcgtgagaaacagagacctttgcctcgggatgaggcactgagtgt	149	16	11%	14	9%
16	56048851	56049300	ctgtggtagccccccactctcttgaaagcattatccgtcagcccccagaccgatggatgacaaatgcccggatgactcactatcagagtctgctgctgactgaacgggtcgtgtttgctccccccgctattctcaaccctgccaccttcctccctgaaacggatgattcctcacccgttcactgctgtgcagacatccttgcggaggaaactgggatccgaagtgatctacgtgaccagccgtggccaggtgttccaaactggtacacagatggaagcagtttcctagtagaaggtaagaggatggcaggggcagcggtggtagatggtaagcgagtcatgtgggctggcagcctgccagaaggtacgtcagctcaaaaagctgaattaattgccctcatccaggccctttggatggctgaggggcagtccatcaacatttacaccgat	449	32	7%	66	15%
16	59128501	59128950	tactcactggtactctcgttccccagctgaaaagttctgaattcatacagttgaatccttcttaacagtctgtgttgtgggaacacttcataaccgcgacccgcagttctggttctggaatgagggatcttccttgcaccggtgatggtaaactctcgtcccgagttttttctcgtcccggaattcggcaccaattgttattagacgcgttctcacgaccggccaggaaagacgcaacaaaccagaatcttctgcggcaaagctttattgcttacatcttcaggagccagagtgcaagaagcaagagagagagaaaacgaaaccccgtccctattttaggagagttatccctcgcctaggacgtgtcactccctgattggctgcagcccatcggccgagttgacgtcacggggaaggcagagcacatggagtgaagaaccaccctcggc	449	50	11%	60	13%
16	60931351	60931650	gcgcttgtgcaacttcgtgccaaagcgctctccattccatatatttgcccatactagggagagcggcttttacaaccgtttgccagtcggcaggagttagtgccatgccggcaagcctgtctaactgcaccaaggtaaaattagcattggttccgtatttacggaccgactcggcaatttctttaatttgtaagtattctaccggagcgtggacacgcccaccctcggctccttcaaagactggaaatgcctgttgtattttcctttgttcctctctgggaatgaatgagtctgcgcac	299	32	11%	36	12%
16	61316251	61316550	cgttccccagctgaaaagttctgaattcatacagttgaatccttcttaacagtctgctttacgggaacctttattaccgcgacccgcagttctggttctggaatgagggatcttccttgcgccagtcccgagttttttctcgtcccgggtttcggcaccaattgttattagacgcgttctcacgaccggccaggaaagacgcaacaaaccagaatcttctgcggcaaagctttattgcttacatcttcaggagccagagtgcaagagagcaagcccgcaaatggcgaaaccccatccct	299	36	12%	42	14%
16	64967101	64967550	ggtcatagtgcacctccaccctatgctgagcccccgccctgcgtagtgcatcagccctgcgcagagaggcaatggacagagaggcaatgcacagactcgttcattccaaaggaggaacaaaggaaaatacaacaggcatttccggtctttgaaggagccgagggtgggcgtgtccacgctccggtagcgtatatacagattaaagagcttgccgagtcggtccgtaactatggagtcagtgctaatttcactatagcacaagtggaaaggcttgcgaatcacgctatgactcctggtgattggcaaacggttgtaaaagccgctctccctagtatgggcaaatatatggaatggagagcgctttggcacgaagctgcacaagcgcaggcccgagcaaacgcagctgctttgactccagagcagagagattggacttttgacttgttaac	449	44	10%	68	15%
16	65176951	65177400	aacagctcataaaaagaaaatCTCAAAGCAGAACTAATGAAATACCATTtgttattagacgcgttctcacgaccggccaggaaagacgcaacaaaccagaatcttctgcggcaaagctttattgcttacatcttcaggagccagagtgcaagaagcaagagagagagaaaacgaaaccccgtccctcttaaggagaattctccttcgcctaggacgtgtcactccctgattggctgcagcccatcggccgagttgacgtcacggggaaggcagagcacatggagtgaagaaccaccctcggcacatgcgcagattatttgtttaccacttagaacacagctgtcagcgccatcttgtaacggcgaatgtgggcgcggctcccaacatctccccctttccttttaataagagcaaataggccacccatattaatgagagtggagatagag	449	42	9%	74	16%
16	65180701	65181300	tagaaaaaattcaaggccaaacattttccactttacttctgatagactgtcttgaatttccttagaaagttcaaggccaggcttacctcgtaaagctatactcactggtactctcgttccccagctgaaaagttctgaattcatacagttgaatccttcttaacagtctgctttacgggaacctttattaccgcgacccgcagttctggttctggaatgagggatcttccttgcgccagtcccgagttttttctcgtcccggaattcggcaccaattgttattagacgcgttctcacgaccggccaggaaagacgcaacaaaccagaatcttctgcggcaaagctttattgcttacatcttcaggagccagagtgcaagaagcaagagagagagaaaacgaaaccccgtccctcttaaggagaattctccttcgcctaggacgtgtcactccctgattggctgcagcccatcggccgagttgacgtcacggggaaggcagagcacatggagtgaagaaccaccctcggcacatgcgcagattatttgtttaccacttagaacacagctgtcagcgccatcttgtaacggcgaatgtggg	599	60	10%	84	14%
16	66243151	66243450	ggcctcagggcagtcggcttcaaggtccgccctatgcggagtccccgccctgcgtagtgcgtcagccctgcgcagagaggcagtgcgcagagaggcagtgcgcagactcattcattcccagagaggaacaaaggaaaatacaacaggcatttccagtctttgaaggagccgagggtgggcgtgtccacgctccggtagaatacttacaaattaaagaactcgccgagtcggtccgtaaatatggaaccaatgctaattttaccttggtgcagttagacaggctcgccggcatggcacta	299	38	13%	48	16%
16	67634701	67634850	ctatcatccccggtagaggctgcaagaaattttcataacaattttcatgtgacggctgaaacattacgcagtcgtttctccttgacaagaaaagaagcccgtgacattgttactcaatgtcaaagctgctgtgagttcttgccagttcc	149	10	7%	24	16%
16	70542751	70543050	ctcttttcctgaagatgtaagaataaagctttgccgcagaagattctggtctgtggtgttcttcctggccggtcgtgagaacgcgtcgaataacaattggtgccgaattccgggacgagaaaatccgggacgagaaaaaactccggactggcgcaggagggatacttcattccagaaccagaactgcgaatcaaggttataaggttcccgtaacacagactgttgagaaggattcaactgccgaattcagaactcatcagctggggaacgacggtgataaaggttcccgtaaagcagac	299	38	13%	28	9%
16	75727951	75728100	ggactccccacgggaccctaagacctctggtgagtggaacacagcgcctgccccaatccaatcgcgcggaacctgagactgcggtacatagggaagcaggctacccgggcttgatctggggcacaaaccccttccactccactcgagcc	149	16	11%	22	15%
16	76064551	76065000	cgttacaagatggcgctgacagctgtgttctaagtggtaaacaaataatctgcgcatatgccgagggtggttctctactccatgtgctctgccttccccgtgacgtcaactcggccgatgggctgcagccaatcagggagtgacacgtcctaggcgaaatataactctcctaaaaaagggacggggtttcgttttctctttctcttgcttcttgcactcctgctcctgaagatgtaagcaataaagttttgccgcagaagattctggtttgttgtgtctttcctggccggtcgtgagaacgcgtctaataacaAATGTCTGTTACAGTGTTTCCATTTTGGAAAGAAACATTTACTAAAGGAAAGAAGCTTGGTAGCATAATTATTGTCATCAGTAAAGAATAAAGAGAGACCAGAAACATAGCAACATGGGAGGAGTTTGGCAATACA	449	34	8%	52	12%
16	76176151	76176600	tatactcactggtactctcgttccccagctgaaaagttctgaattcatgcagttgaatccttcttaacagtctgctttacgggaacctttattaccgcgacccgcagttctggttctggaatgagggatcttccttgcgccagtcccgagttttttctcgtcccggaattcggcaccaattgttattaaacgcgttctcacgcccggccaggaagaacaccacagaccagaatcttctgcggcaaagctttattgcttacatcttcaggagccagagtgcaagaagcaagagagagagaaaacgaaaccccgtccctattaaggagaattctccttcgcctaggacgtgtcactccctgattggctgcagcccatcggccgagttgacgtcacggggaaggcagagcacatggagtggagaaccaccctcggcatatgcgcagattatt	449	50	11%	62	14%
16	79374301	79375950	tttgctcgggcctgcgcttgtgcagcttcgtgccaaagcgctctccattccatatatttgcccatactagggagagcggcttttacaaccgtttgccagtcggcaggagttagtgccatgccggcaagcctgtctaactgcaccaaggtaaaattagcattggttccgtatttacggaccgactcggcaatttctttaatttgtaagtattctaccggagcgtggacacgcccaccctcggctccttcaaagactggaaatgcctgttgtattttcctttgttcctctctgggaatgaatgagtctgcgcactgcctctctgcgcactgcctctctgcgcactgcctctctgcgcatctctctgcgcactgcctctctgcgcatctctctgcgcattgcctctctgcgcatctctctgcgcattgcctctctgcgcatctctctgcgcattgcctctctgcgcatctctctgcgcattgcctctctgcgcattgctgacgcactacgcagggcgggggctccgcatagggcggaccttgaaaccgactgccgggaggttgaacagtacgctggctttcgccagccgcttttggcttttttcttgaccaattagctggctggtaatgggctgcttcttcctcccagtctgtttcctcagaggagaattcttcatctgcttcagaactactaagagctggcttcctgagctcatctagtgacgagtatctcctagagacctctgctaatcgatcttttttcttttcttttttcttttccttccttctaatctctccccaggtattcttacctgacctaaacttttcctcgggttcaagacccttggaaaggcctgtatacttattttgtgtaccatattttctctttgctcctactctctctccccgctttacttctgatagattgccctgaatttcatccagaattttcagccctatcttaatcacctgataacatgtgaaaaggaacaaaagggctcctaacattagaaaaaattcaaggccaaacattttccactttacttctgatagactgtcttgaatttccttagaaagttcaaggccaggcttacctcgtaaagctatacttacgggtactctcgttccccagctgaaaagttctgaattcatacagttgaatccttcttaacagtctgctttacgggaacctttattaccgcgacccgcagttctggttctggaatgagggatcttccttgtgccggtcccgagttttcttgtattttttcgtcccggattttttctcgtcccggatttcagcaccaattcttaatcgcgttctcacgcccggccaggaaagacgcaacagaccagaatcttctgcggcaaaactttattgcttacatctttgggagccaggagggcaagcgcccagcgcccagccccaaaaacgaaagccccttcaataatgaaaccgaaaccccttccctctttaggagagttatatttcgcctaggacgcatcactccctgattggctgcagcccatggccgagctgacgttcacgggaaaggtagagtacaagtagtcataaaatacccttggctcatgcgcagattatttgtttaccacttagaacacaggatgtcagcgccatcttgtgacggcgaa	1649	152	9%	186	11%
16	79854901	79855200	gaactcggtgggggagtcggttccccgtacgggccaccaattgtcgcgtccactctcgaccagcaagaacgacacgaccaccagtccttctaacagcagtttattcagtcttcatctttcttctttctcttcatcagtaccgttccccagctgaaaagttctgaatccacgccggatccttctcaacagtctgttttacgggaacactttattaaccactccttccccgtgatgcagttctgaatcctccatgtagcagggggtcttcactcttgcctgaagatgtttcttttcccggg	299	30	10%	48	16%
16	80289001	80289150	gcagtgcgcagagaggcagtgcgcagactcattcattcccagagaggaacaaaggaaaatacaacaggcatttccggtctttgaaggagccgagggtgggcgtgtccacgctccggtagaatacttacaaattaaagaaattgccgagt	149	16	11%	26	17%
16	80765551	80765850	ttacaaccgtttgccagtcggcaggagttagtgccatgccggcaagcctgtctaactgcaccaaggtaaaattagcattggttccatatttacggaccgactcggcaagctctttaatctgtaagtattctaccggagcgtggacacgcccaccctcggctccttcaaagactggaaatgcctgttgtattttcctttgttcctctctgggaatgaatgagtctgcgcactgcctctctgcgcattgtctctctgcgcagggctgacgcactacgcagggcggggactccgcatagggc	299	34	11%	38	13%
16	82207651	82208100	gaccggcaagaaagacgcaacaaaccagaatcttccgcggcaaaagctttattgcttgcttctcaggaagattccgaaccgggaaaatggcgctgcttttataacccgcagcgtgacgtttcagcacctgatatggcgtgacagctcccgattcgttgcttgcccatcaccccactattacaccccgagaatgggagtgactaggagtgaattcactcttgcacctgcgtacaaggcttgtttactagttaggcacagcggaggcccgcgccatcttataatggcgattgctcgcggcacacacggctctcctcagagattactggcggcacacatgcgattgctcgcagcacgcaccggctttccacatctcccccttttgattttattaaaatttaaggctggtctaggcctgtgtaattatgcccatctgctgtggctcctgtctt	449	54	12%	66	15%
16	82241701	82242000	ggagttagtgccatgctggcaagcctgtctaactgcaccaaggtaaaattagcattgattccatatttaatctgcacatattctaccggagcgtggacacgcccaccctcggctccttcaaagactggaaatgcctgttgtattttcctttgttcctctcggggaatgaatgagtctgcgcactgcctttctgcgcactgcctctctgcgcattgctgacgcactacgggctgacgcactacgcagggcggggactccgcatagggcgggagtgcacctggtagccgattgccctgagg	299	32	11%	38	13%
16	82726801	82727550	caaaagggctcctaacactagagaaagttcaaggccaaacataccttgtaaagctatttcccactttacttctgatagactgtcttgaatttcgttagaaagttcaaggccagacttaccttgtaaagctatttcccactttacttctgatagactgtcttgaatttccttagaaagttcaaggccagacttaccttgtaaagctatacttacgggtaccctgttccccaggagttctgaattcacgcagttgaatccttctcaacagtctgttttacgggaacacttcattaccaccattccccagctgaagagttctgaaTTCacgcagttgaatccttctcaacagtctgttttacgggaacacttcattaccatgacctgcagttctggttccggaatgagggatcttccttgcgccggtgatggtaaccttcccgggttttctcatcccaggatttctcgtcccgggttttctcgtctcgggtttcagcaccaaCtcttacacgcgttcacgcgaccggccaggaagaacgcaacaaaccggaatcttctgcggcaaaactttattgcttacatcttcaggagcaagagtgcaagagtgcaagagctctattgcttacatctttaggagcaagaagcaagagccagagcaagagagcaaaaggagagaatggcgaaaccctgtccctttttaaggagaattattctccgcctaggacgtattactccctgattggctgcagccc	749	50	7%	102	14%
16	83337751	83338200	gtggtgcattaattaattaatataTTAGAAGTATACATATATGTCTTAATCCTATATTTTGTATAtcttacacgcgttcgcgaccggccaggaaagacgcagcaaaccagaatcttctgcggcaaagctttattgcttacatcttcaggagccagagagcaagagcgcaagagagcaagagagcaagaaaaagaacaagaacaagaaagcaagagaaagaacaagaaagcaagagagagaaagcaagaacaagagagagagagagagaatggcaaaaccccgtcccttttaaggagaattatcctccgcctaggacgtattactccctgattgactgcagcccatcggcccagttgtcatcacgagaaaggcagaacacatggcgggaaaactgcccctgcacgtgtgcagattatgtttaccacttagaacacagctgtcagcgccat	449	32	7%	76	17%
16	83340001	83340300	tttacgggaacacttcattaccaccattccccagctgaagagttctgaattcacgcagttgaatccttctcaacagtctgttttacgggaacacttcattaccatgacccgcagttctggttccggaatgagggatcttccttgcgccggtgatggtaaccgtcccaggttttctcgtcccaggatttctcgtcccaggtcttctcgtcccaggttttctcgccccaggttttctcgtcccaggtctcagcaccaACtcttacacgcgttcgcgaccggccaggaagaacgcaacaaac	299	38	13%	52	17%
16	83365501	83365800	gagcccattcaggcctacctggccccatggctctgggaaatgatttggcagataaggccactaaagtggtggctgctgccctatcatccccggtagaggctgcaagaaattttcataacaattttcatgtgacggctgaaacattacgcagtcgtttctccttgacaagaaaagaagcccgtgacattgttactcaatgtcaaagctgctgtgagttcttgccagttcctcatgtgggaattaacccacgcggtattcgacctctacaggtctggcaaatggatgttacacatgtttct	299	16	5%	46	15%
16	84577051	84577200	tctgttttacgggaacacttcattaccaccattccccagctgaagagttctgaattcacgcagttgaatccttctcaacagtctgttttacgggaacacttcattaccatgacccgcagttctggttccggaatgagggatcttccttg	149	10	7%	26	17%
16	88104301	88104450	cctgccccaatccaatcgcgcggaacctgagactgcggtacatagggaagcaggctacccgggcctgatctggggcacaagtcccttccgctcgactcgagactcgagccccgggctaccttgccagcagagtcttgcccaacacccgc	149	22	15%	20	13%
16	89167801	89168100	tccttcaaagaccggaaatgcctgttgtattttcctttgttcctctctgggaatgaatgagtctgcgcactgcctctctgcgcattgcctctctgcgcagggctgacgcactacgcagggcggggactccgcatagggcggaccttgaagccgactgccctgaggccaatcagcaaactggccttcgccagccgcttttggcttccttaactgattagctagcactttacctggctggtacccttttttctcataatgagctgcttcttcctcccagtctgtttcttcagaggagaatt	299	24	8%	30	10%
16	89996701	89997150	aatcagggagtaatacgtcctaggcggaggataattctccttaaaagggacggggttttgccattctttttctctctcttgctttcttgttcttgttctttctcttgctttcttgttcttgttctttttcttgctctcttgctctcttgcgctcttgctctcttgctcctgaagatgtaagcaataaagcttttgccgcagaagattccggtttgttgcgttcttcctggccggtcgcgagaacgcgtgtaagaGttggtgctgagacccgggacgagaagacctgggacgagaaatcccgggacgagaagacctgggacggttaccatcaccggcgcaaggaagatccctcattccggaaccagaactgcgggtcacggtcataaaggttcccgtaaaacagactgttgagaaggattcaactgcatgaattcagaactcttcagctg	449	48	11%	32	7%
16	92307301	92307450	tacacactcatgcacatgaatacatgtttgaacacacacatacacttacacacacatgtacaggcacacgtgcacaaaagcacatacacacatatacccactcacacacataagcatgtgtacacatatacatacaagtgtgcacacac	149	2	1%	76	51%
16	94276051	94276350	cctgcgcagagaggcagtgcgcagactcattcattcccagagaggaacaaaggaaaatacaacaggcatttccggtctttgaaggagccgagggtgggcgtgtccacgctccggtagaatacttacaaattaaagaactcgccgagtcggtccgtaaatacggaaccaatgctaattttaccttggtgcagttagacaggctcgccggcatggcactaactcctgctgactggcaaacggttgtaaaagccgctctccctagtatgggcaaatatatggaatggagagcgctttggcac	299	34	11%	40	13%
16	94768351	94768650	gtggtgtatgtttgtgtatacgtagaaagtgtgtatgtggtgtgtgttcatgtatatgtgctgtctatatgtttgtgtgtatgtggtatgtatgtggtttgtgtttgtgtgtatgtatgtgaagtgtgtatgtatgtgcatgtggtgtgtgtcagtgtgtgtgtggtgtgtttgtggtatgtgtgcaagtgtatatggtgtgtgcgtttgtgcagtgtgtatgtaaagtgtgtgtgtgtgtatgtggagtatgtgtattgtgtatgtggtatgtgtgtcatgtatgtgctgtgtgtgag	299	4	1%	12	4%
16	95509351	95510550	gctcgactcgagactcgagccccgggctaccttgacagcagagtcttgcccaacacccgcaagggcccacacgggactccccacgggaccctaagacctctggtgagtggatcacagcgcctaccccaatccaatctcgcggaactcgagactgcggtacatagggaagcaggctacccgggcctgatctggggcacaagtcccttccgctctactcgagactcgagccccgggctaccttgccagcagagtcttgcccaacacccgcaagggtccacacgggactccccacgggaccctaagacctctggtgagtggaccacagtgcctgccccaatccaatcgcgcggaacttgagactgcggtacatagggaagcaggctacccgggcctgatctggggcacaattcccttccgctcgactcgtgactcgagccccgggctaccttgccagcagagtcttgcccaacacccgcaagggtccacacgggactccccacgggaccctaagacctctggtgagtggatcacagtgcctgccccaatccaatctcgcggaacttgagactgcggtacatagggaagcaggctacccgggcctgatctggggcacaagtcccttccgctcgactcgtgactcgagccccgggctaccttgccagcagagtcttgcccaacacccgcaagggtccacacgggactccccacgggaccctaagacctctggtgagtggaccacagtgcctgccccaatccaatcgcgcggaacttgagactgcggtacatagggaagcaggctacccgggcctgatctggggcacaattcccttccgctcgactcgtgactcgagccccgggctaccttgccagcagagtcttgcccaacacccgcaagggcccacacgggactccccacgggaccctaagacctctggtgagtggaacacagcgcctaccccaatccaatctcgcggaactcgagactgcggtacatagggaagcaggctacccgggcctgatctggggcacaagtcccttccgctctactcgagactcgagccccgggctaccttgccagcagagtcttgcccaacacccgcaagggtccacacgggactccccacgggaccctaagacctctggtgagtggaccacagtgcctgccccaatccaatcgcgcggaacttgagactgcggta	1199	150	13%	184	15%
16	95873251	95873550	cacacacacatgtgcaaatgttgagcacacaaacacaccatatacatttcatacacgtatcatacacacaccatacacactacacatgcacgaatacatgtacacacacacacatgcaaactcatatgtgtgagtacacacatacaccatacacactatatacacacaccacacacaccacacatgcacatacacatacagcatgcacgtgcaaccacacacacttgtacacactacatgtacttacatatcatacacactacacccatacattagagtgcacatgtgcgaacacatac	299	8	3%	154	52%
17	4930351	4930500	acattcacacaaacatgaatatgcacataaacacatgtgaatattcacatactcacacacataaatatacacatacacacatgaatctatacacattcacacacacattaatacacacattcacacatgtgactatacacatacacacg	149	2	1%	74	50%
17	6304501	6304800	TTGGGATCCATCAGACTCCCACCTAGACTAATAACACAAAATGCTGTCATTAAAAAGGCTTTTGTTGTCTTTCAGAGTCCCAGCTGAAGGATAACCCTGCGTTTTCCATGTTGAACGACTCTGACGATGACGTGATTTACGGGTAAGTCGCCGCCACCTCGCGCAGCCCGCCTGGCTCTGCATGCGTCCTCACTCGCAGTATTTGAAAGCTGTCTCCATGGCAGTAGACTGTTAATGGCTTAGTTTTGTGTCCCTTGTGTGGATTTAGTAGCATTCCGTTTTGCAGAATGCATGCAGGG	299	26	9%	40	13%
17	6408901	6409200	TGCTGGGCCATCCCTGAGTCCTGGGTCAGAGGAGAAACAGAGCACTATTACACATACGAACACACGCACACCCTACCCGCGATGCTTACCTGTCCTCAAAGCAAACCGTGCACTTCCATGCACGAGTCCTCCGCAGGAACACACGGCACTCGGAACACACGCGGTGGCTGCAGCCCTGACACACGGCCCCACGGTTCAGCAGAAGGCCCAGAGCCCGCTGGCAACGTGCACAGCACTTTTCCTTGTATTCCTGGCTAGAGCTCTTCGCCCCCTTCCACCGAAGATGCTGCAGGTGTGAT	299	34	11%	68	23%
17	6432751	6433050	agccagcataGCATGTATGAAGGAGAACGCTATGTGAATTAAAATGGAAAAATCTCAAGAGCTGTTAAGCTTTCTGTGTTTTGACATTTCAAACATTTTTACTTTATATCTAAGTAAAATGACTCCTATATTACATAAATTATATAACCTGAATCAAGAAGTCTTAAGTGGCGTTAGAAAGTGTCGAGGCAGATTCCGTAACCTTGCAGCATGAAGACTCATGATGCACGCATAAATGTCTCCAGTGCTCGTGAGGAAGAGCAACTGCAGAGAAAATCTAACAACGTCTATAACTCAGG	299	14	5%	40	13%
17	6442051	6442350	CATGCATTCTGCAAAACGGAATGCTACTAAATCCACACAAGGGACACAAAACTAAGCCATTAACAGTCTACTGCCATGGAGACAGCTTTCAAATACTGCGAGTGAGGACGCATGCAGAGCCAGGCGGGCTGCGCGAGGTGGCGGCGACTTACCCGTAAATCACGTCATCGTCAGAGTCGTTCAACATGGAAAACGCAGGGTTATCCTTCAGCTGGGACTCTGAAAGACAACAAAAGCCTTTTTAATGACAGCATTTTGTGTTATTAGTCTAGGTGGGAGTCTGATGGATCCCAAGCCCC	299	26	9%	56	19%
17	6447901	6448200	AAATAGATAATAAGTAACTATAAAGTGCATGAGCTTAAATGTCAGAATTAGCATTGGCATGGGACCTGAGCTTCAGGGAAGTAAGTGGCATGTGGCAGGGATGCTGCAGAACGCATCAGGCCACGGTGGCACGAAAGACGCATGAAAAGCCACAGACCAACCACGCTGATCAGGGGCTGAGCAGGGTCTCTGAGGAGCTGGGCAGTGCTACACAGGCCTGGAAGCAGTTAGTCACAGAAAGGGATGTGGGTCTAACTAGGATCACGGCAGTCTAAGCAGGGTCACGTGACTCTAAGCAG	299	14	5%	60	20%
17	6449401	6449700	GAGCGGGGAAAGATTGGAGATAAAGACGGCACCCACCATTGTAGAGCAGCAGCAGGGCCAGGAGGACAGACATCCACTTCTGCTCGATGCCCCAGTCCCTCATGGAGAACTTGCGCAGGtgccgcagaccttctgggtccctgtgtctgcgtggaacggggtctctcgacgcgggtgggcaaagcgtggatgaatgacagacagacacacacgcaggagagtttgtgtggaatctgaatgtaatttgtcaaatcgaacatcagactttttatgcagaagacaacaaggtagttgggtga	299	26	9%	54	18%
17	6452551	6452700	CACTTAAGCTGGTTTTCCGAGATAAACTGTACGAGACCCTGATGCATCAAACCACCTAACAAGGGAGTCACAGAAGCTGGCCGCTGGCTGCACGGCACACTCACCGTGAAGTTCATATCCTTGATGGGCTGGTTCAGGTGCTCAAACCC	149	10	7%	28	19%
17	6456901	6457050	ggggATGAATGCGAGCCAAGTGTGTGTGCAAATTGCACGTGGACAAGCAGGTCTGTGACGCACTTGCGGCTCATGACTGACTGTGGAGACATGAAACACACTCACCCCTGCACACGTGAGGGTCCTCGTCCGGTTGTGAACCTTGTTAT	149	14	9%	26	17%
17	6466651	6467100	tttattattattattattattCAAATAAATGGCAGGTAGCAGCAGCTGCCAGTCCCAGCAAACTGATCCAGGGCCCTGAGCTGTGAACAGCATGCTGACATTACCCAGCATGCCTGCTAGGCCTCCCGGGAAGACAAGGCGCAGGGTGTAACCACGCTCTGCCCTGCGGGCTCAGAGAGAAGGCACATCTCCCTTCACACTGAGGGTGGGCGGGTAGAACCGATCCTAAGTGCTGTAAGAGGAAAAACGATTAAAAGGCAGACTTACCCTCAATGCCGACGAAGACGGTCAGTCCGAAACAGATGAAGAAGACAACAAACACAAGGACGAAGTGGCGCTTGGAGAGCGTGTAGAGCCGCATGGGTGCCAACCTGTAGGGAAGAAGCCGGGAGTGAGGACGGTCAGGGCCCTGCCCACGCCAGTGCCACCACCCAGGCTGCACGAGGCCG	449	40	9%	76	17%
17	6492601	6493200	cttgtgCCACAGCAGGATGCCTCCTTTCCCAACCTGGGTCCCGGCTGGGGTCTGCAGCAGTGCGGAAGGGGTGGAGTGATGTCATCCTCCCGACGCCATGAACCCCACCGAGACACGAGCCCAGCGCCGTCTCCCCGGACCGCGGGCACCGCCCACGCGGGAAAGACGCGGAGTGTCTGCAGGGAACCGCCAACGTTCAAACAAAATGATCCTGACTGCCGAAAAGTGTGTTGGGAAAATAGACCAAAACTGAAAGATTCTGATAAATGCAAATGTCTTACTCTTCCCTCAGAATATCCTTAGTTGACACTTTAGAAATGTCAAAAGAGGAAGTGTTAGGGTTTTATTATTATTGTTTTTGACAAATTGTGTGGGATTTTTGACAAATTGTGTGTAGGCTCATCAGCCTCGGGCCAGGTGGCCGTGAGCAGAAGCTGTGTCTTCCCAGACCGGGCCCCGCCACACCCGGATCTCCGCCGCCACCCTCCCTCTCACGGCCCAACCCGAGGTTACCTCCTCGGAGGCCTGGAAGTCTTCCATCTTTAACGCGTCTCCTTCGCCCGCCGAGTAGAGTGGACTGCGCAGCCGCGGCCAGGCCA	599	74	12%	76	13%
17	6493951	6494400	CCACGATCGGGCGGGACTGTTCGGCCGAGGGCACCACCGGAGGGGAAGCCGCAGAGGTCTTGTTCTTCAGGATTCCCTTGATGGGCCGGGGTGAGGCCGTCGAGGCCTCCATGGCCGGTCGCTCTGGCTGCCGGCTCATGGTCGCTGCTGGCCTGGGGTCCCGGAGGAGAAGGGATGGGCGCTGCAGAGACCCTCCAGGCAGCCGTGGAGCCCAGGCCAGGCTAAAGCAGCCGCACCCGCTGCCGCGGAAACCACGACCAGCGTCTCTGTCACGACACAATGACCGCAACGCAACAGCCGACGCCGCGCGGCAGGCGGCCCTTCGCCACTGGCAAAGTAGCCCACGGCCCGCAGAGGAGGCCGGCCTAGTCTCTTCCCTCCTAAATCTTACCTCTTTGATGGCTAGCAAGCCTCTTAGGCCTTGTACATCTTCCTGCATCTTAGGAATG	449	72	16%	60	13%
17	7956301	7957200	aggcccactgcagtcagaaccacacaggcccactgcagtcagaaccacacacgcccactgcagtgagaaccacacacgcccactgcagtgagaaccacacacgcccactgcagtcagaaccacacacgcccactgcagtcagaaccacacacgcccactgcagtcagaaccacacacgcccactgcagtcagaaccacacacgcccactgcagtcagaaccacacacgcccactgcagtcagaaccacacacgcccactgcagtcagaaccacacacgcccactgcagtcagaaccacacacgcccactgcagtcagaaccacacacgcccactgcagtcagaaccacacacgcccactgcagtgagaaccacacacgcccactgcagtcagaaccacacaggcccactgcagtcagaaccacacacgcccactgcagtcagaaccacacacgcccactgcagtcagaaccacacaggcccactgcagtcagaaccacacacgcccactgcagtgagaaccacacacgcccactgcagtgagaaccacacacgcccactgcagtgagaaccacacccgcccactgcagtgagaaccacacacgcccactgcagtgagaaccacacccgcccactgcagtcagaaccacacacgcccactgcagtcagaaccacacccacccactgcagtcagaaccacacacgcccactgcagtcagaaccacacaggcccactgcagtcagaaccacacaggcccactgcagtcagaaccacacacgcccactgcagtgagaaacacacaggcccactgcagtcagaaccacacacgcccactgcagtgagaaccacacacgcccactgcagtcagaaccacacacgcccactgcagtgagaaccaca	899	56	6%	404	45%
17	9087601	9087750	tatgtgtgtatgtatgtatatgtgttgtgtgtatgtgggttgtatgtgtgtgtatatatgtgtgtatgtatgtatatgtgtatgtgagttgtatgtgtctgtatgcatgtatgtatgtatgtatatatgtgttgtgtgtacgtgggttg	149	2	1%	2	1%
17	9787201	9787650	aaagttctgaattcatacagttgaatccttcttaacagtctgctttacgggaacctttattaccgcgacccgcagttctggttctggaatgagggatcttccttgcgccagtcccgagttttttctcgtcccggaattcggcaccaattgttattagacgcgttctcacgaccggccaggaaagacgcaacaaaccagaatcttctgcggcaaagctttattgcttacatcttcaggagccagagtgcaagaagcaagagagagagaaaacgaaaccccgtcccttttttaggagagttatccctcgcctaggacgtgtcactccctgattggctgcagcccatcggccgagttgacgtcacggggaaggcagagcacatggagtgaagaaccaccctcggcacatgcgcagattatttgtttaccacttagaacacagctgtcagcgc	449	52	12%	66	15%
17	12283951	12284100	tgtaagcaaggggctttggggatttactctcttgctcctaaagatgtaaacaatagagcgcgctctggcgctctggcgctctggctcctaaagatgtaagcaaggggtttgagtttttgcactcttgctcctgaagatgtaagcaataa	149	8	5%	10	7%
17	13096801	13097100	TGGTGTGCTTCCAGCTTCCGGGAGGTCGCCCGCAGGCCCCTTCATCTTGTGAGGCTGTGACTGAGACGCATACGGGAAGACCATCTTGCGAGGCAAGTGCCAAGCCTTGTGCCTTGGCTTGCTTTTGGCTGCCTCTTTTGTCAGAAGTCTGTCCCGCCTGCTCATCATTTCTCTCAACTGGGAGGTTCGAGTGTGCTTGGGACAGATGTTCTGGACAGCTGGGTCGCTTTTACTGCCCATCGTAAACTCTATGAGAGACGCATAGGAAGAGGAATTGGGGGTCGCACAAAACTCATGCT	299	24	8%	36	12%
17	13099351	13099650	gtgtatgtgtgtatgtatgtatgtatgtatgtatgtatatgtagtatgtgtgtctgtgttgtgtgcactatgtatgtggggaggggtttctgtgtgtgatgtgtatggtgtatgtgatctgtgtgtctctgtgtatgtcgtatgtgtgtggtatgtatgtcgatgtatgtgtatgtggtatgcatgtctttgtgtatgtgatgtatgtctgtgggtatgtgtgtacgtggtgtgtgtctaagtgacgtgtggttgtttgtgtaagtgttaggtgtggtgtggtgtgatatgtgactgtg	299	8	3%	4	1%
17	13158751	13160100	gcttgtgcagcttcgtgccaaagcgctctccattccatatatttgcccatactagggagagcggcttttacaaccgtttgccagtcagcaggagttagtgccatgccggcgagcctgtctaactgcaccaaggtaaaattagcattggttccgtatttacggaccgactcggcaatttctttaatttgtaagtattctaccggagcgtggacacgcccaccctcggctccttcaaagaccggaaatgcctgttgtattttcctttgttcctctctgggaatgaatgagtctgcgcactgcctctctgcgcagggctgacacactacgcagggcggggactccgcatagggcggaccttgaagccgactgccctgaggccaatcagcaaactggccttcgccagccgcttttggcttccttaactgattagctagcactttacctggctggtacccttttttctcataatgagctgcttcttcctcccagtctgtttcttcagaggagaattcttcatctgcttcagagctactaagagctggctccctgagcccatccagcgatgagcacaggctccttttcctagagacctccgctaattgatctttcttcttttccctttttcctctttttcttctaatctctctccaggtattcctacctaaccttaacttttcctcgggttcaagacccttggaaaggcctgtatacttattttgtgtaccatattttctctttgctcctactctctctccctgctttacttctgatagattgtcctgaatttcatctagaatccgccctatcttaatcacctgataacatgtgaaaaggaacaaaagggctcctaacaccagaaaaaattcaaggccaaacatattccactttacttctgatagactgtcttgaatttccttagaaagttcaagatcagacttacctcgtaaagctgtactcactggtactctcgttccccagctgaaaagttctgaattcatacagttgaatccttcttaacagtctgctttacgggaacctttattaccgcgacccgcagttctggttctggaatgagggatcttccttgcgccagtcccgagttttttctcgtcccgggtttcggcaccaattgttattagacgcgttctcacgaccggccaggaaagacgcaacagaccagaatcttctgcggcaaaactttattgcttacatcttcaggagcaagagtgtaagaagcaagagagcaagaagcaagagagcaagaagcaagagagcaagaagcaagagagagagaaaacgaaaccccgtccctcttaaggagaattctccttcgcctcggacgtgtcact	1349	100	7%	156	12%
17	13158751	13160100	gcttgtgcagcttcgtgccaaagcgctctccattccatatatttgcccatactagggagagcggcttttacaaccgtttgccagtcagcaggagttagtgccatgccggcgagcctgtctaactgcaccaaggtaaaattagcattggttccgtatttacggaccgactcggcaatttctttaatttgtaagtattctaccggagcgtggacacgcccaccctcggctccttcaaagaccggaaatgcctgttgtattttcctttgttcctctctgggaatgaatgagtctgcgcactgcctctctgcgcagggctgacacactacgcagggcggggactccgcatagggcggaccttgaagccgactgccctgaggccaatcagcaaactggccttcgccagccgcttttggcttccttaactgattagctagcactttacctggctggtacccttttttctcataatgagctgcttcttcctcccagtctgtttcttcagaggagaattcttcatctgcttcagagctactaagagctggctccctgagcccatccagcgatgagcacaggctccttttcctagagacctccgctaattgatctttcttcttttccctttttcctctttttcttctaatctctctccaggtattcctacctaaccttaacttttcctcgggttcaagacccttggaaaggcctgtatacttattttgtgtaccatattttctctttgctcctactctctctccctgctttacttctgatagattgtcctgaatttcatctagaatccgccctatcttaatcacctgataacatgtgaaaaggaacaaaagggctcctaacaccagaaaaaattcaaggccaaacatattccactttacttctgatagactgtcttgaatttccttagaaagttcaagatcagacttacctcgtaaagctgtactcactggtactctcgttccccagctgaaaagttctgaattcatacagttgaatccttcttaacagtctgctttacgggaacctttattaccgcgacccgcagttctggttctggaatgagggatcttccttgcgccagtcccgagttttttctcgtcccgggtttcggcaccaattgttattagacgcgttctcacgaccggccaggaaagacgcaacagaccagaatcttctgcggcaaaactttattgcttacatcttcaggagcaagagtgtaagaagcaagagagcaagaagcaagagagcaagaagcaagagagcaagaagcaagagagagagaaaacgaaaccccgtccctcttaaggagaattctccttcgcctcggacgtgtcact	1349	100	7%	156	12%
17	14076901	14077500	acccgcacctccttccaatgctccagagtcagagaaaggggagtggacacagattgtcccatttctagaaaaacagtagtcacaacaagagcggacacgagactaagacaaaaaaaaagaaaccagaagaatcagatggcctctctaaggccggccgattgagaccctctgcacgaggtgggactcgaacccacgatcccgtgaccagactcgaggtgggactcgaacccacggtctcgcaacaaggcgcgaggtgggactctaacccacgatctcgcaacaaaacgcgaggtgggactcgaacccacgatctcgcaactgggcacgaggtgggactcgaacccacgatctcgcaaccccaaatggtctcttggccttcaaaggggtccaccaggcgtccctgatcctcccctgttcctcctgggacgtctcccagggtgaacggacggtggacacctggacacgtctatccttatccaccccgcactccctctcggagcgcggtctcactgagcgtccgcaaaactgaaactgcgatcgcaccaaacttagaaacagaacacagacatcagaacacagacatcagaccaaaacagaac	599	78	13%	106	18%
17	14864851	14866350	gttctaagtggtaaacaaataatctgcgcatgtgccaagggtattttatgactacttgtactctgcctttcccgtgaacgtcagctcggccatgggctgcagccaatcagggagtgatgcgtcctaggcgaaatataactctcctaaatagggaaggggtttcggtttcaatatagaaggggctttcttttttggggctgggcgctgggcgcttgccctcctggctcccaaagatgtaagcaataaagttttgccgcagaagattctggtctgttgtgttcttcctggccgggcgtgagaacgcgattaagaattggtgccgaaacccgggacgagaaaaaatccgggacgaaaaaatacaagaaaactcgggaccggcacaaggaagatccctcattccagaaccagaactgcgggtcgcggtaataaaggttcccgtaaagcagactgttaagaaggattcaactgtatgaattcagaacttttcagctggggaacgagagtaccagtgagtacagctttacgaggtacgcctggccttgaactttctaaggaaattcaagacagtctatcagaagtaaagtggaaaatgtttggccttgaattttttctaatgttaggagtccttttgttccttttcacatgttatcaggtgattaagatagggctgaaaattctggatgaaattcagggcaatctatcagaagtaaagcggggagagagagtaggagcaaagagaaaatatggtacacaaaataagtatacaggcctttccaagggtcttgaacccgaggaaaagtttaggtcaggtaagaatacctggggagagattagaaggaaggaaaagaaaaaagaaaagaaaaaagatcgattagcggaggtctctaggagatactcgtcactagatgagctcaggaagccagctcttagtagctctgaagcagatgaagaattctcctctgaggaaacagactgggaggaagaagcagcccattaccagccagctaattggtcaagaaaaaagccaaaagcggctggcgaaagccagcgtactgttcaacctcccggcagtcggtttcaaggtccgccctatgcggagcccccgccctgcgtagtgcgtcagcaatgcgcagagaggcaatgcgcagagagatgcgcagagaggcaatgcgcagagagatgcgcagagaggcaatgcgcagagagatgcgcagagaggcaatgcgcagagagatgcgcagagaggcagtgcgcagagaggcagtgcgcagagaggcagtgcgcagactcattcattcccagagaggaacaaaggaaaatacaacaggcatttccagtctttgaaggagccgagggtgggcgtgtccacgctccggtagaatacgtacagattaaagaactcgccgagtcggtccgtaaatacggaaccaatgctaattttaccttggtgcagttagacaggctcgccggcatggcactaactcctgctgactggcaaa	1499	134	9%	182	12%
17	17167651	17168100	AGTGATAGAGtgtcgcgcccgctctcgaccagcaagaacgatgcgaccaccagtccttctaacagcagtttattcagtcttcatctttcttctttctcttcatcagtaccgttccccagctgaagagttctgaatccacgccggatccttctcaacagtctgttttacgggaacctttattaaccacttcttccccgttatgcagttctgaatccttcctgtagcagggggtcttcgctcttgtctgaagatgtttcttgtcccgggttttcttgtattttctcgtcccgggttttctcgtcccgtcccgagtttttcttcccgGGTTTCGGCACCAACtgttgcgcgcgctcaacaggccaggaagaacgacgctgctacaggatccttctgcacacgtttattcagtcctgtttcttctttctccatatatctcccttgtttatatc	449	52	12%	54	12%
17	17473801	17474250	aagaagcagcccattaccagccagctaattggtcaagaaaaaagccaaaagcggctggcgaaggccagtttgctgattggcctcagggcagtcggcttcaaggtccgccctatgcggagtccccgccctgcgtagtgcgtcagcaatgcgcagagagatgcgcagagaggcagtgcgcagagaggcagtgcgcagactcattcattcccagagaggaacaaaggaaaatacaacaggcatttccggtctttgaaggagccgagggtgggcgtgtccacgctccggtagaatacttacaaattaaagaaattgccgagtcggtccgtaaatatggaaccaatgctaattttaccttggtgcagttagacaggctcgccggcatggcactaactcctgctgactggcaaacggttgtaaaagccgctctccctagtatgggcaaatatatg	449	48	11%	68	15%
17	18993901	18995250	gctctgccttcctcgtgacgtcaactcggccgatgggctgcagccaatcagggagtgacacgtcctaggcgaaggataattctccttaatagggacggggtttcgttttctcgctctcttgcttcttgcactctggctcctgaagatgtaagcaataaagctttgccgcagaagattctggtttgttgcgtctttcctggccggtcgtgagaacgcgtctaataacaattggtgccgaattccgggacgagaaaaaactcgggactggcgcaaggaagatccctcattccagaaccagaactgcgggtcgcggtaataaaggttcccgtaaagcagactgttaagaaggattcaactgcatgaattcagaacttttcagctggggaacggcggtaacccgtaagtatagctttacgaggtaagcctggccttgaactttctaaggaaattcaagacagtctatcagaagtaaagtggaaaatgtttggccttgaattttttctaatgttagaagcccttttgttccttttcacatgttatcaagtggttaaggcagggcggattctggatgaaattcaggacaagctatcagaagtaaagtggggagagagagtaggaacaaagaggaaatatggtacacaaaataagtatacaggcctttccaagggtcttgaacccgaggaaaagttaaggttaggtaggaatacctggagagagattagaagaaaaagaggaaaaagggaaaagaagaaagatcaattagcggaggtctctaggaaaaggagcctgtgctcatcgctggatgggctcggggagccagctcttagtagctctgaagcagatgaagaattctcctctgaagaaacagactgggaggaagaagcagctcattatgagaaaaaagggtaccagccaggtaaagtgctagctaatcagttaaggaagccaaaagcggctggcgaaggccagtttgctgattggcctcagggcagtcggcttcaaggtccgccctatgcggagtccccgccctgcgtagtgcgtcagccctgcgcagagaggcagtgcgcagactcattcattcccagagaggaacaaaggaaaatacaacaggcatttccggtctttgaaggagccgagggtgggcgtgtccacgctccggtagaatacttacaaattaaagaaattgccgagtcggtccgtaaatacggaaccaatgctaattttaccttggtgcagttagacaggcttgccggcatggcactaactcctgccgactggcaaacggttgtaaaagccgctctccctagtatgggcaaatatatggaatggagagcgctttggcacgaagc	1349	116	9%	138	10%
17	21150901	21151050	ACTTGTGTGTAAGTATGTGTGTACCTGTTCCTTTGTGATTGTGTGTAGTGCAGTTCTGATTTTGTGTAAGAGTTTGTATGCgtgtgttcctgtgtgtgtgtgtataagatcactattgtgtatttgtgtgtgtgcttttgtgtgtgtgt	149	0	0%	4	3%
17	21218551	21218850	gtttgttgcgttcttcctggccggtcgagaaaacgcgtgtaagaGttggtgccggaacccgggacgagaaaacctgggacggaatttaccatcaccggcgcaaggaagatccctcattccggaaccagaactgcgggtcacggtcataaaggttcccgtaaaacagactgttgagaaggatccggcgtggattcagaactcttcagctggggaacagtggtaatgaagtgttcccgcaacacagactgttgagaaggattcaactgcgtggattcagaactcttcagctggggagcagg	299	38	13%	36	12%
17	21253051	21253200	cctgagaagcaagcaataaagctcttgccgcggaagattctggtttgttgcttctttctttccggtcgagcaggacgcaataTATCCGGAGActacctcacccggggatccgtcccataatcagccaccaaaaccagacactattgcat	149	16	11%	24	16%
17	27264901	27265350	ctcacgcccggccaggaagaacacaacagaccagaatcttctgcggcaaaactttattgcttacatctttgggagccaggagggcaagcgcccagcgcccagccccaaaaacgaaagccccttctatatttttaggagccagagctccggcgcgccaaagcgcagagcgtgctctattgtttacatctttaggcagcgagagagcgcagggcgcgcagagccagagagatgccagcgagagagaatggcggaaaccccgtccccttttttaggagaattatccttcgcctaggacgtgtcactccctgattggctgcagcccatcggccgagttgacgtcacggggaaggcagagcacatggagtggagaaccaccctcggcacatgcgcagattatttgtttaccacttagaacacagctgtcagcgccatcttgtaacggcgaatgt	449	58	13%	76	17%
17	27269101	27269850	ctagagaaagttcaaggccaaacataccttataaagctattttccactttacttctgatagactgtcttgaatttccttagaaagttcaaggccaggcttacctcgtaaagctatacttacgggttaccgccgttccccagctgaaaagttctgaattcatgcagttgaatccttcttaacagtctgctttacgggaacctttattaccgcgacccgcagttctggttctggaatgagggatcttccttgcgccggtgaaactcccgtcccgagtttcctcccgggttttttcttcccggattttttctcgtcccggaatttctcgtcccggattttctcgtcccggatttcagcaccaATtcttaatagcgttctcacgcccggccaggaagaacacaacagaccagaatcttctgcggcaaaactttattgcttacatctttgggagccaggagggcaagcgcccagcgcccagccccaaaaacgaaagccccttctatatttttaggagccagagctccggcgcgccaaagcgcagagcgtgctctattgtttacatctttaggcagcgagagagcgcagggcgcgcagagccagagagatgccagcgagagagaatggcggaaaccccgtccccttttttaggagaattatccttcgcctaggacgtgtcactccctgattggctgcagcccatcggccgagttgacgtcacggggaaggcagagcacatggagtggagaaccac	749	90	12%	88	12%
17	27278851	27279000	atgaattggtaaacaaccaatgtgcgcatgtgtgtaagagttttttgccgagtcactgcctggcccgaggcatattaacgaggtactggtagcataaccaatcaggtatggacacgtcactcctaggcctatataagcagcgccatttc	149	12	8%	24	16%
17	27333601	27333900	TGGGCTGGGTGTGGAGCGCATCTCTACGGTGAAGTGTGATGCAGTGTTCATGGAGTGATACAGCAGGCACCAACCTATGAGGTTTGCAACAAGTAGGATTGAAATGGGCGACAGAGCCGCGCCTCACCAGCCCCAGGACTTGTGCATAAGAGAAAGAACATGCGCATGCGCAGGAGTCCCCGTAATGGAGTAAACACATGCTGCCGCCACCTGCCTCAGTGATAAAAAGGAAAGTAGTCGTTGGCTGGAGAGCAGCAGAGAAGCGAGCTCCGGGGGCTCAGACACAGACGTGCAGCTAG	299	26	9%	54	18%
17	27354451	27354900	ccatgacccgcagttctggttccggaatgagggatcttccatgctccggtgatggtaaccgtcccgggttttcttgtcccgggttttctcgtcccaggtcttctcgtcccgggtctcagcaccaaCtcttacacgcgttctcgcgaccggccaggaaagacgcagcaaaccagaatcttctgcggcaaaagctttattgcttacatcttcaggagccagagagcaagagagcaagagcgagggcaagagcgcaagagctttattgcttacatcttcaggagcaagaagcaagagccagagcaagagagagaatggcaaaaccccgtccctttttttttttttttttttctgatcaaggctcaaattttattgttgcgacactagttatcgtcccttttaaggagaattatcctctgcctaggacgtgtcgctccctgattggctgcagc	449	46	10%	62	14%
17	27414901	27415500	CAATACAATTGCCAAGTATATGCACCTGCTGAGCATGCACGGAGCTGCATAGAGTCGAAGATAGATCTTAAGCCACACAACGAACGACACACCTACCTTGGGAGCCTTGAGGTTCATGGGCGCTTGGAAGAGTATTCACGTGAACTGTAGATGAACCAAGCCACGCTGTGGACGAGAGGCACTCTGTGAGCAGGGAGTGGGGTCCTTCCAGATTTGAACCATGCCCAGTGGGGTCTGCTGTGGGCTTGGGCAAGCGGCATCGCAGTCTCCATAGCTACGTGCAAGGGCGGTGGGAGCATCTGCGGATTGATCCGGCTCAGTCAGATTCAATCGCGAGCGAAAATGGATTTTTTAATGCGTCTATTAGCTGCTTTGAAAACGCAAATTGAGTTCAAGAAAAGACAGACGCCGCCATCAGAAAACAATTTGGCGTCCGTCAAAAGGCCCAGTGGGCCAGGGCGTCCAGCTTGGGTAACACGCCCACCGCAAGCCTGAGTGCACCTTGGGCAGGGTCTAGGAGGGTCAATAGGCCACACTGCGGAGTTGTGGATGGCTCTGCTACAGAAATGTGCAAATTTCCCACCCAGAAGAAAGCGGGC	599	56	9%	104	17%
17	27467251	27467550	ggtgtatagtatatgtgtgtgatatgtgtgtgtgagcttgtgcatgtgtgagtgtaggtgtgagtatgtgtgacggtgtgtgtgaattgtctgtgtgagtatgtgagtgtgtgtggtgtgtgtaagtatggggaaatgtgggtttgtatggtgtgtatgtgtggtatgtgtgtgtgtatgtgtatagtgttgagaatgtatgtgtggtatatgtgcgtgtgagtctgtgtatgtgtgattgtgtgtgtgaggtgtgtgtgtatatatgggggatgtaggtgtggtgtgtatgttttgta	299	4	1%	2	1%
17	28108351	28108650	TGAGTGTATATACGTAGCAAGCATGTGTGTATGGATGActgtgtctgtgtctgagtgtgtgggtttggagtgtgtgtgcatgtgtatggctgtgtgtgtgttttgagtgtaagcatgtatgtgcgtgAGCGTGTATATGTAAGTATGTGTGTTTGCATGTGTAGCGGCACATGAGACCAAAAGTTGCCATGGGTTCCTCACTGACTCAGCCAGGCTAGTGGGACTGAGTTCCAGGGAACTCTCTCTGTCTCTCTAGCTGCCCCCACCCGTCCAGGCTTGTCCATGACCACAGGGATTCA	299	10	3%	38	13%
17	28509301	28509600	catatgagtgtgtgtggtacgtgtgtgagtgtgtgatctgtgtgtgtagtgtgtgtggtgtgtgtgttagtgtgtgcatgggtgtgtatgtgtgtttgtgagtcctgtgtgtagtgtgtgtgtgtttgtgtgtgtgtgtgagtcctgtgtgtgtatggtgtgtgtgagtgtgcatgtgtgtgtgtgtgtgtgtgtgagtcctgtgtgtgtatggtgtgtgagtgtgcatgtgtgtgtgtttttgagtgtatgtgtatataggagtattgtgtgttttcaaggacttgtgtgcgtgtgat	299	4	1%	10	3%
17	29186401	29186700	ggcgaaaggagagggcctactctcagaagttatcttctgacttaaacaagcatgcacatacactcacacacacacatgctcaaatacacacacacacaagctcacatactcacatacgcatgTGCACATGCACTTGCACATGTACGCTCAATCACACACAGGCACAGATACTCATGCTcacacatgcacacgcacacacaccaacactcacatactcacacactcactcacacccacatacactcactctcatacacatacacttgctcatacactcacacactcacgtacatatgcat	299	10	3%	144	48%
17	29286301	29286750	gctgtcctctgtgtacgcactgcactgctgtcctctgtgtacacactgcactgctgtcctctgtgtacgcactgcactgctgtcctctgtgtacacactgcactgctgtcctctgtgtacacactacactgctgtcgcccctcggtgtacacaatgcactgctgtcatccctcggtgtacgcactgcactgctgtcctctgtgtacacactgcactgctgtcctctgtgtacacactgcactgctgttctctgtgtacacgctgcactgctgtcctctgtgtacacactgcactgctgtcctctgtgtacacactgcactgctgtcctctgtgtacacactgcactgctgtcatccctcggtgtacgcactgcactgctgtcctctgtgtacgcacggcactgctgtcctctgtgtacgcactgcactgctgtcctctgtgtacgcact	449	26	6%	88	20%
17	30606751	30606900	CACAACAGGGCTGATGCGTGCTCTTCCgataatttcaaaggctttcctgtaagcctcatcagagaaagccagcttcccacactgggcttggttattagccaacgcagtacaCAGGGgtgtgtgtgtgtgtgtgtgtgtgtgtgtgtgtg	149	4	3%	26	17%
17	30651751	30652350	tatacacacacatatacatacacacacgttcacacacatatacacatacacacactcaccccccacatatactcacacacacatacacacactcacccacatacacatatacacacacatacacacacactcacccccacactcacatacacatacacacacttacccacatacacatatacacacacacatatacatacacatacacacactcatcccccacatactcacccacacacatacacatactcacccacatacacatatacacacacatacacatgcacacatacatacacatactcacccacatacacatatacacatacatacacacaagcacacatacatacatacacacactcacacacatacacacatacatacacacatgcacacatacacatgcacacatacatacacacactcacacaatacacatatacacacatacactcacacacatatacacaggcacacatatacacatgcacacatacatatacacactcacacacacatacacacatgcacacatacacgcacataatgcacacacactcacacacatatacacatacacaatcacacatacacat	599	4	1%	384	64%
17	30677251	30677700	AGGCAGACAAGCTGTATCTGCAGGTGAGAGGTGGTGGCTCCCCATGACTTCTTTATTTCTTTTCCtgtgtgcatgtttatgtgtgtgtgtgcatgcgtgtttgcgtgtacatgtgtgtgtgtgtatgtgtgtgtttgtgtgtgtatatgttggtgtgcatgtggatgtgtgtgcatgtttgtgtatgtggtgcatgtttatatgtgtATGTGAATGTCTTcatgtatgtgtttgcatatttctctgtgtgtgcatgtttatgtgcatgtgtttgtgtgtatatttctgtttttgtgcatgtttctgtgtatatgcatgtttgtgtgcatgttcatgtGAgtgtatgcacatgcatgtatggatgtgttgcatgcatgtttgtgtgcatgtgcgtgtatgtgtgtgaacatgtgtgtgcatgtacatgtgcatgtgGGTACTGGGTACAA	449	6	1%	58	13%
17	30694951	30695250	GGAATGCAGGGTTGAATTCATTTCCCAGCGTCATTGAAATTGCATAGTTTGTTCTTTCTTACTGTTCACATGCCATTTTAAATATTGAGCTGTTGTTGCTTTGGGGGATGTTAGGGGTTCACGTCTGGTATTAAATGTAACATGATTTCTTATTATAGGAATGTAAGGAGGTATACGCTTTCTTCTCGCATCAATTACTAGACAGCCTACAGAAGGCGACGCGCTTATCTTTGGACACAATGAAAAGGAGAATATTTGTCGGAAGGCAAGTTGAAAGTGTGTTAAAGATGTCGGGTAAA	299	18	6%	34	11%
17	30712651	30712950	ACAGAgggactgggagacgtctcagcagttacgagtgcttgctgcttaatcatgaggaacggagtttggatataagcacccgtgctgggcagctcacggtgctgtgactccagctatatggaatccgattctctcttctggtctcttgagggtacctgcactcgtgcgtgtataTCCGTCCCTCCCCACCCCACCTCCGCAAacacagacagacagacagacagacagacagacacacacacacacacacacacacacacacacacacacacgcacCTCAAAAGCAATTTAAATCTTCA	299	22	7%	86	29%
17	30744601	30744750	AATCCGCGGTGGACAACCAGGTTAACCTAGAAGGTCTGATAAACCACCCACCCTGGAACCTCAAATTAGTGCAGGTAAGGGCATCGGAAACCCACAGCGAGTGCCCATCAGCGGTCACGGCGTAGCCCACCCCACGATACTTACCAGAT	149	16	11%	30	20%
17	30746851	30748050	TAACGGAGTGTGGGAGGCCTCACAGAGAGATGCGAATGAATCCAAAGGCGATTACCGCGCCTCAGATGTTCGGCAGGCTGGATACAGCCACCAACGACTGGACAGATGGGATCTTTTCCACTCTGTGGAGGAAGACATTAAAAGCTAAAAAGGGTAGGCACGGGCCTCCCTCCGAGTTCACTCTTTCCCTGCGAGCTTATTAGAACGGACCTTGCATTTGCTCAGTTTCCCGTTTTCATTAGTTGCAGAAGGAAAAACCGATCTATCTTCCCCTACTTCCCGTCCTCATTTGCAGGTGAGAACATCTTCCTCATCCTAGACGGCCCCGTGGATGCCATCTGGATTGAGAACTTAAACTCCGTGTTGGACGATAACAAGACGCTCACCCTGGCTAACGGGGACCGCATCCCCATGGCCCCTACCTGTAAGCTGCTGTTTGAGGTGCACAACATTGAGAACGCCTCTCCTGCCACGGTGTCAAGGATGGGCATGGTATACATCAGCAGCTCGGCTCTCAGCTGGAGGCCGATATTACAGGTGGGGACCGGAAACAGGCCAGGGTCTACAGGTCTCTGCTCTTCTCATTTTTGCTTACGTGTGTACACGCGTGTGCAGATAGCCCAgtgtacgggtacatggggatgccattggataaccttgggtgtttttctttaagccaccttaccatccacacttcttttactttgtctatagtgtctctcaatggcctggaacctgtcaaggaggctaggctgactacccagggggtcccaaggacctgcttgtcccctccccctccccaaaccccatcgctggtatcatgagcacatgccagcatatccggcttttttttttttttttttttttttttgatgtgagttcggggaatcaaccccacgtctccgagctcgcaagacaagcaagcacttgatctacagagtcGCACTGGCAGCTCTACACTTTCCTAGTGCTTAGATGTTGTCCTTTGACCTCAGGCATGGTTGAAGAAGCGCAGCCAGCAGGAAGCCTCCGTCTTCCTGAGTCTGTATGATAAGGTGTTTGAAGACGCATACACGTACATGAAACTAAGCCTCAACCCCAAGATGCAGCTCCTGGAGTGTAATTACATCATGCAGGTGAGACTCCGCTCTGCTTTGTACCCACCCTTCTGAAAACACCTGAAGCTTTCCGCTCGGCTG	1199	86	7%	174	15%
17	30749401	30749550	TCTCCGAGAATCTCCGGAGGGCTCAGGGAGCAGGAGCAGGGGAGGTGGAACTATTAGTCAGAGGGCTTGTCCTCAGTGTCTTTAAGAAAAAGATCCCCTAACTCTCTTCCCAAAGCTGCCACCGGGTAGCGGGGCCCACGCGACGCTGC	149	14	9%	16	11%
17	30752701	30753000	TACTTAAGAGTTTAGGTTTGAACTTCCGGGTTACGTCAGCCAATTGCTTCCGATTTTGAAAACAATGAGTCACAAGGATTGAGATCCAGGGTCTGTGTCAAGCCATCTCCCTTTCTCTAGAGGACAATCGAAAGCTACGTGGATAAGAGGATGGGGAGTACCTACGGCCCCCCAGGAGGGAGGAAGATGACGGTGTTTATTGATGATATTAATATGCCCGTGATCAACGAATGGGGAGATCAGGTATGTCTGGGGGACTTCTCGTAGCTGGCACACAACtcccctgaagttagagctac	299	20	7%	30	10%
17	30760801	30761250	CTAAATTACTCAAGCACAGGCCAAACACAAAGAAGAGGTATTTCCTACATCAACAACAGGAAAATCgtgtcttcaatattttgttccctttcccgtaggtgccgtcctttgactttcctgtgtcttcaatattttgttccctttcccgtaggtgccgtcctttgactttcctgtgtcttcaatattttgttccctttcccgtaggtgccgtccttCGAATTCCTGAGTGAAAAGCTTCAGTTCTACCAGAGGCAATTCAACGAGATCATCCGAGGGACGTCTCTCGACCTGGTGTTTTTTAAAGACGCCATGACTCACCTCGTTAAGGTTCTGTTGACTGACTATTTCCTGTGTGCGAGTGCCGTCAAAACTTAGTTCCGTAGGGGAATTACCCTGGGAGCACCCATCCCACCAGGGAGACCAGAGAAGAGCAGCCATGGATGACAGCT	449	32	7%	58	13%
17	30762451	30762750	GAAAAAATGATTTAAATAAAACATTGTGATACATTCAAACAATAACAAGAACCCAAAATGTAGCATTATAAGGAAAGAGTCTGATGTAGTCTGGAAACACGTGGTCAGACTTTGGACCCGTAAGTGTAAGAATGAATATATAAACATTTGCATCCGTTTTTCCGATAAACACTCCTCTTTCAAACACAGATCTCTCGGATCATTCGAACCTCCTGTGGGAACGCATTGCTGGTGGGTGTCGGTGGCTCAGGAAAGCAGAGCCTCTCAAAACTGGCCTCCTTTATTGCTGGGTATCAGAT	299	16	5%	42	14%
17	30799501	30799650	ATCAACCTTGCACGCACACTCCCACACGTGTGAGCCCCACCGCACGCAGAGTCACATATATATGCTTACACGCCCAACCCCTTCACATATGTGAAAAAAGCGAATACGGAAGAAGAGATGAATATTATTGAGATGATTTTCCTTTAGAC	149	14	9%	30	20%
17	30803101	30803400	GCATCACCAAACAGACAGCTGCGGAAGTGAGCGAAAAGCTCCACGTGGCTGCGGAAACGGAGATCAAGATCAATACAGCTCAGGAGGAGTTCCGGCCAGCGGCCACGCGAGGCAGCATCCTTTACTTCCTCATCACAGAGATGAGCATGGTCAACATCATGTACCAAACCTCCCTGGCCCAGTTCTTGAAGTTATTTGACCAGTCCATGGCCAGGCAAGTCCTCCCCATCTTCCCCTCAGTCGTTTCCAAAATGGTGACCTATAGGTTTTTATGAAGCTGGGGGCAGGGGATGGAtgtg	299	20	7%	62	21%
17	30915301	30915450	cagacacacacacatacacacacacagatacacacacaacacacacatatacacacagacacacaaacgcacagatacacatataacacatgcatatacacacagagagacacacacacacagacatacagacacacacacGTGCGAGG	149	4	3%	94	63%
17	31430401	31430550	gacacttgcatacatttacccacatgaatatagaggctcacacatacatatacaagcatgcatgcacgtgcacacatacacatgcacactcacatgtgggtgcacacatacacacacacacatacgctggtgtgcatgtgctcatgcac	149	4	3%	68	46%
17	31431601	31432200	cgtgtttgtgtggtatgtatgtgtggcatgtgtatgtgtgtatactgtgtttgtgatgtgtgtgtatgtggtgtgtatgtgtgttgtgtgtgtatgtgtggtgggtgtgatgtgcatgtatatgtggtgtgtgtgtatgtatacatagtgtgtggtgtgtgtgtggtatgtgtatatgtgtgtgtagtgtgtattgtgctgtgtgtgtaagtatgtatgtgtagggtgtattgtagtgtgtgtgtaagtgtggtgtgtgtatgtatgtgtggtgtgtgtagtgtgactgtgtggttgtgtgtatgtgtgtgtagtgtgtatgtgtggtgtgtgtgtatatgtggtgtgtatgtgtgtagtgtgtgtatatgtggtgtatatgtggtgtgtatgtgtggtgggggtgtatatgtgtgtactgtgtatgtgtggtgtgtgtatatgtggtgtgtatgtatgatgtgtgtatatgtgtggtatgtgtgtagtgtgtattgtggtgtgtgtatatttgtgtagtgtatatgtgtggtgtgtatgtgtggtgtatgaatatgtgtgatgtgtgtgtatgtgtatgtagtgtgtatcgcgtatgt	599	6	1%	6	1%
17	31553851	31554150	tggggcttggggctttgggggcttgctctcttgctcgtaaagaggtaaacaatagagctcttgctctgcgctctggcgctctggcgctctggcgctctggctcctaaagatgtaagcaatgggggattttgcacgcttgctcctgaagatgtaagcaataaagttttgccgcagaagattctggtttgctgcgtctttcctggccggtcgtgaatgcgtgtaagattttctcatttaacctggaattcccattttggccaggctggctggccagccagaccccaggacccaccagtcac	299	22	7%	28	9%
17	31901101	31901400	tgcacatatatacacacatacacacatgcaaacatatgtgcatacacacactcacatacatatacggacacatacatatacacacaagcacacactcccacacacatatacacatgcacacacacatacacacatgaatacacacatgaacacacacatacacacatgagcatacacatatacacaagcacacacacataatgcacgcgcacatatacacacatataaacacacacacatatacatacatacacactcacagacctctgacagatctgagtctgttaagttttttacac	299	6	2%	158	53%
17	35281351	35281500	GCAGTGCAGAGGGAGAGGAACTAAATCACGTCTATTACATTTCCCGTTCTCAGAATTCTGCATGATAACTGTTATTtattgcgtcccactcgaccggcaagaaagacgcaacaaaccggaatcttctgcggcaaaagctttattgctta	149	16	11%	22	15%
17	35367451	35367900	ctccatgtgctctgccttccccgtgacgtcaactcggccgatgggctgcagccaatcagggagtgacacgtcctaggcgagggataactctcctaaaatagggacggggtttcgttttctctctctcttgcttcttgcactctggctcctgaagatgtaagcaataaagctttgccgcagaagattctggtctgtggtgttcttcctggccgggcgtgagaacgcgtctaataacaattggtgccgaattccgggacgagaaaaaactcgggactggcgcaaggaagatccctcattccagaaccagaactgcgggtcgcggtaataaaggttcccgtaaagcagactgttaagaaggattcaactgtatgaattcagaacttttcagctggggaacgagagtaccagtgagtacagctttacgaggtaagtctgatcttgaactttct	449	48	11%	40	9%
17	35478751	35479500	attggccgggaaacagcgcgaccacccagaggtcctagacccacttagaggtaagattctttgttctgttttggtctgatgtctgtgttctgatgtctgtgttctgtttctaagtctggtgcgatcgcagtttcagttttgcggacgctcagtgagaccgcgctccgagagggagtgcggggtggataaggatagacgtgtccaggtgtccaccgtccgttcgccctgggagacgtcccaggaggaacaggggaggatcagggacgcctggtggacccctttgaaggccaagagaccatttggggttgcgagatcgtgggttagagtcccacctcgtgcccagttgcgagatcgtgggttcgagtcccacctcgtgttttgttgcgagatcgtgggttcgagtcccacctcgtgttttgttgcgagatcgtgggttcgagtcccacctcgcgtctggtcacgggatcgtgggttcgagtcccacctcgtgttttgttgcgagatcgtgggttcgagtcccacctcgcgtctggtcacgagatcgtgggttcgagtcccacctcgtgcagagggtctcaatcggccggccttggagaggccatctgattcttctggtttcttttttgtcttagtctcgtgtctgctcttgttgtgactactgtttttctaaaaatgggacaatctgtgtccactcccctttctctgactctggttctgtcgcttggtaattttgtttgtttacgtttgtt	749	102	14%	58	8%
17	35941501	35941650	cgggattagcgtgaccacccacgtctccgaagacccacttggaggtgaaattttttgtccaaaaatatttctgtaagctggctaggttctgtgctgaaatttgcagccgcgatgtttcgtgagaaacagagacctttgcctcgggatga	149	16	11%	12	8%
17	36068251	36069150	cttgggtccgcggctgtcccgaggcttgagtgagggtctcccttcgggggtctttcatttgggggctcgtccggtatcagcgcgaccacccagagaccctagacccactttaaggtaagattctttattctgtcttggtctggtgtctgtcttctgtttttaagtttggtgcgatcgcagtttcggttttgtggacgctcagtgagaccgcgctccgagagggaacgcggggtggataaggatagacgtgtccaggtgtccactgtccgttcgccgtgggagacgtcccaggaggaacaggggaggaccagggacgcctggtggacccctttggaggccaagagaccatctggggttgcgagatcgtgggttcgagtcccacctcgtgccttgttgcaagattgtgggttcgagtcccacctcgtgcagagggtctcaatcggccggccttagaaaggccatctgattctctgagttgcttgtggtcgacgcgaagtcgccgccgcttttggtttcttttttgtcttagtctcatgttcgctcttgttgtgtctactattattctggaaatgggacaatctgtgtccactcccctttctctaactctggagcattggaaggaggtgcaggtcagagcccacaaccagtcggtggaggtcagaaagggtccgtggcagaccttttgcgcctccgagtggccgacgtttggagtgggctggccaccagaaggtgcttttgacttgttactaatcgccgccgtcaggcgaattgtttttcaggaggaagggggtcaccctgatcagatcccctacattgtgacctggcagaatctcgtccaattcccacctccgtgggtcaagccttggaccccaaattcttcgaaactgacggtcgcggtt	899	108	12%	86	10%
17	36073651	36073950	ccagggaccaccgcactaccccacgggttccaagttggagacaaagtcttggtcagacggcatcgaaccggcagcctcgagccacggtggaaggcaccctatttggtgttactaacaacccctactgcggtaaaagttgacgggattgcctcctggatccacgcctcccacgtcaagagggccgccagtcaagatgaagaaaaccacgaagacaattggacagtggcagccactgacaatcctcttaagcttcgtttgcgccgcaggcgccaccctgagcctagggaaccataaccctc	299	34	11%	52	17%
17	36100651	36100800	caggctggcctcgaactcagaaatccgcctgcctctacctcccaagtgctgggattaaaggcgtgtgccaccacgcccggctcccactccttttctataaaaacccctagcttccaagccttgtggtcgaatccactgtctcctgtgtg	149	12	8%	16	11%
17	40984801	40985100	agtcggcaggagttagtgccatgccggcaagcctgtctaactgcaccaaggtaaaattagcattggttccgtatttacggaccgactcggcgagttctttaatttgtaagtattctaccggagcgtggacacgcccaccctcggctccttcaaagaccggaaatgcctgttgtattttcctttgttcctctctgggaatgaatgagtctgcgcactgcctctctgcgcattgtctctctgcgcagggctgacgcactacgcagggcggggactccgcatagggcggaccttgaagccga	299	42	14%	30	10%
17	45350401	45350700	acacaaatatactcacgcacacatacacacactcacacacacattcactcacacacaaacacacacacactcacatatacacacaaatacattcacacacactcaaacacacacaccaacacagatattcactcacactcacatacacacacacattcactcacacataaacacacatacacattcacacacatatactcacacacacatacacacattcagacacatagtcacgtattcacatactcacacaaacatattcatacatgttcaaacacacacacatagtcactcactca	299	4	1%	188	63%
17	45644551	45646200	aaaaaaaaaaacaaaaGAagccgggcagggatggcacacgcttttaatcccagcactcaggaggcagaggtaggcagatttctgagttcgaggcctgtgggaagccgcccccacattcgccgtcacaagatggcgctgacatcctgtgttctaagttggtaaacaaataatctgcgcatgagccaagggtatttacgactacttgtactctgtttttcccgtgaacgtcagctcggccatgggctgcagccaatcagggagtgatgcgccctaggcaatggttgttctctttaaaatagaaggggtttcgttttctctctctcttgcttctctctcttgcttcttacactctggccccaaaaagatgtaagcaataaagctttgccgtagaagattctggttgttgtgttcttcctggccggtcgtgagaacgcgacgaataacaattggtgccgaattccgggacgagaaaatccgggacgagaaaaaactccggactggcgcaggagggatacttcatttcagaaccagaactgcggatcacgtttataaaggttcccgtaacacagactgttgagaaggattcaactgccgaattcagaactcatcagctggggaacgacggtgataaaggttcccgtaaagcagactgttaagaaggattcaactgtatgaattcagaacttttcagctggggaacgagagtaccagtgagtatgtttggccttgaattttttctggtgttaggagcccttttgttctttttcacatgctatcaagtgattaagatagggctgaaaattctagaggaaattcaggacaatctatcagaagtaaagcggggagagagagtaggaacaaagaggaagtatggtacacaaaataagtatacaggcctttccaagggtcttgaacccgaggaaaagttaaggttaggtaggaatacctggagagagattagaagaaaaagaggaaaaagggagaagaaaaaagatcgattagcggaggtctctaggagatactcgtcactagatgagctcaggaagccagctcttagtagctctgaagcaagtgaagaatcctcctctgaggaaacagactgggaggaagaagcagcccattaccagccagctaattggtcaagaaaaaagccaaaagcggctggcgaaagtcagcgtactgttcaacctcccggcagtcggtttcaaggtccgccctatgcggagcccccgccctgcgtagtgcgtcagcaatgcgcagaggggcaatgcgcagagaggtgcgcagagaggcagtgcgcagagaggtgcgcagagaggcagtgcgcagagaggtgcgcagagaggcagtgcgcagagaggcagtgcgcagactcattcattccccgagaggaacaaaagaaaatacaacaggcatttccagtctttgaaggagccgagggtgggcgtgtccacgctccggtagaatacgtacagattaaggaaattgccgagtcggttcgtaaatacggaaccaatgctaattttaccttggcgcagttagacaggctcgctggtatggcactaacgcctgctgattggcagacggttgcaaaagccgctctccctagtatggccaaatatgtggaatggcgagctctgtggcaggag	1649	150	9%	204	12%
17	46346101	46346550	taaacaaaccttatgcgcaagtgcaagagtgaattcacgcccagtcactgcccaactcggggcgtagtaatggggtgatgggcgagcaactaatcaggtgctgtcacgccacatcaggtgctgaaacgtcacactgcaggttatataagcagtgccattttctgggttcggggtcttcctgtgaagtaagcaataaaagctttgccatagaaggatccggttgtccgagtgaattcttgccggcgagatactagctcgggcgagaagtggtgccaagaaacccgggaatatatcatcaccaggcgctgataggagacccccgtttcatggggcgggttcagaactacgggactttacagctttacaaggtatgtctggccttgaactttctccagcgttagaaggctttctgttccttttcacagggctcgttccttttccttttgatt	449	42	9%	62	14%
17	47077951	47078850	atactgacttccaggcagctaggaacgtggtcccaaagctcacacacacagtaacacacctactctaacaaggccacaccatctaatagtgacactccctgggccaagcatatacagagcatcataCAGtgttattagacacgttctcacgaccggccaggaaagacgcaacaaaccagaatcttctgcggcaaagctttattgcttacatcttcaggagccagagtgcaagaagcaagagagagagaaaacgaaaccccgtccctattaaggagaattctccttcgcctaggacgtgtcactccctgattggctgcagcccatcggccgagttgacgtcacggggaaggcagagcacatggagtagagaaccaccctcggcatatgcgcagattatttgtttaccacttagaacacagctgtcagcgccatcttgtaacggcgaatgtgggcgcggctcccaacatctccccctttccttttaataagagcaaataggccacccatattaatgagagtggagatagaggtcaaatccccagtgtgtaggtaaaggagccatgtacaggattagctcttaggctcacaggcttttacccagagcaaccctgacctgctcccgtgtcgttttgcctgggggaagggaactaggacactgaaccttcatgaaagatgacatgtctccctagaataggctcatatatgccgcagagcctttccattgcagtgcttagccgtgcaactctctcgggctgctgaagcacactcactccatcccgtgcaatgagtctagcctcgtgagatgtaagagctgagtggccagcgacctattgcctaagcatagataaccatatatcagggggagctccatgttctagtcctgcaagcgcctgggcaat	899	60	7%	162	18%
17	53371801	53372100	tgggcttggggcttgctctcttgctcctaaagatgtaaacaatagagctcttgctctgcgctctgcgctctggcgctctggcgctctggcgctctggctcctaaagatataagcaatggggggcttgcactcttactcctgaagatgtaagcaataaagttttgccgcagaagattctggtttgctgcgtctttcctggccggtcgcgagaacgcgtgtaagaatgggtaattcaggtagcatagtaacttggtgtcctattgtcaaacgttcagtttccactaaggcccaatagcagg	299	26	9%	24	8%
17	54134251	54134850	gccagacgtaccttgtaaagctatttcccactttacttctgatagactgtcttgaatttcgttagaaagttcaagaccagacttaccttgtaaagttatacttacgggtaccctgttccccagctgaagagttctgaattcacgcagttgaatccttctcaacagtctgttttacgggaacacttcattaccaccattccccagctgaagagttctgaattcacgcagttgaatccttctcaacagtctgttttacgggaacacttcattaccgtgacccgcagttctggttccggaatgagggatcttccttgcgccagtgatggtaaccgtcccaggttttctcgtcccgggatttctcgtcccaggtcttctcgtcccgggtttcggcatcaaCtcttacacgcgttcacgcgaccggccaggaagaacgcagcaaaccggaatcttctgcggcaaaagctttattgcttacatcttcaggagccagaagcaagagccagagcaagagagagaaagaaagcaagaaaaagaacaagaacaagaaagcaagagcaagaagaagaacaagagcaagaaagagaaaaagaacaagaaca	599	52	9%	94	16%
17	58840951	58841400	ggacccctttggaggccaagagaccatctggggttgcgagatcgtgggatcgagtcccacctcgtgccttgttgcgagatcgtgggttcgagtcccacctcgtgttttgttgcgagatcgtgggttcgagtcccacctcgcgccttgttgcgagaccatgggttcgagtcccacctcgtgttttgttacgggatcgtgggttcgagtcccaccttgtgcagagggtctcaatcggccggccttagaaaggccatctgattctttgagttgcttgtggtcgacgcaaagtcaccgccgtttttggtttcttttttgtcttagtcttgtgttcgctcttgttgtgtctactattattctagaaatgggacaatctgtgtccactcccctttctctaactctggagcattggaaggaggtgcaggtcagagcccacaaccagtcggtggagg	449	54	12%	42	9%
17	63762751	63763050	tggcctcagggcagtcggtttcaaggtccgccctatgcggagcccccgccctgcgtagtgcgtcagcaatgcgcagagaggcaatgcgcagagagatgcgcagagaggcagtgcgcagagaggcaatgcgcagagaggcagtgcgcagactcattcattcccagagaggaacaaaggaaaatacaacaggcatttccggtctttgaaggagccgagggtgggcgtgtccacgctccggtagaatacttacaaattaaagaaattgccgagtcggtccgtaaatacggaaccaatgctaa	299	42	14%	50	17%
17	65160301	65160900	tgctcgggcctgcgcctgtgcagcttcgtgccaaagcgctttccattccatatatttgcccatactagggagagcggcttttacaaccgtctgccaatcggcaggagttagtgccatgccagcaagcctgtctaactgcaccaaggtaaaattagcattggttccgtatttacgaaccgactcggcaatttccttaatctgtacgtattctaccggagcgtggacacgcccaccctcggctccttcaaagactggaaatgcctgttctattttcctttgttcctctcggggaatgaatgagtctgcgcactgcctctctgcgcactgcctctctgcgcattgctgacgcactacgggctgacgcactacgcagggcggggactccgcatagggcgggagtgcacctggtagccgattgccctgaggccaattagcaaactggctttcgccagccgcttttggcttttttcttgaccaattagctggctggtaatgggctgcttcttcctcccagtctgtttcctcagaggaggattcttcacttgcttcagagttactaagagctggcttcctgagctcatctagtgacgagtatctcc	599	62	10%	70	12%
17	65461951	65463150	atgctccttaagagggacggggtttcgttttctctctctcttgcttcttgcgctcttgcttcttgcactcttgctcctgaagatgtaagaaataaagctttgccgcagaagattctggtctgtggtgttcttcctggccggtcgtgagaacgcgtctaataacaattggtgccgaattccgggacgagaaaaaaaactcgggactggcgcaaggaagatccctcattccaaaaccagaactgcgggtcgcggtaataaaggttcccgtaaagcagactgttaagaaggattcaactgtatgaattcagaacttttcagctggggaacgagagtaccagtgagtacagctttacgaggtaagtctgatcttgaactttctaacgaaattcaagacagtctatcagaagtaaagtggaaaatgtttggccttgaattttttctggtgttaggagcccttttgttccttttcacatgttatcaagtggttaagatagggcggattctagatgaaattcaggacaagctatcagaagtaaagcggggagagagagtaggagcaaagagaaaatatggtacacaaaataagtatacaggcctttccaagggtcttgaacccgaggaaaagtttaggtcaggtaagaatacctggagagagattagaagaaaaagaggaaaaagggaaaagaagaaagatcaattagcggaggtctctaggaaaaggagcctgtgctcatcgctggatgggctcaggaagccagctcttagtagctctgaagcaggtgaagaattctcctctgaggaaacagactgggaggaagaagcagcccattaccagccagctaattggtcaagaaaaaagccaaaagcggctggcgaaggccagtttgctgattggcctcagggcagtcggcttcaaggtccgccctatgcggagtccccgccctgcgtagtgcgtcagcaatgcgcagagaggcagtgcgcagagaggcagtgcgcagactcattcattcccagagaggaacaaaggaaaatacaacaggcatttccggtctttgaaggagccgagggtgggcgtgtccacgctccggtagaatacttacaaattaaagaaattgccgagtcggtccgtaaatatggaaccaatgctaattttaccttggtgcagttagacaggctcgccggcatggcactaactcctg	1199	92	8%	130	11%
17	66015751	66016200	ggtcctagacccacttagaggtaagattctttgttctgttttggtctgatgtctgtgttctgatgtctgtgttctgtttctaagtctggtgcgatcgcagtttcagttttgcggacgctcagtgagaccgcgctccgagagggagtgcggggtggataaggatagacgtgtccaggtgtccaccgtccgttcaccctgggagacgtcccaggaggaacaggggaggatcagggacgcctggtggacccctttgaaggccaagagaccatttggggttgcgagatcgtgggttagagtcccacctcgtgcccagttgcgagatcgtgggttcgagtcccacctcgtgttttgttgcgagatcgtgggtttgagtcccacctcgcaccttgttgcgagaccgtgggttcgagtcccacctcgcgtctggtcacgggatcgtgggttcgagt	449	62	14%	38	8%
17	67001251	67001700	tcccgtgacgtcagctcggccatgggctgcagccaatcagggagtgatgcgtcctaagcgaaggataactcctccttaaaggggacggggttttccgccattctctctctggctctggcgcctgctcgcttgctcctaaagatgtaaacaatagagcgcgctctgcgctttggcgcgccggagctctggctcctaaagattattggggtggctttcgcttttggggctgggagtttgcgctcctagctcctgaagatgtaagcaataaagttttgccgcagaagattctggtctgttgtgttcttcctggccgggcgtgagaacgcgattaagaattggtgctgaaacccgggacgagaaaaaatccgggacgaaaaaatacaagaaaactcgggaccggcgcaaggaagatccctcattccagaaccagaactgcgggtcgcggtaat	449	64	14%	28	6%
17	67429951	67430100	tggggggttttgcacgcttgctcctgaagatgtaagcaataaagttttgccgcagaagattctggtttgttgcgtctttcctggccggtcgcgtgaacgcgtgtaagaTATGAtgatatagaattgtaagcaacagcaacccttttctc	149	16	11%	12	8%
17	67833901	67834950	tttcttttgttcctctctgggaatgaatgagtctgcgcattgcctctctgcgcattgtctctctgcgcagggctgacgcactacgcagggcggggactccgcatagggcggaccttgaagccgactgccctgaggccaatcagcaaactggccttcgccagccgcttttggctttcttaactgattagctagcactttacctggctggtacccttttttctcataatgagctgcttcttcctcccagtctgtttcttcagaggagaattcattatctgattcagagctaccaagagctggctccccgagcccatctagcgatgagcacaggctccttttcctagagacctccgctaattgatctttcttcttttccctttttcctctttttcttctaatctctctccaggtattcctacctaaccttaacttttcctcgggttcaagacccttggaaaggcctgtatacttattttgtgtaccatattttctctttgctcctactctctctccccgctttacttctgatagattgtcctgaatttcatctagaatcctccctgccttaaccacttgataacatgtgaaaaggaacaaaagggcttctaacactagaaaaaatttaaggccaaacattttccactttacttctgatagactgtctttgaatttccttagaaagttcaagaccagacttacctcgtaaagctgtactcactggtactctcgttctccagctgaaaagttctgaattcatacagttgaatccttcttaacagtctgttttacgggaacctttattaccgcgacccgcagttctggttctggaatgagggatcttccttgcgccagtcccgagttttttctcgtcccggaatttctcgtcccgggtttcggcaccaattgttattaaacgcgttctcacgcccggccaggaagaacacagcaaaccagaatcttctgcggcaaaactttattgcttacatcttcaggagcaagagtgtaagaagcaagagagcgagaaaacgaaaccccgtccctattaagga	1049	74	7%	106	10%
17	69330451	69331650	tgtgctctgccttccccgtgacgtcaactcggccgatgggctgcagccaatcagggagtgacacgtccgaggcgaaggagaatgctccttaagagggacggggtttcgttttctctctctcttgcttcttgctctcttgcttcttgcactctggctcctgaagatgtaagcaataaagttttgccgcagaagattctggtctgtggtgttcttcctggccggtcgtgagaacgcgtctaataacaattggtgccgaattccgggacgagaaaaaaactcgggactggcgcaaggaagatccctcattccagaaccagaactgcgggtcgcggtaataaaggttcccgtaaagcagactgttaagaaggattcaactgtatgaattcagaacttttcagctggggaacgagagtaccagtgagtacagctttacgaggtaagtctgatcttgaactttctaacgaaattcaagacagtctatcagaagtaaagtggaatatgtttggccttgaattttttctggtgttaggagcccttttgttccttttcacatgttatcaagtgattaagatagggctgaaaattctagaggaaattcaggacaagctatcagaagtaaagcggggagagagagtaggaacaaagaggaaatatggtacacaaaataagtatacaggcctttccaagggtcttgaacccgaggaaaagtttaggtcaggtaagaatacctggagagagattagaagaaaaagaggaaaaagggaaaagaagaaagatcaattagcggaggtctctaggaaaaggagcctgtgctcatcgctggatgggctcggggagccagctcttagtagctctgaagcaggtgaagaattctcctctgaggaaacagactgggaggaagaagcagcccattaccagccagctaattggtcaagaaaaaagccaaaagcggctggcgaaggccagtttgctgattggcctcagggcagtcggcttcaaggtccgccctatgcggagtccccgccctgcgtagtgcgtcagcaatgcgcagagaggcagtgcgcagagaggcagtgcgcagactcattcattcccagagaggaacaaaggaaaatacaacaggcatttccagtctttgaaggagccgagggtgggcgtgtccacgctccggtagaatacttacaaattaaagaaattgc	1199	92	8%	132	11%
17	71679601	71679900	gtgtgcgtgtgcgtgtgcgtgtgagtgtgtgtgagtgtgcatgtgagtgtgtgtgagtgtgcgagtgtgcatgtgagtgtgtgagtgtgcatgtgagtgtgtgtgagtgtgcatgtgtgtttgtgtgtctgtgtgagtgtgagtgtgtgagagtgtgagtgtgtgtgagagtgtgtgtgagtatgtgtgagtgtgtgagtgagtgtgtttgtgtgagtgtgtgtatgtgtgtgtgtttgagtgtgcgtgtgagtgtgtgagtgtgtgtgagtgtatgtatgtaagtgagtgtgtgtgtg	299	10	3%	8	3%
17	72450451	72450900	aggaagaagcagcccattaccagccagctaattggtcaagaaaaaagccaaaagcggctggcgaaagccagcgtactgttcaacctccgggcagtcggtttcaaggtccgccctatgcggagcccccgccctgcgtagtgcgtcagcaatgcgcagagaggcaatgcgcagagaggcaatgcgcagagaggcagtgcgcagagaggcagtgcgcagagaggcagtgcgcagagaggcagtgcgcagagaggcagtgcgcagactcattcattcccagagaggaacaaaggaaaatacaacaggcatttccggtctttgaaggagccgagggtgggcgtgtccacgctccggtagaatacttacaaattaaagaacttgccgagtcggtccgtaaatacggaaccaatgctaattttaccttggtgcagttagacaggctcgccggcatg	449	58	13%	80	18%
17	72615451	72616650	tctcctaaaaaagggacggggtttcgttttctctctctcttgcttcttacactcttgctcctgaagatgtaagcaataaagttttgccgcagaagattctggtttgttgcgtctttcctggccggtcgtgagaacgcgtctaataacaattggtgccgaattccgggacgagaaaaaaactcgggactggcgcaaggaagatccctcattccagaaccagaactgcgggtcgcggtaataaaggttcccgtaaagcagactgttaagaaggattcaactgcatgaattcagaacttttcagctggggaacgagagtaccagtgagtacagctttacgaggtaagcctggccttgaactttctaaggaaattcaagacagtctatcagaagtaaagtggaaaatgtttggccttgaattttttctagtgttagaagcccttttgttccttttcacatgttatcaagtggttaaggcagggaggattctagatgaaattcaggaaaagctatcagaagtaaagtggggagagagagtaggaacaaagaggaaatatggtacacaaaataagtatacaggcctttccaagggtcttgaacccgaggaaaagtttaggtcaggtaagaatacctggggagagattagaaggaaggaaaagaaaaaagaaaagaaaaaagatcgattagcggaggtctctaggagatactcgtcactagatgagctcaggaagccagctcttagtagctctgaatcagatgatgaattctcctctgaagaaacagactgggaggaagaagcagctcattatgagaaaaaagggtaccagccaggtaaagtgctagctaatcagttaaggaagccaaaagcggctggcgaaggccagtttgctgattggcctcagggcagtcggcttcaaggtccgccctatgcggagtccccgccctgcgtagtgcgtcagccctgcgcagagaggcagtgcgcagactcattcattcccagagaggaacaaaggaaaatacaacaggcatttccggtctttgaaggagccgagggtgggcgtgtccacgctccggtagaatacttacaaattaaagaaattgccgagtcggtccgtaaatacggaaccaatgctaattttaccttggtgcagttagacaggctcgccggcatggcactaactcctgctgactggcaaacggtt	1199	90	8%	128	11%
17	73466401	73466550	acagatacgtaaagatacacactcatacacacagacacactcacacagacacatacactcacacacatgtgtacacagatacacacgcatacacagagacacacactcacacacacatacacattcatatacactcacagacacagaca	149	4	3%	86	58%
17	76519351	76519500	cctttacctacacactggggatttgacctctatctccactctcattaatatgggtggcctatttgctcttattaatagaaaagggggaACtgtgggaagccgcccccacattcgccgtcacaagatggcgctgacatcctgtgttctaa	149	8	5%	18	12%
17	77920651	77921250	gagtgatgcgtcctaagcgaagaataactcctccttaaaggggacggggttttccgccattctctctctctctctcgctggcttcgctctggctctggcacctgctcgcttgctcctaaagatgtaaacaatagagcgcgctctgcgctttggcgcgccggcgcgccggagctctggctcctaaagatgttatataggggtggctttcgcttttggggctgggggtttgcgctcctagctcctgaagatgtaagcaataaagttttgccgcagaagattctggtctgttgtgttcttcctggccgggcgtgagaacgctattaagaattggtgctgaaatccgggacgagaaaaaatccgggaagaaaaaacccgggaggaaactcgggacgggagtttcaccggcgcaaggaagatccctcattccagaaccagaactgcgggtcgcggtaataaaggttcccgtaaagcagactgttaagaaggattcaactgcatgaattcagaacttttcagctggggaacgagagtaccagtgagtatagctttacgaggtaagcctggccttgaactttctaaggaaattcaagacagtctat	599	72	12%	36	6%
17	78595951	78596250	atacatgtcacgtatgtcatacatgtcacatatagcatgcacaacacatttgtcatgtgtgtcacatgtcacacatgtcacacgtgttacacgtgacatgcatgccatgcatgtcgcatgtgTCATACATGCCACATATAGCACACATATTATATGTGTCGTGTGTGTCACATTtcacacatgttacacatgccatatgtgccacatatgtcacacatgccatacatgccacacgttatatatatcacacctatcacaaatgtcatgcatgccatacatgtcacacatgccacacatgc	299	12	4%	126	42%
17	84268951	84269700	taaccgctgccctcacacggggatctggtaaccgctgccctcacaccgggatctggtaaccgctgccctcacaccgggatctggtaaccgctgccctcacacggggatctggtaaccgctgccctcacaccgggatctggtaaatgctgccctcacacggggatctggtaaatgctgccctcacaccgggatctggtaaatgctgccctcacaccgggatctggtaaccgctgccctcacaccgggatctggtaaatgctgccctcacaccgggatctggtaaccgctgccctcacaccgggatctggtaaccgctgccctcacacggggatctggtaaccgctgccctcacacggggatctggtaaccgctgccctcacacggggatctggtaaccgctgccctcacacggggatctggtaaccgctgccctcacacggggatctggtaaccgctgccctcacaccgggatctggtaaccgctgccctcacaccgggatctggtaaccgctgccctcacaccgggatctggtaaccgctgccctcacacggggatctggtaaccgctgccctcacacggggatctggtaaccgctgccctcacacggggatctggtaaccgctgccctcacacggggatctggtaaccgctgccctcacaccgggatctggtaaccgctgccctcacacggggatctggtaaccgctgccctcacacggggatctggtaactgctgccctcacaccgg	749	98	13%	108	14%
17	84461851	84463500	gctgtgaaacaccgggtgcccacacacacacttactgccctagtctgcactgcactgctgtgaaacaccacgtgcccacacacacacttactgccctagtctgcactgcactgctgtgaaacaccgcgtgcccacacacacacttactgccctagtctgcactgcactgctgtgaaacaccgcgtgcccacacacacacttactgtcctagtctgcactgcactgctgtgaaacaccacgtgcacacacacttactgtcctagtctgcactgcactgctgtgaaacaccacgtgcccacacacacacacttactgccctagtctgcactgcactgctgtgaaacagcacgtgcccacacacacacacttactgccctagtctgcactgcactgctgtgaaacaccacgtgcacacacacttactgtcctagtctgcactgcactgctgtgaaacaccgtgtgcccacacacacacttactgctctagtctgcactgcactgctgtgaaacaccgggtgcccacacacacacttactgccctagtctgcactgcactgctgtgaaacaccacgtgcccacacacacacttactgccctagtctgcactgcactgctgtgaaacaccgcgtgcccacacacacacttactgtcctagtctgcactgcactgctgtgaaacaccacgtgcccacacacttactgtcctagtctgcactgcactgctgtgaaacaccgtgtgcccacacacacacttactgctctagtctgcactgcactgctgtgaaagaccacgtgcgcacacacacacacttactgccctagtctgcactgcactgctgtgaaacagcacgtgcccacacacacacttactgccctagtctgcactgcactgctgtgaaacaccgcgtgcccacacacacacttactgtcctagtctgcactgcactgctgtgaaacaccacgtgcacacacacttactgtcctagtctgcactgcactgctgtgaaacaccgtgtgcccacacacacacttactgctctagtctgcactgcactgctgtgaaacaccgcgtgcccacacacacacttactgccctagtctgcactgcactgctgtgaaacaccacgtgcccacacacacacttactgccctagtctgcactgcactgctgtgaaacaccgcgtgcccacacacacacttactgtcctagtctgcactgcactgctgtgaaacaccacgtgcccacacacttactgtcctagtctgcactgcactgctgtgaaacaccgtgtgcccacacacacacttactgctctagtctgcactgcactgctgtgaaacaccacgtgcccacacacacacacttactgccctagtctgcactgcactgctgtgaaacagcacgtgcccacacacacacacttactgccctagtctgcactgcactgctgtgaaacaccacgtgcccacacacacacttactgccctagtctgcactgcactgctgtgaaacaccacgtgcccacacacacacttactgccctagtctgcactgcactgctgtgaaacaccacgtgcccacacacacacttactgccctagtctgcactgcactgctgtgaaacaccgcgtgcccacacacacacttac	1649	76	5%	504	31%
17	87012901	87013500	ccagaagcacccgctgtctatacgacagcataaccagaagcacccgctgtctatacgacagcataaccagaagcacccgctgtctatacgacagcataaccagaagcacccgctgtctatacgacagcataaccagaagcacccgctgtctatactacagcataaccagaagcacccgctgtctatactacagcataaccagaagcacccgctgtctatactacagcataaccagaagcacccgctgtctatacgacagcataaccagaagcacccgctgtctatacgacagcataaccagaagcacccgctgtctatacgacagcataaccagaagcacccgctgtctatacgacagcataaccagaagcacccgctgtctatacgacagcataaccagaagcacccgctgtctatacgacagcataaccagaagcacccgctgtctatacgacagcataaccagaagcacccgctgtctatactacagcataaccagaagcacccgctgtctatactacagcataaccagaagcacccgctgtctatactacagcataaccagaagcacccgctgtctatactacagcataaccaga	599	58	10%	146	24%
17	87118051	87118500	cctaacatctatgtagaaagccaggtatgactgcatgatcagccagtgtagatgagagggcaggcatggggtcaaccagagaccctgtctcagaaaagaaggtgaagagcagtagaagaggcctgatcacacatggtgtgcacgcacaggtgcctgtgatgcacaccccgtacacaccacatgtgatatgtgtgcacgggcgcctgtgatgtacaccccatacacaccacatgtgatatgtgtgcacgggtgcctgtgatgtacaccccgtacacaccacatgtgatatgtgtgcacgggcacctgtgatgcacaccccatacacaccacatgtgatatgtgtgcacaggtgcctgtgatgcacaccccatacacaccacatgtgatatgtgtgcacgggcgcctgtTCCTGTCCACCACATACACACTACTAAGACTAGTGCTGTTGT	449	18	4%	120	27%
17	87694201	87694950	tccagctccTTAGTTAATGCATTTAGAAAGATTGTAAGGACtggagagagagccggctaagtgtgtaagatggagagagagccggctaagcgtgtaagatggagagaaagccggctaagcgtgtaagatggagagagagccggctaagtgtgtaaggtggagagagagccggctaagtgtgtaagatggagagagagccggctaagcgtgtaaggactggagagagagccggctaagcgtgtaaggtggagagagagccggctaagtgtgtaagatggagagagagctggctaagcgtgtaagatggagagaaagccggctaagcgtgtaaggtggagagagagccggctaagcgtgtaaggtggagagcgagccggccaagcgtgtaaggtggagagcgagccggctaagcgtgtaaggtggagagcgagccggctaagcgtgtaaggtggagagcgagccggctaagcgtgtaagatggagagagagccggctaagcgtgtaagatggagagagagccggctaagcgtgtaagatggagagagagccggctaagcgtgtaaggtggagagagagccggctaagcgtgtaaggtggagagagagccggctaagcgtgtaagatggagagagagccggctaagcgtgtaagatggagagagagccggctaagcgtgtaaggtggagagagagctggctaagcgtgtaagatggagagagagccggctaagcgtgtaagagcatttgttg	749	92	12%	8	1%
17	87750301	87750600	gcgcagagagatgcgcagagaggcagtgcgcagagaggcagtgcgcagactcattcattcccagagaggaacaaaggaaaatacaacaggcatttccagtctttgaaggagccgagggtgggcgtgtccacgctccggtagaatacttacaaattaaagaaattgccgagtcggtccgtaaatacggaaccaatgctaattttaccttggtgcagttagacaggcttgccggcatggcactaactcctgccgactggcaaacggttgtaaaagccgctctccctagtatgggcaaatat	299	32	11%	46	15%
17	89816401	89816850	cgggctaccttgccagcagagtcttgcccaacacccgcaagggtccacacgggactccccacgggaccctaagacctctggtgagtggatcacagtgcctgccccaatccaatcgcgcggaacttgagactgcggtacatagggaagcaggctacccgggcctgatctggggcacaagtcccttcctctcgactcgagactcgagccccgggctaccttgccagcagagtcttgcccaacacccgcaagggtccacacgggactccccacgggaccctaagacctctggtgagtggatcacagtgcctgccccaatccaatcgcgcggaactcgagactgcggtacatagggaagcaggctacccgggcctgatctggggcacaagtcccttccgctcgactcgagactcgagccccgggctaccttgacagcagagtcttgcccaaca	449	54	12%	72	16%
17	89936851	89937000	gctccggtagaatacgtacagattaaggaaattgccgagtcggttcgtaaatacggaaccaatgctaattttaccttggcgcagttagacaggctcgctggcatggcactaactcctgccgactggcaaacggttgtaaaagccgctct	149	22	15%	14	9%
17	89940301	89940750	tggccccatggctctgggaaatgatttggcagataaggccactaaagtggtggctgctgccctatcatccccggtagaggctgcaagaaattttcataacaattttcatgtgacggctgaaacattacgcagtcgtttctccttgacaagaaaagaagcccgtgacattgttactcaatgtcaaagctgctgtgagttcttgccagttcctcatgtgggaattaacccacgcggtattcgacctctacaggtctggcaaatggatgttacacatgtttcttcctttggaaaacttcaatatctccatgtgtccattgacacatgttctggtatcatgtttgcttctccgttaactggagaaaaagcctcacatgtgattcaacattgtcttgaggcatggagtgcttgggggaaacccagactccttaagactgataatggaccagctt	449	18	4%	68	15%
17	90103501	90103800	ttggtcaagaaaaaagccaaaagcggctggcgaaggccagtttactgcttggcctccgggcagtcggcttcaaggtgcacttccgccctatgcggagcccccgccctgcatagtgcgtcagccctgcgcagagagacaatgcgcagagaggcaatgcgcagactcattcattcccagagaggaacaaaggaaaatacaacaggcatttccggtctttgaaggagccgagggtgggcgtgtccacgctctggtagaatatgtgcagattaaagagcttgccgagtcggtccgtaaatatg	299	36	12%	44	15%
17	94302901	94303350	tcgtaaagctgtactcactggtactctcgttccccagctgaaaagttctgaattcatacagttgaatccttcttaacagtctgctttacgggaacctttattaccgcgacccgcagttctggttctggaatgagggatcttccttgcaccggtgatggtaaactctcgtcccgagttttttctcgtcccggaattcggcaccaattgttattagacgcgttctcacgaccggccaggaaagacgcaacaaaccagaatcttctgcggcaaagctttattgcttacatcttcaggagccagagtgcaagaagcaagagagagagaaaacgaaaccccgtcccttttttaggagagttatatttcgcctaggacgtgtcactccctgattggctgcagcccatcggccgagttgacgtcacggggaaggcagagcacatggagtggagaac	449	52	12%	54	12%
18	3619951	3620250	gttctccactccatgtgctctgccttccccgtgacgtcaactcggccgatgggctgcagccaatcagggagtgacacgtcctaggcgaaggataattctccttaatagggacggggtttcgttttctctctctcttgcttcttacactcttgctcctgaagatgtaagcaataaagttttgccgcagaagattctggtttgctgtgttcttcctggccgggcgtgagaacgcgtttaataacaattggtgccgaattccgggacgagaaaaaactcgggactggcgcaaggaagatccc	299	36	12%	24	8%
18	6261751	6263100	cggatcgactcggcaagctctttaatctgcacatattctaccggagcgtggacacgcccacccttggctccttcaaagaccggaaatgcctgttgtattttcctttgttcctctctgggaatgaatgagtctgcgcattgcctctctgcgcattgtctctctgtgcattgtctctctgcgcagggctgacgcactacgcagggcgggggctccgcatagggcggaagtgcaccttgaagccgactgcccggaggccaagcagtaaactgaccttcgccagccgcttttggcttttttcttgaccaattagctcgcattttatctggctggcacttttctctctcataacgagctgcttcttcctcccagtctgtttcttcagaggagaatttgtcatctgattcagagctactaagagctggcttctctaattgatcttttttcttttcttttttcttttccttccttctaatctctctccaggtattcttacctgaccttaacttttcctcgggttcaagacccttggaaaggcctgtatacttagtttgtgtaccatatttcctctttgctcctactctctctccccgctttacttctgatagattgtcctgaatttcatccagaattttcagccctatcttaatcacttgataacatgtgaaaaagaacaaaagggctcctaacactaaaaaaagttcaaggccaaacataccttgtaaagctatttcccactttacttctgatagactgtcttgaatttccttagaaagttcaagaccagacttaccttgtaaagctatacttactggtacccctgttccccagctgaagagttctgaattcatgcagttgaatccttctcaacagtctgtgttgtgggaacacttcattaccaccgttccccagctaaagagttctgaattcacgcagttgaatccttctcaacagtctgttttacgggaaccttcattaccataacccgcagttctggttccggaatgagggatcttccttgcgccggtgatggtagtttccgtcccgggttttctcctcccgggtttcggcaccaactcttacacacgttctcacgaccagccaggaaagacacaacaaaccagaatcttctgcggcaaaactttattgcttacatcttcaggagcaagagtgcaaaactcaaacccaaaaacgaaagcgaaaccccgtccctatttaggagagttatccttcgcctaggacgtatcactccctgattggctgcagcccatggccgagttgttgccacggggaaggcagagtacatggggtggagaaatacccttggcacatgcgcagattatttgtttacc	1349	90	7%	168	12%
18	6354151	6354750	ctctgacctgcacctccttccaatgctccagagttagagaaaggggagtggacacagattgtcccatttctagaataatagtagacacaacaagagcgaacacgagactaagacaaaaaagaaaccaaaaacggcggcgacttcgcgtcgaccacaagcaactcaaagaatcagatggcctttctaaggccggccgattgagaccctctgcacgaggtgggactcgaacccacgatcccgtaacaaaacacgaggtgggactcgaacccacgttctcgcaacaaggcgcgaggcgggactcgaacccacgatctcgcaacaaaacacgaagtgggactcgaacccacgatctcgcaaccccagatggtctcttggcctccaaaggggtccaccaggcgtccctggtcctcccctgttcctcctgggacgtctcccagggcgaacggacggtggacacctggacacgtctatccttatccaccccacgttccctctcggagcgcagtctcactgagcgtctgcaaaaccgaaactgcgatcgcaccaaacttagaaacagaacacagacaccagaccaagacagaacaaagaatcttacc	599	82	14%	104	17%
18	7527751	7528950	gacacgtcctaggcgaaggagaattctccttaatagggacggggtttcgttttctctcgctcttgcttcttgcactcctgctcctgaagatgtaagcaataaagttttgccgcagaagattctggtttgttgcgtctttcctggccggtcgtgagaacgcgtctaataacaattggtgccgaattccgggacgagaaaaaactcgggactggcgcaaggaagatccctcattccagaaccagaactgcgggtcgcggtaataaaggttcccgtaaagcagactgttaagaaggattcaactgtatgaattcagaacttttcagctggggaacgagagtaccagtgagtacagctttacgaggtaagtctgatcttgaactttctaaggaaattcaagacagtctatcagaagtaaagtggaatatgtttggccttgaattttttctggtgttaggagcccttttgttccttttcacatgttatcaagtgattaagatagggctgaaaattctagaggaaattcaggacaagctatcagaagtaaagcggggagagagagtaggaacaaagaggaaatatggtacacaaaataagtatacaggcctttccaagggtcttgaacccgaggaaaagttaaggttaggtaggaatacctggagagagattagaagaaaaagaggaaaaagggaaaaaaagaaagatcaattagcggaggtctctaggaaaaggagcctgtgctcatcgctggatgggctcggggagccagctcttagtagctctgaagcagatgaagaattctcctctgaagaaacagactgggaggaagaagcagctcattatgagaaaaaagggtaccagccaggtaaagtgctagctaatcagttaaggaagccaaaagcggctggcgaaggccagtttgctgattggcctcagggcagtcggcttcaaggtccgccctatgcggagcccccgccctgcgtagtgcgtcagcaatgcgcagagaggcagtgcgcagagaggcagtgcgcagactcattcattcccagagaggaacaaaggaaaatacaacaggcatttccggtctttgaaggagccgagggtgggcgtgtccacgctccggtagaatacttacaaattaaagaaattgccgagtcggtccgtaaatacggaaccaatgctaattttaccttggtgcagtt	1199	94	8%	124	10%
18	8180851	8181150	aggattcagaactgcataacagggaagaaggggttaataaagtgttcccgtaaaacagactgttgagaaggatccagcgtggattcagaactattcagctggggaacggtactgatgaagagaaagaagaaagatgaagactgaataaactgctgttagaaggactggtggtcgtgtcgttcttgctggtcgagagcgggcgcgacaattggtggcccgtacggggaaccgactcccccaccgagttcagaactttcagcagtcagtggttgctggcagggtaagttcacggtgagtga	299	28	9%	30	10%
18	8247451	8247600	acgtgggcgagagggtctgtttgtgtgtttccacaggaccagacggaacctctttgggtgccggagagattggtgagacgctgcaagaatgaggctcctgatccagttgcccctgtggatgtggtggatattcccacaagcacaaagga	149	10	7%	18	12%
18	8775901	8776350	ttagaaagttcaaggccaggcttacctcgtaaagctgtactcactggtactctcgttccccagctgaaaagttctgaattcatacagttgaatccttcttaacagtctgctttacgggaacctttattaccgcgacccgcagttctggttctggaatgagggatcttccttgcgccagtcccgagttttttctcgtcccggaattcggcaccaattgttattagacgcgttctcacgcccggccaggaagaacacagcaaaccagaatcttctgcggcaaaactttattgcttacatcttcaggagcaagagtgtaagaagcaagagagagagaaaacgaaaccccgtccctattaaggagaattatccttcgcctaggacgtgtcactccctgattggctgcagcccatcggccgagttgacgtcacggggaaggcagagcacatgga	449	48	11%	58	13%
18	10545751	10546200	cgtgcatgtgtgtacaggcatgtgtgcatgtgtgtacaggcatgtgtgcatgtgtgtacaggcatgtgtgcatgtgcgtgtgcaggcatgcgtgcatgtgtatgtgcaggcatatgtgcatgtgtgtgtacaggcatgcgtgcatgtgtatgtgcaggcatatgtgcatgtgtgtgtacaggcatgtgtgcatgtgtgtacaggcacgcgtgcatgtgtgtacaggcatgtgtgcatgtgcgtgtgcaggcatgtacaggcatgcgtgcatgtgtgtgtgcaggcatgtgtgcatgtgtgtgtacaggcacgcatgcatgtgtgtacaggcatgtgtgcatgtgtgtgtgcaggcatgtgtgcatgtgtatgtacaggcacgtgtgcatgtgtgtacaggcatgtgtgcatgtgtgtgtgcaggcatgcgtgcatgtgtatgtgcaggc	449	22	5%	118	26%
18	12806401	12806850	CATTACTGTATTCTCCTTTCTACATGACTGATACTGTCATGCACCATCTAGCGAGTTCCGGGGCTGAACTCACGGGTAGGAAGCACACATTGCTGTGCCTCCTAGTGTTctctgaacactagtacacaccagcctctgaacactagtacacaccagcctctgaacactagtacacaccagcctctgaacactagtacacaccagcctctgaacactagtacacaccagcctctgaacactagtacacaccagcctctgaacactagtacacaccagcctctgaacactagtacacaccagccacggaacactagtacacaccagcctctgaacactagtacacaccagcctctgaacactagtacacaccagccacggaacactagtacacaccagcctctgaacactagtacacgccagccacggaacTTATGGCTGAGTCAGACATA	449	14	3%	130	29%
18	15225601	15226050	aaacaaataatctgcgcatatgccgagggtggttctctactccatgtgctctgccttccccgtgacgtcaactcggccgatgggctgcagccaatcagggagtgacacgtcctaggcgaaggagaattctctttaatagggacggggtttcgttttctctctctcttgcttctcgctctctcttgcttcttgcactctggctcctgaagatgtaagcaataaagctttgccgcagaagattctggtctgtggtgttcttcctggccggtcgtgagaacgcgtctaataacaattggtgccgaattccgggacgaggaaaaaactcgggactggcgcaaggaagatccctcattccagaaccagaactgcgggtcgcggtaataaaggttcccgtaaagcagactgttaagaaggattcaactgtatgaattcagaacttttcagctggg	449	50	11%	40	9%
18	15226651	15226950	ggagtccccgccctgcgtagtgcgtcagcaatgcgcagagaggcagtgcgcagagaggcagtgcgcagactcattcattcccagagaggaacaaaggaaaatacaacaggcatttccggtctttgaaggagccgagggtgggcgtgtccacgctccggtagaatacttacaaattaaagaaattgccgagtcggtccgtaaatatggaaccaatgctaattttaccttggtgcagttagacaggctcgccggcatggcactaactcctgctgactggcaaacggttgtaaaagccgctc	299	36	12%	44	15%
18	19430551	19431000	tcttctgcggcaaaactttattgcttacatctttgggagccaggagggcaagcgcccagcgcccagccccaaaaaacgaaagccccttcaattacatctttaggagccagagctccggcgcgcgcgctctattgtttacatctttaggcagcgagcgagcgcagggcgcgcagagccagagagatgccagcgagagagaatggcggaaaccccgtccccttttttaggagagttatatttcgcctaggacgcatcactccctgattggctgtagcccatggccgagctgacgtttacgggaaaggtagagtacaagtagtcataaaatacccttggctcatgcgcagattatttgtttaccacttagaacacaggatgtcagcgccatcttgtgacggcgaatgtgggggcggctcccaacatctccccctttccttttaataagagca	449	54	12%	62	14%
18	24036151	24036600	ttctgatagactgtcttgaatttcgttagaaagttcaagaccagacttaccttgtaaagctgtactcactggtacccctgttccccagctgaagagttctgaattcatgcagttgaatcctcaacagtctgttttacgggaacacttcattaccaccattccccagctgaagagttctgaatccacgctggatccttctcaacagtctgttttacgggaacacttcattaccgtgacccgcagttctggttccggaatgaggaatcttccttgcgccggtgatggttaactcccgtcccgagttttcttgtcccgggttttttcgtcccgggttctttcttcccgggttttcggcaccaACtcttacacgcgttcgcgactggccaggaaagacgcagcaaaccagaatcttctgcggcaaaactttattgcttacatcttcaggagca	449	44	10%	60	13%
18	24539851	24540150	gtggcagctgccagaatacagaataccagaactggtaacacaggtggggctcaaacccacaatctcagaactgaaaaactaagacacaaattcagcagtgccacacttagacaacagacaacataacaagactcacacaaacaaacgcacctccaaggggtccttcggggttcctgggtgtcacgcagatctcggtggaacctccaaatgaaagaactcagtggggaaacccccactcagctcccgattcggcgtgcacccaagaatcacgaatagaacacaacaccttgatgtaacaa	299	16	5%	80	27%
18	28964251	28964400	tgttgtattttcctttgttcctctcggggaatgaatgagtctgcgcactgcctctctgcgcactgcctctctgcgcattgctgacgcactacgggctgacgcactacgcagggcggggactccgcatagggcgggagtgcacctggtag	149	22	15%	16	11%
18	29020501	29020650	aggtaaaattagcattggttccgtatttacggaccgactcggcaatttctttaatttgtaagtattctaccggagcgtggacacgcccaccctcggctccttcaaagaccggaaatgcctgttgtattttcctttgttcctctctggga	149	18	12%	10	7%
18	29021401	29021850	ctgaattcatacagttgaatccttcttaacagtctgctttacgggaacctttattaccgcgacccgcagttctggttctggaatgagggatcttccttgcgccagtcccgagttttttctcgtcccggaattcggcaccaattgttattagacgcgttctcacgcccggccaggaagaacaccacagaccagaatcttctgcggcaaaactttattgcttacatcttcaggagcaagagtgtaagaagcaagagagagagaaaacgaaaccccgtccctattaaggagaattctccttcgcctaggacgtgtcactccctgattggctgcagcccatcggccgagttgacgtcacggggaaggcagagcacatggagtgaagaaccaccctcggcacatgcgcagattatttgtttaccacttagaacacagctgtcagcgccatcttg	449	50	11%	68	15%
18	30011551	30012000	agctttattgcttgcttctcaggaagattccgaaccgggaaaatggcgctgcttttataacccgcagcgtgacgtttcagcacctgatatggcgtgacagctcccgattcgttgcttgcccatcaccccactattacaccccgagaatgggagtgactaggagtgaattcactctcgcacctgcgtacaaggcttgtttactagttaggcacagcggaggcccgcgccatcttataatggcgattgctcgctgcacacacggctctcctcagagattactggcggcacacatgcgattgctcgcagcacgtaccggctctccacatctccccctttttattttattaaaatttaaggctggtctaggcctgtgtaattatgcccatccgctgtggctcctgtcttaggtcgttcctccaatgtcacagcctttcctgtcatagggtaac	449	50	11%	62	14%
18	30015451	30016050	gcagttccagtggtggaaacaaaatgaaaccgaaaggaaaagtgtaatcgccgtgcaaacaatcaaaagggcttctaactctgaagaaatttcaagattgtacgtaccttgtagagccttttgtcccacggttctgattctgccccgcgaacgagggatcttccttgcgccggtgtgatgacagttcccgggtttcggcaccacttattgcgtcccgctcgaccggcaagaaagacgcaacaaaccagaatcttccgcggcaaaagctttattgcttgcttctcaggaagattccgaaccgggaaaatggcgctgcttttataacccgcagcgtgacgtttcagcacctgatatggcgtgacagctcccgattcgttgcttgcccatcaccccactattacaccccgagaatgggagtgactaggagtgaattcactctcgcacctgcgtacaaggcttgtttactagttaggcacagcggaggcccgcgccatcttataatggcgattgctcgctgcacacacggctctcctcagagattactggcggcacacatgcgattgctcgcagcacgtaccggctctccacacatgctcctg	599	84	14%	86	14%
18	36479551	36479850	agtccaatctctctgctctggagtcaaagcagctgcgtttgctcgggcctgcgcttgtgcagcttcgtgccaaagcgctctccattccatatatttgcccatactagggagagcggcttttacaaccgtttgccagtcagcaggagttagtgccatgccggcgagcctgtctaactgcaccaaggtaaaattagcattggttccgtatttacggaccgactcggcaatttctttaatttgtaagtattctaccggagcgtggacacgcccaccctcggctccttcaaagaccggaaatg	299	36	12%	40	13%
18	36480601	36481050	acagttgaatccttcttaacagtctgctttacgggaacctttattaccgcgacccgcagttctggttctggaatgagggatcttccttgcgccagtcccgagttttttctcgtcccggaattcggcaccaattgttattagacgcgttctcacgaccggccaggaagaacaccacagaccagaatcttctgcggcaaaactttattgcttacatcttcaggagcaagagtgcaagaagcaagagagcaagaagcaagagcgcaagaagcaagagagagagaaaacgaaaccccgtccctcttaaggagcattctccttcgcctcggacgtgtcactccctgattggctgcagcccatcggccgagttgacgtcacggggaaggcagagcacaagtagtcataagatacccttggcacatgcgcagattatttgtttaccacttagaaca	449	50	11%	72	16%
18	36987151	36987600	agctctccattccatatatttgcccatactagggagagcggcttttacaaccgtttgccagtcagcaggagttagtgccatgccggcgagcctgtctaactgcaccaaggtaaaattagcattggttccgtatttacggaccgactcggcaatttctttaatttgtaagtattctaccggagcgtggacacgcccaccctcggctccttcaaagaccggaaatgcctgttgtattttcctttgttcctctctgggaatgaatgagtctgcgcactgcctctctgcgcactgcctctctgcgcatctctctgcgcattgcctctctgcgcatctctctgcgcattgctgacgcactacgcagggcggggactccgcatagggcggaccttgaagccgactgccctgaggccaatcagcaaactggccttcgccagccgcttttggcttcc	449	54	12%	56	12%
18	40708501	40708950	caagaagttagactccagagaatcaaataaccctattaaaaatagggtacggagctaaacaaagaattctcaactgaggaatacaaaatggctgagaagtacctaaagaaaggttcaacatctcttattagacgcgttctcacgcccggccaggaaagacgcaacagaccagaatcttctgcggcaaaactttattgcttacatctttgggagccaggagggcaagcgcccagcgcccagccccaaaaacgaaagcccccttcttacatctttaggagccagagctccggcgcgccggggcgcagagcgcgctctattgtttacatctttaggcagcgagcgagcgcagggcgcgcagagccagagagatgccagcgagagagaatggcggaaaacccgtccccttttttaggagcgttatatttcgcctaggacgcatcactccctga	449	56	12%	62	14%
18	42476401	42477150	cgcgctctgagagggaacgcagggtggataaggatagacgtgtccaggtgtccaccgtccgttcaccctgggagacgtcccaggaggaacaggggaggaccagggacgcctggtggacccctttggaggccaagagaccatttggggttgcgagatcgtgggtttgagtcccacctcgtgcccagttgcgagatcgtgggttcgagtcccacctcgcgttttgttgcgagatcgtgggtttgagtcccacctcgcgccttgttgtgagaccgtgggttcgagtcccacctcgcgtttggtcacgggatcgtgggttcgagtcccacctcgtgcagagggtctcaatcggccggccttagaaaggccatctgattctttgagttgcttgtggtcgacgcagagtcgccgccgtttctggtttcttttttgtcttagtctcgtgtccgctcttgttgtgtctactgtttttctagaaatgggacaatctgtgtccactcccctttctctgactctggagcattggaaggaggtgcgggtcagagcccacaaccagtcggtggaggtcagaaagggtccgtggcagaccttttgcgcctccgagtggccaacgtttggagtgggctggccacctgagggtgcttttgacttgtcactaatcgccgccgtcaggcgaattgtttttcaggaggaagggggtcaccctgatcagatcccctacattgtgacctggcagaatctcgtccaattcc	749	96	13%	78	10%
18	44798551	44799150	acatatacacacacaaacacacacacatacatacatacacacacacacacaagcacacacacacacatacatacacacacatatatacacacagatacatacatgcacacacatgcacatgcacaagcacacacatacacatacgcgcacacatgcacatgcatacacatacacacacaagcacacacacatacatacacacatacacacacacatatatacacacacatacatacatgcacacatgcacaagcacacacatacacatacgcacacacatgcacatgcatacacatacacacacaagcacacacacatacatacacacatacacacacatatatacacacacatacatacatgtacacacatgcacatgcacaagcacacacatacacattcgcacacacatacacatatgcacacacatgcacatgcatacacatacacacacaatatgcacacacatacacacacactgacacgcacatcacacgcacatatacacacacTCCTGTGACCACATAGGTATGCACATAGCTTCTGCCACTACACACTACTGTAAAATTGATATTTTAAGTAAGTGAAGATTATTTAAG	599	12	2%	364	61%
18	44908801	44908950	gggatcttccttgcgctggtgatggtaaccgtcccgggttttctcgtcccaggtcttctcgtcccgggtcttctcgtcctgggtctcagcaccaaCtcttacacgcgttctcgcgaccggccaggaaagacgcaacaaaccggaatctt	149	28	19%	16	11%
18	45357451	45357750	agcgcaaacccccagccccaaaagcgaaagccacccctatcttacatctttaggagccagagctccggcgcgccaaagcgcagagcgcgctctattgtttacatctttaggagcaagcgagcaggcgccagagccagagcgaagagcgcaagtaagagagaatggcggaaaaccgtcccctttaaggaggagttatccttcgcttaggacgcatcactccctgattggctgcagcccatggccgagctgacgttcacgggaaaggcagagtacaagtagtcgtaaaatacccttggcac	299	40	13%	44	15%
18	47770051	47770500	gcgctgacagctgtgttctaagtggtaaacaaataatctgcgcatatgccgagggtggttctccactccatgtgctctgccttccccgtgacgtcaactcggccgatgggctgcagccaatcagggagtgacacgtcctaggcgaaatataactctcctaaaaaagggacggggtttcgttttctctctctcttgcttcttgcactctggctcctgaagatgtaagcaataaagctttgccgcagaagattctggtttgttgcgtctttcctggccggtcgtgagaacgcgtctaataacaattggtgccgaattccgggacgagaaaaaactcgggactggcgcaaggaagatccctcattccagaaccagaactgcgggtcgcggtaataaaggttcccgtaaagcagactgttaagaaggattcaactgcatgaattcagaacttt	449	52	12%	44	10%
18	49695001	49696350	aggagttagtgccatgccggcaagcctgtctaactgtaccaaggtaaaattagcattggttccgtatttacggaccgactcggcaagttctttaatctgcacgtattctaccggagcgtggacacgcccaccctcggctcctttaaagaccggaaatgcctgttgtattttcctttgttcctctctgggaatgaatgagtctgcgcattgcctctctgcgcattgtctctctgcgcattgtctctctgcgcattgtctctctgcgcagggctgacgcactacgcagggcgggggctccgcatagggcggaccttgaagccgactgcccggaggctgaacagcatgctggctttcgccagccgcttttggcttttttcttgaccgactagctagcactttatctggctggtaatgagctgcttcttcttcccagtctgtttcttcagaggagaattcttcatctgcttcagagctactaagagctggcttcctgagctcatctagtgacgagtatctcctagagacctccgctaattgatcttttttcttttccttccttctaatctctccccaggtattcttacctgacctaaacttttccttgggttcaagacccttggaaaggcctgtatacttattctgtgcactatatttcctctttgctcctactctctctccccgctttacttctgatagattgtcctgaatttcatctagaatttttagccctatcttaatcacttgataacatgtgaaaaagaacaaaagggctcctaacactagaaaaagttcaaggccaaacataccttgtaaagctattttccactttacttctgatagactgtcttgaatttcgttagaaagttcaagaccagacttaccttgtaaagctgtacttactggtactcctgttccccagctggaaagttttgaattcatgcagttgaatccttctcaacagtctgttttacgggaacctttattaccgtgacccgcagttttggttccggaatgagggatcttccttgcgtcggtgatggttaactcccgtcccgagttttcttgtctcgtcccgggtttcagcaccaactcttaaacgcgttctcacgaccggccaggaagaacacaacaaaccagaatcttctgcggcaaaactttattgcttacatcttcaggagccaggagcgcaagccccaagcccaaaaacgaaagcccccaaaaacgaaagcgaaaccctgtccctatttaggagagttatccttcgcctaggacgcatcactccctgattggctgcagcccatggccgagtaaaggcagagtacatgtagtggaaaattactcttggcaca	1349	104	8%	140	10%
18	50632201	50633550	GTCCCTTATtgttgggagccgcgcccacattcgccgttacaagatggcgctgacagctgtgttctaagtggtaaacaaataatctgcgcatgtgccgagggtggttcttcactccatgtgctctgccttccccgtgacgtcaactcggccgatgggctgcagccaatcagggagtgacacgtcctaggcgaaggagaattctccttaatagggacggggtttcgttttctctctttcttgcttcttgcactctggctcctgaagatgtaagcaataaagctttgccgcagaagattctggtttgttgcgtctttcctggccggtcgtgagaacgcgtctaataacaattggtgccgaaacccgggacgagaaaaaactcgggactggcgcaaggaagatccctcattccagaaccagaactgcgggtcgcggtaataaaggttcccgtaaagcagactgttaagaaggattcaactgtatgaattcagaacttttcagctggggaacgagagtaccagtaagtatagctttacgaggtaagcctggccttgaactttctaaggaaattcaagacagtctatcagaagtaaagtggaaaatgtttggccttgaattttttctagtgttagaagcccttttgttccttttcacatgttatcaagtggttaaggcagggcggattctagatgaaattcaggacaagctatcagaagtaaagcggggagagagagtaggaacaaagaggaaatatggtacacaaaataagtatacaggcctttccaagggtcttgaacccgaggaaaagttaaggttaggtaggaatacctggagagagattagaagaaaaagaggaaaaagggaaaagaagaaagatcaattagcggaggtctctaggaaaaggagcctgtgctcatcgctggatgggctcggggagccagctcttagtagctctgaagcagatgaagaattctcctctgaagaaacagactgggaggaagaagcagctcattatgagaaaaaagggtaccagccaggtaaagtgctagctaatcagttaaggaagccaaaagcggctggcgaaggccagtttgctgattggcctcagggcagtcggcttcaaggtccgccctatgcggagtccccgccctgcgtagtgcgtcagccctgcgcagagaggcagtgcgcagactcattcattcccagagaggaacaaaggaaaatacaacaggcatttccggtctttgaaggagccgagggtgggcgtgtccacgctccggtagaatacttacaaattaaagagcttgccgagtcggtccgtaaatacggaaccaatgctaattttaccttgg	1349	114	8%	140	10%
18	53960101	53960700	ttcacgttgtactgattggaacacctcagtgtacacttcacgttgtactgattggaacacctcagtgtacacttcacgttgtactgactggaacacctcagtgtacacttcacgttgtactgactggaacacctcagtgtacacttcacgttgtactgactggaacacctcagtgtacacgttgtactgattggaacacctcagtgtacacttcacgttgtactgattggaacacctcagtgtacacttcacgttgtactgactggaacacctcagtgtacacttcacgttgtactgactggaacacctcagtgtacacttcacgttgtactgattggaacacctcagtgtacacttcacgttgtactgactggaacacctcagtgtacacttcacgttgtactgattggaacacctcagtgtacacttcacgttgtactgattggaacacctcagtgtacacttcacgttgtactgactggaacacctcagtgtacacttcacgttgtactgactggaacacctcagtgtacacttcacgttgtactgactggaacacctcagtgtacacgttgtactgattggaacacctcagtgta	599	34	6%	130	22%
18	55316701	55317750	gctttgccgcagaagattctggtttgttgcgtctttcctggccggtcgtgagaacgcgtctaataacaattggtgccgaattccgggacgagaaaaaactcgggactggcgcaaggaagatccctcattccagaaccagaactgcgggtcgcggtaataaaggttcccgtaaagcagactgttaagaaggattcaactgtatgaattcagaacttttcagctggggaacgagagtaccagtgagtatagctttacgaggtaagcctggccttgaactttctaaggaaattcaagacagtctatcagaagtaaagtggaaaatgtttggccttgaattttttctaatgttagaagcccttttgttccttttcacatgttatcaagtggttaaggcagggcggattctggatgaaattcagggcaatctatcagaagtaaagcggggagagagagtaggagcaaagaggaaatatggtacacaaaataagtatacaggcctttccaagggtcttgaacccgaggaaaagttaaggttaggtaggaatacctggagagagattagaagaaaaagaggaaaaagggaaaagaagaaagatcaattagcggaggtctctaggaaaaggagcctgtgctcatcgctggatgggctcggggagccagctcttggtagctctgaatcagatgatgaattctcctctgaagaaacagactgggaggaagaagcagctcattatgagaaaaaagggtaccagccaggtaaagtgctagctaatcagttaaggaagccaaaagcggctggcgaaggccagtttgctgattggcctcagggcagtcggcttcaaggtccgccctatgcggagcccccgccctgcgtagtgcgtcagcaatgcgcagagaggcaatgcgcagagagatgcgcagagaggcagtgcgcagagaggcagtgcgcagagaggcagtgcgcagactcattcattcccagagaggaacaaaggaaaatacaacaggcatttccggtctttgaaggagccgagggtgggcgtgtccac	1049	80	8%	122	12%
18	55320301	55320750	atttgctcttattaaaaggaaagggggagatgttgggagccgcgcccacattcgccgttacaagatggcgctgacagctgtgttctaagtggtaaacaaataatctgcgcatatgccgagggtggttctctactccatgtgctctgccttccccgtgacgtcaactcggccgatgggctgcagccaatcagggagtgacacgtcctaggcgaaatataactctcctaaaaaagggacggggtttcgttttctctctctcttgcttcttgcactctggctcctgaagatgtaagcaataaagctttgccgcagaagattctggtttgttgcgtctttcctggccggtcgtgagaacgcgtctaataacactttattaccgcgacccgcagttctggttctggaatgagggatcttccttgcgccagtcccgagttttttctcgtcccgga	449	56	12%	36	8%
18	58450651	58450950	tctgcctttcccgttatgacaactgggccgatgggctgcagccaatcagggagtaatacgtcctaggcggagaataattctccttaaaaagggacggggtttcgccattctctctcttgcttttgctcttgcactcttgcgctcttgcgctctggctcctaaagatgtaagcaatagagctcttgcactcttgctctctggctcctgaagatgtaagcaataaagcttttgccgcagaagattccggtttgttgtgttcttcctggccggtcgcgagaacgcgtgtaagagttagataa	299	30	10%	20	7%
18	65558701	65558850	CATTTATTTTCCCTGGGGATGCCACtgtgtatatatgtatgtgtgtgcatgtgtgtatatgagagtatgtgtatgtgtgtacctgtgcgtgtatgaaagtatgtgtatgtctgtatgtatgtatgtgcatgaatgtatgtgtatgtgtg	149	2	1%	8	5%
18	70842451	70842750	taaccaatccgggtgtgagacacgcccctcctaggcctataaaagcagcaccagttctgggctcgaagtcttttcgcctctacaatcaagctctcccaataaacgtgtgcagaaggatcctgttgcagcgtcgttcttcctggccagtcgagcgcgcgcaagaagtggtgccgaaaacccgggacaagaaacatcttcaggcacgagcgaagaccccctgctacagggaggattcagaactgcatcacggggaaggagcagttaataaaggttcccgcaaaacagactgctgagaagga	299	34	11%	46	15%
18	71081551	71082750	gggagccgcgcccacattcgccgttacaagatggcgctgacagctgtgttctaagtggtaaacaaataatctgcgcatatgccgagggtggttctctactccatgtgctctgccttccccgtgacgtcaactcggccgatgggctgcagccaatcagggagtgacacgtccgaggcgaaggataattctccttaatagggacggggtttcgttttctctctctcttgcttcttacactcttgctcctgaagatgtaagcaataaagttttgccgcagaagattctggtctgtggtgttcttcctggccgggcgtgagaacgcgtctaataacaattggtgccgaattccgggatgagaaaaaactcgggactggcgcaaggaagatccctcattccagaaccagaactgcgggtcgcggtaataaaggttcccgtaaagcagactgttaagaaggattcaactgtatgaattcagaacttttcagctggggaacgagagtaccagtgagtacagctttacgaggtaagtctgatcttgaactttctaaggaaattcaagacagtctatcagaagtaaagtggaatatgtttggccttgaattttttctggtgttaggagcccttttgttccttttcacatgttatcaagtgattaagatagggctgaaaattctagaggaaattcaggacaagctatcagaagtaaagcggggagagagagtaggagcaaagagaaaatatggtacacaaaataagtatacaggcctttccaagggtcttgaacccgaggaaaagttaaggttaggtaggaatacctggagagagattagaagaaaaagaggaaaaagggaaaagaagaaagatcaattagcggaggtctctaggaaaaggagcctgtgctcatcgctggatgggctcggggagccagctcttagtagctctgaagcagatgaagaattctcctctgaggaaacagactgggaggaagaagcagctcattatgagaaaaaagggtaccagccaggtaaagtgctagctaatcagttaaggaagccaaaagcggctggcgaaggccagtttgctgattggcctcagggcagtcggtttcaaggtccgccctatgcggagcccccgccctgcgtagtgcgtcagcaatgcgcagagagatgcgcagagaggcagtgcgcagagaggcagtg	1199	94	8%	124	10%
18	71640601	71640900	tgccttccccgtggcaacaactcggccatgggctgcagccaatcagggagtgatacgtcctaggcgaaggataattctccttaaaggggacggggtttccgccattctctctcttgcttgcgctcttgcgcttttgctctctggctctggctcttgctcgcttgctcctaaagatgtaaacaatagagctcttgctctgcgctctggcgctctggcgcgctggcgctctggctcctaaagatgtaagcggggggcctttcgtttttggggcttggggcttgcgctcctgctcctgaaga	299	34	11%	16	5%
18	72940051	72940500	aggatggcgctgcctcagaagctctgtggctcttgccgggaaggtggctggttgtctggagctgaagatggcgccgcccagaagctctgcgactctcgcccgtcccagaaacggctggcactctgtattccacacggtcacccgtgcagcctgccctccgtggagtcccggagccaagaaggctcccgccggcgcctgtgccacaaacctctcaggccgggcagacccccgtgctctcaccaggaaggtggccggctgtctggagctgaagatggcgccgcccagaagctctgcgactctcgcccgtcccagaaatggctggcactgtgtattccacacggtcacccgtgcagcctgctGTGGCAATTTTTTAAGGCAGCATTGGAAAATTAACATGGTGGAATGTGAGACGTTTTGTAATCTGATTACACAGTTCTGGGGAGAAACTC	449	52	12%	56	12%
18	75967051	75967200	tgacacctcccacacacacatcacacacaccgcaaacacactacacacatatcacatacacatcacacacatcatatacacattatgcacacacatctcacacacattacacacacatctcacacatcatacatatcacacacaccaca	149	2	1%	100	67%
18	76364251	76364550	gagccccgggctaccttgccagcagagtcttgcccaacacccgcaagggcccacacgggactccccacgggatcctaagacctctggtgagtggaacacagcgcctgccccaatccaatcgcgcggaacctgagactgcggtacatagggaagcaggctacccgggcctgatctggggcacaagccccttcagctccactcgagccccgggctaccttgccagcagagtcttgcccaacacccgcaagggcccacacgggactccccacgggatcctaagacctctggtgagtggaaca	299	30	10%	54	18%
18	78058801	78058950	agtaaatatgtatatatgtgtgtggtgtgtgcatgtgagtgtgtatttatatatagtatgtttgtatgagtgtgtatgtgtgtggtgtgtgcatgagagtgtgtgtatgtgtctgtgatgtgcgtgagtgaatatgtatatgtgtgtgg	149	2	1%	4	3%
18	82586551	82587000	caacaaaacagacaacaaaaacccaccaggggctagagagttggtcagccattaagagtattgactgctcttgcagagcatctgggtttggtttccagcaatcacgtggagttcacaatagtgtgtgactaaagttccaggaaatttggtaccttcttctggtctccgcaggcatcaggcacacacaagatgcacatgcatacatgcaggtacacacaagatgcacattcatacatgcaggtgcacacaagatgcacattcatacatgcaggcacacacaagatgcacatgcatacatgcaggtacacacaagatgcacatgcatacatgcaggcacacacaagatgtacatgcatacatgcaagtacacacaagatgcacatacatacatgcaggcacacacaagatacacatgcatacatgcaggcacacacgagatgcacatacac	449	6	1%	186	41%
18	83700751	83701200	cttgtactctgtttttcccgtgaacgtcagctcggccatgggctgcagccaatcagggagtgatgcgccctaggcaatggttgttctctttaaaatagaaggggtttcgtttttctctctctcttgcttctctctcttgcttcttacactctggcccccaaaaagatgtaagcaataaagctttgccgtagaagattctggttgttgtgttcttcctggccggtcgtgagaacgcgacgaataacaattggtgccgaaatccgggacgagaaaaaactccggactggcgcaggagggatacttcatttcagaaccagaactgcggatcacgtttataaaggttcccgtaacacagactgttgagaaggattcaactgccgaattcagaactcatcagctggggaacgacggtgataaaggttcccgtaaagcagactgttaagaaggat	449	46	10%	44	10%
18	85052551	85053150	acttcagaccaatttcccttatgaatatcgatgcaaaaatcctcaataaaattctcactaaccgaatccaagaacacattaaaacaatcatccatcctgactgtcccgagctagtgtatcgccggcaagaacacactcggacaacctgattcttctacagcaacgctttactgctttatcagaaggaagaccccaaacccggaaaatgtcgctgcttatatacccctccacgcggcgtgtcagcacctgatttgttgctcgcccatcacctcattgctacgccccgggatgggcagttacttggcacgaatttactcttgcacctgtgcacattgcttgttcaccagtaggcacagctgaggccagcaccatcttgtaaaggcgattgctcacggctctccacacctgaccaagtaggtttcattccagggatgcggggatgttttaatatatgtaaattcatcaacgtaattcattatataaacaaactcaaagacaaaaaccacatgatcatctccttagactcggagaaagcatttgacaaaatccaacacccattcatgataaaagtcgtggaaagatcaggaattcaatgccac	599	44	7%	122	20%
18	90497701	90498000	gaccagcaagaacgacgcgaccaccagtccttctaacagcagtttattccgtcctcatctttcttctttctcttcatcagtaccgttccccagctgaagagttctgaatccacaccggatccttctcaacagtctgttttacgggaacactttattaaccgctccttcccagtgatgcagttctgaatcctccctgtagcagggggtcttcgctcttgcctgaagatgtttcttttcccgggtttCGGCACCACTTCttgcgcgcactcaactggccaggaagaacgacactgctacag	299	28	9%	50	17%
19	3227701	3228300	cccatttctagaaaaacagtagtcacaacaagagcggacacgagactaagacaaaaaagaaaccagaagaatcagatggcctctctaaggccggccgattgagaccctctgcacgaggtgggactcgaacccacgatcccgtgaccagacgcgaggtgggactcgaacccacgatctcgcaactgggcacgaggtgggactcgaacccacgatctcgcaaccccaaatggtctcttggccttcaaaggggtccaccaggcgtccctgatcctcccctgttcctcctgggacgtctcccagggtgaacggacggtggacacctggacacgtctatccttatccaccccgcactccctctcggagcgcggtctcactgagcgtccgcaaaactgaaactgcgatcgcaccaaacttagaaacagaacacagacatcagaacacagacatcagaccaaaacagaacaaagaatcttacctctaagtgggtctaggacctctgggtggtcgcgctgtttcccggccaatgcaccaaatgaaagacccccgaagtgagaccctcacttcaggcactcaagtcccgggacagccgcgtacccaag	599	74	12%	102	17%
19	4065001	4065900	acagacaacatagacgactcacaaaaacaaacgtaaacaaacaaaattaccaagcgacagaaccagagtcagagaaaggggagtggacacagattgtctcatttttagaaaaacagtagtcacaacaagagcggacacgagactaagacaaaaaagaaaccagaagaatcagatggcctctccaaggccggccaattgagaccctctgcacgaggtgggactcgaacccacgatcccgtgaccagacgcgaggtgggactcgaacccacgatctcgcaacaaaacacgaggtgggactcgaacccacgatcccgtgaccagacgcgaggtgggactcgaacccacgatctcgcaacaaaacacgaggtgggactcgaacccacgatctcgcaacaaaacacgaggtgggactcgaacccacgatctcgcaacaaaacacgaggtgggactcgaacccacgatctcgcaacaaaacacgaggtgggactcgaacccacgatctcgcaaccccaaatggtctcttggccttcaaaggggtccaccaggcgtccctgatcctcccctgttcctcctgggacgtctcccagggcgaacggacggtggacacctggacacgtctatccttatccaccccgcactccctctcggagcgcggtctcactgagcgtccgcaaaactgaaactgcgatcgcaccagacttagaaacagaacacagacatcagaacacagacatcagaacacagacatcagaccaaagcagaacaaagaatcttacctctaagtgggtctaggacctctgggtggtcgcgctgtttcccggccaatgcaccaaatgaaagattttcgaattcccggcccatgtaccaaatgaaagaccctcgagggaagaccctcactc	899	120	13%	174	19%
19	4819051	4819800	agaagcttcttggactgagtcaaacctcatatacggggtcgcataacttaatgatactgggtgtgataatgagttaaagagaagcttcttggactgagtcaaacctcatatacggggtcgcataacttaatgatactgggtgtgataatgagttaaagagaagcttcttggactgagtcaaacctcatacggggtcgcataacttaatgatactgggtgtgataatgagttaaagagaagcttcttggactgagtcaaacctcatatacggggtcgcataacttaatgatactgggtgtgataatgagttaaagagaagcttcttggactgagtcaaacctcatatacggggtcgcataacttaatgatactgggtgtgataatgagttaaagagaagcttcttggactgagtcaaacctcatatacggggtcgcataacttaatgatactgggtgtgataatgagttaaagagaagcttcttggactgagtcaaacctcatatacggggtcgcataacttaatgatactgggtgtgataatgagttaaagagaagcttcttggactgagtcaaacctcatatacggggtcgcataacttaatgatactgggtgtgataatgagttaaagagaagcttcttggactgagtcaaacctcatacggggtcgcataacttaatgatactgggtgtgataatgagttaaagagaagcttcttggactgagtcaaacctcatatacggggtcgc	749	40	5%	58	8%
19	4957051	4957950	tgggctgcagccaatcagggagtgatgcgtcctaggcgaaatataattctcctaaaaaaggggacggggtttccgccattctctctcgctggcatctctctggctctgcgcgccctgcgctcgctcgctgcctaaagatgtaaacaatagagcgcgctctgcgctttggcgcgccggagctctggctcctaaagattatggggggggctttcgcttttggggctggaggtttgcgctcctagctcctgaagatgtaagcaataaagttttgccgcagaagattctggtctgttgtgttcttcctggccgggcgtgagaacgctattaagaCTACACAGAGAAACAGTGTCTcaaacaaacaaacaaacacaacacaacaaaacaaaaacaaGTGTGTTTGATCATATCCAGttgtatgtccgtatgtgttgcctgcatgtatgtctatgcaccacgtatgtacctggtgcctatagaagccagaagagggaatctgatgccctggaactggagttacataggaccgtgaatcacaactgtgtactgggaatcaaacctgggtcctctggaaaagcagccactgctactttaccAGCTCCAGTTTCTATTAATTCACTGATTTTATTGTAGACTTAtcttacacgcgttctcgcgaccggccaggaaagacgcagcaaaccagaatcttctgcggcaaaactttattgcttacatcttcaggagcaagagtgcaagagcaaaagccttattgcttacatctttaggagcaagaagcaagagccagagcaagagctctattgcttacatctttaggagccagagcgcaagagcgcaagagcaagagccttattgcttacatctttaggagcaagaagcaagagccagagcaagagctctat	899	68	8%	124	14%
19	5316601	5317050	gcggacgctcagtgagaccgcgctccgagagggaacgcggggtggataaggatagacgtgtccaggtgtccaccgtccgttcgccctgggagacgtcccaggaggaacaggggaggaccagggacgcctggtggacccctttggaggccaagagaccatctggggttgcgagatcgtgggttcgagtcccacctcgcgccttgttgcgagatcgtgggttcgagtcccacctcgcgccttgttgcgagatcgtgggttcgagtcccacctcgcgccttgttgcgagaccgtgggttcgagtcccacctcgtgttttgttacgggatcgtgggttcgagtcccacctcgtgcagagggtctcaatcggccggccttagaaaggccatctgattctttgagttgcttgtggtcaacgcgaagtcgccgccgtttttggtttcttttttgtc	449	86	19%	34	8%
19	6248401	6248550	CCTGCCCGTGttgagcaccagcatacgacaaaaatgtgagtgtgtgtgagcatgtgagtgtgtgtgagcatgtgagtgtgtgtgagcatgtgagtgtgtgtcagcatgtgagtgtgtgtcagcatgtgagtgtgtgtgagcatgtgagt	149	4	3%	24	16%
19	9836401	9836550	ctaaggttcttgtagaaacttttatctctcgctgttttaaaacagagtgtagagctgtagttacagaatgtgaatttcccatactgctcccttatctacgagaggcttaaatatgagacgagcactgcggcttatatacgtccgtctga	149	12	8%	8	5%
19	11422201	11422350	accagaatcttctgcagcaaaactttattgcttacatcttcaggagcaagagtgcaagagcgagaatggcgaaaccccgtccctttttaaggagaattattctccgcctaggacgtattactccctgattggctgcagcccatcggccg	149	14	9%	18	12%
19	11423851	11424300	tttgcaatcatttgccagtcggcaggagttagtgccatgccagcaagcctgtctaactgcaccaaggtaaaattagcattggttccatatttacggaccgactcggcaagctctttaatctgcacatattctaccggagcgtggacacgcccaccctcggctccttcaaagaccggaaatgcctgttgtattttcctttgttcctcctttggaatgaacgagtctgcgcattgcctctctgcacagggctgacgcactacgcagggcgggggctccgcatagggcggaagtgcactatgaccttgaagccaactgcccggaggctgagcagcatgctggccttcgccagccgcttttggctttttccttaactgattagctagcattttatctggctggtacccttttctctcataatgagctgcttcctcctccaagtctgtttcttc	449	38	8%	62	14%
19	11425051	11425350	ctcgcgaccggccaggaaagacgcagcaaaccggaatcttctgcggcaaaactttattgcttacatcttcaggagcaagagtgcaagagcgagaatggcgaaaccccgtccctttttaaggagaattattctccgcctaggacgtattactccctgattggctgcagcccatcggccgagttgtcatcacggggaaggcagagcacatgtagtggaaaactacccttggcacatgcgcagattatttgtttaccacttagaacacaggatgtcagcgccatcttgcaacggcgaatgtg	299	36	12%	48	16%
19	11800051	11800350	atcacccaagccagatccctgggacacacctggccagggagagtcaactccatcaagtcatcttctaaaactacacatgcacgcacacacacacacacacacacacacacacacacacagacacacacacacacacacacacacagacaaacacacacacacagacacacagacacacacagacacgcacagacacacagacacacacagacacgcacgcacacacacacacacacagacacgcacgcacacacacacagacacacacacacacacacacacacacacacagacacaca	299	12	4%	208	70%
19	12152701	12153000	tcccgccggcgcctgtgacacaaacctctcaggccgggcagacccccgtgctctcaccaggaaggtggccggctctctggagctgaagatggcgccgcctcagaagctctgtggctctcgccaggaaggtggccggttgtctggagtcgaagatgggccgcctcagaagctctgtggctctcaccaggaaggtggccggttgtctggagccgaagatggcgccgccccagaagctctgcgactctcgcccgtaccagaaacggctggcctctgtattccacatggtctcccgtgcagcc	299	42	14%	32	11%
19	13119601	13120650	attttcggctccgggactccgcggacggctccgggactctgcggagggcaggctgcacgggagaccgtgtggaatacagaggccagccgtttctggtacgggcgagagtcgcagagcctctggggcggcgccatcttcagctccagacaaccggccaccttcctggcgagagccacagagcttctgaggcggcgccatcttcagctccagacagccggccaccttcctggtgagagcatgggggtctgcccggcctaagaggtttgtgtcacaggcgccggcgggagccttcttggctccgggaatctgcggagggcaggctgcacgggtgaccgtgtggaatacagaggccagccatttctggtatggacgagagtcgcagagcttctggggcggcgccatcttcagctccagacaaccagccaccttcctggcgagagccacagagcttctgaggcggcgccatcttcagctccagacagccgaccaccttcctggtgagagcacgggggtctgcccggcctgagaggtttgtgtcacaggcgccggcgggagccttcttggctccgggactctgcggagggcaggctgcacgggtgaccgtgtggaatacagaggccagccgtttctggtacgggcgagagtcgcagagcctctggggcggcgccatcttcagctccagacagccggccaccttcctggtgagagcacgggggtctgcccggcctgagaggtttgtgtcacaggcgccggcgggagccttcttggctccgggactctgcggagggcaggctgcacgggagaccgtgtggaatacagaggccagccgtttctggtacgggcgagagtcgcagagcctctggggcggcgccatcttcagctccagacagccggccaccttcctggtgagagcacgggggtctgcccggcctgagaggtttgtgtcacaggcgccggcgggagccttcttggctccgggactctgcggagggcaggctgcacgggagaccgtgtggaatacagaggccagccgtttctgggacgggcga	1049	160	15%	144	14%
19	13269601	13269750	gcagttgaatccttctcaacagtctgttttatgggaacacttcattaccaccgttccccagctgaggagttctgaatccaggctggatccttctcaacagtctgttttacgggaacctttatgaccgtgacccgcagttctggttccga	149	10	7%	22	15%
19	13929151	13929600	tggacacagattgtcccatttctagaaaaacagtagtcacaacaagagcggacacgagactaagacaaaaaagaaaccagaaacggcggcgactctgcgtcgaccacaagcaactcaaagaatcagatggcctctctaaggccggccgattgagaccctctgcacgaggtgggactcgaacccacgatcccgtgaccaaatgcgaggtgggactcgaacccacggtctcgcaacaaggcgcgaggtgggactcaaacccacgatctcgcaacaaaacgcgaggtgggactcgaacccacgatctcgcaactgggcacgaggtgggactcaaacccacgatctcgcaaccccaaatggtctcttggcctccaaaggggtccaccaggcgtccctggtcctcccctgttcctcctgggacgtctcccagggtgaacggacggtggacacct	449	66	15%	74	16%
19	13999801	14000400	cctgatctggggcacaagtcccttccgctcgactcgagccccgggcttccttgccagcagagtcttgcccaacacccgcaagggcccacacgggactccccacgggatcctaagacctctggtgagtggaacacagcgcctgccccgatccaatcgcgcggaacttgagactgcagtacatagggaagcaggctacccgggcctgatctggggcacaagtccattccgctcgactcgagactcgagccccgggctaccttgccagcagagtcttgcccaacacccgcagggcccacacgggactccccacgggaccctgagacctctggtgagtggaacacagcgcctgccccaatccaatcgcgcggaacttgagactgcggtacatagggaagcaggctacccgggcttgatctggggcacaaaccccttccactccactcgagccccgggctaccttgccagctgagtcgcctgacacccgcaagggcccacacaggattccacacgtgatcctaagacctctagtgagtggaacacaacttctgccaggagtccggttcgaacaccagatatctgggtacctgccttgcaagaag	599	68	11%	102	17%
19	15844201	15844500	ggccactaaagtggtggctgctgccctatcatccccggtagaggctgcaagaaattttcataacaattttcatgtgacggctgaaacattacgcagtcgtttctccttgacaagaaaagaagcccgtgacattgttactcaatgtcaaagctgctgtgagttcttgccagttcctcatgtgggaattaacccacgcggtattcgacctctacaggtctggcaaatggatgttacacatgtttcttcctttggaaaacttcaatatctccatgtgtccattgacacatgttctggcatca	299	16	5%	52	17%
19	16012501	16012950	tggggctaacttaaaaagtaatggactaatttgtttggcaaatgaatttaaagatagcctatcattcatcttaaacgcgttctcacgaccggccaggaagaacacaacaaaccagaatcttctgcggcaaaactttattgcttacatcttcaggagccaggagcgcaagccccaagccccaaaaacgaaaggcccccccgcttacatctttaggagccagagcgccagcgcgccagagcgccagagcgcagagcgcaagcaagagagagaatggcggaaacccccgtcccctttaaaggagaattattctttgcctaggacgcatcactccctgattggctgcagcccatggccgagttgacgtcacgggaaagacagagtacatgtagtggtaaaatacccttggcacatgcgcagattatttgtttaccacttagaacacaggatgt	449	42	9%	74	16%
19	18923701	18924300	gtaattaatgtcacatagcactgcggtatccagggacgggcaactttcctcatgcacagatcaacctaagacacggggcccggtggcgatagggttaccctatgacaggaaaggctgtgacattggaggaacgacctaagacaggagccacagcggatgggcataattacacaggcctagaccagccttaaattttaataaaataaaaagggggagatgtggagagccggtacgtgctgcgagcaatcgcatgtgtgccgccagtaatctctgaggagagccgtgtgtgcagcgagcaatcgccattataagatggcgcgggcctccgctgtgcctaactagtaaacaagccttgtacgcaggtgcgagagtgaattcactcctagtcactcccattctcggggtgtaatagtggggtgatgggcaagcaacgaatcgggagctgtcacgccatatcaggtgctgaaacgtcacgctgcgggttataaaagcagcgccattttcccggtttgggatcttcctgagaagcaagcaataaagcttttgccgcggaagattctggtttgttgcgtctttcttgccggttgagcgggacgcaa	599	70	12%	82	14%
19	22441051	22441200	AGGCTCGTGGACCAGTGACATCCAGAAATTAAGAGTTTTTTGAGACCCGGGAGGTCGCGGACCGGTGCTCCGCGGCTGTCATCATGCCACAAAATGAATATATTGAATTGCACCGCAAACGATACGGATATCGTTTGGACTACCATGAG	149	22	15%	20	13%
19	24130951	24131250	GCTTCGGGAACGTAGGTGTTCTCGGCTGCGGCTCCGTTCATAGCGGGTCTCTGGATGGGCTCTACGGTCATATGATGGGCTGTAGCCGCCTCCGTAGTCGGGTTCATAAGCTTCGTGATAGGAGCGCTCATAGTCTCGGTCGTAGTCCCTGTCGATGCTACGGCCACGGCTGTGGTCCCTGGACACAAAGTCGCGGTCCAGCCCGCGCTCCAGGCTCCGGCCACGGCTGCGCTCACGGCTGCGCCCATAGTCTTCCTGGTCCAGGCCCCGTTCCAGGCTCCTGCCACGGCTGCGCTCCC	299	58	19%	30	10%
19	29320651	29320800	gcgcaatacaatgtgtctgtctactattacagcgcaatacaatgtgtctgtctactattacagcgcaatacaatgtgtctgtctactattacagcgcaatacaatgtgtctgtctactattacagcgcaatacaatgtgtctgtctgct	149	10	7%	28	19%
19	29686051	29686650	gctttcttgctgttgcgttattaaatcttgccttcaacattttgagttcggtctcagtgtcttcttgggtccgcggctgtcccgaggcttgagtgaggatctcccttcgggggggggtctttcatttgggggctcgtccgggatcagcgcgaccactcagagaccctagacccactttaaggtaagattctttgacctgtcttggtctggtgtctgtgttctgtttctaagtttggtgcgatcacagtttcggttttgcggacgctcagtgagaccgcgctccgagagggaacgcggggtggataaggatagacttgtccaggtgtccaccgtccgttcgccctgggagacgtcccaggaggaacaggggaggaccagggacgcctggtggacccctttggaggccaagagaccatctggggttgcgagatcgtgggttcgagtcccacctcgtgccttgttgcgagaccgtgggttcgagtcccacctcgtgttttgttacgggatcgtgggttcgagtcccacctcgtgcagagggtctcaatcggccggccttagaaaggccatctgattctttgagttgcttgtggtcgacgcga	599	82	14%	48	8%
19	30964951	30965250	cacgctccggtagcgtatatacagattaaagagcttgccgagtcggtccgtaactatggagtcagtgctaatttcactatagcacaagtggaaaggcttgcgaatcacgctatgactcctggtgattggcaaacggttgtaaaagccgctctccctagtatgggcaaatatatggaatggagagcgctttggcacgaagctgcacaagcgcaggcccgagcaaacgcagctgctttgactccagagcagagagattggacttttgacttgttaacgggtcagggagcttattctgctga	299	32	11%	36	12%
19	32877451	32877600	gcctcgcaccccacggcataacgcagcataatttcttttagagcggcaaaccgaatctgaggagattgtcccgcctccactgcagcaaaagcctacgctaccatggcgaaagtgcgggcctgcacacgctgcaactaacacatgtgcca	149	20	13%	32	21%
19	32878651	32878950	ggcaaccactaactgctgaaagttctgaactcggtgggggagtcggttccccgtacgggccaccaattgtcacgcctgctctcgaccagcaagaacgatgcgaccaccagtccttctaacagcagtttattcagtcttcatctttcttctttctcttcatcagtaccgttccccagctgaatagttctgaatccacgccggatccttctcaacagtctgttttacgggaacctttattaaccccttcttccccgttatgcagttctgaatcctccctgtagcagggggtcttcgctctt	299	28	9%	42	14%
19	33078151	33078450	tgtacacgtgagtacaggaagctgcagaggtcagaagcacgatacatgcatgagtgcatttatgtgtacacgtgagtacaggaagctgcagaggtcagaagcacgatacatgcatgagtgcatttatgtgtacacgtgagtacaggaagctgcagaggtcagaagcacgatacatgcatgagtgcatttatgtgtacacgtgagtacaggaagctgcagaggtcagaagcacgatacatgcatgagtgcatttatgtgtacacgtgagtacaggaagctgcagaggtcagaagcacgat	299	20	7%	74	25%
19	38494651	38495100	ttacctcgtaaagctgtactcactggtactctcgttccccagctgaaaagttctgaattcatacagttgaatccttcttaacagtctgctttacgggaacctttattaccgcgacccgcagttctggttctggaatgagggatcttccttgcgccagtcccgagttttttctcgtcccggaattcggcaccaattgttattagacgcgttctcacgaccggccaggaagaacaccacagaccagaatcttctgcggcaaaactttattgcttacatcttcaggagccagagtgcaagaagcaagagagcgagaaaacgaaaccccgtccctattaaggagaattctccttcgcctaggacgtgtcactccctgattggctgcagcccatcggccgagttgacgtcacggggaaggcagagcacatggagtgaagaaccaccctcggcac	449	52	12%	60	13%
19	40066051	40066650	gctcttgctctcttgctcctgaagatgtaagcaataaagttttgccgcagaagattccggtttgttgcgttcttcctggccggtcgcgtgaacgcaggtaagaGttggtgccgaaacccgggacgagaaaacctgggacgagaaatcctgggacgagaaaacctgggacggttaccatcaccggcacaaggaagatccctcattccggaaccagaactgcgggtcatggtaatgaagtgttcccgcaacacagactgttgagaaggatccagcgtgaattcagaactcttcagctggggaatggtggtaatgaagtgttcccgtaaaacagactgttgagaaggattcaactgcgtgaattcagaactcttcagctggggaatggtggtaatgaagtgttcccgtaaaacagactgttgagaaggattcaactgcgtgaattcagaactcttcagctggggaatggtggtaatgaagtgttcccgtaaaacagactgttgagaaggattcaactgcgtgaattcagaactcttcagctggggaacagggtacccgtaagtatagctttacaaggtaagtctggtcttgaactttctaac	599	50	8%	60	10%
19	41142901	41144250	cgagggtggttcttcactccatgtgctctgccttcctcgtgacgtcaactcggccgatgggctgcagccaatcaaggagtgacacgtcctaggcgaaggaaaattctccttaatagggacggggtttcgttttctctcgctcttgctttttacactcttgctcctgaagatgtaagcaataaagttttgccgcagaagattttggtttgttgcgtctttcctggccgggcgtgagaacgcgtctaataacaattggtgccgaattccgggacgagaaaaaactcgggactggcgcaaggaagatccctcattccagaaccagaactgcgggtcgcggtaataaaggttcccgtaaagcagactgttaagaaggattcaactgtatgaattcagaacttttcagctggggaacgagagtaccagtgagtatagctttacgaggtaagtctgatcttgaactttctaaggaaattcaagacagtctatcagaagtaaagtggaatatgtttggccttgaattttttctagtgttagaagcccttttgttccttttcacatgttatcaagtggttaaggcagggcggattctagatgaaattcaggacaagctatcagaagtaaagtggggagagagagtaggaacaaagaggaaatatggtacacaaaataagtatacaggcctttccaagggtcttgaacccgaggaaaagtttaggtcaggtaagaatacctggggagagattagaaggaaggaaaagaaaaaagaaaagaaaaaagatcgattagcggaggtctctaggagatactcgtcactagatgagctcaggaagccagctcttagtagctctgaagcagatgaagaattctcctctgaggaaacagactgggaggaagaagcagctcattatgagaaaaaagggtaccagccaggtaaagtgctagctaatcagttaaggaagccaaaagcggctggcgaaggccagtttgctgattggcctcagggcagtcggtttcaaggtccgccctatgcggagcccccgccctgcgtagtgcgtcagcaatgcgcagagagatgcacagagaggcagtgcgcagagaggcagtgcgcagactcattcattcccagagaggaacaaaggaaaatacaacaggcatttccagtctttgaaggagccgagggtgggcgtgtccacgctccggtagaatacttacaaattaaagaaattgccgagtcggtccgtaaatacggaaccaatgctaattttaccttggtgcagttagacaggcttgccggcatggcactaactcctgccgactggcaaacggttgtaaaagccgctctccctagt	1349	110	8%	152	11%
19	42346051	42346500	cgcatatgccgagggtggttctctactccatgtgctctgccttccccgtgacgtcaactcggccgatgggctgcagccaatcagggagtgacacgtcctaggcgaaggaaaattctccttaatagggacggggtttcgttttctctcgctcttgcttcttacactcctgctcctgaagatgtaagcaataaagttttgccgcagaagattctggtctgttgcgtctttcctggccggtcgtgagaacgcgtctaataacaattggtgccgaattccgggacgagaaaaaactcgggactggcgcaaggaagatccctcattccagaaccagaactgcgggtcgcggtaataaaggttcccgtaaagcagactgttaagaaggattcaactgtatgaattcagaacttttcagctggggaacgagagtaccagtgagtacagctttacga	449	56	12%	42	9%
19	44713201	44713350	tctccaccccatgtgctctgccttccccgtgacgacaactcggccgatgggctgcagccaatcagggagtgacacgtcctaggcggaggataattctccttaaaagggacggggttttgccattcgctctcttgctctcttgctctctg	149	16	11%	16	11%
19	46579951	46580700	atgccccgcccttttccctcctaacttccatactttgttctgcaacaagaaagcagtagcACCAGGATTGtaaggagaggagccatcgctctgtcccacctgatcacgtggctttaaggagaggagccatcgctgtgtcccacctgatcacgtggctttaaggagaggagccatcgctctgtcccacctgatcacgtggctttaaggagaggagccatcgctgtgtcccacctgatcacgtggctttaaggagaggagccatcgctgtgtcccacctgatcacgtggctttaaggagaggagccatcgctgtgtcccacctgatcacgtggctttaaggagaggagccatcgctgtgtcccacctgatcacgtggctttaaggagaggagccatcgctgtgtcccacctgatcacgtggctttaaggagaggagccatcgctgtgtcccacctgatcacgtggctttaaggagaggagccatcgctgtgtcccacctgatcacgtggctttaaggagaggagccatcgctgtgtcccacctgatcacgtggctttaaggagaggagccatcgctgtgtcccacctgatcacgtggctttaaggagaggagccatcgctctgtcccacctgatcacgtggctttaaggagaggagccatcgctgtgtcccacctgatcacgtggcttgcaggccttcggcgtgcaagagggatggatgagtttgcaaccacaaactaggaaaggcctcag	749	62	8%	106	14%
19	46752751	46753200	agtaacacacgtgtctgtaaacccttgggcaagtgtggcacagtaacacacgtgtctgtaaacccttgggcaagtgtgacacagtaacacacgtgtctgtaaacccttgggcaagtgtggcacagtaacacacgtgtctgtaaacccttgggcaagtgtgacacagtaacacacgtgtctgtaaacccttgggcaagtgtgacacagtaacacacgtgtctgtaaacccttgggcaagtgtgacacagtaacacacgtgtctgtaaacccttgggcaagtgtggcacagtaacacacgtgtctgtaaacccttgggcaagtgtgacacagtaacacacgtgtctgtaaacccttgggcaagtgtggcacagtaacacacgtgtctgtaaacccttgggcaagtgtgacacagtaacacacgtgtctgtaaacccttgggcaagtgtggc	449	22	5%	106	24%
19	50400901	50401350	acatcttcaggcatgagcgaagaccccctgctacagggaggattcagaactgcataacggggaagaaggggttaataaaggttcccgtgaaacagactgttgagaaggatccggcgtggattcagaactcttcagctggggaacggtactgatgaagagaaagaagaaagatgaagactgaataaactgctgttagaaggactggtggtcgcatcgttcttgctggtcgagagcaggcgcgacaattggtggcccgtacggggaaccgactcccccgccgagttcagaactttcagcagtcagtggttgccggcagggtaagttcacggtgagtgaaacttgcaaccccaggagtttgggaaggacctcggataaagtagaggtgagcataaagttgccaggaagtaggcataaagtaacccaggagtttgggaaggacctcggataaa	449	40	9%	48	11%
19	53286301	53287050	ACCAAAAGTCAATCTAAGCTTTAAAGAAAATCAAACCCAGTTAGGGACCAAGGGATGATAATGGGGGTAGGGAATAAAATACCTTGTTTTTTCTGATATGCAGAATCTTATCTTATACACCTATACTcacacacacacatacactcgcatacacacacacacatacatacatacatacatacatacactcacacacatacatgcacatatatacacatacacacatatacacatacactcacataaatatacacacatacatgcacatatacacacacacatacacgcataaataccaccacatacatacacatacactcacacacatacagtcacatacactcacatacatacacacacatatacacatacactcacacacatacatgcacatatatacacatacacacatatacacatactcacacacatacatgcacatatatacacatacacacatatacacatacactcacacacatacattcacacatacacacacacatacgctcactcacatacacatgcgtacactctctcacacacatatacactcatacatacatacacatacatgtgccacacacatgtgacatTAAAATTGTAGGGAACTATTTGCAAGAAGGCAGAAGAGACACACACGTGAGCAGCGGACAGTGACTTGACTGTATAAAAATGTCACAGAGAACCCACCATTTTGTATGCTAATAACTTTAGAAAGAGGAAGAAAAGAGCCGATTCTGATGTAA	749	14	2%	314	42%
19	54996151	54996300	actcattcattcccagagaggaacaaaggaaaatacaacaggcatttccggtctttgaaggagccgagggtgggcgtgtccacgctccggtagaatacttacaaattaaggaaattgccgagtcggttcgtaaatacggaaccaatgct	149	18	12%	20	13%
19	56339401	56339700	TATGGGCTCatgagtcagcgacttgatattcttgtatgtgtgtttgtgtgtgtatgcgtatgtgtgtgcagagtgtatgtatgcacgtgcaagcatgtgtatgtaaaatatgtgtacagtatgtgtgtctgtatgtacacactgtatatatgtacgtgcatgggtgtgtttacagtatgtatattcacatgcatgcatatttgtgtacagtgtgtacaatgtgtatgcatgtgtatgcatatttgtgtgcagtgtgtatgtattgcagtgtacatgcatgtgtgtacaatgtgtatata	299	8	3%	46	15%
19	59607151	59607300	atcatgtccctgcctctacattacgacaaaagtttaagctcacaagaaaagaagcccgagatattgtcctacggtgtggtaaatgtgtagaatttgttaacgcaccttccgtgggtgttaatcctcgcggattgcgacccctagatgtt	149	16	11%	12	8%
X	3216901	3217500	gggagtggacacagattgtcccatttctagaaaaacagtaaacacaacaagagcggacacgagactaagacaaaaaagaaatcagaaacagcagcaactctgcgtcgaccacaagcaactcaaagaatcagattgcctttctaaggccggccgattgagaccctctgcacgaggtgggactcgaacccacaatcccgtgaccaaacgcgaggtgggactcgaacgcacggtctcgcaacaaggcgcaaggtgggactcaaacccacgatctcgcaacaaaacgcgaggtgggactcgaacccacgatctcgcaactgggcacgaggtgggactcaaacccacgatctcgcaaccccaaatggtctcatggcctccaaaggggtccaccaggcgtccctgatcctcccctgttcctcctgaaacgtctcccagggtgaacggacagtggacacctggacacgtctatccttatccaccccgcgttccctcttggagcgcggtctcactgagcgtccgcaaaaccgaaactgcgatctcaccaaacttagaaacagaacacaaacagaccaaaacagaacaaaaaatcttacctctacgtg	599	78	13%	114	19%
X	3465901	3466200	gcctgcgcttgtgcagcttcgtgccaaagcgctctccattccatatatttgcccatactagggagagcggcttttacaaccgtttgccagtcagcaggagttagtgccatgccggcgagcctgtctaactgcaccaaggtaaaattagcattggttccatatttacggaccgactcggcaatttctttaatttgtaagtattctaccggagcgtggacacgcccaccctcggctccttcaaagaccggaaatgcctgttgtattttcctttgttcctctctgggaatgaatgagtctgc	299	30	10%	36	12%
X	3708001	3708150	actgcaccaaggtaaaattagcattaattccatatttacgaaccgattcggcaagttctttaatctgcacatattctaccggagcgtggacacgcccaccctcggctccttcaaagactggaaatgcctgttgtattttcctttgttcc	149	14	9%	20	13%
X	5197051	5197350	gaagcagatgaagaattctcctctgaagaaacagactgggaggaagaagcagctcattatgagaaaaaagggtaccagccaggtaaagtgctagctaatcagttaaggaagccaaaagcggctggcgaaggccagtttgctgattggcctcagggcagtcggcttcaaggtccgccctatgcggagtccccgccctgcgtagtgcgtcagccctgcgcagagaggcagtgcgcagagaggcagtgcgcagactcattcattcccagagaggaacaaaggaaaatacaacaggcatttcc	299	22	7%	50	17%
X	8518951	8519100	tggcgaaggccagtttgctaattggcctcagggcaatcggctaccaggtgcactcccgccctatgcggagtccccgccctgcgtagtgcgtcagcccgtagtgcgtcagcaatgcgcagagaggcagtgcgcagaaaggcagtgcgcag	149	24	16%	26	17%
X	13257601	13257900	tcccgggacgagaaaacctgggacaagaaacgtcttcaggcatgagcgaagaccccctgctacagggaggattcagaactgcataacggggaagaaggggttaataaagtgttcccgtgaaacagactgttgagaaggatccggcgtggattcagaactcttcagctggggaacggtactgatgaagagaaagaagaaagatgaagacggaataaactgctgttagaaggactggtggtcgcgtcgttcttgctggtcgagagcgggcgtgacaattggtggcccgtacggggaaccga	299	38	13%	20	7%
X	15399451	15400350	tgtattccacacggtcacccgtgcagcctgccctccgcggagtcccggagccaagaaggctcccgccggcgcctgtgccacaaacctctcaggccaggcagacccccgtgctctcaccaggaaggtggccggctgtctggagctgaagatggcgccgcccagaagctctttgactctctcgcccgtcccagaaacggctggcactctgtattccacacggtcacccgtgcagcctgccctccgcggagtcccggagccaagaaggctcccgccggcgcctgtgccacaaacctctcaggccaggcagacccccgtgctctcaccaggaaggtggccggctgtctggagctgaagatggcgccgcctagaagctctgcgactctctcgcccgtcccagaaacggctggcactctgtattccacacggtcacccgtgcagcctgccctccgcggagtcccggagccaagaaggctcccgccggcgcctgtgccacaaacctctcaggccaggcagacccccgtgctctcaccaggaaggtggccggctgtctggagctgaagatggcgccgcccagaagctctgcgactctctcgcccgtcccagaaacggctggcactctgtattccacacggtcacccgtgcagcctgccctccgcggagtcccggagccaagaaggctcccgccggcgcctgtgccacaaacctctcaggccaggcagacccccgtgctctcaccaggaaggtggccggctgtctggagctgaagatggcgccgcccagaagctctgcgactctctcgcccgtcccagaaacggctggcactctgtattccacacggtcacccgtgcagcctgccctccgcggagtcccggagccaagaaggctcccgccggcgcctg	899	142	16%	128	14%
X	18335401	18336750	cccgtgacgtcaactcggccgatgggctgcagccaatcagggagtgacacgtcctaggcgaaggagaattctctttaatagggacggggtttcgttttctctctctcttgcttctctctctcttgcttcttgcactctggctcctgaagatgtaagcaataaagttttgccgcagaagattctggtctgtggtgttcttcctggccggtcgtgagaacgcgtctaataacaattggtgccgaaacccgggacgagaaaaaaaaactcgggactggcgcaaggaagatccctcattccagaaccagaactgcgggtcgcggtaataaaggttcccgtaaagcagactgttaagaaggattcaactgtatgaattcagaacttttcagctggggaacgagagtaccagtgagtacagctttacgaggtaagtctgatcttgaactttctaaggaaattcaagatagtctatcagaagtaaagtggaaaatgtttggccttgaattttttctaatgttaggagcccttttgttccttttcacatgttatcaagtggttaagatagggaggattttagatgaaattcagggcaatctatcagaagtaaagcggggagagagagtaggagcaaagagaaaatatggtacacaaaataagcgtacaggcctttccaagggtcttgaacccgaggaaaagttaaggttaggtaggaatacctggagagagattagaagaaaaagaggaaaaagggaaaagaagaaagatcaattagcggaggtctctaggaaaaggagcctgtgctcatcgctggatgggctcggggagccagctcttagtagttctgaagcagatgaagaattctcctctgaggaaacagactgggaggaagaagcagcccattaccagccagctaattggtcaagaaaaaagccaaaagcggctggcgaaggccagtttgctgattggcctcagggcagtcggcttcaaggtccgccctatgcggagtccccgccctgcgtagtgcgtcagcaatgcgcagagaggcagtgcgcagagaggcagtgcgcagactcattcattcccagagaggaacaaaggaaaatacaacaggcatttccagtctttgaaggagccgagggtgggcgtgtccacgctccggtagaatacttacaaattaaagaaattgccgagtcggtccgtaaatacggaaccaatgctaattttaccttggtgcagttagacaggctcgccggcatggcactaactcctgccgactggcaaacggttgtaaaagccgctctccctagtatgggcaaatatatggaatggagagcgctttggcacgaagctgc	1349	112	8%	144	11%
X	23595301	23595900	ggcggcaactctgcgttgaccacaagcaactcaaagaatcagatggcctttctaaggccggccgattgagaccctctgcacgaggtgggactcgaacccacgatcccgtgaccaaacgcgaggtgggactcgaacccacggtctcgcaacaaggcgcaaggtgggactcaaacccacgatctcgcaaccccaaatggtctcttggcctccaaaggggtccaccaggcgtccctggtcctcccctgttcctcctgggacgtctcccagggtgaacggacggtggacacctggacacgtctatccttatccaccccgcgttccctctcggagcgcggtctcactgagcgtccgcaaaaccgaaactgcgatcgcaccaaacttagaaacagaacacaaacatcagaccaaaacagaacaaaaaatcttacctctaagtgggtctaggacctctgggtggtcgcgctgattcccggccaatgcaccaaaAtgaaagacccccgaagggagaccctcactcaagcactcaagccccgggacggccgcggacccaagaagacactgagaccgtactcaaaatgtagaaggcaagatttaataga	599	80	13%	94	16%
X	29631151	29631300	cagagaggcaatgcgcagagagatgcgcagagaggcaatgcgcagagagatgcgcagagaggcagtgcgcagagaggcagtgcgcagagaggcagtgcgcagactcattcattcccagagaggaacaaaggaaaatacaacaggcattt	149	14	9%	40	27%
X	29678701	29679000	agtgccatgccggcaagcctgtctaactgcaccaaggtaaaattagcattggttccatatttacggaccgactcggcaagctctttaatctgtaagtattctaccggagcgtggacacgcccaccctcggctccttcaaagactggaaatgcctgttgtattttcctttgttcctctctgggaatgaatgagtctgcgcactgcctctctgcgcattgtctctctgcgcactgcctctctgcgcatctctctgcgcattgcctctctgcgcatctctctgcgcattgcctctctgcgca	299	32	11%	36	12%
X	33356851	33357150	catcccgggtttcagcaccaaCtcttacacgcattcgcgacctgccaggaaagacgcagcaaaccagaatcttctgcggcaaaactttattgcttacatcttcaggagcaagagtgcaagagagcaagagctctattgcttacatctttaggagccagagcacaagagcgcaagagagagagtgcaagagcaaaagcaagagtgcaagagagagaatggcgaaaccccgtccctttttaaggagaattattctccgcctaggacgtattactccctgattggctgcagcccatcggccg	299	26	9%	54	18%
X	33495301	33495750	ggaagccaaaagcggctggcgaaggccagtttgctgattggcctcagggcagtcggtttcaaggtccgccctatgcggagcccccgccctgcgtagtgcgtcagcaatgcgcagagagatgcgcagagaggcaatgcgcagagagatgcgcagagaggcagtgcgcagagaggcagtgcgcagactcattcattcccagagaggaacaaaggaaaatacaacaggcatttccggtctttgaaggagccgagggtgggcgtgtccacgctccggtagaatacttacaaattaaagaactcgccgagtcggtccgtaaatacggaaccaatgctaattttaccttggtgcagttagacaggcttgccggcatggcactaactcctgccgactggcaaacggttgtaaaagccgctctccctagtatgggcaaatatatggaatggagagcg	449	58	13%	64	14%
X	33944551	33945750	tggacacgcccaccctcggctccttcaaagaccggaaatgcctgttgtattttcctttgttcctctctgggaatgaatgagtctgcgcactgcctctctgcgcagggctgacgcactacgcagggcggggactccgcatagggcggaccttgaagccgactgccctgaggccaatcagcaaactggccttcgccagccgcttttggcttccttaactgattagctagcactttacctggctggtacccttttttctcataatgagctgcttcttcctcccagtctgtttcttcagaggagaattcttcatctgcttcagagctactaagagctggctccccgagcccatccagcgatgagcacaggctccttttcctagagacctccgctaattgatctttcttcttttccctttttcctctttttcttctaatctctctccaggtattcctacctaaccttaacttttcctcgggttcaagacccttggaaaggcctgtatacttattttgtgtaccatatttcctctttgttcctactctctctccccgctttacttctgatagattgtcctgaatttcatctagaatccgccctgccttaaccacttgataacatgtgaaaaggaacaaaagggcttctaacactagaaaaaattcaaggccaaatataccttgcaaagccattttccactttacttctgatagactgtcttgaatttccttagaaagttcaagatcagacttacctcgtaaagctgtactcactggtactctcgttccccagctgaaaagttctgaattcatacagttgaatccttcttaacagtctgctttacgggaacctttattaccgcgacccgcagttctggttctggaatgagggatcttccttgcgccagtcccgagttttttctcgtcccggaattcggcaccaattgttattagacgcgttctcacgaccggccaggaaagacgcaacagaccagaatcttctgcggcaaaactttattgcttacatcttcaggagcaggagtgcaagaagcaagagagagagaaaacgaaaccccgtcccttttttaggagagttatatttcgcctaggacgtgtcactccctgattggctgcagcccatcggccgagttgacgtcacggggaaggcagagcacatggagtagagaaccaccctcggcatatgcg	1199	92	8%	132	11%
X	33944551	33945750	tggacacgcccaccctcggctccttcaaagaccggaaatgcctgttgtattttcctttgttcctctctgggaatgaatgagtctgcgcactgcctctctgcgcagggctgacgcactacgcagggcggggactccgcatagggcggaccttgaagccgactgccctgaggccaatcagcaaactggccttcgccagccgcttttggcttccttaactgattagctagcactttacctggctggtacccttttttctcataatgagctgcttcttcctcccagtctgtttcttcagaggagaattcttcatctgcttcagagctactaagagctggctccccgagcccatccagcgatgagcacaggctccttttcctagagacctccgctaattgatctttcttcttttccctttttcctctttttcttctaatctctctccaggtattcctacctaaccttaacttttcctcgggttcaagacccttggaaaggcctgtatacttattttgtgtaccatatttcctctttgttcctactctctctccccgctttacttctgatagattgtcctgaatttcatctagaatccgccctgccttaaccacttgataacatgtgaaaaggaacaaaagggcttctaacactagaaaaaattcaaggccaaatataccttgcaaagccattttccactttacttctgatagactgtcttgaatttccttagaaagttcaagatcagacttacctcgtaaagctgtactcactggtactctcgttccccagctgaaaagttctgaattcatacagttgaatccttcttaacagtctgctttacgggaacctttattaccgcgacccgcagttctggttctggaatgagggatcttccttgcgccagtcccgagttttttctcgtcccggaattcggcaccaattgttattagacgcgttctcacgaccggccaggaaagacgcaacagaccagaatcttctgcggcaaaactttattgcttacatcttcaggagcaggagtgcaagaagcaagagagagagaaaacgaaaccccgtcccttttttaggagagttatatttcgcctaggacgtgtcactccctgattggctgcagcccatcggccgagttgacgtcacggggaaggcagagcacatggagtagagaaccaccctcggcatatgcg	1199	92	8%	132	11%
X	51998101	51998400	gctgaaaagttctgaattcatacagttgaatccttcttaacagtctgctttacgggaacctttattaccgcgacccgcagttctggttctggaatgagggatcttccttgcgccagtcccgagttttttctcgtcccgggtttcggcaccaattgttattagacgcgttctcacgaccggccaggaaagacgcaacaaaccagaatcttctgcggcaaagctttattgcttacatcttcaggagccagagtgcaagagagcaagcaagcaaatggcgaaaccccatccctttttaagga	299	32	11%	42	14%
X	55537801	55538100	gtggaagggaccctatttggtgttactgacaacccctactgcggtaaaagttgacggaatcgcctcctggatccacgcctcccacgtcaagaggaccgccagccaagatgaagaaaaccacgacgacaattggacagtggcagccactgacaatcctcttaagcttcgtctgcgtcgcaggcgccactctagacctagggaaccttaaccctcatgctccaattcaacagtcctgggaggtgcttaatgaaaagggaaacattgtatgggcaaccactgcagtccatcccctctggact	299	24	8%	46	15%
X	58208551	58208700	agctttgacattgagtaacaatgtcacgggcttcttttcttgtcaaggagaaacgactgcgtaatgtttcagccgtcacatgaaaattgttatgaaaatttcttgcagcctctaccagggatgatagggcagcagccaccactttagtg	149	8	5%	26	17%
X	58218751	58219050	ggagttagtgccatgccggcaagcctgtctaactgcaccaaggtaaaattagcattggttccgtatttacggaccgactcggcaatttctttaatttgtaagtattctaccggagcgtggacacgcccaccctcggctccttcaaagaccggaaatgcctgttgtattttcctttgttcctctctgggaatgaatgagtctgcgcactgcctctctgcgcactgcctctctgcgcagggctgacgcactacgcagggcggggactccgcatagggcggaccttgaagccgactgccctg	299	38	13%	30	10%
X	61770601	61770900	agagctctccattccatatatttgcccatactagggagagcggcttttacaaccgtttgccagtcagcaggagttagtgccatgccggcgagcctgtctaactgcaccaaggtaaaattagcattggttccgtatttacggaccgactcggcaatttctttaatttgtaagtattctaccggagcgtggacacgcccaccctcggctccttcaaagaccggaaatgcctgttgtattttcctttgttcctctctgggaatgaatgagtctgcgcactgcctctctgcgcattgcctctc	299	30	10%	34	11%
X	61968751	61969350	caggaaggtggccggctgtctggagctgaagatggcgccgcccagaagctctgcgactctctcgcccgtcccagaaacggctggcactctgtattccacacggtcacccgtgcagcctgccctccgcggagtcccggagccaagaaggctcccgccggcgcctgtgccacaaacctctcaggccaggcagacccccgtgctctcaccaggaaggtggccggctgtctggagctgaagatggcgccgcccagaagctctgcgactctctcgcccgtcccagaaacggctggcactctgtattccacacggtcacccgtgcagcctgccctccgcggagtcccggagccaagaaggctcccgccggcgcctgtgccacaaacctctcaggccaggcagacccccgtgctctcaccaggaaggtggtcggctgtctggagctgaagatggcgccgcccagaagctctgcgactctctcgcccgtcccagaaacggctggcactctgtattccacacggtcacccgtgcagcctgccctccgcggagtcccggagccaagaaggctcccgccggcgcctgtgccacaaacctctcaggccagg	599	94	16%	86	14%
X	64632601	64633050	cggctggcactctgtattccacacggtcacccgtgcagcctgccctccgcggagtcccggagccaagaaggctcccgctggcgcctgtgccacaaacctctcaggccaggcagacccccgtgctctcaccaggaaggtggccggctgtctggagctgaagatggcgccgcccagaagctctgcgactctctcgcccgtcccagaaacggctggcactctgtattccacacggtcacccgtgcagcctgccctccgcggagtcccggagccaagaaggctcccgccggcgcctgtgccacaaacctctcaggccaggcagacccccgtgctctcaccaggaaggtggccggctgtctggagctgaagatggcgccgcccagaagctctgcgactctctcgcccgtcccagaaacggctggcactctgtattccacacggtcacccgtgca	449	68	15%	70	16%
X	64933801	64934400	tctgagtttggatccatctgagtttattgaatttgtgtcttggtttcagggttgcgagatcgtgggttccagtcccacctcgtgctttggtttcagggttacgagatcgtgggttcgagtcccaccttgtgccttggttttacacctggcagagtgaggaacaagtgtgcttCTCTGGTTTTGGTCGTCTAGGTAGAAGTGGACGACGGTGTTTGTAGACGATGGGGTGATGGGGTTTTCTGAAATGCGCGCGTCTGTATTTGCAGCTGTCCTTTTGGGCCGTAAGGACCGGAGGACTGTGGTCGGCAGACGTGCTAGGAGGACCACAGGCTGTGGCCCTGGGGGACGCCCTGGGAGGTAAGGAGAGCCAGGGATGCCTGGCCGTCTCCGGATCGGTCAGAGGGACCGAGTTCTGTTGAAGCGGAAGCTTCCCCCTCCAACATCGTCTAATTCTTTTGCCTGATTGTGGAGGACAAGAAAGGGTCGAGTGTGTCTGGATTTGTTGGTTTCTGTTTTAtgtgtttttgtgtacgtgtttagagctatgtgaaaatctagagaaacaaaggtaattctcataggtgctttataccctgact	599	52	9%	40	7%
X	65707051	65708100	gacgtcaactcggccgatgggctgcagccaatcagggagtgacacgtcctaggcgaaggagaattctccttaatagggacggggtttcgttttctctctctcttgcttcttacactcttgctcctgaagatgtaagcaataaagttttgccgcagaagattctggtctgttgtgttcttcctggccgggcgagagaacgcgtctaataacaattggtgccgaattccgggacgagaaaaaactcgggactggcgcaaggaagatccctcattccagaaccagaactgcgggtcgcggtaataaaggttcccgtaaagcagactgttaagaaggattcaactgtatgaattcagaacttttcagctggggaacgagagtaccagtgagtacagctttacgaggtaagtctgatcttgaactttctaaggaaattcaagacagtctatcagaagtaaagtggaatatgtttggccttgaattttttctggtgttaggagcccttctgttccttttcacatgttatcaagtgattaagatagggctgattctagaggaaattcaggacaagctatcagaagtaaagtggggagagagagtaggaacaaagaggaaatatggtacacaaaataagtatacaggcctttccaagggtcttgaacccgaggaaaagttaaggttaggtaggaatacctggagagagattagaagaaaaagaggaaaaagggaaaagaagaaagatcaattagcggaggtctctaggaaaaggagcctgtgctcatcgctggatgggctcggggagccagctcttagtagctctgaagcagatgaagaattctcctctgaagaaacagactgggaggaagaagcagctcattatgagaaaaaagggtaccagccaggtaaagtgctagctaatcagttaaggaagccaaaagcggctggcgaaggccagtttgctgattggcctcagggcagtcggcttcaaggtccgccctatgcggagtccccgccctgcgtagtgcgtcagccctgcgcagagaggcagtgcg	1049	74	7%	102	10%
X	65707051	65708100	gacgtcaactcggccgatgggctgcagccaatcagggagtgacacgtcctaggcgaaggagaattctccttaatagggacggggtttcgttttctctctctcttgcttcttacactcttgctcctgaagatgtaagcaataaagttttgccgcagaagattctggtctgttgtgttcttcctggccgggcgagagaacgcgtctaataacaattggtgccgaattccgggacgagaaaaaactcgggactggcgcaaggaagatccctcattccagaaccagaactgcgggtcgcggtaataaaggttcccgtaaagcagactgttaagaaggattcaactgtatgaattcagaacttttcagctggggaacgagagtaccagtgagtacagctttacgaggtaagtctgatcttgaactttctaaggaaattcaagacagtctatcagaagtaaagtggaatatgtttggccttgaattttttctggtgttaggagcccttctgttccttttcacatgttatcaagtgattaagatagggctgattctagaggaaattcaggacaagctatcagaagtaaagtggggagagagagtaggaacaaagaggaaatatggtacacaaaataagtatacaggcctttccaagggtcttgaacccgaggaaaagttaaggttaggtaggaatacctggagagagattagaagaaaaagaggaaaaagggaaaagaagaaagatcaattagcggaggtctctaggaaaaggagcctgtgctcatcgctggatgggctcggggagccagctcttagtagctctgaagcagatgaagaattctcctctgaagaaacagactgggaggaagaagcagctcattatgagaaaaaagggtaccagccaggtaaagtgctagctaatcagttaaggaagccaaaagcggctggcgaaggccagtttgctgattggcctcagggcagtcggcttcaaggtccgccctatgcggagtccccgccctgcgtagtgcgtcagccctgcgcagagaggcagtgcg	1049	74	7%	102	10%
X	66759301	66759900	gaagcagatgaagaattctcctctgaggaaacagactgggagaaagaagcagctcattatgagaaaaaagggtaccagccaggtaaagtgctagctaatcagttaaggaagccaaaagcggctggcgaaggccagtttgctgattggcctcagggcagtcggcttcaaggtccgccctatgcggagtccccgccctgcgtagtgcatcagccctgcgcagagaggcaatggacagagaggcaatgcacagactcgttcattccaaaggaggaacaaaggaaaatacaacaggcatttccggtctttgaaggagccgagggtgggcgtgtccacgctccggtagcgtatatacagattaaagagcttgccgagtcggtccgtaactatggagtcagtgctaatttcactatagcacaagtggaaaggcttgcgaatcacgctatgactcctggtgattggcaaacggttgtaaaagccgctctccctagtatgggcaaatatatggaatggagagcgctttggcacgaagctgcacaagcgcaggcccgagcaaacgcagctgctttgactccagagcagagagattggacttttgactt	599	54	9%	86	14%
X	68030551	68031150	acgtcaactcggccgatgggctgcagccaatcagggagtgacacgtccgaggcgaaggagaatgctccttaagagggacggggtttcgttttctctctctcttgcttcttgctctcttgcttcttgctctcttgcttcttacacgcttgctcctgaagatgtaagaaataaagctttgccgcagaagattctggtctgtggtgttcttcctggccggtcgtgagaacgcgtctaataacaattggtgccgaattccgggacgagaaaaaactcgggactggcgcaaggaagatccctcattccagaaccagaactgcgggtcgcggtaataaaggttcccgtaaagcagactgttaagaaggattcaactacatgaattcagaacttttcagctggggaacggtggataccagtaagtatagctttacgaggtacgcctggccttgaactttctaacgaaattcaagacagtctatcagaagtaaagtggggaatagctttacaaggtacgcctggccttgaactttctaacgaaattcaggacagtctatcagaagtaaagtggaaaatggctttacgaggtatgcttggccttaaac	599	60	10%	50	8%
X	70612951	70613250	tgcctacttcctggcaactttatgctcacctctattttatccgaggtccttcccaaactcctggggtcgcaagtttcactcaccgtgaacttaccctgccagcaaccactgactgctgaaagttctgaactcggtgggggagtcggttccccgtacgggccaccaattgtcgcgcccgctctcgaccagcaagaacgacgcgaccaccagtccttctaacagcagtttattcagtcctcatctctcttctttctcttcatcagtaccgttccccagctgaagagttctgaatccacgcc	299	32	11%	46	15%
X	72877651	72878850	gagagcggcttttacaaccgtttgccagtcagcaggagttagtgccatgccggcgagcctgtctaactgcaccaaggtaaaattagcattggttccatatttacggaccgactcggcaatttctttaatttgtaagtattctaccggagcgtggacacgcccaccctcggctccttcaaagactggaaatgcctgttgtattttcctttgttcctctctgggaatgaatgagtctgcgcattgcctctctgcgcagggctgacgcactacgcagggcggggactccgcatagggcggaccttgaagccgactgccctgaggccaatcagcaaactggccttcgccagccgcttttggcttccttaactgattagctagcactttacctggctggtacccttttttctcataatgagctgcttcttcctcccagtctgtttcctcagaggagaattcttcatctgcttcagagctactaagagctggcttcctgagctcatctagtgacgagtatctcctagagacctccgctaatcgatcttttttcttttcttttttcttttccttccttctaatctctccccaggtattcttacctgacctaaacttttcctcgggttcaagacccttggaaaggcctgtatacttattttgtgtaccatatttcctctttgttcctactctctctccccactttacttctgatagcttgtcctgaatttcatctagaatccgccctatcttaaccacttgataacatgtgaaaaggaacaaaagggcttctaacactagaaaaaattcaaggccaaacatattccactttacttctgatagactgtcttgaatttccttagaaagttcaagatcagacttacctcgtaaagctgtactcactggtactctcgttccccagctgaaaagttctgaattcatacagttgaatccttcttaacagtctgctttacgggaacctttattaccgcgacccgcagttctggttctggaatgagggatcttccttgcgccagtcccgagttttttctcgtcccggaattcggcaccaattgttattagacgcgttctcacgcccggccaggaagaacaccacagaccagaatcttctgcggcaaagctttattgcttacatcttcaggagccagagtgcaagaagcaagagagagagaaaacgaaacccgtcc	1199	88	7%	130	11%
X	74879701	74880000	agcactgcggcttatatacgtccgtctgatcgtgcttaacagcattcaaaactttttctttcagcgccacttctggtgagtgcaggatcaaaccgggagaaatagggttaacacagccagcatgagaacaaaaggctttcagttaaggggagggattaagaaggatcagagttacttacaaggattcagcatgctctcggaattccaaaatccaccgtggttctgaatctgctccggttggtcggagggtctcctctaggtgccgcgttgttaaggcgttttttcccgggtttcggcac	299	30	10%	42	14%
X	78888001	78888600	tgttgctgctttattaaatcttaccttctacattttatgtatggtctcagtgtcttcttgggtccgcggctgtcccgggacttgagtgcctgagtgagggtctcccttcgggggtctttcaTTTTGGTGCATTGGCCGGGAATcagcgcgaccacccagaggtcctagacccacttagaggtaagattctttgttctgttttggtctgatgtctgtgttctgtttctaagtttggtgcgatcgcagtttcggttttgcggacgctcagtgagaccgcgctccgagagggaacgcggggtggataaggatagacgtgtccaggtgtccaccgtccgttcaccctgggagacgtcccaggaggaacaggggaggaccagggacgcctggtggacccctttggaggccaagagaccatttggggttgcgagatcgtgggtttgagtcccacctcgtgcccagttgcgagatcgtgggttcgagtcccgcctcgcgttctgttgcgagatcatgggtttgagtcccacctctcgccttgttgcgagaccgtgggttcgagtcccacctcgcgtttggtcacgggatcgtgggttcgagtccca	599	82	14%	50	8%
X	79688701	79689000	gctctcttttcctgaagatgtaagaataaagctttgccgcagaagattctggtctgtggtgttcttcctggccggtcgtgagaacgcgtcgaataacaattggtgccgaattccgggacgagaaaatccgggacgagaaaaaactccggactggcgcaggagggatacttcattccagaaccagaactgcgaatcaaggttataaggttcccgtaacacagactgttgagaaggattcaactgccgaattcagaactcatcagctggggaacgacggtgataaaggttcccgtaaagca	299	38	13%	28	9%
X	81647851	81648300	aaaagccaaaagcggctggcgaaggccagttagctaattggcctcagggcaatcggctaccaggtgcactcccgccctatgcggagtccccgccctgcgtagtgcgtcagcccgtagtgcgtcagcaatgcgcagagaggcagtgcgcagactcattcattccccgagaggaacaaaggaaaatacaacaggcatttccagtctttgaaggagccgagggtgggcgtgtccacgctccggtagaatatgtgcagattaaatatggaatcaatgctaattttaccttggtgcagttagacaggcttgccagcatggcactaactcctgccgactggcaaatgattgcaaaagccgctctccctagtatggccaaatatgtggaatggcgagctctgtggcaggaggcggcacaggcgcaggcccgagcaaacgctgctgctttaactcca	449	48	11%	72	16%
X	82161301	82161450	tcattcttgcagcgtctcaccaatctctccggcacccaaagaggttccgtctggtccctgccggcaaccactgactgctgaaagttctgaactcggtgggggagtcggttccccgtacgggccaccaattgtcgcgcccgctctcgacc	149	24	16%	20	13%
X	95349751	95350650	aggctgtcccacgtagggatctatcccatttgtagacaacaaatccagacactattgctgatgccaagaagtgcttactgataggagcccagtatagctgaaccctgagaggctctgccagagtgttgggagccgcccccacattcgccgtcacaagatggcgctgacatcctgtgttctaagtggtaaacaaatgatctgcgcatgagccaagggtattttatgactacttgtactctacctttcccgtgaacgtcagctcggccatgggctgcagccaatcagggagtgatgcgtcctaggcgaaatataacgctcctaaaaaaggggacgggtttccgccattctctctcgctggcatctctctggctctgcgcgccctgcgctcgctcgctgcctaaagatgtaaacaatagagcgcgcgcgccggagctctggctcctaaagatgtaattgaaggggctttcgtttttggggctgggcgctgggcgcttgccctcctggctcccaaagatgtaagcaataaagttttgccgcagaagattctggtctgttgcgtctttcctggccgggcgtgagaacgcgtctaataagaattggtgccgaaacccaggacgagaaattccgggacgagaaaaaatccgggaagaaaaaacccgggaggaaactcgggacgggagtttcaccggcgcaaggaagatccctcattccagaaccagaactgcgggtcgcggtaataaaggttcccgtaaagcagactgttaagaaggattcaactacatgaattcagaacttttcagctggggaacggcggtaacccgtaagtatagctttacgaggtaagcctggccttgaactttctaaggaaattcaagacagtctatcagaagtaaagtgga	899	104	12%	84	9%
X	95354251	95354850	tgagcctaagagctaatcctgtacatggctcctttacctacacactggggatttgacctctatctccactctcattagttgggtggcctatttgctcttattaaaaggaaagggggagatgttgggagccgcccccacattcgccgtcacaagatggcgctgacatcctgtgttctaagtggtaaacaaatgatctgcgcatgagccaagggtattttatgactacttgtactctacctttcccgtgaacgtcagctcggccatgggctgcagccaatcagggagtgatgcgtcctaggcgaaatataacgctcctaaaaaaggggacgggtttccgccattctctctcgctggcatctctctggctctgcgcgccctgcgctcgctcgctgcctaaagatgtaaacaatagagcgcgcgcgccggagctctggctcctaaagatgtaattgaaggggctttcgtttttggggctgggcgctgggcgcttgccctcctggctcccaaagatgtaagcaataaagttttgccgcagaagattctggtctgttgtgtctttcctggccgggcgtgagaacgcgtctaaTAAGAccagagct	599	64	11%	50	8%
X	96348751	96349050	tctctaggagatactcgtcactagatgagctcaggaagccagctcttagtagttctgaagcagatgaagaatcctcctctgaggaaacagactgggaggaagaagcagcccattaccagccagctaatcggtcaagaaaaaagccaaaagcggctggcgaaggccagtttgctaattggcctcagggcaatcggctaccaggtgcactcccgccctatgcggagtccccgccctgcgtagtgcgtcagcccgtagtgcgtcagcaatgcgcagagaggcagtgcgcagaaaggcagtgc	299	28	9%	46	15%
X	110863201	110863350	agtgcaagaagcaagagagagagaaaacgaaaccccgtccctattaaggagaattctccttcgcctaggacgtgtcactccctgattggctgcagcccatcggccgagttgacgtcacggggaaggcagagcacatggagtagagaacc	149	16	11%	18	12%
X	110866501	110866800	tacaaccgtttgccagtcggcaggagttagtgccatgccggcaagcctgtctaactgcaccaaggtaaaattagcattggttccgtatttacggaccgactcggcaatttctttaatttgtaagtattctaccggagcgtggacacgcccaccctcggctccttcaaagaccggaaatgcctgttgtattttcctttgttcctctctgggaatgaatgagtctgcgcactgcctctctgcgcagggctgacgcactacgcagggcggggactccgcatagggcggaccttgaagccgac	299	40	13%	34	11%
X	114296101	114296700	gcctaggacgtgtcactccctgattggctgcagcccatcggccgagttgacgtcacggggaaggcagagcacatggagtgaagaaccaccctcggcacatgcgcagattatttgtttaccacttagaacacagctgtcagcgccatcttgtaacggcgaatgtgggcgcggctcccaacatctccccctttccttttaataagagcaaataggccacccatattaatgagagtggagatagaggtcaaatccccagtgtgtaggtaaaggagccatgtacaggattagctcttaggctcacaggcttttacccagagcaaccctgacctgctcccgtgtcgttttgcctgggggaagggaactaggacactgaaccttcatgaaagatgacatgtctccctagaataggctcatatatgccgcagagcctttccattgcagtgcttagccgtgcaactctctcgggctgctgaagcacactcactccatcccgtgcaatgagtctagcctcgtgagatgtaagagctgagtggccagcgacctattgcctaagcatagataaccatatatcagggggagctccatgttctagtcctgca	599	40	7%	96	16%
X	114301051	114301500	aattcatacagttgaatccttcttaacagtctgctttacgggaacctttattaccgcgacccgcagttctggttctggaatgagggatcttccttgcgccagtcccgagttttttctcgtcccggaattcggcaccaattgttattagacgcgttctcacgaccggccaggaaagacgcaacaaaccagaatcttctgcggcaaagctttattgcttacatcttcaggagccagagtgcaagaagcaagagagcaagaagcaagagagagagaaaacgaaaccccgtccctattttaggagagttatccctcgcctaggacgtgtcactccctgattggctgcagcccatcggccgagttgacgtcacggggaaggcagagcacatggagtgaagaaccaccctcggcacatgcgcagattatttgtttaccacttagaacacagctgt	449	50	11%	68	15%
X	118412101	118412700	ctgcgcttgtgcagtttcatgccaaagagctctccattccatatatttgcccatactagggagagcggcttttacaaccgtttgccagtcggcaggagttagtgccatgccggcaagcctgtctaactgcaccaaggtaaaattagcattggttccgtatttacggaccgactcggcaagttctttaatttgtaagtattctaccggagcgtggacacgcccaccctcggctccttcaaagaccggaaatgcctgttgtattttcctttgttcctctctgggaatgaatgagtctgcgcactgcctctctgcgcattgtctctctgcgcactgcctctctgcgcatctctctgcgcattgcctctctgcgcatctctctgcgcattgctgacgcactacgcagggcgggggctccgcatagggcggaccttgaaaccgactgccctgaggccaatcagcaaactggccttcgccagccgcttttggcttccttaactgattagctagcactttacctggctggtacccttttttctcataatgagctgcttcttcctcccagtctgtttcttcagaggagaattcatcatctgattcag	599	58	10%	78	13%
X	119590501	119590950	tgatagactgtcttgaatttcgttagaaagttcaaggccagacttaccttgtaaagctatacttacgggtaccctgttccccagctgaagagttctgaattcacgcagttgaatccttctcaacagtctgtgatgcgggaacactttattaccaccgttccccagctgaagagttctgaattcacgcagttgaatccttctcaacagtctgttttacgggaacctttatgaccgtgacccgcagttctggttccggaatgaggaatcttccttgcgccggtgatggttaactcccgtcccgagttttcttgtcccgggttttttcttcccggattttctcgtcccggattttctcgtcccggatttcagcaccaaCtcttacacgcgttcacgcgaccggccaggaaggacgcaacaaaccggaatcttctgcggcaaaactttattgc	449	56	12%	48	11%
X	119681701	119682900	ttctaccggagcgtggacacgcccaccctcggctccttcaaagaccggaaatgcctgttgtattttcctttgttcctctctgggaatgaatgagtctgcgcactgcctctctgcgcactgcctctctgcgcatctctctgcgcattgctgacgcactacgcagggcggggactccgcatagggcggaccttgaagccgactgccctgaggccaatcagcaaactggccttcgccagccgcttttggcttttttcttgaccaattagctggctggtaatgggctgcttcttcctcccagtctgtttcctcagaggaggattcttcacctgcttcagagctactaagagctggcttcccgagcccatccagcgatgagcacaggctccttttcctagagacctccgctaattgatctttcttcttttccctttttcctctttttcttctaatctctctccaggtattcctaccttaccttaacttttcctcgggttcaagacccttggaaaggcctgtatacttattttgtgtaccatatttcctctttgctcctactctctctccccgctttacttctgatagcttgtcctgaatttcatctagaatcctccctatcttaaccacttgataacatgtgaaaaggaacaaaagggctcctaacaccagaaaaaattcaaggccaaacatattccactttacttctgatagactgtcttgaatttcgttagaaagttcaagatcagacttacctcgtaaagctgtactcactggtactctcgttccccagctgaaaagttctgaattcatacagttgaatccttcttaacagtctgctttacgggaacctttattaccgcgacccgcagttctggttctggaatgagggatcttccttgcgccagtcccgagttttttctcgtcccggaattcggcaccaattgttattagacgcgttctcacgaccggccaggaagaacaccacagaccagaatcttctgcggcaaagctttatttcttacatcttcaggagccagggtgcaggaagcaagagagcaagaagcaagagaggaagaaaacgaaaccccgtccctcttaaggagcattaacttcgcctcggacgtgtcactccctgattggctgcagcccatcggccgagttgacgtcacggggaaggcagagcacaagtagtcataagatac	1199	96	8%	140	12%
X	119854951	119855700	GGTCTGCAGGGCAGGACAAAATCCTGTTCCCATTGTGAATTATGTGGTGTGTGTAAAGCAACCCCTCGCCTGGAGTCTGATAGCTGTCttatacgcgttctcacgcccggccaggaaagaacacaacaaaccagaatcttctgcggcaaaactttattgcttacatcttcaggagccaggagcgcaaacccccagccccaaaagcgaaagccaccccaataacgaaaccgaaaccccttccctatttaggagagttatatttcgcctaggacgcatcactccctgattggctgcagcccatggccgagctgacgttcacgggaaaggcagagtacaagtagtcgtaaaatacccttggcacatgcgcagattatttgtttaccacttagaacacaggatgtcagcgccatcttgtgacggcgaatgtgggggcggctcccaacatctcccccttttcttttaataagagcaaataggccacccatattaatgagagtggagatagaggtcaaatccccagtgtgtaggtaaaggagccatgtacaggattagctcttaggctcacaggcttttacccagagcaaccctgacctgctcccgtgtcgttttgcctggagagaaggacacttggacactcaaccttcttgaaagatgacatgtctccctagaataggctcatatatgccgcagagcccttctactgcagtgcttagccgtgcaactctctcgggctgctgaagcacactcac	749	52	7%	118	16%
X	121556851	121557150	gctttacgggaacctttattaccgcgacccgcagttctggttctggaatgagggatcttccttgcgccagtcccgagttttcttgtatttttttgtcccaggattttctcgtcccggaatttctcgtcccgggtttcggcaccaattcttaatAgcgttctcacgcgaccggccaggaaagacgcaacaaaccaaaatcttttgcggcaaaactttattgcttacatctttgggagccaggagggcaagcgcccagcgcccagccccaaaaacgaaagccccttcaataatgaaaccga	299	42	14%	36	12%
X	123258901	123259350	aacaagtcaaaagtccaatctctctgctctggagtcaaagcagctgcgtttgctcgggcctgcgcttgtgcagcttcgtgccaaagcgctctccattccatatatttgcccatactagggagagcggcttttacaaccgtttgccagtcagcaggagttagtgccatgccggcgagcctgtctaactgcaccaaggtaaaattagcattggttccgtatttacggaccgactcggcaatttctttaatttgtaagtattctaccggagcgtggacacgcccaccctcggctccttcaaagaccggaaatgcctgttgtattttcctttgttcctctctgggaatgaatgagtctgcgcactgcctctctgcgcactgcctctctgcgcagggctgacgcactacgcagggcggggactccgcatagggcggaccttgaagccgactgcc	449	54	12%	56	12%
X	123260101	123260550	tgttattagacgcgttctcacgaccggccaggaaagacgcaacaaaccagaatcttctgcggcaaagctttattgcttacatcttcaggagccagagtgcaagaagcaagagagcaagaagcaagagagagagaaaacgaaaccccgtccctattttaggagagttatccctcgcctaggacgtgtcactccctgattggctgcagcccatcggccgagttgacgtcacggggaaggcagagcacatggagtgaagaaccaccctcggcacatgcgcagattatttgtttaccacttagaacacagctgtcagcgccatcttgtaacggcgaatgtgggcgcggctcccaacaGGTATGTATAGATTACATGTGGATTTATTCTCTACAATAACTAGGTATGTATAGATTATATATGATTCATTTGTTCTATATAGTAACCAGGCATGT	449	42	9%	72	16%
X	126144601	126145050	ctaattggtcaagaaaaaagccaaaagcggctggcgaaggccagtttgctgattggcctcagggcagtcggcttcaaggtccgccctatgcggagtccccgccctgcgtagtgcgtcagcaatgcgcagagaggcagtgcgcagagaggcagtgcgcagactcattcattcccagagaggaacaaaggaaaatacaacaggcatttccggtctttgaaggagccgagggtgggcgtgtccacgctccggtagaatacttacaaattaaggaaattgccgagtcggttcgtaaatacggaaccaatgctaattttaccttggtgcagttagacaggctcgctggcatggcactaactcctgccgactggcaaacggttgtaaaagccgctctccctagtatgggcaaatatatggaatggagagcgctttggcacgaagctgcacaagcg	449	54	12%	64	14%
X	137694901	137695500	tccctgacccgttaacaagtcaaaagtccaatctctctgctctggagtcaaagcagctgcgtttgctcgggcctgcgcttgtgcagcttcgtgccaaagcgctctccattccatatatttgcccatactagggagagcggcttttacaaccgtttgccagtcggcaggagttagtgccatgccagcgagcctgtctaactgcaccaaggtaaaattagcattggttccgtatttacgaaccgactcggcaatttccttaatttgtaagtattctaccggagcgtggacacgcccaccctcggctccttcaaagaccggaaatgcctgttgtattttcctttgttcctctctgggaatgaatgagtctgcgcactgcctctctgcgcactgcctctctgcgcattgctgacgcactacgcagggcggggactccgcatagggcggaccttgaagccgactgccctgaggccaatcagcaaactggccttcgccagccgcttttggcttttttcttgaccaattagctggctggtaatgggctgcttcttcctcccagtctgtttcctcagaggaggattcttcacctgcttcagagctac	599	60	10%	74	12%
X	137967001	137967300	cctgtctaactgcaccaaggtaaaattagcattggttccgtatttacggaccgactcggcaatttctttaatttgtaagtattctaccggagcgtggacacgcccaccctcggctccttcaaagaccggaaatgcctgttgtattttcctttgttcctctctgggaatgaatgagtctgcgcactgcctctctgcgcactgcctctctgcgcattgctgacgcactacgcagggcggggactccgcatagggcggaccttgaagccgactgccctgaggttgaacagtacgctggcttt	299	38	13%	28	9%
X	140896351	140896650	cagcttcgtgccaaagcgctctccattccatatatttgcccatactagggagagcggcttttacaaccgtttgccaatcaccaggagtcatagcgtgattcgcaagcctttccacttgtgctatagtgaaattagcactgactccatagttacggaccgactcggcaagctctttaatctgtatatacgctaccggagcgtggacacgcccaccctcggctccttcaaagaccggaaatgcctgttgtattttcctttgttcctcctttggaatgaacgagtctgtgcattgcctctct	299	32	11%	38	13%
X	143178301	143179500	gtgccatgccagcaagcctgtctaactgcaccaaggtaaaattagcattggttccgtatttacgaaccgactcggcaatttccttaatctgtacgtattctaccggagcgtggacacgcccaccctcggctccttcaaagactggaaatgcctgttctattttcctttgttcctctcggggaatgaatgagtctgcgcactgcctctctgcgcattgctgacgcactacgggctgacgcactacgcagggcggggactccgcatagggcgggagtgcacctggtagccgattgccctgaggccaattagcaaactggccttcgccagccgcttttggcttttttcttgaccgattagctggctggtaatgggctgcttcttcctcccagtctgtttcctcagaggaggattcttcatctgcttcagaactactaagagctggcttcctgagctcatctagtgacgagtatctcctagagacctccgctaatcgatcttttttcttctccctttttcctctttttcttctaatctctctccaggtattcctacctaaccttaacttttcctcgggttcaagacccttggaaaggcctgtatacttaccgtttctccttgctcctactctctctctccgctttacttctgatagactgtcctgaatttcctctagaatttttagccctgccttaagcactatataacatgtgaaaaggaacaaaagggctcctaacaccagaaaaaattcaaggccaaacatactcactggtactctcgttccccagctgaaaagttctgaattcatacagttgaatccttcttaacagtctgctttacgggaacctttatcaccgtcgttccccagctgatgagttctgaattcggcagttgaatccttctcaacagtctgtgttacgggaaccttataaccttgattcgcagttctggttctggaatgaggtatccctcctgcgccagtccggagttttttctcgtcccggattttctcgtcccggaattcggcaccaattgttattagacgcgttctcacgaccggccaggaagaacaccacagaccagaatcttctgcggcaaagctttattcttacatcttcaggaaaagagagcaagaagcaagagagagagaaaacgaaaaccccgtccctcttaaggagcattctccttcgcctcggacgtgt	1199	106	9%	122	10%
X	152894701	152896200	gcccccacattcgccgttacaagatggcgctgacatcctgtgttctaagtggtaaacaaataatctgcgcatgtgccaagggtatcttatgactacttgtgctctgccttccccgtgacgtcaactcggccgatgggctgcagccaatcagggagtgacacgtccgaggcgaaggagaatgctccttaagagggacggggtttcgttttctctctctcttgcttcttgctctcttgcttcctgcaccctggctcctgaagatgtaagaaataaagctttgccgcagaagattctggtctgtggtgttcttcctggccggtcgtgagaacgcgtctaataacaattggtgccgaattccgggacgagaaaaaactcgggactggcgcaaggaagatccctcattccagaaccagaactgcgggtcgcggtaataaaggttcccgtaaagcagactgttaagaaggattcaactgtatgaattcagaacttttcagctggggaacgagagtaccagtgagtacagctttacgaggtaagtccgatcttgaactttctaacgaaattcaagacagtctatcagaagtaaagtggaatatgtttggccttgaattttttctggtgttaggagcccttttgttccttttcacatgttatcaagtgattaagatagggctgaaaattctagaggaaattcaggacaagctatcagaagtaaagcggggagagagagtaggaacaaagaggaaatatggtacacaaaataagtatacaggcctttccaagggtcttgaacccgaggaaaagttaaggttaggtaggaatacctggagagagattagaagaaaaagaggaaaaagggaaaagaagaaagatcaattagcggaggtctctaggagatactcgtcactagatgagctcaggaagccagctcttagtagttctgaagcagatggagaattctcctctaaggaaacagactgggaggaagaagcagcccattaccagccagctaattggtcaagaaaaaagccaaaagcggctggcgaaggccagtttgctgattggcctcagggcagtcggcttcaaggtccgccctatgcggagtccccgccctgcgtagtgcgtcagcaatgcgcagagaggcagtgcgcagagaggcagtgcgcagactcattcattcccagagaggaacaaaggaaaatacaacaggcatttccggtctttgaaggagccgagggtgggcgtgtccacgctccggtagaatacttacaaattaaggaaattgccgagtcggttcgtaaatacggaaccaatgctaattttaccttggtgcagttagacaggctcgctggcatggcactaactcctgccgactggcaaacggttgtaaaagccgctctccctagtatgggcaaatatatggaatggagagcgctttggcacgaagctgcacaagcgcaggcccgagcaaacgcagctgctttgactccagagcagag	1499	128	9%	172	11%
X	152909851	152910150	TTGCCACTGAACTTTTTCTCCAATTCACGAACTAGCCGGACTTGGATTTTCTGGAAAGATTTAAGCTGAGGAACTGGTACAAAAATTATGATAGCTTTCCGACCACCACCAACTTCGATTTCCTTGGCTGCGGTGATGTTGAGTTCACGCAGCTGCGCCTTGAGATCGGAGTTCATCTCCAGCTCGAGCAGCGCCTGAGAGATGCCAGACTCGAACTCGTCTGGCTTCTCGCCATTGGGCTTCCCGATCTTGGCGCTCGAGCTGAACATGGCTTCACCCTGACGGATCGCTGGCTTAGA	299	36	12%	32	11%
X	155778901	155779050	ctccttaagagggacggggtttcgttttctctctctcttgcttcttgctctcttgcttcttgcactcttgctcctgaagatgtaagcaataaagctttgccgcagaagattctggtctgtggtgttcttcctggccgggcgtgagaacg	149	12	8%	6	4%
X	156579901	156581100	aagatggcgctgacagctgtgttctaagtggtaaacaaataatctgcgcatgtgccgagggtggttcttcactccatgtgctctgccttccccgtgacgtcaactcggccgatgggctgcagccaatcagggagtgacacgtcctaggcgaaggataattctccttaatagggacggggtttcgttttctctctctcttgcttcttacactcttgctcctgaagatgtaagcaataaagttttgccgcagaagattctggtttgttgcgtctttcctggccggtcgtgagaacgcgtctaataacaattggtgccgaattccgggacgagaaaaaactcgggactggcgcaaggaagatccctcattccagaaccagaactgcgggtcgcggtaataaaggttcccgtaaagcagactgttaagaaggattcaactgtatgaattcagaacttttcagctggggaacgagagtaccagtgagtatagctttacgaggtaagcctggccttgaactttctaaggaaattcaagacagtctatcagaagtaaagtggaaaatgtttggccttgaattttttctagtgttagaagcccttttgttccttttcacatgttatcaagtggttaaggcagggaggattctagaggaaattcaggacaagctatcagaagtaaagtggggagagagagtaggaacaaagaggaaatatggtacacaaaataagtatacaggcctttccaagggtcttgaacccgaggaaaagttaaggttaggtaggaatacctggagagagattagaagaaaaagaggaaaaagggaaaagaagaaagatcaattagcggaggtctctaggaaaaggagcctgtgctcatcgctggatgggctcggggagccagctcttagtagctctgaagcagatgaagaattctcctctgaagaaacagactgggaggaagaagcagctcattatgagaaaaaagggtaccagccaggtaaagtgctagctaatcagttaaggaagccaaaagcggctggcgaaggccagtttgctgattggcctcagggcagtcggcttcaaggtccgccctatgcggagtccccgccctgcgtagtgcgtcagccctgcgcagagaggcaatgcgcagagaggcagtgcgcagactcattcattcccagagaggaacaaaggaaaataca	1199	86	7%	128	11%
X	157624351	157624650	tagggagagcggcttttacaaccgtttgccagtcggcaggagttagtgccatgccggcaagcctgtctaactgcaccaaggtaaaattagcattggttccgtatttacggaccgactcggcgagttctttaatttgtaagtattctaccggagcgtggacacgcccaccctcggctccttcaaagactggaaatgcctgttgtattttcctttgttcctctctgggaatgaatgagtctgcgcactgcctctctgcgcactgcctctctgcgcagggctgacgcactacgcagggcagg	299	36	12%	34	11%
X	159151051	159151350	aaaagcggctggcgaaggccagtttgctgattggcctcagggcagtcggcttcaaggtccgccctatgcggagtccccgccctgcgtagtgcgtcagccctgcgcagagaggcagtgcgcagactcattcattcccagagaggaacaaaggaaaatacaacaggcatttccggtctttgaaggagccgagggtgggcgtgtccacgctccggtagaatacttacaaattaaagaaattgccgagtcggtccgtaaatacggaaccaatgctaattttaccttggtgcagttagacaggc	299	38	13%	40	13%
X	162185701	162185850	ttttctctctctcttgcttcttacactcttgctcctgaagatgtaagcaataaagttttgccgcagaagattctggtttgctgcgtctttcctggccggtcgcgtgagaacgcgtctaataacagctaatatcttcaacaaaataatag	149	14	9%	12	8%
X	164890951	164891100	aaaagctttattgcttgcttctcaggaagattccgaaccaggaaaatggcgctgcttttataacccgcagcgtgacgtttcagcacctgatatggcgtgacagctcccaattcgttgcttgcccatcaccccactattacaccccgaga	149	16	11%	22	15%
X	165869851	165870150	ggatggggtttcgccatttgctggcttgctctcttgcactctggctcctgaagatgtaagcaataaagctttgccgcagaagattctggtttgttgcgtctttcctggccggtcgtgagaacgcgtctaataacaATTGGTGCCGaaacccgggacgagaaaaaactcgggactggcgcaaggaagatccctcattccagaaccagaactgcgggtcgcggtaataaaggttcccgtaaagcagactgttaagaaggattcaactgcatgaattcagaacttttcagctggggaacgag	299	34	11%	28	9%
X	169983151	169983300	TTTGTGTAAACAGAATTACTTGCATTTTAGCACCCGCTAGATTGTTCTGCTGTCAGTCACTTTCCAAATGAACTCAAGAGCACACAGGAGACAGACACACATACCTTGCTTTACGCTTTATACAAGGGAGCACTCACCAGAAAATCTGA	149	4	3%	36	24%
X	169984801	169986150	CGCTCAGAAAAATCAACAACAGATAAACCAAGAAAACATTCTTTAAGTAGACGGCTAAGCGCTCTGGAACCAAAACCTCCTGTTAGTAAATGTGCTAGACCTGTTTAGGAAGAAGACCTGCTTCGACAGTCGAATACCTCCAAATTGTCGTCCTAATGGTATCTGCTGCTCCGCTGACATGCGTGTGATGTCCACAGCTCCCAACCCTCCCGCGATTAGAGAAGAGCTCTGCACCGCTTCCTACGACACCATCACCGTCCACTGGACCTCAGAGGACGAGTTCAGCGTGGTCTCCTACGAGCTCCAGTACACCATATTCACCGGACAAGCCAATGTTGTCAGTGAGTATCTCTCGGCTGATTCCCTTCCGCGTTCGACGACTGTTTTCAGATGAGCTGGGTGAAGGGATCTCAACACAGAAAGGAGATGATGAGGACTGAACATGATGACAATATTTATCGGCTTCTCTTTCCTGTTCAAGGAATGGATAATGCTCACTTGTATCGCAGTCATGAGAACAGCTGACTAAATACCCATGAAATTAACAACCTCCGGAAAACCACATGGATGTAGttttttttttttttttttaaagatttatttattattatatgtaagtacactgtagctgtcttcagacactccagaagagggagtcagatcttgttacagatggttgtgagccaccatgtggttgctgggatttgaactctggaccttcggaagagcagtcgggtgctcttacccactgagccatctcaccagcccGGATGTAGTTTTAAAAAAGAAGCCGGTAACCACATACACACTGTGAATCCATTGATCACCTCATAACATAGATATCCAAACTCAACCACTCTTACGTAAAATGTATTATCAGAGGTTAAAATTGTAGATATTAATTAGGATTGTTTGTACGGAATAGAGAAAAGTGTGGCAGAAAAGCGGAACGCGCAAAGAGGACGTATATGATACGAAGTGAACTCTCCATAGAGGTAGCACGCTGAGCAGTATTTTATTGATCAAGCCGCATAAAAAGCCAGAAAGCTCTCCGTTTTCCAATGTTCAATGTCCAAATAATCTGCCATTCTGCAGACGTGGCCTGTGACGGCACCTGTCTCCTCGGCTCCGCAGGTCTGTGTAACTCGGCGGACAGCTGGATGATCGTGCCCAACATCAAGCAGAACCACTACACCGTGCACGGCCTGCAAAGTGGCACCAAGTATATCTTCACGGTGAAGGCCATCAACCAGGCGGGCAGCCGTAGCAGCGAGCCCGGAAAGCTGAAGACCAACAGTGAGTGCTGTGGACTCGGCTGAGCTGCCAGCTTACActgcctcagaaaatca	1349	106	8%	210	16%
X	169984801	169986150	CGCTCAGAAAAATCAACAACAGATAAACCAAGAAAACATTCTTTAAGTAGACGGCTAAGCGCTCTGGAACCAAAACCTCCTGTTAGTAAATGTGCTAGACCTGTTTAGGAAGAAGACCTGCTTCGACAGTCGAATACCTCCAAATTGTCGTCCTAATGGTATCTGCTGCTCCGCTGACATGCGTGTGATGTCCACAGCTCCCAACCCTCCCGCGATTAGAGAAGAGCTCTGCACCGCTTCCTACGACACCATCACCGTCCACTGGACCTCAGAGGACGAGTTCAGCGTGGTCTCCTACGAGCTCCAGTACACCATATTCACCGGACAAGCCAATGTTGTCAGTGAGTATCTCTCGGCTGATTCCCTTCCGCGTTCGACGACTGTTTTCAGATGAGCTGGGTGAAGGGATCTCAACACAGAAAGGAGATGATGAGGACTGAACATGATGACAATATTTATCGGCTTCTCTTTCCTGTTCAAGGAATGGATAATGCTCACTTGTATCGCAGTCATGAGAACAGCTGACTAAATACCCATGAAATTAACAACCTCCGGAAAACCACATGGATGTAGttttttttttttttttttaaagatttatttattattatatgtaagtacactgtagctgtcttcagacactccagaagagggagtcagatcttgttacagatggttgtgagccaccatgtggttgctgggatttgaactctggaccttcggaagagcagtcgggtgctcttacccactgagccatctcaccagcccGGATGTAGTTTTAAAAAAGAAGCCGGTAACCACATACACACTGTGAATCCATTGATCACCTCATAACATAGATATCCAAACTCAACCACTCTTACGTAAAATGTATTATCAGAGGTTAAAATTGTAGATATTAATTAGGATTGTTTGTACGGAATAGAGAAAAGTGTGGCAGAAAAGCGGAACGCGCAAAGAGGACGTATATGATACGAAGTGAACTCTCCATAGAGGTAGCACGCTGAGCAGTATTTTATTGATCAAGCCGCATAAAAAGCCAGAAAGCTCTCCGTTTTCCAATGTTCAATGTCCAAATAATCTGCCATTCTGCAGACGTGGCCTGTGACGGCACCTGTCTCCTCGGCTCCGCAGGTCTGTGTAACTCGGCGGACAGCTGGATGATCGTGCCCAACATCAAGCAGAACCACTACACCGTGCACGGCCTGCAAAGTGGCACCAAGTATATCTTCACGGTGAAGGCCATCAACCAGGCGGGCAGCCGTAGCAGCGAGCCCGGAAAGCTGAAGACCAACAGTGAGTGCTGTGGACTCGGCTGAGCTGCCAGCTTACActgcctcagaaaatca	1349	106	8%	210	16%
X	169987051	169987950	CGATGGAAAACGCGACCGCCTCGCCGGGTCGGATCCGCCAGCCTGGCCGGCTCCCCCTCACCCTGGCCGGGATGAAGCAGGCAGATCCGACCCCTTTGGTGGAAGTTTTTTCCCGGCGTGCTCTCTGTCGCCACCCGGTGGTGACAGAGGAGAATGCGGTGGTCGTGACCGTTCGATTTTCCTTTTTTTCAAAGGACACTTGTTTTTGGTTTCCGTGAGCGTTGATTCTTTTTCAAAGCATCTACGCGCACGTTCGTTTTTCTTTTATTATCGTTGATGGCTCACCACTCTTTGCATATGTGTGAACCCAGAATATGTCAACTCTGCTTATTATGTGTATTAATAAATCCAAATATAGAGAACCTAGGCGTTGCTGTCGGCATTTAGGCAGCTCTCTCCCTTCAGCCCTTGTTTCAGACTCTTAAATGTAAATGAGGTTACGCTCCCTGTCATCTTTCCAGTCAACCGTGCTCTTGGTGTCTCTCTCTCTGGTGAACTCGCCTTCAGGTCAGCCGTTTAGACTGGATCCCAAATCGGCTCATCGCAAGCTGAAGGTGTCCCACGACAACCTGACTGTCGAGCGCGACGAGTCGTCCTCTAAGAAGAGTCACGCGCCGGAGCGCTTCGCTGGTCAGGGGAGCTACGGAGTGGCTGGCAACGTGTTCATCGACAGCGGCCGTCACTACTGGGAAGTGGTCACCAGCGGAAGCACATGGTAGGCCGTCTCCGTCTGGATCCgtctgtctgtccctgtgtgtccatctgtcttctgtccatctgtccacctgtcctctgtctgtccatccgtctacctgtctgcccttctctctgtctgtttctgtccatcagtctgtctgctcttctgtccatctgtctgtccatcttttgtctatctgtcc	899	108	12%	98	11%
X	169987051	169987950	CGATGGAAAACGCGACCGCCTCGCCGGGTCGGATCCGCCAGCCTGGCCGGCTCCCCCTCACCCTGGCCGGGATGAAGCAGGCAGATCCGACCCCTTTGGTGGAAGTTTTTTCCCGGCGTGCTCTCTGTCGCCACCCGGTGGTGACAGAGGAGAATGCGGTGGTCGTGACCGTTCGATTTTCCTTTTTTTCAAAGGACACTTGTTTTTGGTTTCCGTGAGCGTTGATTCTTTTTCAAAGCATCTACGCGCACGTTCGTTTTTCTTTTATTATCGTTGATGGCTCACCACTCTTTGCATATGTGTGAACCCAGAATATGTCAACTCTGCTTATTATGTGTATTAATAAATCCAAATATAGAGAACCTAGGCGTTGCTGTCGGCATTTAGGCAGCTCTCTCCCTTCAGCCCTTGTTTCAGACTCTTAAATGTAAATGAGGTTACGCTCCCTGTCATCTTTCCAGTCAACCGTGCTCTTGGTGTCTCTCTCTCTGGTGAACTCGCCTTCAGGTCAGCCGTTTAGACTGGATCCCAAATCGGCTCATCGCAAGCTGAAGGTGTCCCACGACAACCTGACTGTCGAGCGCGACGAGTCGTCCTCTAAGAAGAGTCACGCGCCGGAGCGCTTCGCTGGTCAGGGGAGCTACGGAGTGGCTGGCAACGTGTTCATCGACAGCGGCCGTCACTACTGGGAAGTGGTCACCAGCGGAAGCACATGGTAGGCCGTCTCCGTCTGGATCCgtctgtctgtccctgtgtgtccatctgtcttctgtccatctgtccacctgtcctctgtctgtccatccgtctacctgtctgcccttctctctgtctgtttctgtccatcagtctgtctgctcttctgtccatctgtctgtccatcttttgtctatctgtcc	899	108	12%	98	11%
X	169988551	169989300	atctgtccgtccctctgtctgtctgtctgtccacccgtctGCACGGGCATGCACAGGAGAGAAACGGGGCAGTGAAGGAATGGAAAATCGAGATTCTCTGGTGACACTTAAGCTGCAGACCAGAAGGTCGGTCGACACACCGGCCGCCGTCCACCTCTAATGTGTTTAGGAAGGACAGACAGACATATTTAGACGTAAAGACTTAAAGGGAGTGTGATCGCCAATAAAGGATCACTTTAAAAAGAAAACACCTGTGGACCACGAGCAAATCTCACCGACAGGCGATGTGAttttcttttttttCTCGGCAGGTACGCCATCGGCCTGGCGTACAGATCGGCGCCGAAACACGAGTGGATCGGGAAGAACGCGGCGTCCTGGGCCCTCTGCCGCTGCCACAACCACTGGGCGGTGCGACACGACGGCAAGGAGACCCCCATCGCGCCGGCCCCTCACCTCAGGCGCGTCGGCGTCCTGCTGGACTACGACAACGGCTCCATCGCCTTCTACGACGCTCTGAGCTCCGTCCACCTCCACACCTTCCACGCGGCGCTCGCGCAGCCCGTGTGCCCCACCTTCACCGTGTGGAACAAGTGTCTGACCATCGTCACGGGTCTGCCCATCCCGGACCATCTGGACTGTACGGAGCAGCGACCTTGAGGGACCCGGCCCCACAGCGGCCCCGGGGAGGGACACAGGTGGAGGCCGCTGTTTATGGGGTCGAGAAACTCAGGCTTCCAGAGCGTCGT	749	128	17%	110	15%
X	169993951	169994400	ctcacagtcatccccctgcctcagagaatcacttacagtcaccccctggccccccgcaacctgaccaggcgcggcggagggagagactggggagcgcggggtgctgaggagacgtctccgtggccgccgcccgtcctcctctcgaggctcagagaaccgtgcggaagggggggcagagacgggacgagccggggagggggacggacatggaggacgcgcttccagacaccgggggacggactcgctcacgcgggggctcccggagacggtggcggcacgcagcggccactcacagtcatccccctgcctcagacagtcactcagcgtcatccccctgcctcagacagtcactcagcttcatccccctgcctcagacactcactcagcgtcatccccctgcctcagacagtcactcagcttcatccccctgcctcacacagcctctcagg	449	64	14%	90	20%
X	170009101	170011350	GGAGACACAGAGCCGCTCCCGCCAGGGGCGGGGTCACCGCGGCCTCCCGAGTCCCGCGGGGTGACGTCACGCGGGccccgggctcccgattggccgccgccgccgcccgtctctcgcggccgccgccccggccccgccccccgcgcaggcgccgcggccgTCCCTGCACACTCGCTCCTGGGATCGCCATGTGCTCGCAGCTCCGCGGACGTCCCCGGCTCCCCGCCGTCTCCCCGCGATCGGACTCGGCCTCCGCCGCCCGCGCAcggccccgccggctcccctccgcctccccgggcctccgccgccgccgcctcggcctccccggccttccccgcgcgggcgggcgggcgggcgggAGCAGCGGACCGCGCCTGCCGCCATGAGAGGTGAGTGCGGCCCCGGGCCGCGTCCCGCCCGAGCTCCCGCCTTCTCCGCTCACTCCCGGCCATCCCCCTGCCTCCGTCTCAGCCCCGCTCTCTTCCCCACAGGCTCGGCCGCGCACGGACGGGGCTTGCTCGGCCCGCAGCCGCCTCCAGGGTCCCCGGTTCccgccgccgccgccgccgccgcgtgacgtgaggcccgcccgcgcgcccgcccgggatccccagccgccaccgcgcccgcccgcccggggccccgGCTGCAGAACCGTGACGTACAAttggggtctgggggggtctggggggcatttgggggCTTTTTTAAACTCGATCCGACCGTGCGGACTTAAGATGGAGGCACTTCCTGTCTGCGGCGGGAAGAGAAGGCTCGGTCGGAGCCGGGAatgctgggacttgtagtgcgtagtcaatggttctctatgggctttcagagtgagtggcgggaaggcggccccgaggcatgctgggagttgtagtcctgccgtcgtcaatggttctctatgggctttcagagtgagtggcgggaaggcggccccgaggcatgctgggagttgtagtcctgccgtagtcaatggttctctatgggctttcagagtgagtggcgggaaggcggccccgaggcatgctgggagttgCAGCGCCATGTTTTAAAGCACGCgtttctctgtatagtcctggctgtgggtttttcactaattatttcttttagctttatttttaatttttactttttcacacaggatttctctttagagccttggctaccgttttttccctaattattcttattttcattttggtttatttttttttaattttggtttttttaagacagggtttctctgtatagacctggctgtggatttttcactaattattttttttgttttatttttaatttttacttttccagacaggatttctctttatagccttggctaccgttttttccgtaattattctccttttcatttttgtttattttttaattttaatttttgattttggagacagggtttctcttttagccgcagctatggtttctgccctaattattcttgtccttatttgtaatttaattcttaatttaatttaatttaTAAATTTTGTTGTAAGTTTTTCTGTGGGCGTGAATGGAAAGTCTAACCCGTGTTTCTCTGTTCAGCCTCCGCCGGTCACGGCCGCCGCCCCCAGCGACGTCACCCACACGCGCAGAAGCGGACGCCGCGGTCAAGATGTCTCTGCCATGCCCACGggacgcacggacgcacggacgcacggacgGACTCCACAAGGTAGGAAGCCTGCGCCGAGCGCACCGCCGCACCCACCACAGCACACAGGacacacgcgggccccgcgcccgcccaggcacacgcggcacacacggcacacacggcaggcaggccaggcacacGCATCCGCAGGACCCGCACCCGCCACGCAGACACGGACGAGCCGCCGCGGTCAAGATGTTCACCCGCCGCGGTCAAGATGTATGTGCCACCGACCCTCGCCCCGCTGGACGGACGGACGGACGCGCGCACGCCGTCAGGTAGGACACGCAGCGCCGACCACTGACACGCACGGCCGCCCACAGGGGCTCAGGGACCCGGGTGGACACCGCGACCTCCCAGTGTGGCTCGGTCCCGAGACGCCGCCCGGTGGCCGCGGGACGTCCCTGCGACGTCACGGGTCTTCTTGAAGGCTTGGttttttttcccaagcatttcgtatttttaatttttGAGAGTTTGTGCTGGACGCGGGCTCTGGGGCGCCGCCCGGGGCGCACGGGACGTCACGGCAACGGCACACGGTGTGTTTAGCTTTCATTTCTGC	2249	466	21%	242	11%
X	170018551	170020200	tgggatgaaaggtgtgcaccaccacgcccgactCCAAttttttttatttattattttttttGTTGTGTGATTTGAAAGTCTAACACGTGTTTCTCTGTTTATGGACCTGGATCCCACGCCAGCGTCCACCGGTCACTGCCGCCGCCCACAGTGATGTCACCCACGAAAGCACACACGTAGAAGCGGACGCCGTGGTCAAGATGTCTCTGCCATCCCCACAGGACGGACGGACGGACTCCACAAGGTAGGAAGCCTGCGCCGACCGCACCGCTGCACCCACCACAGCACACAGGACACACGCGGGCCCCGCGCCCGcccaggcacacgcggcacacacggcacacacggcaggcaggccaggcacacGCATCCGCAGGACCCGCCGCACCCGCCACGCAGACACGGACGAGCCGCCGCGGTCAAGATGTTCACCCGCCGTGGTCAAGATGTATGTGCCACCGACCCTCGCCCCGCTGGACGGACGGACGGACGCACGCACGCCGTCAGGTAGGACACGCAGCGCCGACCACTGACACGCACAGCCGCCCACAGGGGCTCAGGGACCCAGGTGGACAACGCGACCTCCCAGTGTGACTCAGTCCCAAGACGCCGCCCGGTGGCCGCAGGACTTCCCTGCGACGTCACGGGTCTTCTTGAAGGCTTGGTAATTTTTCCAAACAGGACGTTACTGCAACGCTCCAATTTCTGAGGTTTTTACGTTTTTAAGGCTTGGGATTTCTttttggtttttcgagacagggtttctctgtgtagccctggctgtcctggagctcaggctgtagaccaggctggcctccaactcagcaatccccctgcctctgactcccgagggctgggatagaaggcgtgcgggcgccacgacgcccggcCGGGATATCTAttttgtaatttttttcttttggttttttagagacagggttttttgttttgaatttttGAAATCAGCTCGGTTCTCTGCATCTGTCTGTCCCCCTGTCCTGGTTCTCCCTGCTTCCTGCTTCCTTTTTCTCACCTGGGACCAAGCCCGAGTCTGCATGCGAACGAGACTCACCATCCCGGcttccgtgtgtctcgctgtccccgggtttctgtctgtctctctgtccccgcccttctCCTTCCTTCTTCCACTTTCTTCCACCCGGGGACCAAGCCCGAGTCCGTGGCCCCCGCAGCTCAGGTCTCTGTCATCTCTCTGTCCCCCATCTCCCTACCTTCTCTGCCTCATGGGGACAAATCTGGGACCCGAATCCCAGCCCGGGCTCCCCAGGAGGGGTGTGGCTTCCTCAGTGGGGTCCCCGGGCAGGCAGCGTCTCAGGTCCCTGTCCCCTGCTCCCTTTGCGCCTGTAGAAGTGTAGGGAGATGAGCCTCTCTCTGACTCTTTGAATTGATTTCTGTTTTGTCTCTGGTGCTCCACCATTTAAATGAGGCGCTCAGGTAACTCACAGAGACTTTAACCAGGACCCAGGGAGCTCGCACAGATTTGCATAATGAGGCACACAGAGATGCAAATTTGCAGAAACTTTAAAATGCAACGCTCAGATTTGCACACTGAGGCGCTCAGATGCTCTGGCGCCACCCAGTGGCCACAGGACGTCACTGCAACCTTGCGATTGTTTATTGTTGGT	1649	204	12%	270	16%
Y	2605351	2605650	gcagccaatcagggagtgatgcgtcctaagcgaaggataactcctccttaaaggggacggggtttccgccattctcctctcttgcttgcgctctggcgcgcttgctctaaaagatgtaaacaatagctctcttacttgcgcttcttgcgcttttgctctggcgcgctggcgctctggctcctaaagatgtaagaagggggctttcgtttttggggcttggggttttgcgctcctgctcctgaagatgtaagcaataaagttttgccgcagaagattctggtttgttgtgtctttcctgg	299	30	10%	14	5%
Y	3335251	3336900	atacaactaaaGGGAACCACAGAGCCTGACATCCTAATGTTTTTTCCTTCCCCTTTTTATTTATtgttgggagccgcccccacattcgccgtcacaagatggcgttgacatcctgtgttctaagtggtaaacaaataatctgcgcatgtgccaagggtatttacgactacttgtactctgcttttcccgtgaacgtcagctcggccatgggctgcagccaatcagggagtgatgcgtcctaagtgaagggtaactctcctaaagagggaaggggtttcggtttcattattgaaggggctttcgttttttggggctgggcgctgggcgcttgctctcctggctcccaaagatgtaagcaataaagttttgccgcagaagattctggtctgttgcgtctttcctggccgggcgtgagaacgcgtctaataagaattggtgccgaattccgggacgagaaaaaactcgggactggcgcagggaagatccctcattccagaatcagaactgcgggtcgcggtaataaaggttcccgtaaaacagactgttaagaaggattcaactgtatgaattcagaacttttcagctggggaacgagagtaccagtgagtacagctttacgaggtaagtctgatcttgaactttctaaggaaattcaagacagtctatcagaagtaaagtggaaaatggctttgcaaggtatatttggccttgaattttttctagtgttaggagcccttttgttccttttcacatgttatcaggtgattaagatagggctgaaaattctagaggaaattcaggacaatctatcagaagtaaagcggggagagagagtaggagcaaagagaaaatatggtacacaaaataagtatacaggcctttccaagggtcttgaacccgaggaaaagtttaggtcaggtaagaatacctggggagagattagaaggaaggaaaagaaaaaagaaaagaaaaaagatcgattagcggaggtctctaggagatactcgtcactagatgagctcaggaagccagctcttagtagttctgaagcagatgaagaattctcctctgaggaaacagactgggaggaagaagcagcccattaccagccagctaattggtcaagaaaaaagccaaaagcggctggcgaaagccagcgtactgttcaacctcccggcagtcggtttcaaggtccgccctatgcggagcccccgccctgcgtagtgcgtcagcaatgcgcagagaggcaatgcgcagagagatgcgcagagaggcaatgcgcagagagatgcgcagagaggcaatgcgcagagagatgcgcagagaggcagtgcgcagagagatgcgcagagaggcagtgcgcagagagatgcgcagagaggcagtgcgcagagaggcagtgcgcagagaggcagtgcgcagagaggcagtgcgcagactcattcattcccagagaggaacaaaggaaaatacaacaggcatttccggtctttgaaggagccgagggtgggcgtgtccacgctccggtagaatacttacaaattaaagaaattgccgagtcggtccgtaaatacggaaccaatgctaattttaccttggtgcagttagacaggctcgctggcatggcactaactcctgccgactggcaa	1649	144	9%	206	12%
Y	3335251	3336900	atacaactaaaGGGAACCACAGAGCCTGACATCCTAATGTTTTTTCCTTCCCCTTTTTATTTATtgttgggagccgcccccacattcgccgtcacaagatggcgttgacatcctgtgttctaagtggtaaacaaataatctgcgcatgtgccaagggtatttacgactacttgtactctgcttttcccgtgaacgtcagctcggccatgggctgcagccaatcagggagtgatgcgtcctaagtgaagggtaactctcctaaagagggaaggggtttcggtttcattattgaaggggctttcgttttttggggctgggcgctgggcgcttgctctcctggctcccaaagatgtaagcaataaagttttgccgcagaagattctggtctgttgcgtctttcctggccgggcgtgagaacgcgtctaataagaattggtgccgaattccgggacgagaaaaaactcgggactggcgcagggaagatccctcattccagaatcagaactgcgggtcgcggtaataaaggttcccgtaaaacagactgttaagaaggattcaactgtatgaattcagaacttttcagctggggaacgagagtaccagtgagtacagctttacgaggtaagtctgatcttgaactttctaaggaaattcaagacagtctatcagaagtaaagtggaaaatggctttgcaaggtatatttggccttgaattttttctagtgttaggagcccttttgttccttttcacatgttatcaggtgattaagatagggctgaaaattctagaggaaattcaggacaatctatcagaagtaaagcggggagagagagtaggagcaaagagaaaatatggtacacaaaataagtatacaggcctttccaagggtcttgaacccgaggaaaagtttaggtcaggtaagaatacctggggagagattagaaggaaggaaaagaaaaaagaaaagaaaaaagatcgattagcggaggtctctaggagatactcgtcactagatgagctcaggaagccagctcttagtagttctgaagcagatgaagaattctcctctgaggaaacagactgggaggaagaagcagcccattaccagccagctaattggtcaagaaaaaagccaaaagcggctggcgaaagccagcgtactgttcaacctcccggcagtcggtttcaaggtccgccctatgcggagcccccgccctgcgtagtgcgtcagcaatgcgcagagaggcaatgcgcagagagatgcgcagagaggcaatgcgcagagagatgcgcagagaggcaatgcgcagagagatgcgcagagaggcagtgcgcagagagatgcgcagagaggcagtgcgcagagagatgcgcagagaggcagtgcgcagagaggcagtgcgcagagaggcagtgcgcagagaggcagtgcgcagactcattcattcccagagaggaacaaaggaaaatacaacaggcatttccggtctttgaaggagccgagggtgggcgtgtccacgctccggtagaatacttacaaattaaagaaattgccgagtcggtccgtaaatacggaaccaatgctaattttaccttggtgcagttagacaggctcgctggcatggcactaactcctgccgactggcaa	1649	144	9%	206	12%
Y	10707751	10708050	tatctcctatatgcctccattagacgctcaagaaagactgatggtggttcagtctgcccctgcaagacctctcttaccttagccaaattggtgggccgtctagcggctcctctgagacctgccactagagtccggcgatagacaaggaggcgtcccctaccttccgcggtgttgtagtcccagttggggcggttcaagggaaaagcctcgtccacgagattagggagggcagtgggtgtgccgtcctctcccagaacattttttctcgcctccatcaggattctttctctttcttctgt	299	26	9%	30	10%
Y	10708801	10709400	aaggggagtggacacagattgtcccatttctagaaaaacagtagttacaacaagagcggacacaagactgagacaaaaaagaaaccagaaacggcggcgacttcgcgtcgaccacaagcaactcaaagaatcagatggcctctctaaggccggccgattgagaccctctgcacgaggtgggactcgaacccacgatcccgtgaccaaacgcgaggtgggactcgaacccacgctctcgcaacaaggtgcgaggtgggactcaaacccacgatctcgcaacaaaacgcgaggtgggactcgaacccacgatctcgcaactgggcacgaggtgggactcaaacccacgatctcgcaaccccaaatggtctcttggccttcaaaggggtccaccaggcgtccctgatcctcccctgttcctcctgagacgtctcccagggtgaacggactgtggacacctggacacgtctatccttatccaccccgcgctccctctcggagcgcggtctcactgagcatccgcaaaactgaaactgcgatcgcaccaaacttagaaacaaaacacagacatcagaacacagacatcagaacacagacatcag	599	82	14%	114	19%
Y	21227101	21227550	aaagggtaccagccaggtaaagtgctagctaatcagttaaggaagccaaaagcggctggcgaaggccagtttgctgattggcctcagggcagtcggcttcaaggtccgccctatgcggagtccccgccctgcgtagtgcgtcagccctgcgcagagaggcagtgcgcagactcattcattcccagagaggaacaaaggaaaatacaacaggcatttccggtctttgaaggagccgagggtgggcgtgtccacgctccggtagaatatttacaaattaaagaaattgccgagtcggttcgtaaatacggaaccaatgctaattttaccttggtgcagttagacaggctcgccggcatggcactaactcctgccgactggcaaacggttgtaaaagccgctctccctagtatgggcaaatatatggaatggagagcgctttggcacgaagc	449	52	12%	58	13%
Y	35099851	35100000	gctgcaagaaattttcataacaattttcatgtgacggctgaaacattacgcagtcgtttctccttgacaagaaaagaagcccgtgacattgttactcaatgtcaaagctgctgtgagttcttgccagttcctcatgtgggaattaaccc	149	8	5%	24	16%
Y	74732551	74732850	cccggaattcggcaccaattgttattagacgcgttctcacgcccggccaggaaagacgcaacagaccagaatcttctgcggcaaaactttattgcttacatctttgggagccaggagagcaagcgcccagcgcccagccccaaaaacgaaagcccctcaataattttaggagccagagctccggcgcgccaaagcgcagagcgtgctctattgtttacatctttaggcagcgagcgagcgcagggcgcgcagagccagagagatgccagcgagagagaatggcggaaaaccccgtcccc	299	48	16%	48	16%
Y	89125951	89126700	actcgtcactagatgagctcaggaagccagctcttagtagctctgaagcaagtgaagaatcctcctctgaggaaacagactgggaggaagaagcagcccattaccagccagctaattggtcaagaaaaaagccaaaagcggctggcgaaagtcagcgtactgttcaacctcccggcagtcggtttcaaggtccgccctatgcggagcccccgccctgcgtagtgcgtcagcaatgcgcagagaggcagtgcgcagagagatgcgcagaggggcagtgcgcagagaggcagtgcgcagagaggcagtgcgcagattcattcattccccgagaggaacaaaagaaaatacaacaggcatttccggtctttgaaggagccgagggtgggcgtgtccacgctccggtagaatacgtacagattaaggaaattgccgagtcggttcgtaaatacggaaccaatgctaattttaccttggtgcagttagacaggctcgctggtatggcactaacgcctgctgattggcagacggttgtaaaagccgctctccctagtatgggcaaatatatggaatggaaagcgctttggcacgaagctgcacaggcgcaggcccgagcaaatgcagctgctttgactccagagcagagagattggacttttgacttgttaacgggtcagggagcttattctgctgatcagacaaactaccattggggagcttatgcccagatttcttccacggctattagggcc	749	76	10%	110	15%
Y	90738901	90739350	CTCAGGTCTGCACACGGAGGCCCAGATGTTCAGATTAGACTCAGAGCAGCATAATGAGATGCAGAGGAACCTCAGGTCTGCACACGGAGGCAGCAGACACGCAACTGATGATTAGCACAATGAGGCCGCCTCACACTCCAATTAGGCGGGGTGTCCAAACACTCACACCCTTAAACAGCGAGTCGCCACGGTCCCGTCCACAGACGCTGACCCCCCTCCCTCTCTTCCCGTCTTTTCCAGGTGCGCGTGTCGCCGAGGCCGCCAGGACGGAGCGATTCTCACGGAGGAAGGAGCACGCCAACAGGGCCTGACTGCGTACAGACATGTCCCCCTCAATAAAATTGCAGTTGAAATGGATATGCAAATGTGTGTGTGTCTTCCTTCTGCGACAGACGGAACAGAAAAGACAGGGACGATAAAGAAAATGTAAAAACCGCCCCTAAAGTGTG	449	50	11%	86	19%
Y	90741901	90742500	CGCGGAAGCCGGGATGGGTCCCTCGATGGCGGACGCCGACGCCAGGCAGCCCCGGGTGGAAGGgaggaggagagagacttagacagagagacacagagacagagagacagagagagGCTCGTCTCCTACACTTCTACAGGTACAACGGGAGCGGAGGACGCAGACCTGAGACGCCGCCTGCCCGGGGACCCCAATGACAGAGCCACACCTCTCGTCGGGAACCCGGGCTGGGGTTCGGGTCCCAGATTCGACCCCACGAGACAGAGAAGGTAGGGAGACGGGGGGGACAGAGAGATGACAGAGACCTGAGCTGCGGgggacacggactcgggcttggtccccgggtggaagaaagtggaggaaggatggagacagacagagacccggggacggcgagacgcacggaagccgggatggtgcgtctcggtcggatgcagactcgggcttggtccccggggagaagaaggaagcagggagaaggaaggagaagggagaaccaggacagggggacagggggacagacagacccgaactacacgggactcggactcgggcttggtccccgggtggaagaaggaaggagaagggaggttgacaga	599	86	14%	66	11%
Y	90755401	90755550	GGAAGtttttttttCCCGGCGTGCTCTCTGTCGCCACCCGGTGGTGACAGAGGAGAATGCGGTGGTCGTGACCGTTCGATTTTCCTTTTTTTCAAAGGACACTTGTTTTTGGTTTCCGTGAGCGTTGATTCTTTTGGAAAGCATCTGCG	149	22	15%	10	7%
Y	90762751	90763650	tgcccttctctctgtctgtttctgtccatcagtctgtctgctcttctgtccatctgtctgtccatcttttgtctatctgtccgtccctctgtctgtctgtctgtccacccgtctGCACGGGCATGCACAGGAGAGAAACGGGGCAGTGAAGGAATGGAAAATCGAGATTCTCTGGTGACACTTAAGCTGCAGACCAGAAGGTCGGTCGACACACCGGCCGCCGTCCACCTCTAATGTGTTTAGGAAGGACAGACAGACATATTTAGACGTAAAGACTTAAAGGGAGTGTGATCGCCAATAAAGGATCACTTTAAAAAGAAAACACCTGTGGACCACGAGCAAATCTCACCGACAGGCGATGTGAttttcttttttttCTCGGCAGGTACGCCATCGGCCTGGCGTACAGATCGGCGCCGAAACACGAGTGGATCGGGAAGAACGCGGCGTCCTGGGCCCTCTGCCGCTGCCACAACCACTGGGCGGTGCGACACGACGGCAAGGAGACCCCCATCGCGCCGGCCCCTCACCTCAGGCGCGTCGGCGTCCTGCTGGACTACGACAACGGCTCCATCGCCTTCTACGACGCTCTGAGCTCCGTCCACCTCCACACCTTCCACGCGGCGCTCGCGCAGCCCGTGTGCCCCACCTTCACCGTGTGGAACAAGTGTCTGACCATCGTCACGGGTCTGCCCATCCCGGACCATCTGGACTGTACGGAGCAGCGACCTTGAGGGACCCGGCCCCACAGCGGCCCCGGGGAGGGACACAGGTGGAGGCCGCTGTTTATGGGGTCGAGAAACTCAGGCTTCCAGAGCGTCGTGACATCTTCCCCAATCTGTCcagaaaatcactcacagtcatccccctgcctcacacggtcactcagggtcatcccc	899	130	14%	142	16%
Y	90784051	90786300	CACCGCGGCCTCCCGAGTCCCGCGGGGTGACGTCACGCGGGCCCCGGGCTCCCGATTGGCcgccgccgccgcccgtctctcgcggccgccgccccggccccgccccccgcgcaggcgccgcGGCCGTCCCTGCACACTCGCTCCTGGGATCGCCATGTGCTCGCAGCTCCGCGGACGTCCCCGGCTCCCCGCCGTCTCCCCGCGATCGGACTCGGCCTCCgccgcccgcgcacggccccgccggctcccctccgcctccccgggcctccgccgccgccgcctcggcctccccggccttccccgcgcgggcgggcgggcgggcgggAGCAGCGGACCGCGCCTGCCGCCATGAGAGGTGAGTGCGGCCCCGGGCCGCGTCCCGCCCGAGCTCCCGCCTTCTCCGCTCACTCCCGGCCATCCCCCTGCCTCCGTCTCAGCCCCGCTCTCTTCCCCACAGGCTCGGCCGCGCACGGACGGGGCTTGCTCGGCCCGCAGCCGCCTCCAGGGTCCCCGGTTCccgccgccgccgccgccgccgcgtgacgtgaggcccgcccgcgcgcccgcccgggatccccagccgccaccgcgcccgcccgcccgGGGCCCCGGCTGCAGAACCGTGACGTACAAttggggtctgggggggtctggggggcatttgggggCTTTTTTAAACTCGATCCGACCGTGCGGACTTAAGATGGAGGCACTTCCTGTCTGCGGCGGGAAGAGAAGGCTCGGTCGGAGCCGGGAatgctgggacttgtagtgcgtagtcaatggttctctatgggctttcagagtgagtggcgggaaggcggccccgaggcatgctgggagttgtagtcctgccgtcgtcaatggttctctatgggctttcagagtgagtggcgggaaggcggccccgaggcatgctgggagttgtagtcctgccgtagtcaatggttctctatgggctttcagagtgagtggcgggaaggcggccccgaggcatgctgggagttgCAGCGCCATGTTTTAAAGCACGCgtttctctgtatagtcctggctgtgggtttttcactaattatttcttttagctttatttttaatttttactttttcacacaggatttctctttagagccttggctaccgttttttccctaattattcttattttcattttggtttatttttttttaattttggtttttttaagacagggtttctctgtatagacctggctgtggatttttcactaattattttttttgttttatttttaatttttacttttccagacaggatttctctttatagccttggctaccgttttttccgtaattattctccttttcatttttgtttattttttaattttaatttttgattttggagacagggtttctcttttagccgcagctatggtttctgccctaattattcttgtccttatttgtaatttaattcttaatttaatttaatttaTAAATTTTGTTGTAAGTTTTTCTGTGGGCGTGAATGGAAAGTCTAACCCGTGTTTCTCTGTTCAGCCTCCGCCGGTCACGGCCGCCGCCCCCAGCGACGTCACCCACACGCGCAGAAGCGGACGCCGCGGTCAAGATGTCTCTGCCATGCCCACGggacgcacggacgcacggacgcacggacgGACTCCACAAGGTAGGAAGCCTGCGCCGAGCGCACCGCCGCACCCACCACAGCACACAGGacacacgcgggccccgcgcccgcccaggcacacgcggcacacacggcacacacggcaggcAGGCCAGGCACACGCATCCGCAGGACCCGCACCCGCCACGCAGACACGGACGAGCCGCCGCGGTCAAGATGTTCACCCGCCGCGGTCAAGATGTATGTGCCACCGACCCTCGCCCCGCTGGACGGACGGACGGACGCGCGCACGCCGTCAGGTAGGACACGCAGCGCCGACCACTGACACGCACGGCCGCCCACAGGGGCTCAGGGACCCGGGTGGACACCGCGACCTCCCAGTGTGGCTCGGTCCCGAGACGCCGCCCGGTGGCCGCGGGACGTCCCTGCGACGTCACGGGTCTTCTTGAAGGCTTGGttttttttcccaagcatttcgtatttttaatttttGAGAGTTTGTGCTGGACGCGGGCTCTGGGGCGCCGCCCGGGGCGCACGGGACGTCACGGCAACGGCACACGGTGTGTTTAGCTTTCATTTCTGCCGTGGGAGGTTTATGCCAGCGCAACAATTGGTGG	2249	462	21%	240	11%
Y	90793351	90794850	AGAAGCGGACGCCGTGGTCAAGATGTCTCTGCCATCCCCACAGGACGGACGGACGGACTCCACAAGGTAGGAAGCCTGCGCCGACCGCACCGCTGCACCCACCACAgcacacaggacacacgcgggccccgcgcccgcccaggcacacgcggcacacacggcacacacggcaggcaggccaggcacacgcaTCCGCAGGACCCGCCGCACCCGCCACGCAGACACGGACGAGCCGCCGCGGTCAAGATGTTCACCCGCCGTGGTCAAGATGTATGTGCCACCGACCCTCGCCCCGCTGGACGGACGGACGGACGCACGCACGCCGTCAGGTAGGACACGCAGCGCCGACCACTGACACGCACAGCCGCCCACAGGGGCTCAGGGACCCAGGTGGACAACGCGACCTCCCAGTGTGACTCAGTCCCAAGACGCCGCCCGGTGGCCGCAGGACTTCCCTGCGACGTCACGGGTCTTCTTGAAGGCTTGGTAATTTTTCCAAACAGGACGTTACTGCAACGCTCCAatttctgaggtttttacgtttttaaggcttgggatttctttttggtttttcgagacagggtttctctgtgtagccctggctgtcctggagctcaggctgtagaccaggctggcctccaactcagcaatccccctgcctctgactcccgagggctgggatagaaggcgtgcgggcgccacgacgcccggcCGGGATATCTattttgtaatttttttcttttggttttttagagacagggttttttgttttgaatttTTGAAATCAGCTCGGTTCTCTGCATCTGTCTGTCCCCCTGTCCTGGTTCTCCCTGCTTCCTGCTTCCTTTTTCTCACCTGGGACCAAGCCCGAGTCTGCATGCGAACGAGACTCACCATCCCGGcttccgtgtgtctcgctgtccccgggtttctgtctgtctctctgtccccgcccttctCCTTCCTTCTTCCACTTTCTTCCACCCGGGGACCAAGCCCGAGTCCGTGGCCCCCGCAGCTCAGGTCTCTGTCATCTCTCTGTCCCCCATCTCCCTACCTTCTCTGCCTCATGGGGACAAATCTGGGACCCGAATCCCAGCCCGGGCTCCCCAGGAGGGGTGTGGCTTCCTCAGTGGGGTCCCCGGGCAGGCAGCGTCTCAGGTCCCTGTCCCCTGCTCCCTTTGCGCCTGTAGAAGTGTAGGGAGATGAGCCTCTCTCTGACTCTTTGAATTGATTTCTGTTTTGTCTCTGGTGCTCCACCATTTAAATGAGGCGCTCAGGTAACTCACAGAGACTTTAACCAGGACCCAGGGAGCTCGCACAGATTTGCATAATGAGGCACACAGAGATGCAAATTTGCAGAAACTTTAAAATGCAACGCTCAGATTTGCACACTGAGGCGCTCAGATGCTCTGGCGCCACCCAGTGGCCACAGGACGTCACTGCAACCTTGCGATTGTTTATTGTTGGTTTTCTTCAAGACGAGGTATTTTTCTTTT	1499	188	13%	240	16%
Y	90825151	90825750	GGACTCGCGGAAGCCGGGATGGGTCCCTCGATGGCGGACGCCGACGCCAGGCAGCCCCGGGTGGAAGggaggaggaggagagagacttagacacagagacagagagacacagagacagagagacagagagacagagacagagagagGCTCGTCTCCTACACTTCTACAGGTACAACGGGAGCGGAGGACGCAGACCTGAGACGCCGCCTGCCCGGGGACCCCAATGACAGAGCCACACCTCTCGTCGGGAGCCCGGGCTGGGGTTCGGGTCCCAGATTCGACCCCATGAGGCAGAGAAGGTAGGGAgacggggggacagagagatgacagagacccgagctgctcgggacacggactcgggcttggtccccgggtggaagaaagtggaagaaggaaggagacggagagacccggggacggcgagacgcacggaagccgggatggtgcgtctcggtcggatgcagactcgggcttggtccccagggagaaggaagcagggagaaggaaggagaagggagaaccaggacagggggacagtgggacagacagacccagactgcgcgggacacggactcgggcttggtccctgggtggaagaa	599	84	14%	72	12%
Y	90827101	90827400	ggaagcaggagaaggaagaaccgggacagggggacagacagacgcagagacccgagctgcgcgggccacggcagagaccaggcaggccgggatggaagaaggaagcaggaagaaggaagaaccgggacagggggacagggggacagacagacccagactgcgcgggacacggactcgggcttggtccctgggtggaagaaggaaggagaagggaggttgacagacagagaccgggggacggcgagacacacggaagccgggatggtgcatctcggtcggatgcagactcgggcttggtc	299	40	13%	44	15%
Y	90839701	90839850	ACAATTATGTGACAGAAAACAGCTACAGAAGAAATTGGGCAATCCGACCCCTCGGAGGAAGtttttttttCCCGGCGTGCTCTCTGTCGCCACCCGGTGGTGACAGAGGAGAATGCGGTGGTCGTGACCGTTCGATTTTCCTTTTTTTC	149	20	13%	14	9%
Y	90844351	90844650	tgtgagccaccatgtggttgctgggatttgaactctggaccttcggaagagcagtcgggtgctcttacccactgagccatctcaccagcccGGATGTAGTTTTAAAAAAGAAGCCGGTAACCACATACACACTGTGAATCCATTGATCACCTCATAACATAGATATCCAAACTCAACCACTCTTACGTAAAATGTATTATCAGAGGTTAAAATTGTAGATATTAATTAGGATTGTTTGTACGGAATAGAGAAAAGTGTGGCAGAAAAGCGGAACGCGCAAAGAGAACGTATATGGTACG	299	20	7%	42	14%
